Month,Cbs district,City symbol,Name,City or Regional council,Total jobseekers,Men,Weman,Academic,Non academic,Hh,Unemployed job seekers,Placement from reference,Estimated unemployed rate in city
2010-01,אזור יהודה והשומרון,3760,אורנית,יישוב,83,34,49,36,47,4,83,2,2.22%
2010-01,אזור יהודה והשומרון,3750,אלפי מנשה,יישוב,88,38,50,26,62,5,88,4,2.18%
2010-01,אזור יהודה והשומרון,3560,אלקנה,יישוב,20,12,8,9,11,2,20,2,1.19%
2010-01,אזור יהודה והשומרון,3650,אפרתה,יישוב,48,28,20,18,30,8,48,5,1.37%
2010-01,אזור יהודה והשומרון,3570,אריאל,יישוב,410,189,221,111,299,156,410,16,4.12%
2010-01,אזור יהודה והשומרון,3574,בית אל,יישוב,41,22,19,18,23,15,41,2,1.93%
2010-01,אזור יהודה והשומרון,3652,בית אריה,יישוב,59,28,31,10,49,4,59,0,2.78%
2010-01,אזור יהודה והשומרון,3780,ביתר עילית,יישוב,318,152,166,13,305,181,313,8,3.78%
2010-01,אזור יהודה והשומרון,3730,גבעת זאב,יישוב,153,68,85,25,128,32,153,6,2.55%
2010-01,אזור יהודה והשומרון,3769,הר אדר,יישוב,29,14,15,16,13,4,29,2,1.69%
2010-01,אזור יהודה והשומרון,3797,מודיעין עילית,יישוב,261,98,163,14,247,93,261,8,2.53%
2010-01,אזור יהודה והשומרון,3616,מעלה אדומים,יישוב,590,253,337,93,497,242,584,36,3.32%
2010-01,אזור יהודה והשומרון,3660,עמנואל,יישוב,97,55,42,5,92,74,97,2,10.20%
2010-01,אזור יהודה והשומרון,3557,קדומים,יישוב,22,11,11,7,15,6,22,2,1.38%
2010-01,אזור יהודה והשומרון,3611,קריית ארבע,יישוב,121,64,57,24,97,67,121,4,4.34%
2010-01,אזור יהודה והשומרון,3640,קרני שומרון,יישוב,76,42,34,13,63,23,76,3,2.34%
2010-01,הדרום,31,אופקים,יישוב,1368,579,789,95,1273,1054,1358,39,12.11%
2010-01,הדרום,2600,אילת,יישוב,1534,707,827,73,1461,732,1519,42,4.95%
2010-01,הדרום,70,אשדוד,יישוב,7073,2794,4279,823,6250,4675,7025,180,7.04%
2010-01,הדרום,7100,אשקלון,יישוב,3890,1604,2286,611,3279,2392,3833,214,6.66%
2010-01,הדרום,9000,באר שבע,יישוב,7816,3354,4462,1013,6803,5568,7774,306,8.25%
2010-01,הדרום,2200,דימונה,יישוב,2033,898,1135,138,1895,1502,2009,108,11.53%
2010-01,הדרום,1303,חורה,יישוב,673,308,365,0,673,612,673,4,22.49%
2010-01,הדרום,831,ירוחם,יישוב,428,219,209,32,396,306,419,26,10.19%
2010-01,הדרום,1059,כסיפה,יישוב,947,425,522,1,946,853,946,14,25.60%
2010-01,הדרום,1271,להבים,יישוב,48,24,24,27,21,3,48,4,1.57%
2010-01,הדרום,1060,לקיה,יישוב,899,429,470,5,894,830,897,3,28.13%
2010-01,הדרום,1268,מיתר,יישוב,57,25,32,25,32,6,57,5,1.55%
2010-01,הדרום,99,מצפה רמון,יישוב,223,85,138,23,200,135,209,28,9.47%
2010-01,הדרום,246,נתיבות,יישוב,865,374,491,43,822,538,857,25,7.44%
2010-01,הדרום,666,עומר,יישוב,52,19,33,24,28,6,52,4,1.40%
2010-01,הדרום,2560,ערד,יישוב,1033,421,612,202,831,736,1014,64,8.18%
2010-01,הדרום,1192,ערערה-בנגב,יישוב,902,364,538,3,899,804,901,6,28.77%
2010-01,הדרום,2630,קריית גת,יישוב,2478,987,1491,207,2271,1729,2474,107,9.91%
2010-01,הדרום,1034,קריית מלאכי,יישוב,1191,525,666,32,1159,865,1180,41,11.04%
2010-01,הדרום,1161,רהט,יישוב,2925,1206,1719,8,2917,2605,2922,51,20.88%
2010-01,הדרום,1286,שגב-שלום,יישוב,530,220,310,1,529,483,529,5,25.82%
2010-01,הדרום,1031,שדרות,יישוב,809,337,472,49,760,443,807,30,7.49%
2010-01,הדרום,1054,תל שבע,יישוב,1153,555,598,5,1148,1035,1149,16,30.04%
2010-01,המרכז,182,אבן יהודה,יישוב,142,68,74,44,98,24,142,4,2.39%
2010-01,המרכז,41,אליכין,יישוב,47,20,27,4,43,13,47,1,3.00%
2010-01,המרכז,1309,אלעד,יישוב,362,167,195,34,328,108,360,9,3.43%
2010-01,המרכז,2530,באר יעקב,יישוב,238,111,127,36,202,88,232,8,3.33%
2010-01,המרכז,466,בית דגן,יישוב,111,61,50,17,94,38,111,4,3.40%
2010-01,המרכז,1066,"בני עי""ש",יישוב,189,87,102,37,152,95,185,6,4.80%
2010-01,המרכז,681,גבעת שמואל,יישוב,248,121,127,94,154,53,248,15,2.39%
2010-01,המרכז,2550,גדרה,יישוב,353,159,194,66,287,121,350,4,3.50%
2010-01,המרכז,627,ג'לג'וליה,יישוב,50,26,24,0,50,27,50,0,1.78%
2010-01,המרכז,166,גן יבנה,יישוב,325,132,193,42,283,107,324,18,3.37%
2010-01,המרכז,229,גני תקווה,יישוב,169,81,88,43,126,25,168,3,2.42%
2010-01,המרכז,9700,הוד השרון,יישוב,557,238,319,185,372,61,557,23,2.24%
2010-01,המרכז,1290,זמר,יישוב,181,65,116,3,178,136,181,5,7.42%
2010-01,המרכז,2730,טייבה,יישוב,2045,878,1167,7,2038,1745,2034,31,13.91%
2010-01,המרכז,2720,טירה,יישוב,274,136,138,3,271,177,273,10,3.08%
2010-01,המרכז,2660,יבנה,יישוב,959,434,525,69,890,526,953,36,5.32%
2010-01,המרכז,9400,יהוד,יישוב,477,196,281,60,417,90,459,20,3.15%
2010-01,המרכז,1224,כוכב יאיר,יישוב,85,35,50,47,38,4,85,1,1.62%
2010-01,המרכז,633,כפר ברא,יישוב,23,12,11,0,23,9,23,0,2.26%
2010-01,המרכז,168,כפר יונה,יישוב,352,146,206,50,302,99,348,17,3.70%
2010-01,המרכז,6900,כפר סבא,יישוב,1130,518,612,326,804,260,1124,42,2.46%
2010-01,המרכז,634,כפר קאסם,יישוב,175,88,87,2,173,104,175,1,2.70%
2010-01,המרכז,7000,לוד,יישוב,2255,946,1309,191,2064,1429,2235,198,6.82%
2010-01,המרכז,1200,מודיעין-מכבים-רעות*,יישוב,827,360,467,332,495,81,821,50,2.25%
2010-01,המרכז,28,מזכרת בתיה,יישוב,158,70,88,33,125,42,155,0,2.82%
2010-01,המרכז,7200,נס ציונה,יישוב,641,276,365,132,509,224,634,5,3.20%
2010-01,המרכז,7400,נתניה,יישוב,4514,2028,2486,740,3774,2173,4463,191,4.79%
2010-01,המרכז,587,סביון*,יישוב,16,7,9,7,9,1,16,0,0.99%
2010-01,המרכז,171,פרדסייה,יישוב,77,31,46,11,66,10,76,2,2.25%
2010-01,המרכז,7900,פתח תקווה,יישוב,3890,1742,2148,775,3115,1385,3871,86,3.59%
2010-01,המרכז,195,קדימה-צורן,יישוב,235,103,132,70,165,49,233,17,2.72%
2010-01,המרכז,638,קלנסווה,יישוב,930,376,554,1,929,763,922,19,12.95%
2010-01,המרכז,469,קריית עקרון,יישוב,251,125,126,18,233,129,249,5,4.69%
2010-01,המרכז,2640,ראש העין,יישוב,684,335,349,79,605,197,671,56,3.36%
2010-01,המרכז,8300,ראשון לציון,יישוב,4459,1971,2488,917,3542,1977,4443,121,3.54%
2010-01,המרכז,8400,רחובות,יישוב,2445,1088,1357,519,1926,1114,2412,63,4.25%
2010-01,המרכז,8500,רמלה,יישוב,1772,814,958,116,1656,983,1725,86,5.42%
2010-01,המרכז,8700,רעננה,יישוב,698,331,367,266,432,103,696,30,2.01%
2010-01,המרכז,1304,שוהם,יישוב,165,69,96,80,85,3,165,22,1.73%
2010-01,המרכז,154,תל מונד,יישוב,142,57,85,42,100,25,142,8,2.66%
2010-01,הצפון,473,אבו סנאן,יישוב,679,257,422,10,669,555,675,4,14.24%
2010-01,הצפון,478,אכסאל,יישוב,663,291,372,17,646,552,661,2,14.18%
2010-01,הצפון,529,אעבלין,יישוב,669,280,389,12,657,577,669,1,14.23%
2010-01,הצפון,482,בועיינה-נוג'ידאת,יישוב,503,214,289,5,498,425,499,1,15.80%
2010-01,הצפון,4001,בוקעאתא,יישוב,373,170,203,2,371,308,365,0,15.75%
2010-01,הצפון,998,ביר אל-מכסור,יישוב,425,177,248,2,423,324,424,0,14.20%
2010-01,הצפון,480,בית ג'ן,יישוב,333,110,223,3,330,242,331,2,8.07%
2010-01,הצפון,9200,בית שאן,יישוב,786,335,451,18,768,453,782,47,8.49%
2010-01,הצפון,944,בסמת טבעון,יישוב,308,117,191,3,305,243,308,3,11.34%
2010-01,הצפון,483,בענה,יישוב,464,193,271,1,463,419,464,1,16.53%
2010-01,הצפון,1292,ג'דיידה-מכר,יישוב,1393,595,798,6,1387,1178,1393,9,18.32%
2010-01,הצפון,485,ג'ולס,יישוב,182,65,117,6,176,117,182,3,7.82%
2010-01,הצפון,487,ג'ש (גוש חלב),יישוב,56,22,34,3,53,31,56,1,3.94%
2010-01,הצפון,489,דבורייה,יישוב,421,203,218,14,407,329,421,2,11.70%
2010-01,הצפון,490,דייר אל-אסד,יישוב,444,185,259,7,437,359,444,1,10.75%
2010-01,הצפון,492,דייר חנא,יישוב,666,298,368,13,653,517,666,4,16.97%
2010-01,הצפון,975,זרזיר,יישוב,303,126,177,2,301,217,299,9,12.36%
2010-01,הצפון,496,חורפיש,יישוב,138,50,88,7,131,100,138,1,6.67%
2010-01,הצפון,2034,חצור הגלילית,יישוב,285,127,158,13,272,155,282,22,6.51%
2010-01,הצפון,6700,טבריה,יישוב,1874,833,1041,110,1764,1297,1789,41,8.91%
2010-01,הצפון,962,טובא-זנגרייה,יישוב,355,163,192,3,352,266,352,19,13.33%
2010-01,הצפון,498,טורעאן,יישוב,565,219,346,11,554,470,563,8,12.29%
2010-01,הצפון,8900,טמרה,יישוב,2064,904,1160,20,2044,1832,2059,5,17.67%
2010-01,הצפון,1295,יאנוח-ג'ת,יישוב,159,56,103,5,154,115,159,6,7.54%
2010-01,הצפון,46,יבנאל,יישוב,109,68,41,6,103,79,103,0,7.92%
2010-01,הצפון,499,יפיע,יישוב,684,305,379,14,670,533,679,9,10.48%
2010-01,הצפון,240,יקנעם עילית,יישוב,535,190,345,106,429,256,532,35,5.22%
2010-01,הצפון,502,ירכא,יישוב,429,175,254,3,426,330,429,3,9.66%
2010-01,הצפון,504,כאבול,יישוב,777,365,412,22,755,644,774,0,18.62%
2010-01,הצפון,505,כאוכב אבו אל-היג'א,יישוב,230,84,146,5,225,185,230,0,16.11%
2010-01,הצפון,1296,כסרא-סמיע,יישוב,248,85,163,4,244,197,247,12,9.24%
2010-01,הצפון,978,כעביה-טבאש-חג'אג'רה,יישוב,225,99,126,2,223,159,224,4,11.93%
2010-01,הצפון,1263,כפר ורדים,יישוב,58,24,34,26,32,8,58,2,2.00%
2010-01,הצפון,507,כפר יאסיף,יישוב,443,187,256,4,439,359,443,5,10.53%
2010-01,הצפון,508,כפר כמא,יישוב,91,43,48,4,87,47,89,1,6.60%
2010-01,הצפון,509,כפר כנא,יישוב,1238,530,708,13,1225,1048,1223,17,16.79%
2010-01,הצפון,510,כפר מנדא,יישוב,880,428,452,13,867,673,869,8,14.81%
2010-01,הצפון,47,כפר תבור,יישוב,41,18,23,11,30,6,41,2,2.47%
2010-01,הצפון,1139,כרמיאל,יישוב,1729,660,1069,347,1382,1036,1684,60,6.86%
2010-01,הצפון,481,מגאר,יישוב,1451,596,855,34,1417,1246,1448,1,19.62%
2010-01,הצפון,516,מג'ד אל-כרום,יישוב,694,317,377,9,685,549,693,0,13.07%
2010-01,הצפון,874,מגדל העמק,יישוב,975,411,564,93,882,531,952,74,7.65%
2010-01,הצפון,4201,מג'דל שמס,יישוב,461,171,290,21,440,388,456,1,11.72%
2010-01,הצפון,517,מזרעה,יישוב,179,70,109,1,178,145,177,0,11.06%
2010-01,הצפון,4203,מסעדה,יישוב,181,66,115,3,178,153,180,0,12.56%
2010-01,הצפון,518,מעיליא,יישוב,66,29,37,7,59,36,66,2,4.74%
2010-01,הצפון,1063,מעלות-תרשיחא,יישוב,1072,444,628,140,932,717,1066,67,9.35%
2010-01,הצפון,520,משהד,יישוב,329,128,201,7,322,282,323,3,12.43%
2010-01,הצפון,9100,נהרייה,יישוב,2124,962,1162,251,1873,1419,2110,44,7.59%
2010-01,הצפון,522,נחף,יישוב,480,203,277,10,470,410,478,0,11.75%
2010-01,הצפון,7300,נצרת,יישוב,2006,979,1027,42,1964,1430,1999,7,7.14%
2010-01,הצפון,1061,נצרת עילית,יישוב,1626,709,917,254,1372,920,1567,118,7.01%
2010-01,הצפון,525,סאג'ור,יישוב,115,44,71,1,114,86,113,0,8.08%
2010-01,הצפון,7500,סח'נין,יישוב,2005,917,1088,27,1978,1720,2005,7,17.51%
2010-01,הצפון,4501,ע'ג'ר,יישוב,134,53,81,5,129,105,133,0,15.08%
2010-01,הצפון,530,עיילבון,יישוב,202,86,116,9,193,165,200,1,9.39%
2010-01,הצפון,511,עילוט,יישוב,329,143,186,2,327,258,329,2,14.22%
2010-01,הצפון,532,עין מאהל,יישוב,483,258,225,1,482,370,478,6,11.59%
2010-01,הצפון,7600,עכו,יישוב,3367,1521,1846,147,3220,2640,3345,40,13.80%
2010-01,הצפון,7700,עפולה,יישוב,1753,766,987,216,1537,1035,1704,51,7.85%
2010-01,הצפון,531,עראבה,יישוב,1340,580,760,31,1309,1150,1339,3,16.63%
2010-01,הצפון,535,פסוטה,יישוב,143,64,79,8,135,106,143,2,9.54%
2010-01,הצפון,536,פקיעין (בוקייעה),יישוב,156,80,76,7,149,115,154,3,6.57%
2010-01,הצפון,8000,צפת,יישוב,989,469,520,88,901,687,984,19,8.70%
2010-01,הצפון,4100,קצרין,יישוב,209,90,119,43,166,109,208,11,5.61%
2010-01,הצפון,2800,קריית שמונה,יישוב,821,405,416,71,750,392,801,52,6.53%
2010-01,הצפון,543,ראמה,יישוב,322,138,184,8,314,258,319,2,9.94%
2010-01,הצפון,26,ראש פינה,יישוב,54,25,29,7,47,21,53,5,3.86%
2010-01,הצפון,542,ריינה,יישוב,645,280,365,9,636,504,640,14,11.52%
2010-01,הצפון,122,רמת ישי,יישוב,93,34,59,31,62,10,91,7,2.50%
2010-01,הצפון,913,שבלי - אום אל-גנם,יישוב,286,143,143,4,282,205,283,2,12.98%
2010-01,הצפון,812,שלומי,יישוב,287,122,165,13,274,167,285,7,8.65%
2010-01,הצפון,538,שעב,יישוב,465,194,271,6,459,406,464,3,18.57%
2010-01,הצפון,8800,שפרעם,יישוב,2143,906,1237,26,2117,1810,2135,4,14.40%
2010-01,חיפה,2710,אום אל-פחם,יישוב,3339,1398,1941,10,3329,2821,3335,47,19.94%
2010-01,חיפה,1020,אור עקיבא,יישוב,576,258,318,53,523,221,562,17,6.23%
2010-01,חיפה,6000,באקה אל-גרביה,יישוב,492,278,214,5,487,289,491,15,NULL
2010-01,חיפה,9800,בנימינה-גבעת עדה*,יישוב,191,83,108,64,127,47,190,7,3.11%
2010-01,חיפה,1326,"בסמ""ה",יישוב,274,146,128,5,269,200,274,8,8.95%
2010-01,חיפה,541,ג'סר א-זרקא,יישוב,341,206,135,3,338,242,339,10,6.83%
2010-01,חיפה,628,ג'ת,יישוב,154,78,76,2,152,95,154,4,NULL
2010-01,חיפה,494,דאלית אל-כרמל,יישוב,489,208,281,8,481,321,487,2,7.21%
2010-01,חיפה,9300,זכרון יעקב,יישוב,216,85,131,62,154,45,216,9,2.40%
2010-01,חיפה,6500,חדרה,יישוב,2029,853,1176,259,1770,850,2006,56,4.60%
2010-01,חיפה,4000,חיפה,יישוב,8722,3695,5027,1673,7049,5994,8678,94,6.61%
2010-01,חיפה,1247,חריש-קציר,יישוב,26,12,14,4,22,14,26,0,1.59%
2010-01,חיפה,2100,טירת כרמל,יישוב,803,353,450,25,778,559,800,2,8.35%
2010-01,חיפה,654,כפר קרע,יישוב,285,140,145,8,277,149,284,11,4.21%
2010-01,חיפה,1327,מעלה עירון,יישוב,801,343,458,1,800,654,799,7,17.07%
2010-01,חיפה,2500,נשר,יישוב,621,275,346,140,481,339,619,11,5.07%
2010-01,חיפה,534,עספיא,יישוב,329,132,197,7,322,217,328,1,6.92%
2010-01,חיפה,637,ערערה,יישוב,418,204,214,5,413,251,418,11,6.43%
2010-01,חיפה,537,פוריידיס,יישוב,338,168,170,4,334,249,337,2,7.25%
2010-01,חיפה,7800,פרדס חנה-כרכור,יישוב,670,298,372,108,562,209,665,29,4.00%
2010-01,חיפה,6800,קריית אתא,יישוב,1989,782,1207,164,1825,1341,1981,34,7.40%
2010-01,חיפה,9500,קריית ביאליק,יישוב,1312,513,799,158,1154,788,1304,33,6.53%
2010-01,חיפה,2300,קריית טבעון,יישוב,195,87,108,62,133,60,195,7,2.59%
2010-01,חיפה,9600,קריית ים,יישוב,1930,822,1108,191,1739,1352,1924,48,9.57%
2010-01,חיפה,8200,קריית מוצקין,יישוב,1289,495,794,203,1086,775,1281,22,6.15%
2010-01,חיפה,922,רכסים,יישוב,157,83,74,11,146,108,155,1,5.73%
2010-01,ירושלים,472,אבו גוש,יישוב,272,129,143,1,271,187,272,4,11.19%
2010-01,ירושלים,2610,בית שמש,יישוב,1134,479,655,114,1020,637,1118,52,4.55%
2010-01,ירושלים,3000,ירושלים,יישוב,7949,3468,4481,1128,6821,4818,7913,211,3.21%
2010-01,ירושלים,1015,מבשרת ציון,יישוב,306,141,165,65,241,142,305,8,2.62%
2010-01,ירושלים,1137,קריית יערים,יישוב,19,6,13,3,16,9,19,0,1.92%
2010-01,תל אביב,2400,אור יהודה,יישוב,811,373,438,50,761,365,799,28,4.60%
2010-01,תל אביב,565,אזור,יישוב,148,74,74,20,128,50,148,4,2.53%
2010-01,תל אביב,6100,בני ברק,יישוב,2139,1005,1134,128,2011,1420,2127,93,4.63%
2010-01,תל אביב,6200,בת ים,יישוב,3544,1499,2045,581,2963,1861,3474,157,4.98%
2010-01,תל אביב,6300,גבעתיים,יישוב,656,292,364,254,402,129,654,30,2.40%
2010-01,תל אביב,6400,הרצלייה,יישוב,1112,483,629,305,807,195,1085,62,2.39%
2010-01,תל אביב,6600,חולון,יישוב,3129,1433,1696,504,2625,1214,3089,110,3.35%
2010-01,תל אביב,2620,קריית אונו,יישוב,407,180,227,167,240,69,406,10,2.51%
2010-01,תל אביב,8600,רמת גן,יישוב,2025,898,1127,610,1415,606,2008,84,2.82%
2010-01,תל אביב,2650,רמת השרון,יישוב,393,160,233,161,232,48,391,13,1.92%
2010-01,תל אביב,5000,תל אביב -יפו,יישוב,7402,3584,3818,1959,5443,3153,7339,220,3.20%
2010-02,אזור יהודה והשומרון,3760,אורנית,יישוב,85,37,48,37,48,3,85,3,2.28%
2010-02,אזור יהודה והשומרון,3750,אלפי מנשה,יישוב,98,42,56,28,70,7,96,2,2.38%
2010-02,אזור יהודה והשומרון,3560,אלקנה,יישוב,27,16,11,9,18,3,27,0,1.59%
2010-02,אזור יהודה והשומרון,3650,אפרתה,יישוב,60,31,29,24,36,10,60,8,1.70%
2010-02,אזור יהודה והשומרון,3570,אריאל,יישוב,456,213,243,124,332,140,455,58,4.56%
2010-02,אזור יהודה והשומרון,3574,בית אל,יישוב,46,22,24,19,27,16,46,2,2.17%
2010-02,אזור יהודה והשומרון,3652,בית אריה,יישוב,69,31,38,10,59,4,69,3,3.24%
2010-02,אזור יהודה והשומרון,3780,ביתר עילית,יישוב,348,166,182,14,334,183,343,14,4.12%
2010-02,אזור יהודה והשומרון,3730,גבעת זאב,יישוב,177,80,97,23,154,36,175,15,2.91%
2010-02,אזור יהודה והשומרון,3769,הר אדר,יישוב,33,14,19,21,12,4,33,1,1.92%
2010-02,אזור יהודה והשומרון,3797,מודיעין עילית,יישוב,271,101,170,16,255,80,270,14,2.61%
2010-02,אזור יהודה והשומרון,3616,מעלה אדומים,יישוב,651,272,379,96,555,241,643,60,3.64%
2010-02,אזור יהודה והשומרון,3660,עמנואל,יישוב,106,60,46,6,100,76,106,6,11.04%
2010-02,אזור יהודה והשומרון,3557,קדומים,יישוב,26,14,12,9,17,5,26,0,1.63%
2010-02,אזור יהודה והשומרון,3611,קריית ארבע,יישוב,125,66,59,23,102,66,125,8,4.48%
2010-02,אזור יהודה והשומרון,3640,קרני שומרון,יישוב,79,47,32,16,63,21,79,4,2.43%
2010-02,הדרום,31,אופקים,יישוב,1426,615,811,98,1328,1037,1416,76,12.56%
2010-02,הדרום,2600,אילת,יישוב,1691,809,882,83,1608,719,1670,128,5.42%
2010-02,הדרום,70,אשדוד,יישוב,7532,3034,4498,870,6662,4675,7467,485,7.45%
2010-02,הדרום,7100,אשקלון,יישוב,4053,1696,2357,632,3421,2295,3988,309,6.92%
2010-02,הדרום,9000,באר שבע,יישוב,8177,3558,4619,1039,7138,5465,8126,585,8.59%
2010-02,הדרום,2200,דימונה,יישוב,2138,945,1193,145,1993,1519,2106,140,12.02%
2010-02,הדרום,1303,חורה,יישוב,696,317,379,0,696,626,696,4,23.08%
2010-02,הדרום,831,ירוחם,יישוב,450,223,227,32,418,304,443,69,10.71%
2010-02,הדרום,1059,כסיפה,יישוב,983,442,541,1,982,876,982,28,26.31%
2010-02,הדרום,1271,להבים,יישוב,51,27,24,27,24,5,51,1,1.66%
2010-02,הדרום,1060,לקיה,יישוב,920,444,476,5,915,840,918,11,28.60%
2010-02,הדרום,1268,מיתר,יישוב,60,25,35,23,37,8,60,2,1.63%
2010-02,הדרום,99,מצפה רמון,יישוב,253,94,159,21,232,133,230,43,10.32%
2010-02,הדרום,246,נתיבות,יישוב,923,397,526,50,873,540,915,95,7.90%
2010-02,הדרום,666,עומר,יישוב,61,24,37,25,36,6,61,1,1.64%
2010-02,הדרום,2560,ערד,יישוב,1053,444,609,191,862,685,1027,121,8.28%
2010-02,הדרום,1192,ערערה-בנגב,יישוב,926,368,558,3,923,821,925,7,29.31%
2010-02,הדרום,2630,קריית גת,יישוב,2572,1029,1543,215,2357,1702,2562,185,10.22%
2010-02,הדרום,1034,קריית מלאכי,יישוב,1280,574,706,36,1244,871,1267,113,11.75%
2010-02,הדרום,1161,רהט,יישוב,2999,1246,1753,9,2990,2639,2996,28,21.30%
2010-02,הדרום,1286,שגב-שלום,יישוב,554,235,319,2,552,495,553,9,26.68%
2010-02,הדרום,1031,שדרות,יישוב,899,375,524,52,847,438,896,60,8.25%
2010-02,הדרום,1054,תל שבע,יישוב,1184,572,612,5,1179,1058,1180,12,30.60%
2010-02,המרכז,182,אבן יהודה,יישוב,170,83,87,58,112,25,169,14,2.84%
2010-02,המרכז,41,אליכין,יישוב,57,29,28,5,52,13,57,4,3.61%
2010-02,המרכז,1309,אלעד,יישוב,377,174,203,33,344,101,373,20,3.55%
2010-02,המרכז,2530,באר יעקב,יישוב,264,117,147,35,229,85,258,20,3.69%
2010-02,המרכז,466,בית דגן,יישוב,130,69,61,22,108,37,129,6,3.92%
2010-02,המרכז,1066,"בני עי""ש",יישוב,222,94,128,43,179,97,216,15,5.56%
2010-02,המרכז,681,גבעת שמואל,יישוב,260,125,135,102,158,52,260,12,2.50%
2010-02,המרכז,2550,גדרה,יישוב,395,166,229,78,317,119,389,21,3.87%
2010-02,המרכז,627,ג'לג'וליה,יישוב,59,29,30,0,59,31,59,2,2.10%
2010-02,המרכז,166,גן יבנה,יישוב,358,139,219,48,310,108,357,21,3.70%
2010-02,המרכז,229,גני תקווה,יישוב,183,87,96,50,133,26,181,13,2.60%
2010-02,המרכז,9700,הוד השרון,יישוב,605,262,343,205,400,60,603,37,2.42%
2010-02,המרכז,1290,זמר,יישוב,184,64,120,1,183,140,184,8,7.54%
2010-02,המרכז,2730,טייבה,יישוב,2131,930,1201,8,2123,1755,2121,36,14.42%
2010-02,המרכז,2720,טירה,יישוב,309,164,145,7,302,185,308,13,3.46%
2010-02,המרכז,2660,יבנה,יישוב,1100,524,576,73,1027,512,1097,100,6.08%
2010-02,המרכז,9400,יהוד,יישוב,587,245,342,81,506,89,560,59,3.82%
2010-02,המרכז,1224,כוכב יאיר,יישוב,97,40,57,43,54,4,96,2,1.83%
2010-02,המרכז,633,כפר ברא,יישוב,20,11,9,1,19,7,20,2,1.97%
2010-02,המרכז,168,כפר יונה,יישוב,386,157,229,61,325,99,380,40,4.03%
2010-02,המרכז,6900,כפר סבא,יישוב,1271,574,697,369,902,248,1262,80,2.75%
2010-02,המרכז,634,כפר קאסם,יישוב,216,112,104,2,214,112,215,5,3.30%
2010-02,המרכז,7000,לוד,יישוב,2331,1023,1308,197,2134,1350,2318,172,7.06%
2010-02,המרכז,1200,מודיעין-מכבים-רעות*,יישוב,900,385,515,348,552,68,892,105,2.44%
2010-02,המרכז,28,מזכרת בתיה,יישוב,165,74,91,34,131,40,163,10,2.96%
2010-02,המרכז,7200,נס ציונה,יישוב,716,323,393,164,552,216,709,33,3.57%
2010-02,המרכז,7400,נתניה,יישוב,4889,2248,2641,795,4094,2012,4825,427,5.16%
2010-02,המרכז,587,סביון*,יישוב,19,10,9,8,11,0,19,0,1.17%
2010-02,המרכז,171,פרדסייה,יישוב,85,31,54,15,70,10,83,4,2.45%
2010-02,המרכז,7900,פתח תקווה,יישוב,4364,1932,2432,857,3507,1370,4336,357,4.00%
2010-02,המרכז,195,קדימה-צורן,יישוב,245,109,136,72,173,44,244,21,2.85%
2010-02,המרכז,638,קלנסווה,יישוב,915,374,541,2,913,741,909,16,12.80%
2010-02,המרכז,469,קריית עקרון,יישוב,278,138,140,20,258,132,272,11,5.10%
2010-02,המרכז,2640,ראש העין,יישוב,739,374,365,81,658,193,722,80,3.60%
2010-02,המרכז,8300,ראשון לציון,יישוב,4809,2138,2671,972,3837,1894,4778,438,3.79%
2010-02,המרכז,8400,רחובות,יישוב,2680,1213,1467,572,2108,1079,2648,120,4.65%
2010-02,המרכז,8500,רמלה,יישוב,1972,905,1067,131,1841,930,1920,151,6.00%
2010-02,המרכז,8700,רעננה,יישוב,793,369,424,296,497,91,790,44,2.27%
2010-02,המרכז,1304,שוהם,יישוב,199,81,118,91,108,2,199,19,2.07%
2010-02,המרכז,154,תל מונד,יישוב,150,66,84,43,107,24,150,4,2.81%
2010-02,הצפון,473,אבו סנאן,יישוב,711,268,443,10,701,560,707,19,14.81%
2010-02,הצפון,478,אכסאל,יישוב,663,285,378,15,648,549,661,5,14.18%
2010-02,הצפון,529,אעבלין,יישוב,702,299,403,16,686,583,701,12,14.81%
2010-02,הצפון,482,בועיינה-נוג'ידאת,יישוב,519,219,300,4,515,438,515,1,16.22%
2010-02,הצפון,4001,בוקעאתא,יישוב,406,186,220,2,404,330,396,2,16.87%
2010-02,הצפון,998,ביר אל-מכסור,יישוב,450,191,259,2,448,345,449,6,14.91%
2010-02,הצפון,480,בית ג'ן,יישוב,351,124,227,5,346,246,349,8,8.47%
2010-02,הצפון,9200,בית שאן,יישוב,904,382,522,20,884,484,900,90,9.64%
2010-02,הצפון,944,בסמת טבעון,יישוב,326,129,197,2,324,256,326,13,11.93%
2010-02,הצפון,483,בענה,יישוב,470,196,274,1,469,422,470,7,16.71%
2010-02,הצפון,1292,ג'דיידה-מכר,יישוב,1445,615,830,8,1437,1196,1445,38,18.87%
2010-02,הצפון,485,ג'ולס,יישוב,207,79,128,8,199,127,207,19,8.80%
2010-02,הצפון,487,ג'ש (גוש חלב),יישוב,59,21,38,5,54,33,59,1,4.14%
2010-02,הצפון,489,דבורייה,יישוב,440,222,218,19,421,330,440,10,12.17%
2010-02,הצפון,490,דייר אל-אסד,יישוב,451,182,269,10,441,351,451,11,10.90%
2010-02,הצפון,492,דייר חנא,יישוב,688,310,378,16,672,532,688,26,17.43%
2010-02,הצפון,975,זרזיר,יישוב,331,144,187,3,328,222,328,13,13.39%
2010-02,הצפון,496,חורפיש,יישוב,150,55,95,7,143,105,150,7,7.21%
2010-02,הצפון,2034,חצור הגלילית,יישוב,308,125,183,14,294,155,297,28,6.83%
2010-02,הצפון,6700,טבריה,יישוב,2023,908,1115,108,1915,1310,1934,101,9.56%
2010-02,הצפון,962,טובא-זנגרייה,יישוב,374,171,203,3,371,268,368,14,13.86%
2010-02,הצפון,498,טורעאן,יישוב,573,226,347,11,562,475,571,16,12.44%
2010-02,הצפון,8900,טמרה,יישוב,2164,965,1199,24,2140,1892,2157,36,18.36%
2010-02,הצפון,1295,יאנוח-ג'ת,יישוב,185,68,117,7,178,126,185,5,8.67%
2010-02,הצפון,46,יבנאל,יישוב,112,67,45,7,105,81,106,0,8.14%
2010-02,הצפון,499,יפיע,יישוב,701,314,387,16,685,527,696,39,10.71%
2010-02,הצפון,240,יקנעם עילית,יישוב,583,220,363,118,465,259,580,55,5.66%
2010-02,הצפון,502,ירכא,יישוב,460,189,271,3,457,351,459,20,10.27%
2010-02,הצפון,504,כאבול,יישוב,784,367,417,22,762,650,779,13,18.72%
2010-02,הצפון,505,כאוכב אבו אל-היג'א,יישוב,236,88,148,6,230,187,236,5,16.46%
2010-02,הצפון,1296,כסרא-סמיע,יישוב,259,92,167,3,256,208,258,13,9.61%
2010-02,הצפון,978,כעביה-טבאש-חג'אג'רה,יישוב,225,102,123,2,223,157,223,6,11.88%
2010-02,הצפון,1263,כפר ורדים,יישוב,59,25,34,26,33,7,59,3,2.04%
2010-02,הצפון,507,כפר יאסיף,יישוב,461,197,264,5,456,360,459,8,10.87%
2010-02,הצפון,508,כפר כמא,יישוב,98,44,54,4,94,47,97,0,7.15%
2010-02,הצפון,509,כפר כנא,יישוב,1257,536,721,21,1236,1056,1240,42,16.99%
2010-02,הצפון,510,כפר מנדא,יישוב,922,447,475,14,908,695,911,57,15.41%
2010-02,הצפון,47,כפר תבור,יישוב,48,22,26,14,34,7,48,3,2.87%
2010-02,הצפון,1139,כרמיאל,יישוב,1914,757,1157,366,1548,1040,1861,125,7.52%
2010-02,הצפון,481,מגאר,יישוב,1513,613,900,35,1478,1282,1510,38,20.29%
2010-02,הצפון,516,מג'ד אל-כרום,יישוב,708,321,387,10,698,545,707,19,13.30%
2010-02,הצפון,874,מגדל העמק,יישוב,1098,456,642,108,990,549,1068,144,8.51%
2010-02,הצפון,4201,מג'דל שמס,יישוב,489,183,306,20,469,405,484,4,12.35%
2010-02,הצפון,517,מזרעה,יישוב,200,85,115,2,198,155,198,7,12.21%
2010-02,הצפון,4203,מסעדה,יישוב,201,72,129,4,197,171,200,1,13.76%
2010-02,הצפון,518,מעיליא,יישוב,68,32,36,9,59,36,68,2,4.88%
2010-02,הצפון,1063,מעלות-תרשיחא,יישוב,1081,478,603,134,947,691,1077,68,9.44%
2010-02,הצפון,520,משהד,יישוב,346,133,213,7,339,291,342,5,13.06%
2010-02,הצפון,9100,נהרייה,יישוב,2289,1047,1242,267,2022,1432,2276,136,8.13%
2010-02,הצפון,522,נחף,יישוב,483,205,278,13,470,405,481,12,11.81%
2010-02,הצפון,7300,נצרת,יישוב,2079,1022,1057,49,2030,1428,2074,71,7.39%
2010-02,הצפון,1061,נצרת עילית,יישוב,1722,788,934,248,1474,861,1656,188,7.38%
2010-02,הצפון,525,סאג'ור,יישוב,116,47,69,2,114,84,115,6,8.21%
2010-02,הצפון,7500,סח'נין,יישוב,2062,958,1104,37,2025,1741,2062,39,17.92%
2010-02,הצפון,4501,ע'ג'ר,יישוב,140,56,84,5,135,109,139,6,15.65%
2010-02,הצפון,530,עיילבון,יישוב,210,88,122,11,199,163,208,6,9.72%
2010-02,הצפון,511,עילוט,יישוב,331,141,190,4,327,259,330,12,14.25%
2010-02,הצפון,532,עין מאהל,יישוב,490,263,227,1,489,369,485,9,11.74%
2010-02,הצפון,7600,עכו,יישוב,3538,1603,1935,160,3378,2715,3516,169,14.41%
2010-02,הצפון,7700,עפולה,יישוב,1993,872,1121,226,1767,1077,1928,149,8.79%
2010-02,הצפון,531,עראבה,יישוב,1400,613,787,40,1360,1185,1399,49,17.25%
2010-02,הצפון,535,פסוטה,יישוב,149,69,80,10,139,102,149,4,9.90%
2010-02,הצפון,536,פקיעין (בוקייעה),יישוב,157,79,78,7,150,118,155,8,6.61%
2010-02,הצפון,8000,צפת,יישוב,1024,500,524,79,945,683,1016,27,8.96%
2010-02,הצפון,4100,קצרין,יישוב,218,94,124,43,175,118,216,25,5.81%
2010-02,הצפון,2800,קריית שמונה,יישוב,869,422,447,75,794,374,849,106,6.90%
2010-02,הצפון,543,ראמה,יישוב,340,146,194,7,333,261,337,3,10.45%
2010-02,הצפון,26,ראש פינה,יישוב,53,22,31,10,43,22,52,4,3.79%
2010-02,הצפון,542,ריינה,יישוב,681,295,386,9,672,526,674,26,12.06%
2010-02,הצפון,122,רמת ישי,יישוב,106,38,68,35,71,8,104,5,2.85%
2010-02,הצפון,913,שבלי - אום אל-גנם,יישוב,298,149,149,6,292,207,295,21,13.46%
2010-02,הצפון,812,שלומי,יישוב,313,134,179,14,299,178,310,18,9.34%
2010-02,הצפון,538,שעב,יישוב,494,205,289,7,487,416,493,17,19.51%
2010-02,הצפון,8800,שפרעם,יישוב,2232,955,1277,33,2199,1852,2224,108,14.92%
2010-02,חיפה,2710,אום אל-פחם,יישוב,3446,1478,1968,12,3434,2871,3443,52,20.45%
2010-02,חיפה,1020,אור עקיבא,יישוב,607,263,344,51,556,199,593,43,6.55%
2010-02,חיפה,6000,באקה אל-גרביה,יישוב,528,300,228,7,521,291,527,34,NULL
2010-02,חיפה,9800,בנימינה-גבעת עדה*,יישוב,202,82,120,69,133,47,202,14,3.30%
2010-02,חיפה,1326,"בסמ""ה",יישוב,290,161,129,6,284,197,290,11,9.43%
2010-02,חיפה,541,ג'סר א-זרקא,יישוב,353,214,139,4,349,245,350,14,7.04%
2010-02,חיפה,628,ג'ת,יישוב,164,84,80,3,161,100,164,8,NULL
2010-02,חיפה,494,דאלית אל-כרמל,יישוב,542,231,311,11,531,323,539,23,7.92%
2010-02,חיפה,9300,זכרון יעקב,יישוב,233,97,136,66,167,42,232,14,2.57%
2010-02,חיפה,6500,חדרה,יישוב,2256,976,1280,261,1995,798,2220,170,5.07%
2010-02,חיפה,4000,חיפה,יישוב,9233,3932,5301,1718,7515,5999,9184,559,6.97%
2010-02,חיפה,1247,חריש-קציר,יישוב,32,15,17,3,29,11,32,3,1.95%
2010-02,חיפה,2100,טירת כרמל,יישוב,859,376,483,26,833,573,855,69,8.88%
2010-02,חיפה,654,כפר קרע,יישוב,298,151,147,10,288,151,296,18,4.38%
2010-02,חיפה,1327,מעלה עירון,יישוב,841,366,475,2,839,666,839,14,17.78%
2010-02,חיפה,2500,נשר,יישוב,656,286,370,141,515,334,654,54,5.35%
2010-02,חיפה,534,עספיא,יישוב,361,154,207,9,352,225,360,23,7.54%
2010-02,חיפה,637,ערערה,יישוב,436,208,228,6,430,248,436,38,6.69%
2010-02,חיפה,537,פוריידיס,יישוב,352,180,172,5,347,248,351,14,7.53%
2010-02,חיפה,7800,פרדס חנה-כרכור,יישוב,776,349,427,132,644,199,771,77,4.61%
2010-02,חיפה,6800,קריית אתא,יישוב,2123,856,1267,180,1943,1335,2113,133,7.86%
2010-02,חיפה,9500,קריית ביאליק,יישוב,1413,562,851,180,1233,784,1402,101,6.99%
2010-02,חיפה,2300,קריית טבעון,יישוב,215,93,122,78,137,63,215,16,2.84%
2010-02,חיפה,9600,קריית ים,יישוב,2010,867,1143,194,1816,1332,2002,114,9.92%
2010-02,חיפה,8200,קריית מוצקין,יישוב,1336,519,817,198,1138,760,1324,100,6.34%
2010-02,חיפה,922,רכסים,יישוב,160,77,83,8,152,111,159,17,5.87%
2010-02,ירושלים,472,אבו גוש,יישוב,288,149,139,6,282,185,287,11,11.73%
2010-02,ירושלים,2610,בית שמש,יישוב,1240,536,704,119,1121,632,1220,112,4.94%
2010-02,ירושלים,3000,ירושלים,יישוב,8652,3882,4770,1211,7441,4655,8604,552,3.48%
2010-02,ירושלים,1015,מבשרת ציון,יישוב,338,157,181,71,267,138,336,33,2.88%
2010-02,ירושלים,1137,קריית יערים,יישוב,29,9,20,6,23,10,29,2,2.91%
2010-02,תל אביב,2400,אור יהודה,יישוב,895,411,484,56,839,362,878,68,5.04%
2010-02,תל אביב,565,אזור,יישוב,173,82,91,24,149,50,171,16,2.91%
2010-02,תל אביב,6100,בני ברק,יישוב,2216,1048,1168,133,2083,1361,2201,132,4.78%
2010-02,תל אביב,6200,בת ים,יישוב,3738,1663,2075,553,3185,1731,3660,292,5.24%
2010-02,תל אביב,6300,גבעתיים,יישוב,743,330,413,301,442,127,740,58,2.71%
2010-02,תל אביב,6400,הרצלייה,יישוב,1227,537,690,317,910,189,1191,164,2.62%
2010-02,תל אביב,6600,חולון,יישוב,3466,1576,1890,541,2925,1214,3414,374,3.68%
2010-02,תל אביב,2620,קריית אונו,יישוב,438,198,240,171,267,63,433,27,2.67%
2010-02,תל אביב,8600,רמת גן,יישוב,2190,986,1204,669,1521,576,2168,155,3.04%
2010-02,תל אביב,2650,רמת השרון,יישוב,455,185,270,175,280,48,451,53,2.21%
2010-02,תל אביב,5000,תל אביב -יפו,יישוב,8160,3967,4193,2193,5967,3052,8078,586,3.51%
2010-03,אזור יהודה והשומרון,3760,אורנית,יישוב,82,34,48,38,44,4,82,8,2.20%
2010-03,אזור יהודה והשומרון,3750,אלפי מנשה,יישוב,93,36,57,28,65,6,93,7,2.31%
2010-03,אזור יהודה והשומרון,3560,אלקנה,יישוב,26,17,9,12,14,3,26,3,1.54%
2010-03,אזור יהודה והשומרון,3650,אפרתה,יישוב,49,28,21,24,25,5,49,5,1.40%
2010-03,אזור יהודה והשומרון,3570,אריאל,יישוב,433,216,217,117,316,134,433,41,4.35%
2010-03,אזור יהודה והשומרון,3574,בית אל,יישוב,42,20,22,19,23,15,42,2,1.98%
2010-03,אזור יהודה והשומרון,3652,בית אריה,יישוב,67,29,38,9,58,3,66,5,3.10%
2010-03,אזור יהודה והשומרון,3780,ביתר עילית,יישוב,332,161,171,16,316,188,326,20,3.93%
2010-03,אזור יהודה והשומרון,3730,גבעת זאב,יישוב,176,84,92,23,153,36,175,18,2.91%
2010-03,אזור יהודה והשומרון,3769,הר אדר,יישוב,32,13,19,18,14,3,32,1,1.87%
2010-03,אזור יהודה והשומרון,3797,מודיעין עילית,יישוב,298,94,204,20,278,83,298,16,2.88%
2010-03,אזור יהודה והשומרון,3616,מעלה אדומים,יישוב,631,261,370,90,541,229,625,63,3.54%
2010-03,אזור יהודה והשומרון,3660,עמנואל,יישוב,95,52,43,4,91,69,95,4,10.01%
2010-03,אזור יהודה והשומרון,3557,קדומים,יישוב,30,21,9,10,20,6,30,4,1.87%
2010-03,אזור יהודה והשומרון,3611,קריית ארבע,יישוב,113,51,62,24,89,66,113,9,4.07%
2010-03,אזור יהודה והשומרון,3640,קרני שומרון,יישוב,85,51,34,19,66,23,85,3,2.61%
2010-03,הדרום,31,אופקים,יישוב,1367,588,779,95,1272,1038,1356,50,12.09%
2010-03,הדרום,2600,אילת,יישוב,1532,727,805,77,1455,693,1518,140,4.95%
2010-03,הדרום,70,אשדוד,יישוב,7331,2906,4425,850,6481,4606,7267,475,7.26%
2010-03,הדרום,7100,אשקלון,יישוב,3989,1678,2311,650,3339,2295,3931,393,6.82%
2010-03,הדרום,9000,באר שבע,יישוב,7984,3517,4467,1059,6925,5344,7931,612,8.40%
2010-03,הדרום,2200,דימונה,יישוב,2073,918,1155,138,1935,1499,2044,148,11.71%
2010-03,הדרום,1303,חורה,יישוב,706,313,393,0,706,640,706,9,23.34%
2010-03,הדרום,831,ירוחם,יישוב,433,206,227,31,402,296,426,51,10.34%
2010-03,הדרום,1059,כסיפה,יישוב,977,431,546,1,976,876,975,16,26.17%
2010-03,הדרום,1271,להבים,יישוב,57,27,30,35,22,6,57,4,1.86%
2010-03,הדרום,1060,לקיה,יישוב,918,433,485,3,915,845,916,13,28.55%
2010-03,הדרום,1268,מיתר,יישוב,57,23,34,23,34,7,57,5,1.55%
2010-03,הדרום,99,מצפה רמון,יישוב,249,92,157,21,228,132,228,31,10.24%
2010-03,הדרום,246,נתיבות,יישוב,885,412,473,51,834,520,878,69,7.61%
2010-03,הדרום,666,עומר,יישוב,60,24,36,26,34,7,60,4,1.62%
2010-03,הדרום,2560,ערד,יישוב,1013,412,601,182,831,667,986,180,7.97%
2010-03,הדרום,1192,ערערה-בנגב,יישוב,940,377,563,2,938,837,939,4,29.62%
2010-03,הדרום,2630,קריית גת,יישוב,2511,1017,1494,208,2303,1689,2502,203,10.01%
2010-03,הדרום,1034,קריית מלאכי,יישוב,1277,581,696,30,1247,873,1257,112,11.67%
2010-03,הדרום,1161,רהט,יישוב,3024,1253,1771,10,3014,2669,3021,78,21.43%
2010-03,הדרום,1286,שגב-שלום,יישוב,556,238,318,2,554,500,555,8,26.75%
2010-03,הדרום,1031,שדרות,יישוב,907,404,503,50,857,439,905,68,8.32%
2010-03,הדרום,1054,תל שבע,יישוב,1202,584,618,6,1196,1075,1199,16,30.94%
2010-03,המרכז,182,אבן יהודה,יישוב,147,70,77,58,89,25,147,9,2.48%
2010-03,המרכז,41,אליכין,יישוב,61,32,29,5,56,14,61,3,3.86%
2010-03,המרכז,1309,אלעד,יישוב,368,172,196,34,334,107,366,16,3.48%
2010-03,המרכז,2530,באר יעקב,יישוב,242,105,137,40,202,86,237,14,3.40%
2010-03,המרכז,466,בית דגן,יישוב,120,63,57,18,102,34,119,9,3.63%
2010-03,המרכז,1066,"בני עי""ש",יישוב,207,96,111,38,169,88,203,9,5.25%
2010-03,המרכז,681,גבעת שמואל,יישוב,274,140,134,111,163,53,273,14,2.62%
2010-03,המרכז,2550,גדרה,יישוב,390,171,219,86,304,118,386,16,3.85%
2010-03,המרכז,627,ג'לג'וליה,יישוב,52,23,29,0,52,30,52,5,1.85%
2010-03,המרכז,166,גן יבנה,יישוב,352,135,217,52,300,100,351,28,3.64%
2010-03,המרכז,229,גני תקווה,יישוב,170,75,95,50,120,24,169,9,2.43%
2010-03,המרכז,9700,הוד השרון,יישוב,607,265,342,210,397,71,604,28,2.42%
2010-03,המרכז,1290,זמר,יישוב,182,61,121,2,180,139,182,7,7.46%
2010-03,המרכז,2730,טייבה,יישוב,2136,939,1197,5,2131,1786,2125,53,14.44%
2010-03,המרכז,2720,טירה,יישוב,322,170,152,9,313,196,320,9,3.59%
2010-03,המרכז,2660,יבנה,יישוב,996,479,517,69,927,488,991,99,5.53%
2010-03,המרכז,9400,יהוד,יישוב,556,236,320,88,468,92,529,43,3.62%
2010-03,המרכז,1224,כוכב יאיר,יישוב,102,44,58,50,52,4,102,3,1.94%
2010-03,המרכז,633,כפר ברא,יישוב,21,9,12,0,21,7,21,2,2.07%
2010-03,המרכז,168,כפר יונה,יישוב,352,136,216,56,296,90,348,26,3.70%
2010-03,המרכז,6900,כפר סבא,יישוב,1286,604,682,374,912,239,1280,77,2.79%
2010-03,המרכז,634,כפר קאסם,יישוב,207,104,103,2,205,107,207,12,3.18%
2010-03,המרכז,7000,לוד,יישוב,2275,993,1282,213,2062,1305,2262,182,6.90%
2010-03,המרכז,1200,מודיעין-מכבים-רעות*,יישוב,869,384,485,352,517,64,860,76,2.35%
2010-03,המרכז,28,מזכרת בתיה,יישוב,154,70,84,32,122,39,152,3,2.77%
2010-03,המרכז,7200,נס ציונה,יישוב,699,304,395,162,537,210,692,28,3.48%
2010-03,המרכז,7400,נתניה,יישוב,4740,2162,2578,810,3930,2008,4680,407,5.01%
2010-03,המרכז,587,סביון*,יישוב,15,5,10,7,8,0,15,1,0.92%
2010-03,המרכז,171,פרדסייה,יישוב,79,28,51,14,65,10,78,6,2.31%
2010-03,המרכז,7900,פתח תקווה,יישוב,4365,1977,2388,877,3488,1350,4336,313,4.00%
2010-03,המרכז,195,קדימה-צורן,יישוב,249,112,137,74,175,42,248,17,2.89%
2010-03,המרכז,638,קלנסווה,יישוב,919,372,547,1,918,743,914,17,12.86%
2010-03,המרכז,469,קריית עקרון,יישוב,252,128,124,16,236,124,250,16,4.71%
2010-03,המרכז,2640,ראש העין,יישוב,725,372,353,81,644,193,709,70,3.54%
2010-03,המרכז,8300,ראשון לציון,יישוב,4771,2114,2657,953,3818,1830,4743,297,3.77%
2010-03,המרכז,8400,רחובות,יישוב,2665,1197,1468,572,2093,1060,2630,99,4.62%
2010-03,המרכז,8500,רמלה,יישוב,1907,895,1012,122,1785,919,1860,150,5.82%
2010-03,המרכז,8700,רעננה,יישוב,767,366,401,292,475,84,765,41,2.20%
2010-03,המרכז,1304,שוהם,יישוב,190,82,108,90,100,2,190,12,1.98%
2010-03,המרכז,154,תל מונד,יישוב,150,65,85,44,106,22,150,5,2.81%
2010-03,הצפון,473,אבו סנאן,יישוב,720,276,444,10,710,572,716,16,14.97%
2010-03,הצפון,478,אכסאל,יישוב,679,296,383,19,660,558,677,9,14.47%
2010-03,הצפון,529,אעבלין,יישוב,703,301,402,15,688,583,703,25,14.84%
2010-03,הצפון,482,בועיינה-נוג'ידאת,יישוב,542,230,312,4,538,449,537,3,16.80%
2010-03,הצפון,4001,בוקעאתא,יישוב,401,183,218,2,399,329,391,7,16.69%
2010-03,הצפון,998,ביר אל-מכסור,יישוב,442,186,256,3,439,345,441,10,14.69%
2010-03,הצפון,480,בית ג'ן,יישוב,355,131,224,4,351,241,352,4,8.54%
2010-03,הצפון,9200,בית שאן,יישוב,844,345,499,20,824,457,837,97,9.03%
2010-03,הצפון,944,בסמת טבעון,יישוב,303,118,185,2,301,242,303,12,11.18%
2010-03,הצפון,483,בענה,יישוב,469,190,279,2,467,422,469,8,16.68%
2010-03,הצפון,1292,ג'דיידה-מכר,יישוב,1443,612,831,7,1436,1214,1443,36,18.85%
2010-03,הצפון,485,ג'ולס,יישוב,202,77,125,7,195,126,202,13,8.61%
2010-03,הצפון,487,ג'ש (גוש חלב),יישוב,64,26,38,6,58,36,64,4,4.48%
2010-03,הצפון,489,דבורייה,יישוב,453,225,228,20,433,338,452,8,12.46%
2010-03,הצפון,490,דייר אל-אסד,יישוב,452,175,277,9,443,354,452,14,10.92%
2010-03,הצפון,492,דייר חנא,יישוב,684,307,377,18,666,543,684,26,17.35%
2010-03,הצפון,975,זרזיר,יישוב,309,126,183,2,307,217,305,15,12.57%
2010-03,הצפון,496,חורפיש,יישוב,148,60,88,6,142,101,148,8,7.12%
2010-03,הצפון,2034,חצור הגלילית,יישוב,291,129,162,9,282,158,283,32,6.53%
2010-03,הצפון,6700,טבריה,יישוב,1907,835,1072,111,1796,1273,1816,122,9.03%
2010-03,הצפון,962,טובא-זנגרייה,יישוב,378,170,208,4,374,257,374,20,14.05%
2010-03,הצפון,498,טורעאן,יישוב,576,222,354,8,568,483,574,28,12.50%
2010-03,הצפון,8900,טמרה,יישוב,2143,941,1202,22,2121,1877,2141,84,18.25%
2010-03,הצפון,1295,יאנוח-ג'ת,יישוב,177,63,114,8,169,124,177,7,8.32%
2010-03,הצפון,46,יבנאל,יישוב,116,72,44,6,110,85,110,1,8.42%
2010-03,הצפון,499,יפיע,יישוב,671,298,373,14,657,507,667,32,10.31%
2010-03,הצפון,240,יקנעם עילית,יישוב,539,204,335,105,434,238,537,33,5.27%
2010-03,הצפון,502,ירכא,יישוב,457,195,262,3,454,357,456,22,10.21%
2010-03,הצפון,504,כאבול,יישוב,783,353,430,19,764,649,781,15,18.76%
2010-03,הצפון,505,כאוכב אבו אל-היג'א,יישוב,233,91,142,6,227,189,233,5,16.28%
2010-03,הצפון,1296,כסרא-סמיע,יישוב,255,95,160,2,253,211,254,12,9.47%
2010-03,הצפון,978,כעביה-טבאש-חג'אג'רה,יישוב,229,102,127,2,227,157,226,2,12.02%
2010-03,הצפון,1263,כפר ורדים,יישוב,67,30,37,31,36,9,67,4,2.31%
2010-03,הצפון,507,כפר יאסיף,יישוב,476,207,269,4,472,378,474,14,11.18%
2010-03,הצפון,508,כפר כמא,יישוב,100,44,56,4,96,48,98,2,7.22%
2010-03,הצפון,509,כפר כנא,יישוב,1253,515,738,24,1229,1055,1239,52,16.97%
2010-03,הצפון,510,כפר מנדא,יישוב,908,421,487,13,895,691,896,36,15.20%
2010-03,הצפון,47,כפר תבור,יישוב,48,22,26,17,31,6,48,2,2.87%
2010-03,הצפון,1139,כרמיאל,יישוב,1839,705,1134,351,1488,1023,1797,106,7.29%
2010-03,הצפון,481,מגאר,יישוב,1500,598,902,35,1465,1288,1497,57,20.15%
2010-03,הצפון,516,מג'ד אל-כרום,יישוב,696,302,394,11,685,545,695,25,13.11%
2010-03,הצפון,874,מגדל העמק,יישוב,1040,440,600,104,936,528,1012,119,8.10%
2010-03,הצפון,4201,מג'דל שמס,יישוב,491,180,311,22,469,418,486,8,12.39%
2010-03,הצפון,517,מזרעה,יישוב,190,74,116,2,188,149,189,10,11.72%
2010-03,הצפון,4203,מסעדה,יישוב,212,76,136,4,208,177,211,3,14.41%
2010-03,הצפון,518,מעיליא,יישוב,68,35,33,9,59,34,68,4,4.88%
2010-03,הצפון,1063,מעלות-תרשיחא,יישוב,1042,467,575,127,915,692,1038,53,9.13%
2010-03,הצפון,520,משהד,יישוב,336,126,210,6,330,284,331,8,12.70%
2010-03,הצפון,9100,נהרייה,יישוב,2232,1023,1209,273,1959,1401,2217,108,7.94%
2010-03,הצפון,522,נחף,יישוב,472,197,275,15,457,397,471,8,11.60%
2010-03,הצפון,7300,נצרת,יישוב,2082,1009,1073,54,2028,1448,2077,71,7.40%
2010-03,הצפון,1061,נצרת עילית,יישוב,1664,747,917,246,1418,846,1613,184,7.20%
2010-03,הצפון,525,סאג'ור,יישוב,117,45,72,3,114,88,116,1,8.27%
2010-03,הצפון,7500,סח'נין,יישוב,2071,961,1110,44,2027,1760,2071,58,17.98%
2010-03,הצפון,4501,ע'ג'ר,יישוב,137,52,85,4,133,107,136,4,15.37%
2010-03,הצפון,530,עיילבון,יישוב,209,91,118,10,199,161,207,12,9.68%
2010-03,הצפון,511,עילוט,יישוב,340,144,196,4,336,267,339,5,14.59%
2010-03,הצפון,532,עין מאהל,יישוב,478,246,232,1,477,366,473,8,11.48%
2010-03,הצפון,7600,עכו,יישוב,3462,1584,1878,149,3313,2677,3442,134,14.15%
2010-03,הצפון,7700,עפולה,יישוב,1901,865,1036,220,1681,1045,1843,156,8.44%
2010-03,הצפון,531,עראבה,יישוב,1374,592,782,34,1340,1167,1373,48,16.98%
2010-03,הצפון,535,פסוטה,יישוב,143,69,74,8,135,100,143,5,9.54%
2010-03,הצפון,536,פקיעין (בוקייעה),יישוב,155,79,76,6,149,114,153,6,6.53%
2010-03,הצפון,8000,צפת,יישוב,984,484,500,79,905,678,978,44,8.65%
2010-03,הצפון,4100,קצרין,יישוב,206,87,119,34,172,114,203,14,5.48%
2010-03,הצפון,2800,קריית שמונה,יישוב,823,394,429,75,748,363,805,89,6.56%
2010-03,הצפון,543,ראמה,יישוב,343,153,190,9,334,266,341,6,10.56%
2010-03,הצפון,26,ראש פינה,יישוב,49,20,29,5,44,21,49,7,3.58%
2010-03,הצפון,542,ריינה,יישוב,669,284,385,9,660,527,664,32,11.90%
2010-03,הצפון,122,רמת ישי,יישוב,104,42,62,34,70,10,104,7,2.85%
2010-03,הצפון,913,שבלי - אום אל-גנם,יישוב,292,145,147,6,286,208,288,6,13.18%
2010-03,הצפון,812,שלומי,יישוב,297,126,171,13,284,174,295,15,8.93%
2010-03,הצפון,538,שעב,יישוב,494,209,285,7,487,417,493,16,19.51%
2010-03,הצפון,8800,שפרעם,יישוב,2153,895,1258,31,2122,1785,2146,64,14.47%
2010-03,חיפה,2710,אום אל-פחם,יישוב,3475,1483,1992,12,3463,2919,3472,56,20.59%
2010-03,חיפה,1020,אור עקיבא,יישוב,585,267,318,50,535,199,574,53,6.35%
2010-03,חיפה,6000,באקה אל-גרביה,יישוב,498,282,216,8,490,297,497,39,NULL
2010-03,חיפה,9800,בנימינה-גבעת עדה*,יישוב,196,78,118,68,128,45,196,9,3.21%
2010-03,חיפה,1326,"בסמ""ה",יישוב,285,156,129,4,281,198,285,6,9.28%
2010-03,חיפה,541,ג'סר א-זרקא,יישוב,355,218,137,2,353,245,352,16,7.08%
2010-03,חיפה,628,ג'ת,יישוב,163,80,83,4,159,99,163,5,NULL
2010-03,חיפה,494,דאלית אל-כרמל,יישוב,542,234,308,12,530,324,539,21,7.92%
2010-03,חיפה,9300,זכרון יעקב,יישוב,223,95,128,67,156,44,222,22,2.47%
2010-03,חיפה,6500,חדרה,יישוב,2159,928,1231,268,1891,794,2119,198,4.85%
2010-03,חיפה,4000,חיפה,יישוב,9107,3914,5193,1703,7404,5931,9052,514,6.88%
2010-03,חיפה,1247,חריש-קציר,יישוב,27,13,14,3,24,10,27,3,1.65%
2010-03,חיפה,2100,טירת כרמל,יישוב,832,371,461,27,805,554,827,49,8.61%
2010-03,חיפה,654,כפר קרע,יישוב,295,146,149,8,287,152,294,19,4.36%
2010-03,חיפה,1327,מעלה עירון,יישוב,846,362,484,2,844,682,844,20,17.86%
2010-03,חיפה,2500,נשר,יישוב,646,286,360,142,504,339,645,42,5.28%
2010-03,חיפה,534,עספיא,יישוב,361,154,207,10,351,226,360,31,7.54%
2010-03,חיפה,637,ערערה,יישוב,428,206,222,6,422,253,428,24,6.58%
2010-03,חיפה,537,פוריידיס,יישוב,364,191,173,5,359,260,363,10,7.77%
2010-03,חיפה,7800,פרדס חנה-כרכור,יישוב,766,342,424,137,629,214,763,85,4.56%
2010-03,חיפה,6800,קריית אתא,יישוב,2087,855,1232,179,1908,1318,2078,113,7.74%
2010-03,חיפה,9500,קריית ביאליק,יישוב,1367,551,816,172,1195,761,1360,95,6.79%
2010-03,חיפה,2300,קריית טבעון,יישוב,210,92,118,69,141,60,210,17,2.78%
2010-03,חיפה,9600,קריית ים,יישוב,1970,861,1109,186,1784,1319,1965,120,9.76%
2010-03,חיפה,8200,קריית מוצקין,יישוב,1282,503,779,195,1087,736,1272,98,6.11%
2010-03,חיפה,922,רכסים,יישוב,161,75,86,10,151,112,160,4,5.91%
2010-03,ירושלים,472,אבו גוש,יישוב,284,142,142,5,279,181,284,17,11.63%
2010-03,ירושלים,2610,בית שמש,יישוב,1153,498,655,110,1043,602,1137,119,4.62%
2010-03,ירושלים,3000,ירושלים,יישוב,8446,3784,4662,1225,7221,4706,8411,451,3.41%
2010-03,ירושלים,1015,מבשרת ציון,יישוב,342,163,179,78,264,131,341,21,2.92%
2010-03,ירושלים,1137,קריית יערים,יישוב,29,12,17,5,24,12,28,2,2.81%
2010-03,תל אביב,2400,אור יהודה,יישוב,846,395,451,59,787,343,831,57,4.78%
2010-03,תל אביב,565,אזור,יישוב,179,86,93,27,152,48,178,16,3.03%
2010-03,תל אביב,6100,בני ברק,יישוב,2158,1037,1121,132,2026,1340,2147,126,4.67%
2010-03,תל אביב,6200,בת ים,יישוב,3608,1613,1995,540,3068,1676,3531,292,5.06%
2010-03,תל אביב,6300,גבעתיים,יישוב,745,333,412,315,430,120,739,51,2.71%
2010-03,תל אביב,6400,הרצלייה,יישוב,1220,551,669,355,865,199,1187,141,2.61%
2010-03,תל אביב,6600,חולון,יישוב,3315,1523,1792,539,2776,1134,3268,278,3.53%
2010-03,תל אביב,2620,קריית אונו,יישוב,426,193,233,156,270,61,421,18,2.60%
2010-03,תל אביב,8600,רמת גן,יישוב,2215,1002,1213,710,1505,577,2198,152,3.08%
2010-03,תל אביב,2650,רמת השרון,יישוב,425,167,258,177,248,43,424,38,2.08%
2010-03,תל אביב,5000,תל אביב -יפו,יישוב,8170,3937,4233,2442,5728,3011,8089,598,3.51%
2010-04,אזור יהודה והשומרון,3760,אורנית,יישוב,76,36,40,31,45,4,76,8,2.04%
2010-04,אזור יהודה והשומרון,3750,אלפי מנשה,יישוב,95,35,60,31,64,4,95,2,2.35%
2010-04,אזור יהודה והשומרון,3560,אלקנה,יישוב,31,18,13,16,15,3,31,0,1.83%
2010-04,אזור יהודה והשומרון,3650,אפרתה,יישוב,46,28,18,22,24,5,46,1,1.31%
2010-04,אזור יהודה והשומרון,3570,אריאל,יישוב,424,212,212,102,322,128,424,37,4.26%
2010-04,אזור יהודה והשומרון,3574,בית אל,יישוב,48,22,26,24,24,14,47,0,2.21%
2010-04,אזור יהודה והשומרון,3652,בית אריה,יישוב,63,31,32,8,55,4,63,2,2.97%
2010-04,אזור יהודה והשומרון,3780,ביתר עילית,יישוב,338,153,185,15,323,180,334,9,4.02%
2010-04,אזור יהודה והשומרון,3730,גבעת זאב,יישוב,179,78,101,21,158,39,178,13,2.96%
2010-04,אזור יהודה והשומרון,3769,הר אדר,יישוב,27,13,14,15,12,2,27,1,1.58%
2010-04,אזור יהודה והשומרון,3797,מודיעין עילית,יישוב,291,98,193,16,275,82,290,18,2.80%
2010-04,אזור יהודה והשומרון,3616,מעלה אדומים,יישוב,645,267,378,99,546,230,638,69,3.61%
2010-04,אזור יהודה והשומרון,3660,עמנואל,יישוב,90,46,44,3,87,65,90,11,9.53%
2010-04,אזור יהודה והשומרון,3557,קדומים,יישוב,31,19,12,11,20,5,31,2,1.93%
2010-04,אזור יהודה והשומרון,3611,קריית ארבע,יישוב,111,58,53,22,89,68,111,10,4.00%
2010-04,אזור יהודה והשומרון,3640,קרני שומרון,יישוב,84,43,41,15,69,26,84,4,2.58%
2010-04,הדרום,31,אופקים,יישוב,1350,569,781,84,1266,1011,1339,35,11.96%
2010-04,הדרום,2600,אילת,יישוב,1410,648,762,78,1332,687,1399,88,4.58%
2010-04,הדרום,70,אשדוד,יישוב,7178,2824,4354,829,6349,4487,7117,425,7.12%
2010-04,הדרום,7100,אשקלון,יישוב,3929,1604,2325,646,3283,2279,3875,244,6.73%
2010-04,הדרום,9000,באר שבע,יישוב,7839,3415,4424,1021,6818,5289,7788,467,8.26%
2010-04,הדרום,2200,דימונה,יישוב,2063,915,1148,134,1929,1485,2040,103,11.69%
2010-04,הדרום,1303,חורה,יישוב,693,305,388,0,693,637,693,8,23.01%
2010-04,הדרום,831,ירוחם,יישוב,431,212,219,27,404,286,424,43,10.30%
2010-04,הדרום,1059,כסיפה,יישוב,968,417,551,1,967,873,967,16,26.02%
2010-04,הדרום,1271,להבים,יישוב,58,29,29,30,28,6,57,6,1.86%
2010-04,הדרום,1060,לקיה,יישוב,899,417,482,3,896,833,897,5,28.13%
2010-04,הדרום,1268,מיתר,יישוב,64,29,35,26,38,5,63,6,1.71%
2010-04,הדרום,99,מצפה רמון,יישוב,238,87,151,19,219,130,224,25,10.08%
2010-04,הדרום,246,נתיבות,יישוב,880,395,485,51,829,525,877,50,7.60%
2010-04,הדרום,666,עומר,יישוב,66,32,34,27,39,6,66,8,1.77%
2010-04,הדרום,2560,ערד,יישוב,955,391,564,166,789,651,932,104,7.57%
2010-04,הדרום,1192,ערערה-בנגב,יישוב,932,375,557,2,930,842,931,6,29.44%
2010-04,הדרום,2630,קריית גת,יישוב,2452,984,1468,201,2251,1658,2446,181,9.81%
2010-04,הדרום,1034,קריית מלאכי,יישוב,1311,580,731,34,1277,873,1292,127,11.96%
2010-04,הדרום,1161,רהט,יישוב,2939,1224,1715,10,2929,2622,2936,104,20.96%
2010-04,הדרום,1286,שגב-שלום,יישוב,547,231,316,2,545,493,546,3,26.43%
2010-04,הדרום,1031,שדרות,יישוב,889,389,500,52,837,443,885,68,8.15%
2010-04,הדרום,1054,תל שבע,יישוב,1186,575,611,5,1181,1068,1183,22,30.66%
2010-04,המרכז,182,אבן יהודה,יישוב,145,62,83,58,87,25,145,11,2.44%
2010-04,המרכז,41,אליכין,יישוב,80,38,42,7,73,17,80,6,5.00%
2010-04,המרכז,1309,אלעד,יישוב,360,175,185,28,332,108,359,11,3.42%
2010-04,המרכז,2530,באר יעקב,יישוב,255,122,133,40,215,88,250,20,3.58%
2010-04,המרכז,466,בית דגן,יישוב,115,59,56,16,99,36,115,6,3.51%
2010-04,המרכז,1066,"בני עי""ש",יישוב,205,97,108,38,167,96,202,7,5.22%
2010-04,המרכז,681,גבעת שמואל,יישוב,265,128,137,106,159,56,265,16,2.55%
2010-04,המרכז,2550,גדרה,יישוב,361,157,204,82,279,113,356,12,3.56%
2010-04,המרכז,627,ג'לג'וליה,יישוב,53,24,29,1,52,29,53,2,1.89%
2010-04,המרכז,166,גן יבנה,יישוב,352,134,218,54,298,98,351,16,3.64%
2010-04,המרכז,229,גני תקווה,יישוב,176,79,97,52,124,24,175,11,2.52%
2010-04,המרכז,9700,הוד השרון,יישוב,637,272,365,215,422,73,635,46,2.54%
2010-04,המרכז,1290,זמר,יישוב,180,59,121,1,179,137,180,7,7.39%
2010-04,המרכז,2730,טייבה,יישוב,2084,912,1172,8,2076,1765,2066,43,14.10%
2010-04,המרכז,2720,טירה,יישוב,319,161,158,11,308,198,319,14,3.58%
2010-04,המרכז,2660,יבנה,יישוב,1047,499,548,76,971,490,1041,81,5.79%
2010-04,המרכז,9400,יהוד,יישוב,554,241,313,90,464,92,525,38,3.59%
2010-04,המרכז,1224,כוכב יאיר,יישוב,101,42,59,56,45,4,101,6,1.92%
2010-04,המרכז,633,כפר ברא,יישוב,17,7,10,0,17,6,17,0,1.68%
2010-04,המרכז,168,כפר יונה,יישוב,375,142,233,57,318,97,368,35,3.91%
2010-04,המרכז,6900,כפר סבא,יישוב,1207,556,651,370,837,229,1197,83,2.61%
2010-04,המרכז,634,כפר קאסם,יישוב,204,100,104,3,201,105,204,6,3.14%
2010-04,המרכז,7000,לוד,יישוב,2220,945,1275,207,2013,1279,2210,153,6.75%
2010-04,המרכז,1200,מודיעין-מכבים-רעות*,יישוב,870,358,512,349,521,71,862,107,2.36%
2010-04,המרכז,28,מזכרת בתיה,יישוב,150,59,91,30,120,40,148,8,2.69%
2010-04,המרכז,7200,נס ציונה,יישוב,673,304,369,151,522,212,666,25,3.36%
2010-04,המרכז,7400,נתניה,יישוב,4679,2126,2553,768,3911,1936,4615,386,4.94%
2010-04,המרכז,587,סביון*,יישוב,15,6,9,7,8,1,15,0,0.92%
2010-04,המרכז,171,פרדסייה,יישוב,78,31,47,15,63,10,77,10,2.28%
2010-04,המרכז,7900,פתח תקווה,יישוב,4176,1855,2321,848,3328,1299,4146,284,3.83%
2010-04,המרכז,195,קדימה-צורן,יישוב,236,108,128,71,165,40,232,16,2.71%
2010-04,המרכז,638,קלנסווה,יישוב,885,348,537,2,883,737,880,32,12.44%
2010-04,המרכז,469,קריית עקרון,יישוב,260,129,131,12,248,130,258,9,4.85%
2010-04,המרכז,2640,ראש העין,יישוב,719,363,356,73,646,193,707,75,3.53%
2010-04,המרכז,8300,ראשון לציון,יישוב,4642,2061,2581,924,3718,1873,4614,333,3.67%
2010-04,המרכז,8400,רחובות,יישוב,2566,1114,1452,537,2029,1044,2531,95,4.45%
2010-04,המרכז,8500,רמלה,יישוב,1854,846,1008,125,1729,915,1812,144,5.68%
2010-04,המרכז,8700,רעננה,יישוב,721,350,371,277,444,83,717,40,2.07%
2010-04,המרכז,1304,שוהם,יישוב,197,86,111,96,101,2,197,15,2.05%
2010-04,המרכז,154,תל מונד,יישוב,150,63,87,46,104,19,150,14,2.81%
2010-04,הצפון,473,אבו סנאן,יישוב,717,267,450,8,709,588,713,24,14.92%
2010-04,הצפון,478,אכסאל,יישוב,675,289,386,22,653,559,674,6,14.41%
2010-04,הצפון,529,אעבלין,יישוב,668,287,381,13,655,559,668,10,14.21%
2010-04,הצפון,482,בועיינה-נוג'ידאת,יישוב,525,217,308,5,520,436,520,1,16.35%
2010-04,הצפון,4001,בוקעאתא,יישוב,398,178,220,2,396,327,388,0,16.58%
2010-04,הצפון,998,ביר אל-מכסור,יישוב,416,161,255,4,412,331,416,6,13.97%
2010-04,הצפון,480,בית ג'ן,יישוב,343,115,228,4,339,250,340,5,8.27%
2010-04,הצפון,9200,בית שאן,יישוב,836,362,474,19,817,465,832,102,8.98%
2010-04,הצפון,944,בסמת טבעון,יישוב,292,114,178,1,291,230,292,4,10.82%
2010-04,הצפון,483,בענה,יישוב,456,183,273,2,454,415,456,7,16.29%
2010-04,הצפון,1292,ג'דיידה-מכר,יישוב,1427,605,822,6,1421,1211,1427,24,18.68%
2010-04,הצפון,485,ג'ולס,יישוב,210,80,130,7,203,125,210,4,8.92%
2010-04,הצפון,487,ג'ש (גוש חלב),יישוב,59,23,36,5,54,35,59,2,4.14%
2010-04,הצפון,489,דבורייה,יישוב,430,205,225,22,408,326,427,11,11.85%
2010-04,הצפון,490,דייר אל-אסד,יישוב,436,173,263,8,428,349,436,8,10.57%
2010-04,הצפון,492,דייר חנא,יישוב,653,289,364,15,638,534,653,18,16.69%
2010-04,הצפון,975,זרזיר,יישוב,296,119,177,2,294,208,293,9,12.14%
2010-04,הצפון,496,חורפיש,יישוב,140,52,88,6,134,102,140,2,6.76%
2010-04,הצפון,2034,חצור הגלילית,יישוב,307,122,185,5,302,160,298,38,6.86%
2010-04,הצפון,6700,טבריה,יישוב,1853,802,1051,104,1749,1259,1755,127,8.75%
2010-04,הצפון,962,טובא-זנגרייה,יישוב,358,154,204,2,356,246,351,15,13.30%
2010-04,הצפון,498,טורעאן,יישוב,549,201,348,7,542,475,547,24,11.98%
2010-04,הצפון,8900,טמרה,יישוב,2059,875,1184,20,2039,1815,2057,37,17.66%
2010-04,הצפון,1295,יאנוח-ג'ת,יישוב,160,50,110,5,155,118,160,4,7.58%
2010-04,הצפון,46,יבנאל,יישוב,125,77,48,5,120,92,118,3,8.97%
2010-04,הצפון,499,יפיע,יישוב,646,278,368,9,637,498,643,29,9.98%
2010-04,הצפון,240,יקנעם עילית,יישוב,538,204,334,109,429,240,536,41,5.26%
2010-04,הצפון,502,ירכא,יישוב,439,173,266,2,437,355,438,7,9.85%
2010-04,הצפון,504,כאבול,יישוב,756,336,420,15,741,639,754,14,18.23%
2010-04,הצפון,505,כאוכב אבו אל-היג'א,יישוב,223,80,143,4,219,185,223,8,15.69%
2010-04,הצפון,1296,כסרא-סמיע,יישוב,255,92,163,1,254,210,254,10,9.47%
2010-04,הצפון,978,כעביה-טבאש-חג'אג'רה,יישוב,222,105,117,1,221,149,220,7,11.74%
2010-04,הצפון,1263,כפר ורדים,יישוב,62,29,33,27,35,10,62,4,2.14%
2010-04,הצפון,507,כפר יאסיף,יישוב,453,199,254,2,451,367,451,13,10.70%
2010-04,הצפון,508,כפר כמא,יישוב,87,40,47,4,83,45,85,3,6.32%
2010-04,הצפון,509,כפר כנא,יישוב,1223,494,729,21,1202,1038,1210,52,16.64%
2010-04,הצפון,510,כפר מנדא,יישוב,879,404,475,10,869,685,867,37,14.78%
2010-04,הצפון,47,כפר תבור,יישוב,43,15,28,19,24,6,43,1,2.58%
2010-04,הצפון,1139,כרמיאל,יישוב,1790,694,1096,348,1442,995,1742,111,7.08%
2010-04,הצפון,481,מגאר,יישוב,1447,568,879,32,1415,1267,1443,28,19.56%
2010-04,הצפון,516,מג'ד אל-כרום,יישוב,675,290,385,9,666,539,674,10,12.76%
2010-04,הצפון,874,מגדל העמק,יישוב,1059,442,617,99,960,529,1027,127,8.21%
2010-04,הצפון,4201,מג'דל שמס,יישוב,466,166,300,22,444,408,461,2,11.83%
2010-04,הצפון,517,מזרעה,יישוב,172,64,108,3,169,137,171,3,10.72%
2010-04,הצפון,4203,מסעדה,יישוב,213,78,135,4,209,179,212,1,14.47%
2010-04,הצפון,518,מעיליא,יישוב,65,34,31,12,53,34,65,4,4.68%
2010-04,הצפון,1063,מעלות-תרשיחא,יישוב,1000,436,564,127,873,660,997,63,8.80%
2010-04,הצפון,520,משהד,יישוב,336,126,210,6,330,281,333,10,12.76%
2010-04,הצפון,9100,נהרייה,יישוב,2171,989,1182,255,1916,1383,2159,93,7.75%
2010-04,הצפון,522,נחף,יישוב,465,198,267,12,453,396,464,9,11.44%
2010-04,הצפון,7300,נצרת,יישוב,2031,985,1046,54,1977,1430,2026,60,7.23%
2010-04,הצפון,1061,נצרת עילית,יישוב,1633,733,900,220,1413,838,1581,161,7.07%
2010-04,הצפון,525,סאג'ור,יישוב,115,41,74,4,111,85,114,2,8.14%
2010-04,הצפון,7500,סח'נין,יישוב,2019,918,1101,42,1977,1741,2019,42,17.61%
2010-04,הצפון,4501,ע'ג'ר,יישוב,131,52,79,5,126,108,130,8,14.79%
2010-04,הצפון,530,עיילבון,יישוב,193,82,111,11,182,150,191,4,9.00%
2010-04,הצפון,511,עילוט,יישוב,332,141,191,4,328,258,331,13,14.29%
2010-04,הצפון,532,עין מאהל,יישוב,463,234,229,2,461,370,458,13,11.16%
2010-04,הצפון,7600,עכו,יישוב,3366,1519,1847,149,3217,2638,3347,135,13.81%
2010-04,הצפון,7700,עפולה,יישוב,1888,810,1078,216,1672,1064,1839,138,8.42%
2010-04,הצפון,531,עראבה,יישוב,1351,579,772,34,1317,1165,1350,41,16.75%
2010-04,הצפון,535,פסוטה,יישוב,134,64,70,9,125,98,134,2,8.99%
2010-04,הצפון,536,פקיעין (בוקייעה),יישוב,150,75,75,5,145,112,148,4,6.33%
2010-04,הצפון,8000,צפת,יישוב,997,492,505,81,916,697,992,36,8.76%
2010-04,הצפון,4100,קצרין,יישוב,187,78,109,35,152,107,186,7,5.05%
2010-04,הצפון,2800,קריית שמונה,יישוב,835,371,464,67,768,368,820,93,6.68%
2010-04,הצפון,543,ראמה,יישוב,333,141,192,9,324,259,331,5,10.28%
2010-04,הצפון,26,ראש פינה,יישוב,45,17,28,7,38,19,45,2,3.29%
2010-04,הצפון,542,ריינה,יישוב,636,259,377,9,627,513,632,30,11.39%
2010-04,הצפון,122,רמת ישי,יישוב,107,43,64,36,71,10,107,4,2.93%
2010-04,הצפון,913,שבלי - אום אל-גנם,יישוב,251,112,139,7,244,195,247,18,11.52%
2010-04,הצפון,812,שלומי,יישוב,274,115,159,9,265,164,272,17,8.29%
2010-04,הצפון,538,שעב,יישוב,482,200,282,5,477,417,481,12,19.13%
2010-04,הצפון,8800,שפרעם,יישוב,2100,863,1237,25,2075,1749,2093,61,14.16%
2010-04,חיפה,2710,אום אל-פחם,יישוב,3428,1441,1987,11,3417,2924,3424,52,20.36%
2010-04,חיפה,1020,אור עקיבא,יישוב,628,289,339,47,581,212,609,54,6.71%
2010-04,חיפה,6000,באקה אל-גרביה,יישוב,473,257,216,10,463,288,472,27,NULL
2010-04,חיפה,9800,בנימינה-גבעת עדה*,יישוב,184,77,107,64,120,42,184,10,3.02%
2010-04,חיפה,1326,"בסמ""ה",יישוב,280,152,128,3,277,197,280,10,9.13%
2010-04,חיפה,541,ג'סר א-זרקא,יישוב,337,204,133,2,335,235,335,8,6.76%
2010-04,חיפה,628,ג'ת,יישוב,158,77,81,4,154,95,158,4,NULL
2010-04,חיפה,494,דאלית אל-כרמל,יישוב,499,211,288,14,485,307,497,30,7.35%
2010-04,חיפה,9300,זכרון יעקב,יישוב,228,107,121,69,159,48,226,17,2.51%
2010-04,חיפה,6500,חדרה,יישוב,2172,899,1273,259,1913,804,2133,161,4.88%
2010-04,חיפה,4000,חיפה,יישוב,8783,3745,5038,1641,7142,5816,8734,434,6.65%
2010-04,חיפה,1247,חריש-קציר,יישוב,25,12,13,2,23,10,25,1,1.53%
2010-04,חיפה,2100,טירת כרמל,יישוב,817,358,459,25,792,548,812,48,8.47%
2010-04,חיפה,654,כפר קרע,יישוב,284,138,146,7,277,151,283,13,4.20%
2010-04,חיפה,1327,מעלה עירון,יישוב,823,347,476,2,821,679,821,18,17.46%
2010-04,חיפה,2500,נשר,יישוב,616,275,341,133,483,331,615,31,5.04%
2010-04,חיפה,534,עספיא,יישוב,326,135,191,9,317,212,325,8,6.86%
2010-04,חיפה,637,ערערה,יישוב,415,193,222,5,410,248,415,26,6.39%
2010-04,חיפה,537,פוריידיס,יישוב,356,187,169,5,351,250,355,15,7.61%
2010-04,חיפה,7800,פרדס חנה-כרכור,יישוב,766,345,421,131,635,212,759,64,4.54%
2010-04,חיפה,6800,קריית אתא,יישוב,2012,830,1182,162,1850,1269,2005,93,7.48%
2010-04,חיפה,9500,קריית ביאליק,יישוב,1331,540,791,166,1165,759,1323,94,6.62%
2010-04,חיפה,2300,קריית טבעון,יישוב,200,90,110,67,133,55,200,11,2.65%
2010-04,חיפה,9600,קריית ים,יישוב,1924,819,1105,170,1754,1293,1917,137,9.54%
2010-04,חיפה,8200,קריית מוצקין,יישוב,1258,475,783,181,1077,710,1248,77,6.00%
2010-04,חיפה,922,רכסים,יישוב,157,73,84,9,148,110,156,2,5.77%
2010-04,ירושלים,472,אבו גוש,יישוב,262,124,138,5,257,177,262,13,10.82%
2010-04,ירושלים,2610,בית שמש,יישוב,1179,511,668,118,1061,597,1168,114,4.74%
2010-04,ירושלים,3000,ירושלים,יישוב,8494,3769,4725,1193,7301,4693,8451,564,3.42%
2010-04,ירושלים,1015,מבשרת ציון,יישוב,333,156,177,73,260,135,332,27,2.85%
2010-04,ירושלים,1137,קריית יערים,יישוב,33,12,21,7,26,13,33,3,3.29%
2010-04,תל אביב,2400,אור יהודה,יישוב,839,379,460,52,787,347,825,59,4.75%
2010-04,תל אביב,565,אזור,יישוב,163,81,82,28,135,42,160,13,2.73%
2010-04,תל אביב,6100,בני ברק,יישוב,2112,1010,1102,128,1984,1327,2101,90,4.57%
2010-04,תל אביב,6200,בת ים,יישוב,3494,1544,1950,544,2950,1658,3425,255,4.92%
2010-04,תל אביב,6300,גבעתיים,יישוב,699,311,388,299,400,120,690,33,2.53%
2010-04,תל אביב,6400,הרצלייה,יישוב,1167,525,642,350,817,178,1138,123,2.51%
2010-04,תל אביב,6600,חולון,יישוב,3146,1439,1707,517,2629,1119,3108,231,3.37%
2010-04,תל אביב,2620,קריית אונו,יישוב,403,173,230,150,253,60,400,10,2.48%
2010-04,תל אביב,8600,רמת גן,יישוב,2111,955,1156,673,1438,547,2090,147,2.94%
2010-04,תל אביב,2650,רמת השרון,יישוב,407,166,241,166,241,40,407,29,2.00%
2010-04,תל אביב,5000,תל אביב -יפו,יישוב,7892,3816,4076,2345,5547,3000,7826,477,3.40%
2010-05,אזור יהודה והשומרון,3760,אורנית,יישוב,80,43,37,29,51,5,80,3,2.14%
2010-05,אזור יהודה והשומרון,3750,אלפי מנשה,יישוב,103,39,64,30,73,5,103,6,2.55%
2010-05,אזור יהודה והשומרון,3560,אלקנה,יישוב,32,18,14,15,17,3,32,3,1.88%
2010-05,אזור יהודה והשומרון,3650,אפרתה,יישוב,46,26,20,19,27,4,46,2,1.31%
2010-05,אזור יהודה והשומרון,3570,אריאל,יישוב,436,206,230,108,328,134,436,63,4.37%
2010-05,אזור יהודה והשומרון,3574,בית אל,יישוב,45,18,27,23,22,15,44,4,2.07%
2010-05,אזור יהודה והשומרון,3652,בית אריה,יישוב,63,31,32,10,53,5,63,5,2.97%
2010-05,אזור יהודה והשומרון,3780,ביתר עילית,יישוב,363,166,197,17,346,195,359,19,4.31%
2010-05,אזור יהודה והשומרון,3730,גבעת זאב,יישוב,166,74,92,19,147,38,165,12,2.75%
2010-05,אזור יהודה והשומרון,3769,הר אדר,יישוב,24,9,15,14,10,3,24,2,1.41%
2010-05,אזור יהודה והשומרון,3797,מודיעין עילית,יישוב,286,99,187,14,272,81,284,13,2.75%
2010-05,אזור יהודה והשומרון,3616,מעלה אדומים,יישוב,675,266,409,103,572,238,666,65,3.77%
2010-05,אזור יהודה והשומרון,3660,עמנואל,יישוב,85,44,41,4,81,61,85,4,9.05%
2010-05,אזור יהודה והשומרון,3557,קדומים,יישוב,31,17,14,10,21,6,31,1,1.93%
2010-05,אזור יהודה והשומרון,3611,קריית ארבע,יישוב,115,58,57,20,95,71,115,12,4.14%
2010-05,אזור יהודה והשומרון,3640,קרני שומרון,יישוב,78,40,38,18,60,24,78,6,2.40%
2010-05,הדרום,31,אופקים,יישוב,1408,580,828,88,1320,1017,1399,77,12.43%
2010-05,הדרום,2600,אילת,יישוב,1419,657,762,76,1343,691,1400,96,4.58%
2010-05,הדרום,70,אשדוד,יישוב,7309,2850,4459,839,6470,4523,7239,464,7.23%
2010-05,הדרום,7100,אשקלון,יישוב,4641,1775,2866,709,3932,2885,4542,423,7.80%
2010-05,הדרום,9000,באר שבע,יישוב,7989,3534,4455,1028,6961,5363,7935,567,8.40%
2010-05,הדרום,2200,דימונה,יישוב,2126,945,1181,130,1996,1520,2097,110,11.97%
2010-05,הדרום,1303,חורה,יישוב,704,304,400,0,704,643,704,5,23.29%
2010-05,הדרום,831,ירוחם,יישוב,445,221,224,24,421,278,439,52,10.62%
2010-05,הדרום,1059,כסיפה,יישוב,974,429,545,1,973,881,973,40,26.13%
2010-05,הדרום,1271,להבים,יישוב,51,24,27,27,24,5,51,9,1.66%
2010-05,הדרום,1060,לקיה,יישוב,903,426,477,2,901,831,901,8,28.22%
2010-05,הדרום,1268,מיתר,יישוב,64,28,36,29,35,6,63,13,1.71%
2010-05,הדרום,99,מצפה רמון,יישוב,235,90,145,21,214,124,217,36,9.79%
2010-05,הדרום,246,נתיבות,יישוב,955,432,523,51,904,552,949,63,8.17%
2010-05,הדרום,666,עומר,יישוב,56,26,30,25,31,7,56,3,1.51%
2010-05,הדרום,2560,ערד,יישוב,954,393,561,165,789,636,931,86,7.56%
2010-05,הדרום,1192,ערערה-בנגב,יישוב,952,385,567,2,950,859,951,8,29.89%
2010-05,הדרום,2630,קריית גת,יישוב,2470,1021,1449,203,2267,1656,2461,169,9.86%
2010-05,הדרום,1034,קריית מלאכי,יישוב,1304,571,733,32,1272,889,1284,102,11.89%
2010-05,הדרום,1161,רהט,יישוב,2964,1204,1760,6,2958,2611,2961,88,21.10%
2010-05,הדרום,1286,שגב-שלום,יישוב,561,244,317,3,558,499,560,7,26.92%
2010-05,הדרום,1031,שדרות,יישוב,1112,451,661,60,1052,631,1109,54,10.01%
2010-05,הדרום,1054,תל שבע,יישוב,1197,592,605,6,1191,1073,1194,8,30.85%
2010-05,המרכז,182,אבן יהודה,יישוב,149,71,78,54,95,24,148,7,2.49%
2010-05,המרכז,41,אליכין,יישוב,70,40,30,8,62,17,70,3,4.40%
2010-05,המרכז,1309,אלעד,יישוב,363,165,198,25,338,116,362,21,3.45%
2010-05,המרכז,2530,באר יעקב,יישוב,254,121,133,39,215,81,249,19,3.57%
2010-05,המרכז,466,בית דגן,יישוב,109,53,56,17,92,38,108,12,3.31%
2010-05,המרכז,1066,"בני עי""ש",יישוב,194,90,104,34,160,93,191,12,4.95%
2010-05,המרכז,681,גבעת שמואל,יישוב,252,125,127,100,152,51,252,17,2.43%
2010-05,המרכז,2550,גדרה,יישוב,337,143,194,76,261,107,333,8,3.34%
2010-05,המרכז,627,ג'לג'וליה,יישוב,53,23,30,2,51,28,52,3,1.85%
2010-05,המרכז,166,גן יבנה,יישוב,345,128,217,47,298,101,344,25,3.57%
2010-05,המרכז,229,גני תקווה,יישוב,178,78,100,44,134,28,177,14,2.54%
2010-05,המרכז,9700,הוד השרון,יישוב,626,280,346,206,420,77,622,44,2.49%
2010-05,המרכז,1290,זמר,יישוב,175,55,120,1,174,138,175,7,7.20%
2010-05,המרכז,2730,טייבה,יישוב,2075,902,1173,9,2066,1763,2064,43,14.09%
2010-05,המרכז,2720,טירה,יישוב,329,162,167,10,319,201,328,12,3.68%
2010-05,המרכז,2660,יבנה,יישוב,1031,489,542,75,956,491,1026,97,5.71%
2010-05,המרכז,9400,יהוד,יישוב,569,261,308,91,478,85,540,40,3.69%
2010-05,המרכז,1224,כוכב יאיר,יישוב,106,48,58,52,54,4,106,6,2.02%
2010-05,המרכז,633,כפר ברא,יישוב,19,9,10,0,19,7,19,2,1.88%
2010-05,המרכז,168,כפר יונה,יישוב,354,129,225,51,303,99,349,35,3.71%
2010-05,המרכז,6900,כפר סבא,יישוב,1203,549,654,365,838,235,1194,77,2.61%
2010-05,המרכז,634,כפר קאסם,יישוב,212,109,103,2,210,111,212,1,3.26%
2010-05,המרכז,7000,לוד,יישוב,2246,985,1261,201,2045,1307,2235,186,6.82%
2010-05,המרכז,1200,מודיעין-מכבים-רעות*,יישוב,911,373,538,360,551,73,900,90,2.46%
2010-05,המרכז,28,מזכרת בתיה,יישוב,167,65,102,23,144,37,166,5,3.01%
2010-05,המרכז,7200,נס ציונה,יישוב,682,313,369,149,533,217,677,33,3.41%
2010-05,המרכז,7400,נתניה,יישוב,5173,2232,2941,787,4386,2369,5096,624,5.43%
2010-05,המרכז,587,סביון*,יישוב,14,6,8,7,7,1,13,4,0.80%
2010-05,המרכז,171,פרדסייה,יישוב,76,32,44,18,58,9,75,9,2.22%
2010-05,המרכז,7900,פתח תקווה,יישוב,4278,1940,2338,849,3429,1289,4249,335,3.92%
2010-05,המרכז,195,קדימה-צורן,יישוב,239,115,124,75,164,39,236,18,2.76%
2010-05,המרכז,638,קלנסווה,יישוב,857,328,529,1,856,727,853,14,12.10%
2010-05,המרכז,469,קריית עקרון,יישוב,265,126,139,14,251,125,263,17,4.94%
2010-05,המרכז,2640,ראש העין,יישוב,775,403,372,79,696,189,759,71,3.78%
2010-05,המרכז,8300,ראשון לציון,יישוב,4855,2123,2732,923,3932,1882,4829,389,3.83%
2010-05,המרכז,8400,רחובות,יישוב,2575,1131,1444,536,2039,1061,2538,127,4.46%
2010-05,המרכז,8500,רמלה,יישוב,1904,883,1021,120,1784,901,1866,181,5.84%
2010-05,המרכז,8700,רעננה,יישוב,745,354,391,287,458,87,740,47,2.13%
2010-05,המרכז,1304,שוהם,יישוב,197,89,108,92,105,2,197,15,2.05%
2010-05,המרכז,154,תל מונד,יישוב,142,66,76,46,96,18,142,10,2.66%
2010-05,הצפון,473,אבו סנאן,יישוב,712,267,445,9,703,589,708,14,14.83%
2010-05,הצפון,478,אכסאל,יישוב,663,282,381,19,644,556,662,18,14.19%
2010-05,הצפון,529,אעבלין,יישוב,679,290,389,14,665,564,679,14,14.41%
2010-05,הצפון,482,בועיינה-נוג'ידאת,יישוב,537,227,310,5,532,448,533,3,16.69%
2010-05,הצפון,4001,בוקעאתא,יישוב,401,176,225,2,399,332,391,3,16.69%
2010-05,הצפון,998,ביר אל-מכסור,יישוב,417,157,260,4,413,334,417,7,14.00%
2010-05,הצפון,480,בית ג'ן,יישוב,330,109,221,3,327,247,326,10,7.96%
2010-05,הצפון,9200,בית שאן,יישוב,787,355,432,18,769,450,783,93,8.50%
2010-05,הצפון,944,בסמת טבעון,יישוב,307,126,181,2,305,243,307,11,11.31%
2010-05,הצפון,483,בענה,יישוב,459,181,278,1,458,410,459,8,16.38%
2010-05,הצפון,1292,ג'דיידה-מכר,יישוב,1448,609,839,7,1441,1240,1448,30,18.91%
2010-05,הצפון,485,ג'ולס,יישוב,230,77,153,4,226,136,230,12,9.69%
2010-05,הצפון,487,ג'ש (גוש חלב),יישוב,62,26,36,8,54,32,62,3,4.34%
2010-05,הצפון,489,דבורייה,יישוב,408,188,220,23,385,316,407,7,11.36%
2010-05,הצפון,490,דייר אל-אסד,יישוב,431,170,261,5,426,350,431,7,10.46%
2010-05,הצפון,492,דייר חנא,יישוב,659,294,365,15,644,526,659,21,16.82%
2010-05,הצפון,975,זרזיר,יישוב,283,118,165,1,282,202,280,7,11.66%
2010-05,הצפון,496,חורפיש,יישוב,138,49,89,4,134,101,138,4,6.67%
2010-05,הצפון,2034,חצור הגלילית,יישוב,294,121,173,7,287,147,289,53,6.66%
2010-05,הצפון,6700,טבריה,יישוב,1827,769,1058,104,1723,1252,1733,106,8.65%
2010-05,הצפון,962,טובא-זנגרייה,יישוב,383,161,222,2,381,249,378,11,14.18%
2010-05,הצפון,498,טורעאן,יישוב,529,192,337,10,519,469,527,9,11.60%
2010-05,הצפון,8900,טמרה,יישוב,2031,851,1180,20,2011,1795,2029,34,17.46%
2010-05,הצפון,1295,יאנוח-ג'ת,יישוב,163,49,114,5,158,119,163,7,7.71%
2010-05,הצפון,46,יבנאל,יישוב,117,75,42,5,112,95,111,2,8.49%
2010-05,הצפון,499,יפיע,יישוב,637,267,370,9,628,499,632,20,9.82%
2010-05,הצפון,240,יקנעם עילית,יישוב,502,195,307,101,401,218,501,50,4.93%
2010-05,הצפון,502,ירכא,יישוב,468,184,284,3,465,370,467,15,10.43%
2010-05,הצפון,504,כאבול,יישוב,740,317,423,15,725,639,738,11,17.91%
2010-05,הצפון,505,כאוכב אבו אל-היג'א,יישוב,220,81,139,4,216,183,220,10,15.51%
2010-05,הצפון,1296,כסרא-סמיע,יישוב,255,97,158,1,254,205,254,8,9.47%
2010-05,הצפון,978,כעביה-טבאש-חג'אג'רה,יישוב,211,95,116,2,209,147,209,5,11.22%
2010-05,הצפון,1263,כפר ורדים,יישוב,58,29,29,25,33,6,58,3,2.00%
2010-05,הצפון,507,כפר יאסיף,יישוב,456,199,257,2,454,371,452,11,10.72%
2010-05,הצפון,508,כפר כמא,יישוב,77,35,42,3,74,44,75,3,5.62%
2010-05,הצפון,509,כפר כנא,יישוב,1184,480,704,17,1167,1019,1173,30,16.22%
2010-05,הצפון,510,כפר מנדא,יישוב,870,389,481,9,861,687,859,28,14.66%
2010-05,הצפון,47,כפר תבור,יישוב,48,19,29,22,26,7,48,3,2.87%
2010-05,הצפון,1139,כרמיאל,יישוב,1780,688,1092,341,1439,989,1723,126,7.01%
2010-05,הצפון,481,מגאר,יישוב,1487,584,903,33,1454,1278,1483,68,20.00%
2010-05,הצפון,516,מג'ד אל-כרום,יישוב,663,276,387,8,655,532,662,16,12.56%
2010-05,הצפון,874,מגדל העמק,יישוב,1073,457,616,99,974,531,1041,149,8.31%
2010-05,הצפון,4201,מג'דל שמס,יישוב,486,173,313,21,465,417,479,4,12.24%
2010-05,הצפון,517,מזרעה,יישוב,161,60,101,3,158,133,160,4,10.10%
2010-05,הצפון,4203,מסעדה,יישוב,213,78,135,6,207,180,212,1,14.47%
2010-05,הצפון,518,מעיליא,יישוב,62,33,29,9,53,36,62,2,4.47%
2010-05,הצפון,1063,מעלות-תרשיחא,יישוב,1023,456,567,117,906,664,1020,63,8.98%
2010-05,הצפון,520,משהד,יישוב,328,125,203,5,323,264,327,12,12.56%
2010-05,הצפון,9100,נהרייה,יישוב,2178,978,1200,252,1926,1394,2163,112,7.76%
2010-05,הצפון,522,נחף,יישוב,463,190,273,10,453,396,462,7,11.40%
2010-05,הצפון,7300,נצרת,יישוב,2777,1240,1537,60,2717,2148,2760,210,9.60%
2010-05,הצפון,1061,נצרת עילית,יישוב,2025,818,1207,244,1781,1273,1930,386,8.49%
2010-05,הצפון,525,סאג'ור,יישוב,123,49,74,4,119,89,122,2,8.66%
2010-05,הצפון,7500,סח'נין,יישוב,2043,940,1103,43,2000,1768,2043,50,17.78%
2010-05,הצפון,4501,ע'ג'ר,יישוב,125,46,79,2,123,104,124,11,14.20%
2010-05,הצפון,530,עיילבון,יישוב,195,82,113,11,184,153,194,6,9.13%
2010-05,הצפון,511,עילוט,יישוב,334,141,193,5,329,258,333,14,14.37%
2010-05,הצפון,532,עין מאהל,יישוב,625,284,341,3,622,530,617,54,14.47%
2010-05,הצפון,7600,עכו,יישוב,3390,1544,1846,152,3238,2651,3370,138,13.89%
2010-05,הצפון,7700,עפולה,יישוב,1916,814,1102,207,1709,1062,1858,164,8.50%
2010-05,הצפון,531,עראבה,יישוב,1371,583,788,34,1337,1176,1370,47,16.95%
2010-05,הצפון,535,פסוטה,יישוב,133,64,69,8,125,95,133,0,8.93%
2010-05,הצפון,536,פקיעין (בוקייעה),יישוב,155,78,77,6,149,116,153,1,6.53%
2010-05,הצפון,8000,צפת,יישוב,982,501,481,79,903,714,978,34,8.65%
2010-05,הצפון,4100,קצרין,יישוב,186,75,111,35,151,102,184,8,4.99%
2010-05,הצפון,2800,קריית שמונה,יישוב,804,367,437,52,752,371,787,122,6.43%
2010-05,הצפון,543,ראמה,יישוב,334,146,188,6,328,259,330,8,10.25%
2010-05,הצפון,26,ראש פינה,יישוב,48,18,30,6,42,21,48,5,3.51%
2010-05,הצפון,542,ריינה,יישוב,642,264,378,11,631,517,637,30,11.47%
2010-05,הצפון,122,רמת ישי,יישוב,106,42,64,32,74,9,105,9,2.87%
2010-05,הצפון,913,שבלי - אום אל-גנם,יישוב,235,109,126,8,227,187,232,10,10.90%
2010-05,הצפון,812,שלומי,יישוב,278,115,163,11,267,162,276,14,8.40%
2010-05,הצפון,538,שעב,יישוב,474,195,279,5,469,414,473,18,18.87%
2010-05,הצפון,8800,שפרעם,יישוב,2103,852,1251,18,2085,1757,2096,82,14.18%
2010-05,חיפה,2710,אום אל-פחם,יישוב,3446,1440,2006,11,3435,2946,3442,66,20.44%
2010-05,חיפה,1020,אור עקיבא,יישוב,666,285,381,46,620,266,652,104,7.15%
2010-05,חיפה,6000,באקה אל-גרביה,יישוב,549,275,274,14,535,348,548,27,NULL
2010-05,חיפה,9800,בנימינה-גבעת עדה*,יישוב,182,77,105,59,123,48,182,16,2.99%
2010-05,חיפה,1326,"בסמ""ה",יישוב,339,165,174,4,335,253,339,23,10.85%
2010-05,חיפה,541,ג'סר א-זרקא,יישוב,386,209,177,1,385,250,384,13,7.67%
2010-05,חיפה,628,ג'ת,יישוב,191,88,103,5,186,124,191,21,NULL
2010-05,חיפה,494,דאלית אל-כרמל,יישוב,523,223,300,13,510,311,518,25,7.64%
2010-05,חיפה,9300,זכרון יעקב,יישוב,214,98,116,58,156,46,214,18,2.38%
2010-05,חיפה,6500,חדרה,יישוב,2445,954,1491,268,2177,1040,2404,210,5.47%
2010-05,חיפה,4000,חיפה,יישוב,8776,3774,5002,1648,7128,5807,8720,506,6.64%
2010-05,חיפה,1247,חריש-קציר,יישוב,27,11,16,2,25,13,26,1,1.59%
2010-05,חיפה,2100,טירת כרמל,יישוב,817,358,459,26,791,540,812,44,8.47%
2010-05,חיפה,654,כפר קרע,יישוב,312,147,165,9,303,177,310,16,4.58%
2010-05,חיפה,1327,מעלה עירון,יישוב,820,332,488,2,818,683,818,14,17.41%
2010-05,חיפה,2500,נשר,יישוב,614,271,343,126,488,333,613,25,5.03%
2010-05,חיפה,534,עספיא,יישוב,342,138,204,11,331,219,340,22,7.15%
2010-05,חיפה,637,ערערה,יישוב,457,199,258,4,453,299,457,22,6.99%
2010-05,חיפה,537,פוריידיס,יישוב,353,177,176,4,349,252,350,9,7.51%
2010-05,חיפה,7800,פרדס חנה-כרכור,יישוב,839,353,486,136,703,270,831,102,4.95%
2010-05,חיפה,6800,קריית אתא,יישוב,2007,814,1193,149,1858,1266,1996,132,7.45%
2010-05,חיפה,9500,קריית ביאליק,יישוב,1330,527,803,174,1156,738,1323,99,6.62%
2010-05,חיפה,2300,קריית טבעון,יישוב,199,89,110,71,128,51,199,11,2.64%
2010-05,חיפה,9600,קריית ים,יישוב,1889,806,1083,164,1725,1289,1885,125,9.40%
2010-05,חיפה,8200,קריית מוצקין,יישוב,1251,476,775,192,1059,688,1239,83,5.96%
2010-05,חיפה,922,רכסים,יישוב,150,73,77,8,142,111,149,3,5.52%
2010-05,ירושלים,472,אבו גוש,יישוב,260,123,137,5,255,175,260,12,10.75%
2010-05,ירושלים,2610,בית שמש,יישוב,1149,513,636,112,1037,556,1138,120,4.63%
2010-05,ירושלים,3000,ירושלים,יישוב,9712,4273,5439,1257,8455,5813,9624,768,3.88%
2010-05,ירושלים,1015,מבשרת ציון,יישוב,348,163,185,82,266,139,347,20,2.97%
2010-05,ירושלים,1137,קריית יערים,יישוב,29,10,19,8,21,12,29,2,2.91%
2010-05,תל אביב,2400,אור יהודה,יישוב,824,371,453,42,782,343,807,59,4.65%
2010-05,תל אביב,565,אזור,יישוב,161,75,86,30,131,47,160,21,2.73%
2010-05,תל אביב,6100,בני ברק,יישוב,2112,1016,1096,113,1999,1322,2100,125,4.57%
2010-05,תל אביב,6200,בת ים,יישוב,3576,1595,1981,551,3025,1669,3504,273,5.02%
2010-05,תל אביב,6300,גבעתיים,יישוב,721,314,407,306,415,120,714,39,2.62%
2010-05,תל אביב,6400,הרצלייה,יישוב,1175,551,624,346,829,178,1141,148,2.51%
2010-05,תל אביב,6600,חולון,יישוב,3277,1511,1766,532,2745,1149,3224,302,3.49%
2010-05,תל אביב,2620,קריית אונו,יישוב,445,206,239,149,296,63,440,37,2.72%
2010-05,תל אביב,8600,רמת גן,יישוב,2115,949,1166,677,1438,566,2096,136,2.94%
2010-05,תל אביב,2650,רמת השרון,יישוב,409,180,229,163,246,40,405,38,1.99%
2010-05,תל אביב,5000,תל אביב -יפו,יישוב,7919,3855,4064,2332,5587,3022,7842,481,3.41%
2010-06,אזור יהודה והשומרון,3760,אורנית,יישוב,115,62,53,30,85,6,115,12,3.05%
2010-06,אזור יהודה והשומרון,3750,אלפי מנשה,יישוב,146,65,81,22,124,3,146,12,3.57%
2010-06,אזור יהודה והשומרון,3560,אלקנה,יישוב,48,29,19,17,31,3,48,5,2.80%
2010-06,אזור יהודה והשומרון,3650,אפרתה,יישוב,126,76,50,21,105,5,126,3,3.51%
2010-06,אזור יהודה והשומרון,3570,אריאל,יישוב,498,240,258,102,396,130,497,56,4.96%
2010-06,אזור יהודה והשומרון,3574,בית אל,יישוב,54,21,33,25,29,18,53,3,2.49%
2010-06,אזור יהודה והשומרון,3652,בית אריה,יישוב,91,42,49,11,80,5,91,12,4.23%
2010-06,אזור יהודה והשומרון,3780,ביתר עילית,יישוב,364,152,212,13,351,197,360,11,4.32%
2010-06,אזור יהודה והשומרון,3730,גבעת זאב,יישוב,212,96,116,22,190,40,210,18,3.47%
2010-06,אזור יהודה והשומרון,3769,הר אדר,יישוב,36,18,18,12,24,3,36,1,2.09%
2010-06,אזור יהודה והשומרון,3797,מודיעין עילית,יישוב,292,100,192,14,278,89,290,14,2.80%
2010-06,אזור יהודה והשומרון,3616,מעלה אדומים,יישוב,722,298,424,106,616,229,714,68,4.03%
2010-06,אזור יהודה והשומרון,3660,עמנואל,יישוב,97,51,46,4,93,65,96,7,10.11%
2010-06,אזור יהודה והשומרון,3557,קדומים,יישוב,38,19,19,13,25,5,38,1,2.36%
2010-06,אזור יהודה והשומרון,3611,קריית ארבע,יישוב,123,60,63,20,103,66,123,13,4.41%
2010-06,אזור יהודה והשומרון,3640,קרני שומרון,יישוב,101,49,52,18,83,20,101,7,3.09%
2010-06,הדרום,31,אופקים,יישוב,1480,644,836,85,1395,1022,1469,73,12.97%
2010-06,הדרום,2600,אילת,יישוב,1726,797,929,81,1645,694,1713,116,5.55%
2010-06,הדרום,70,אשדוד,יישוב,7609,3012,4597,849,6760,4474,7532,461,7.51%
2010-06,הדרום,7100,אשקלון,יישוב,5127,1955,3172,715,4412,2974,5013,661,8.54%
2010-06,הדרום,9000,באר שבע,יישוב,8554,3817,4737,1014,7540,5335,8499,1218,8.95%
2010-06,הדרום,2200,דימונה,יישוב,2234,1035,1199,128,2106,1535,2201,213,12.49%
2010-06,הדרום,1303,חורה,יישוב,723,320,403,0,723,655,723,10,23.77%
2010-06,הדרום,831,ירוחם,יישוב,515,264,251,24,491,284,509,85,12.11%
2010-06,הדרום,1059,כסיפה,יישוב,952,426,526,1,951,873,951,10,25.70%
2010-06,הדרום,1271,להבים,יישוב,68,35,33,22,46,4,68,33,2.21%
2010-06,הדרום,1060,לקיה,יישוב,915,439,476,3,912,833,912,11,28.46%
2010-06,הדרום,1268,מיתר,יישוב,86,35,51,25,61,5,85,46,2.29%
2010-06,הדרום,99,מצפה רמון,יישוב,287,105,182,23,264,130,264,71,11.67%
2010-06,הדרום,246,נתיבות,יישוב,1172,515,657,55,1117,566,1165,183,9.85%
2010-06,הדרום,666,עומר,יישוב,89,37,52,25,64,7,89,36,2.38%
2010-06,הדרום,2560,ערד,יישוב,1003,423,580,172,831,638,973,169,7.87%
2010-06,הדרום,1192,ערערה-בנגב,יישוב,963,396,567,1,962,868,963,8,30.15%
2010-06,הדרום,2630,קריית גת,יישוב,2617,1087,1530,207,2410,1683,2610,197,10.39%
2010-06,הדרום,1034,קריית מלאכי,יישוב,1446,644,802,32,1414,881,1416,202,12.96%
2010-06,הדרום,1161,רהט,יישוב,3061,1282,1779,6,3055,2653,3058,133,21.64%
2010-06,הדרום,1286,שגב-שלום,יישוב,572,246,326,2,570,510,571,13,27.31%
2010-06,הדרום,1031,שדרות,יישוב,1295,537,758,63,1232,641,1291,71,11.47%
2010-06,הדרום,1054,תל שבע,יישוב,1222,614,608,5,1217,1088,1219,19,31.30%
2010-06,המרכז,182,אבן יהודה,יישוב,164,83,81,48,116,21,164,8,2.75%
2010-06,המרכז,41,אליכין,יישוב,67,35,32,7,60,15,67,5,4.22%
2010-06,המרכז,1309,אלעד,יישוב,398,177,221,25,373,115,396,21,3.76%
2010-06,המרכז,2530,באר יעקב,יישוב,272,127,145,36,236,86,266,16,3.80%
2010-06,המרכז,466,בית דגן,יישוב,148,78,70,19,129,34,147,8,4.45%
2010-06,המרכז,1066,"בני עי""ש",יישוב,218,105,113,32,186,88,216,13,5.56%
2010-06,המרכז,681,גבעת שמואל,יישוב,377,177,200,100,277,48,377,15,3.59%
2010-06,המרכז,2550,גדרה,יישוב,422,208,214,75,347,111,417,18,4.14%
2010-06,המרכז,627,ג'לג'וליה,יישוב,77,42,35,3,74,29,77,4,2.72%
2010-06,המרכז,166,גן יבנה,יישוב,392,142,250,53,339,101,391,22,4.04%
2010-06,המרכז,229,גני תקווה,יישוב,238,113,125,48,190,28,237,14,3.38%
2010-06,המרכז,9700,הוד השרון,יישוב,890,462,428,189,701,71,886,61,3.51%
2010-06,המרכז,1290,זמר,יישוב,176,57,119,1,175,139,176,6,7.23%
2010-06,המרכז,2730,טייבה,יישוב,2111,921,1190,4,2107,1754,2100,40,14.30%
2010-06,המרכז,2720,טירה,יישוב,334,165,169,9,325,201,333,15,3.73%
2010-06,המרכז,2660,יבנה,יישוב,1190,542,648,80,1110,482,1188,106,6.55%
2010-06,המרכז,9400,יהוד,יישוב,678,315,363,91,587,90,652,86,4.42%
2010-06,המרכז,1224,כוכב יאיר,יישוב,137,64,73,45,92,4,137,11,2.59%
2010-06,המרכז,633,כפר ברא,יישוב,19,9,10,0,19,9,19,2,1.88%
2010-06,המרכז,168,כפר יונה,יישוב,429,157,272,61,368,93,426,29,4.49%
2010-06,המרכז,6900,כפר סבא,יישוב,1521,724,797,357,1164,233,1511,130,3.28%
2010-06,המרכז,634,כפר קאסם,יישוב,225,119,106,3,222,115,225,6,3.45%
2010-06,המרכז,7000,לוד,יישוב,2419,1071,1348,200,2219,1295,2403,185,7.30%
2010-06,המרכז,1200,מודיעין-מכבים-רעות*,יישוב,1497,676,821,347,1150,79,1483,196,3.99%
2010-06,המרכז,28,מזכרת בתיה,יישוב,253,118,135,27,226,36,251,15,4.49%
2010-06,המרכז,7200,נס ציונה,יישוב,811,386,425,143,668,212,806,31,4.03%
2010-06,המרכז,7400,נתניה,יישוב,5743,2595,3148,758,4985,2255,5673,593,6.01%
2010-06,המרכז,587,סביון*,יישוב,15,4,11,6,9,1,15,2,0.92%
2010-06,המרכז,171,פרדסייה,יישוב,101,44,57,22,79,10,100,10,2.94%
2010-06,המרכז,7900,פתח תקווה,יישוב,5604,2599,3005,789,4815,1261,5567,434,5.08%
2010-06,המרכז,195,קדימה-צורן,יישוב,310,138,172,80,230,38,307,20,3.56%
2010-06,המרכז,638,קלנסווה,יישוב,874,342,532,1,873,736,870,16,12.31%
2010-06,המרכז,469,קריית עקרון,יישוב,323,158,165,11,312,123,320,18,5.95%
2010-06,המרכז,2640,ראש העין,יישוב,1008,517,491,92,916,195,986,94,4.86%
2010-06,המרכז,8300,ראשון לציון,יישוב,5694,2535,3159,917,4777,1853,5661,569,4.46%
2010-06,המרכז,8400,רחובות,יישוב,2878,1282,1596,521,2357,1061,2844,136,4.98%
2010-06,המרכז,8500,רמלה,יישוב,1984,929,1055,106,1878,885,1954,167,6.10%
2010-06,המרכז,8700,רעננה,יישוב,1099,548,551,263,836,88,1095,61,3.12%
2010-06,המרכז,1304,שוהם,יישוב,541,228,313,94,447,2,541,18,5.44%
2010-06,המרכז,154,תל מונד,יישוב,158,64,94,43,115,22,158,9,2.96%
2010-06,הצפון,473,אבו סנאן,יישוב,730,276,454,7,723,595,726,16,15.15%
2010-06,הצפון,478,אכסאל,יישוב,639,265,374,19,620,530,638,31,13.75%
2010-06,הצפון,529,אעבלין,יישוב,679,288,391,12,667,565,679,11,14.41%
2010-06,הצפון,482,בועיינה-נוג'ידאת,יישוב,545,229,316,7,538,444,541,25,16.90%
2010-06,הצפון,4001,בוקעאתא,יישוב,386,167,219,2,384,322,376,3,16.15%
2010-06,הצפון,998,ביר אל-מכסור,יישוב,413,156,257,2,411,335,413,7,13.88%
2010-06,הצפון,480,בית ג'ן,יישוב,342,107,235,5,337,252,337,4,8.20%
2010-06,הצפון,9200,בית שאן,יישוב,885,398,487,15,870,459,883,100,9.48%
2010-06,הצפון,944,בסמת טבעון,יישוב,302,122,180,3,299,240,302,9,11.15%
2010-06,הצפון,483,בענה,יישוב,454,180,274,0,454,403,454,4,16.23%
2010-06,הצפון,1292,ג'דיידה-מכר,יישוב,1461,616,845,6,1455,1248,1461,31,19.04%
2010-06,הצפון,485,ג'ולס,יישוב,241,76,165,3,238,137,241,8,10.10%
2010-06,הצפון,487,ג'ש (גוש חלב),יישוב,71,28,43,8,63,35,71,0,4.94%
2010-06,הצפון,489,דבורייה,יישוב,439,207,232,24,415,322,438,10,12.12%
2010-06,הצפון,490,דייר אל-אסד,יישוב,433,173,260,6,427,345,433,7,10.51%
2010-06,הצפון,492,דייר חנא,יישוב,662,300,362,15,647,524,662,29,16.88%
2010-06,הצפון,975,זרזיר,יישוב,272,122,150,1,271,191,268,8,11.22%
2010-06,הצפון,496,חורפיש,יישוב,147,58,89,5,142,101,147,9,7.07%
2010-06,הצפון,2034,חצור הגלילית,יישוב,352,159,193,9,343,150,345,49,7.85%
2010-06,הצפון,6700,טבריה,יישוב,1969,842,1127,100,1869,1254,1867,155,9.26%
2010-06,הצפון,962,טובא-זנגרייה,יישוב,403,175,228,5,398,262,397,9,14.79%
2010-06,הצפון,498,טורעאן,יישוב,536,207,329,10,526,458,534,10,11.73%
2010-06,הצפון,8900,טמרה,יישוב,2042,857,1185,27,2015,1790,2039,58,17.53%
2010-06,הצפון,1295,יאנוח-ג'ת,יישוב,173,58,115,5,168,118,173,9,8.15%
2010-06,הצפון,46,יבנאל,יישוב,132,83,49,5,127,103,126,1,9.52%
2010-06,הצפון,499,יפיע,יישוב,670,305,365,13,657,501,667,27,10.31%
2010-06,הצפון,240,יקנעם עילית,יישוב,588,251,337,98,490,228,586,45,5.72%
2010-06,הצפון,502,ירכא,יישוב,516,194,322,3,513,384,515,14,11.38%
2010-06,הצפון,504,כאבול,יישוב,753,328,425,14,739,646,751,11,18.17%
2010-06,הצפון,505,כאוכב אבו אל-היג'א,יישוב,214,81,133,3,211,177,214,8,15.16%
2010-06,הצפון,1296,כסרא-סמיע,יישוב,260,106,154,1,259,200,259,18,9.64%
2010-06,הצפון,978,כעביה-טבאש-חג'אג'רה,יישוב,210,98,112,2,208,148,208,3,11.17%
2010-06,הצפון,1263,כפר ורדים,יישוב,104,50,54,27,77,8,104,29,3.54%
2010-06,הצפון,507,כפר יאסיף,יישוב,492,222,270,5,487,375,489,12,11.50%
2010-06,הצפון,508,כפר כמא,יישוב,87,39,48,4,83,44,85,5,6.32%
2010-06,הצפון,509,כפר כנא,יישוב,1214,509,705,14,1200,1012,1202,25,16.55%
2010-06,הצפון,510,כפר מנדא,יישוב,872,381,491,6,866,688,863,25,14.72%
2010-06,הצפון,47,כפר תבור,יישוב,64,28,36,19,45,8,64,2,3.80%
2010-06,הצפון,1139,כרמיאל,יישוב,1907,757,1150,330,1577,986,1848,127,7.48%
2010-06,הצפון,481,מגאר,יישוב,1471,580,891,34,1437,1246,1469,62,19.85%
2010-06,הצפון,516,מג'ד אל-כרום,יישוב,683,291,392,6,677,540,682,9,12.89%
2010-06,הצפון,874,מגדל העמק,יישוב,1178,505,673,97,1081,528,1143,170,9.05%
2010-06,הצפון,4201,מג'דל שמס,יישוב,507,189,318,22,485,410,500,24,12.71%
2010-06,הצפון,517,מזרעה,יישוב,164,63,101,4,160,130,163,6,10.27%
2010-06,הצפון,4203,מסעדה,יישוב,210,82,128,5,205,178,209,8,14.30%
2010-06,הצפון,518,מעיליא,יישוב,63,32,31,6,57,34,63,5,4.54%
2010-06,הצפון,1063,מעלות-תרשיחא,יישוב,1029,456,573,114,915,641,1026,98,9.03%
2010-06,הצפון,520,משהד,יישוב,334,130,204,3,331,270,333,17,12.76%
2010-06,הצפון,9100,נהרייה,יישוב,2291,1041,1250,266,2025,1355,2272,167,8.12%
2010-06,הצפון,522,נחף,יישוב,468,197,271,11,457,391,467,13,11.51%
2010-06,הצפון,7300,נצרת,יישוב,2903,1354,1549,73,2830,2119,2890,155,10.01%
2010-06,הצפון,1061,נצרת עילית,יישוב,2070,914,1156,223,1847,1149,1988,279,8.73%
2010-06,הצפון,525,סאג'ור,יישוב,121,48,73,2,119,84,119,4,8.47%
2010-06,הצפון,7500,סח'נין,יישוב,2049,945,1104,43,2006,1748,2049,71,17.83%
2010-06,הצפון,4501,ע'ג'ר,יישוב,113,45,68,3,110,94,112,14,13.01%
2010-06,הצפון,530,עיילבון,יישוב,205,87,118,11,194,160,204,19,9.56%
2010-06,הצפון,511,עילוט,יישוב,332,143,189,4,328,261,331,10,14.29%
2010-06,הצפון,532,עין מאהל,יישוב,614,282,332,6,608,531,604,34,14.21%
2010-06,הצפון,7600,עכו,יישוב,3451,1595,1856,143,3308,2623,3435,148,14.12%
2010-06,הצפון,7700,עפולה,יישוב,2168,949,1219,200,1968,1079,2109,192,9.54%
2010-06,הצפון,531,עראבה,יישוב,1344,572,772,34,1310,1158,1343,37,16.67%
2010-06,הצפון,535,פסוטה,יישוב,132,65,67,7,125,96,132,5,8.87%
2010-06,הצפון,536,פקיעין (בוקייעה),יישוב,159,78,81,9,150,118,157,7,6.69%
2010-06,הצפון,8000,צפת,יישוב,1025,537,488,75,950,711,1021,97,9.00%
2010-06,הצפון,4100,קצרין,יישוב,250,114,136,32,218,103,248,7,6.62%
2010-06,הצפון,2800,קריית שמונה,יישוב,852,408,444,61,791,351,836,115,6.80%
2010-06,הצפון,543,ראמה,יישוב,342,147,195,7,335,267,341,6,10.56%
2010-06,הצפון,26,ראש פינה,יישוב,51,18,33,6,45,19,51,4,3.72%
2010-06,הצפון,542,ריינה,יישוב,659,281,378,13,646,508,654,31,11.74%
2010-06,הצפון,122,רמת ישי,יישוב,131,53,78,35,96,9,131,10,3.56%
2010-06,הצפון,913,שבלי - אום אל-גנם,יישוב,232,103,129,9,223,187,231,11,10.86%
2010-06,הצפון,812,שלומי,יישוב,276,117,159,10,266,166,274,17,8.34%
2010-06,הצפון,538,שעב,יישוב,474,199,275,3,471,411,473,7,18.87%
2010-06,הצפון,8800,שפרעם,יישוב,2111,865,1246,20,2091,1727,2103,57,14.22%
2010-06,חיפה,2710,אום אל-פחם,יישוב,3457,1472,1985,10,3447,2928,3454,49,20.50%
2010-06,חיפה,1020,אור עקיבא,יישוב,730,320,410,47,683,251,711,83,7.75%
2010-06,חיפה,6000,באקה אל-גרביה,יישוב,581,306,275,13,568,354,580,44,NULL
2010-06,חיפה,9800,בנימינה-גבעת עדה*,יישוב,219,100,119,58,161,46,217,13,3.54%
2010-06,חיפה,1326,"בסמ""ה",יישוב,353,175,178,4,349,264,353,10,11.25%
2010-06,חיפה,541,ג'סר א-זרקא,יישוב,392,221,171,3,389,255,390,9,7.78%
2010-06,חיפה,628,ג'ת,יישוב,198,98,100,7,191,123,198,20,NULL
2010-06,חיפה,494,דאלית אל-כרמל,יישוב,502,213,289,12,490,303,499,25,7.38%
2010-06,חיפה,9300,זכרון יעקב,יישוב,265,111,154,65,200,48,264,13,2.92%
2010-06,חיפה,6500,חדרה,יישוב,2749,1111,1638,273,2476,1020,2701,247,6.10%
2010-06,חיפה,4000,חיפה,יישוב,9297,4065,5232,1637,7660,5806,9246,750,7.01%
2010-06,חיפה,1247,חריש-קציר,יישוב,27,13,14,2,25,15,27,3,1.65%
2010-06,חיפה,2100,טירת כרמל,יישוב,842,378,464,22,820,533,834,57,8.68%
2010-06,חיפה,654,כפר קרע,יישוב,340,169,171,10,330,188,338,27,4.97%
2010-06,חיפה,1327,מעלה עירון,יישוב,835,332,503,1,834,693,833,15,17.67%
2010-06,חיפה,2500,נשר,יישוב,703,314,389,120,583,339,702,77,5.72%
2010-06,חיפה,534,עספיא,יישוב,326,140,186,9,317,204,324,17,6.84%
2010-06,חיפה,637,ערערה,יישוב,507,231,276,5,502,321,507,23,7.70%
2010-06,חיפה,537,פוריידיס,יישוב,367,185,182,3,364,248,365,15,7.81%
2010-06,חיפה,7800,פרדס חנה-כרכור,יישוב,938,415,523,141,797,259,928,93,5.50%
2010-06,חיפה,6800,קריית אתא,יישוב,2176,916,1260,150,2026,1292,2168,148,8.04%
2010-06,חיפה,9500,קריית ביאליק,יישוב,1368,549,819,175,1193,734,1359,76,6.79%
2010-06,חיפה,2300,קריית טבעון,יישוב,240,106,134,72,168,53,240,31,3.16%
2010-06,חיפה,9600,קריית ים,יישוב,1947,834,1113,165,1782,1249,1940,133,9.64%
2010-06,חיפה,8200,קריית מוצקין,יישוב,1336,543,793,193,1143,670,1324,89,6.34%
2010-06,חיפה,922,רכסים,יישוב,155,75,80,8,147,108,154,6,5.70%
2010-06,ירושלים,472,אבו גוש,יישוב,259,119,140,10,249,176,259,18,10.71%
2010-06,ירושלים,2610,בית שמש,יישוב,1278,592,686,114,1164,579,1264,190,5.11%
2010-06,ירושלים,3000,ירושלים,יישוב,10500,4713,5787,1230,9270,5694,10432,860,4.19%
2010-06,ירושלים,1015,מבשרת ציון,יישוב,408,185,223,84,324,142,407,33,3.47%
2010-06,ירושלים,1137,קריית יערים,יישוב,31,13,18,10,21,13,30,2,3.00%
2010-06,תל אביב,2400,אור יהודה,יישוב,947,435,512,43,904,332,927,83,5.30%
2010-06,תל אביב,565,אזור,יישוב,212,97,115,26,186,44,211,18,3.57%
2010-06,תל אביב,6100,בני ברק,יישוב,2221,1046,1175,109,2112,1315,2207,118,4.79%
2010-06,תל אביב,6200,בת ים,יישוב,4186,1941,2245,540,3646,1631,4115,341,5.85%
2010-06,תל אביב,6300,גבעתיים,יישוב,845,365,480,304,541,128,834,71,3.04%
2010-06,תל אביב,6400,הרצלייה,יישוב,1503,704,799,323,1180,177,1478,434,3.23%
2010-06,תל אביב,6600,חולון,יישוב,3993,1876,2117,522,3471,1112,3946,431,4.23%
2010-06,תל אביב,2620,קריית אונו,יישוב,533,248,285,150,383,52,530,65,3.25%
2010-06,תל אביב,8600,רמת גן,יישוב,2579,1195,1384,663,1916,557,2562,196,3.58%
2010-06,תל אביב,2650,רמת השרון,יישוב,597,292,305,169,428,44,592,193,2.88%
2010-06,תל אביב,5000,תל אביב -יפו,יישוב,8720,4280,4440,2300,6420,3038,8644,626,3.74%
2010-07,אזור יהודה והשומרון,3760,אורנית,יישוב,129,59,70,39,90,5,129,9,3.41%
2010-07,אזור יהודה והשומרון,3750,אלפי מנשה,יישוב,104,44,60,23,81,2,103,4,2.55%
2010-07,אזור יהודה והשומרון,3560,אלקנה,יישוב,46,21,25,21,25,3,46,2,2.69%
2010-07,אזור יהודה והשומרון,3650,אפרתה,יישוב,88,44,44,20,68,3,88,3,2.48%
2010-07,אזור יהודה והשומרון,3570,אריאל,יישוב,451,208,243,98,353,129,451,36,4.52%
2010-07,אזור יהודה והשומרון,3574,בית אל,יישוב,59,27,32,22,37,18,58,9,2.72%
2010-07,אזור יהודה והשומרון,3652,בית אריה,יישוב,88,39,49,9,79,3,88,7,4.09%
2010-07,אזור יהודה והשומרון,3780,ביתר עילית,יישוב,517,198,319,14,503,206,511,16,6.02%
2010-07,אזור יהודה והשומרון,3730,גבעת זאב,יישוב,223,96,127,26,197,41,223,14,3.68%
2010-07,אזור יהודה והשומרון,3769,הר אדר,יישוב,43,20,23,14,29,4,43,1,2.49%
2010-07,אזור יהודה והשומרון,3797,מודיעין עילית,יישוב,514,124,390,20,494,87,508,15,4.81%
2010-07,אזור יהודה והשומרון,3616,מעלה אדומים,יישוב,734,293,441,108,626,236,727,76,4.10%
2010-07,אזור יהודה והשומרון,3660,עמנואל,יישוב,92,48,44,2,90,60,92,2,9.73%
2010-07,אזור יהודה והשומרון,3557,קדומים,יישוב,29,15,14,12,17,6,29,3,1.81%
2010-07,אזור יהודה והשומרון,3611,קריית ארבע,יישוב,164,83,81,22,142,70,164,11,5.80%
2010-07,אזור יהודה והשומרון,3640,קרני שומרון,יישוב,92,54,38,22,70,20,92,6,2.82%
2010-07,הדרום,31,אופקים,יישוב,1552,642,910,94,1458,1020,1537,75,13.49%
2010-07,הדרום,2600,אילת,יישוב,1578,694,884,93,1485,685,1563,121,5.09%
2010-07,הדרום,70,אשדוד,יישוב,8144,3140,5004,896,7248,4486,8071,464,8.00%
2010-07,הדרום,7100,אשקלון,יישוב,5015,1879,3136,744,4271,2845,4912,518,8.38%
2010-07,הדרום,9000,באר שבע,יישוב,8486,3761,4725,1081,7405,5360,8435,948,8.88%
2010-07,הדרום,2200,דימונה,יישוב,2286,975,1311,126,2160,1544,2250,145,12.74%
2010-07,הדרום,1303,חורה,יישוב,723,313,410,0,723,656,723,8,23.77%
2010-07,הדרום,831,ירוחם,יישוב,558,279,279,22,536,292,551,101,12.98%
2010-07,הדרום,1059,כסיפה,יישוב,995,443,552,1,994,900,993,24,26.53%
2010-07,הדרום,1271,להבים,יישוב,59,31,28,24,35,3,59,23,1.92%
2010-07,הדרום,1060,לקיה,יישוב,927,433,494,4,923,839,925,20,28.75%
2010-07,הדרום,1268,מיתר,יישוב,86,34,52,21,65,6,85,30,2.29%
2010-07,הדרום,99,מצפה רמון,יישוב,278,113,165,23,255,136,258,52,11.43%
2010-07,הדרום,246,נתיבות,יישוב,1181,481,700,58,1123,572,1174,140,9.92%
2010-07,הדרום,666,עומר,יישוב,72,37,35,24,48,8,72,22,1.93%
2010-07,הדרום,2560,ערד,יישוב,1043,441,602,168,875,618,1012,174,8.16%
2010-07,הדרום,1192,ערערה-בנגב,יישוב,956,382,574,1,955,876,955,7,29.97%
2010-07,הדרום,2630,קריית גת,יישוב,2635,1037,1598,218,2417,1656,2629,188,10.46%
2010-07,הדרום,1034,קריית מלאכי,יישוב,1442,646,796,43,1399,886,1414,148,12.94%
2010-07,הדרום,1161,רהט,יישוב,3140,1270,1870,6,3134,2642,3137,94,22.08%
2010-07,הדרום,1286,שגב-שלום,יישוב,570,241,329,2,568,510,569,11,27.24%
2010-07,הדרום,1031,שדרות,יישוב,1248,521,727,67,1181,639,1242,57,11.08%
2010-07,הדרום,1054,תל שבע,יישוב,1221,611,610,5,1216,1098,1219,17,31.30%
2010-07,המרכז,182,אבן יהודה,יישוב,183,79,104,53,130,23,183,10,3.06%
2010-07,המרכז,41,אליכין,יישוב,67,31,36,12,55,15,66,5,4.16%
2010-07,המרכז,1309,אלעד,יישוב,469,196,273,25,444,119,467,15,4.40%
2010-07,המרכז,2530,באר יעקב,יישוב,293,131,162,45,248,90,284,24,4.05%
2010-07,המרכז,466,בית דגן,יישוב,131,71,60,20,111,34,130,7,3.95%
2010-07,המרכז,1066,"בני עי""ש",יישוב,202,89,113,33,169,85,200,7,5.17%
2010-07,המרכז,681,גבעת שמואל,יישוב,304,145,159,103,201,52,303,8,2.90%
2010-07,המרכז,2550,גדרה,יישוב,410,157,253,77,333,114,405,22,4.03%
2010-07,המרכז,627,ג'לג'וליה,יישוב,65,32,33,4,61,28,65,0,2.31%
2010-07,המרכז,166,גן יבנה,יישוב,475,175,300,59,416,111,474,22,4.86%
2010-07,המרכז,229,גני תקווה,יישוב,213,99,114,45,168,31,210,14,3.00%
2010-07,המרכז,9700,הוד השרון,יישוב,756,348,408,187,569,73,751,43,3.00%
2010-07,המרכז,1290,זמר,יישוב,179,58,121,3,176,138,179,4,7.35%
2010-07,המרכז,2730,טייבה,יישוב,2097,883,1214,6,2091,1762,2086,35,14.22%
2010-07,המרכז,2720,טירה,יישוב,336,169,167,15,321,198,335,19,3.75%
2010-07,המרכז,2660,יבנה,יישוב,1120,507,613,77,1043,460,1118,68,6.19%
2010-07,המרכז,9400,יהוד,יישוב,629,295,334,90,539,85,603,74,4.10%
2010-07,המרכז,1224,כוכב יאיר,יישוב,264,133,131,46,218,5,264,3,4.88%
2010-07,המרכז,633,כפר ברא,יישוב,23,9,14,0,23,9,23,0,2.26%
2010-07,המרכז,168,כפר יונה,יישוב,390,135,255,65,325,104,387,42,4.10%
2010-07,המרכז,6900,כפר סבא,יישוב,1440,658,782,350,1090,225,1430,91,3.11%
2010-07,המרכז,634,כפר קאסם,יישוב,273,121,152,8,265,116,273,7,4.15%
2010-07,המרכז,7000,לוד,יישוב,2477,1030,1447,198,2279,1342,2458,186,7.45%
2010-07,המרכז,1200,מודיעין-מכבים-רעות*,יישוב,1105,456,649,345,760,73,1096,93,2.98%
2010-07,המרכז,28,מזכרת בתיה,יישוב,183,61,122,32,151,39,178,13,3.22%
2010-07,המרכז,7200,נס ציונה,יישוב,761,337,424,153,608,206,752,38,3.77%
2010-07,המרכז,7400,נתניה,יישוב,5426,2405,3021,740,4686,2132,5373,517,5.71%
2010-07,המרכז,587,סביון*,יישוב,24,13,11,7,17,1,24,0,1.47%
2010-07,המרכז,171,פרדסייה,יישוב,86,39,47,19,67,11,85,7,2.51%
2010-07,המרכז,7900,פתח תקווה,יישוב,4761,2117,2644,795,3966,1292,4727,361,4.35%
2010-07,המרכז,195,קדימה-צורן,יישוב,304,145,159,84,220,47,301,19,3.49%
2010-07,המרכז,638,קלנסווה,יישוב,922,342,580,1,921,751,916,16,12.88%
2010-07,המרכז,469,קריית עקרון,יישוב,309,136,173,7,302,129,306,13,5.70%
2010-07,המרכז,2640,ראש העין,יישוב,960,490,470,100,860,185,939,86,4.64%
2010-07,המרכז,8300,ראשון לציון,יישוב,5307,2320,2987,920,4387,1815,5285,490,4.18%
2010-07,המרכז,8400,רחובות,יישוב,2954,1233,1721,547,2407,1057,2920,135,5.10%
2010-07,המרכז,8500,רמלה,יישוב,2050,940,1110,113,1937,888,2013,185,6.27%
2010-07,המרכז,8700,רעננה,יישוב,1054,509,545,252,802,88,1047,51,2.99%
2010-07,המרכז,1304,שוהם,יישוב,244,108,136,92,152,6,243,17,2.52%
2010-07,המרכז,154,תל מונד,יישוב,178,72,106,47,131,20,177,13,3.30%
2010-07,הצפון,473,אבו סנאן,יישוב,767,307,460,7,760,598,762,24,15.78%
2010-07,הצפון,478,אכסאל,יישוב,621,252,369,19,602,515,620,15,13.41%
2010-07,הצפון,529,אעבלין,יישוב,681,285,396,15,666,553,681,16,14.45%
2010-07,הצפון,482,בועיינה-נוג'ידאת,יישוב,526,236,290,8,518,422,521,9,16.38%
2010-07,הצפון,4001,בוקעאתא,יישוב,392,173,219,3,389,319,382,7,16.37%
2010-07,הצפון,998,ביר אל-מכסור,יישוב,444,181,263,2,442,338,444,1,14.77%
2010-07,הצפון,480,בית ג'ן,יישוב,336,108,228,3,333,247,330,7,8.05%
2010-07,הצפון,9200,בית שאן,יישוב,914,393,521,19,895,468,911,94,9.75%
2010-07,הצפון,944,בסמת טבעון,יישוב,313,127,186,3,310,238,313,12,11.51%
2010-07,הצפון,483,בענה,יישוב,473,183,290,2,471,404,473,9,16.80%
2010-07,הצפון,1292,ג'דיידה-מכר,יישוב,1506,618,888,7,1499,1270,1506,43,19.52%
2010-07,הצפון,485,ג'ולס,יישוב,248,67,181,2,246,134,248,22,10.37%
2010-07,הצפון,487,ג'ש (גוש חלב),יישוב,82,32,50,10,72,36,82,5,5.66%
2010-07,הצפון,489,דבורייה,יישוב,451,209,242,31,420,329,450,5,12.41%
2010-07,הצפון,490,דייר אל-אסד,יישוב,467,183,284,6,461,354,467,7,11.24%
2010-07,הצפון,492,דייר חנא,יישוב,676,296,380,17,659,540,676,16,17.18%
2010-07,הצפון,975,זרזיר,יישוב,293,128,165,1,292,193,288,12,11.96%
2010-07,הצפון,496,חורפיש,יישוב,154,63,91,5,149,100,154,9,7.39%
2010-07,הצפון,2034,חצור הגלילית,יישוב,325,154,171,13,312,143,319,36,7.30%
2010-07,הצפון,6700,טבריה,יישוב,2055,848,1207,123,1932,1267,1944,119,9.61%
2010-07,הצפון,962,טובא-זנגרייה,יישוב,391,166,225,6,385,256,388,17,14.50%
2010-07,הצפון,498,טורעאן,יישוב,578,203,375,17,561,465,573,15,12.48%
2010-07,הצפון,8900,טמרה,יישוב,2066,834,1232,32,2034,1774,2064,30,17.71%
2010-07,הצפון,1295,יאנוח-ג'ת,יישוב,179,56,123,7,172,125,179,10,8.41%
2010-07,הצפון,46,יבנאל,יישוב,133,80,53,5,128,104,127,4,9.59%
2010-07,הצפון,499,יפיע,יישוב,651,282,369,10,641,490,647,18,10.03%
2010-07,הצפון,240,יקנעם עילית,יישוב,571,230,341,97,474,228,569,50,5.56%
2010-07,הצפון,502,ירכא,יישוב,513,191,322,4,509,384,512,11,11.32%
2010-07,הצפון,504,כאבול,יישוב,761,310,451,18,743,639,759,8,18.33%
2010-07,הצפון,505,כאוכב אבו אל-היג'א,יישוב,237,92,145,1,236,178,237,26,16.52%
2010-07,הצפון,1296,כסרא-סמיע,יישוב,238,88,150,2,236,183,237,21,8.90%
2010-07,הצפון,978,כעביה-טבאש-חג'אג'רה,יישוב,211,92,119,2,209,148,209,3,11.22%
2010-07,הצפון,1263,כפר ורדים,יישוב,102,41,61,24,78,12,102,40,3.47%
2010-07,הצפון,507,כפר יאסיף,יישוב,508,226,282,7,501,384,505,26,11.83%
2010-07,הצפון,508,כפר כמא,יישוב,76,37,39,3,73,40,75,2,5.62%
2010-07,הצפון,509,כפר כנא,יישוב,1221,477,744,25,1196,1012,1208,34,16.62%
2010-07,הצפון,510,כפר מנדא,יישוב,863,361,502,10,853,685,855,18,14.60%
2010-07,הצפון,47,כפר תבור,יישוב,58,22,36,16,42,7,58,1,3.45%
2010-07,הצפון,1139,כרמיאל,יישוב,1881,746,1135,339,1542,973,1826,108,7.39%
2010-07,הצפון,481,מגאר,יישוב,1491,587,904,43,1448,1258,1488,52,20.05%
2010-07,הצפון,516,מג'ד אל-כרום,יישוב,689,274,415,7,682,536,688,16,12.99%
2010-07,הצפון,874,מגדל העמק,יישוב,1170,507,663,107,1063,516,1132,137,8.97%
2010-07,הצפון,4201,מג'דל שמס,יישוב,479,177,302,23,456,399,473,24,12.10%
2010-07,הצפון,517,מזרעה,יישוב,177,69,108,5,172,138,175,7,10.94%
2010-07,הצפון,4203,מסעדה,יישוב,209,79,130,7,202,176,208,3,14.24%
2010-07,הצפון,518,מעיליא,יישוב,78,43,35,7,71,31,78,12,5.56%
2010-07,הצפון,1063,מעלות-תרשיחא,יישוב,1154,495,659,132,1022,660,1152,132,10.03%
2010-07,הצפון,520,משהד,יישוב,334,125,209,5,329,268,333,9,12.76%
2010-07,הצפון,9100,נהרייה,יישוב,2303,1039,1264,259,2044,1360,2287,132,8.17%
2010-07,הצפון,522,נחף,יישוב,469,189,280,12,457,383,468,9,11.53%
2010-07,הצפון,7300,נצרת,יישוב,2876,1284,1592,87,2789,2082,2862,109,9.92%
2010-07,הצפון,1061,נצרת עילית,יישוב,2021,892,1129,250,1771,1118,1939,201,8.53%
2010-07,הצפון,525,סאג'ור,יישוב,115,44,71,1,114,80,113,1,8.08%
2010-07,הצפון,7500,סח'נין,יישוב,2005,890,1115,45,1960,1731,2005,51,17.51%
2010-07,הצפון,4501,ע'ג'ר,יישוב,112,44,68,1,111,86,111,10,12.91%
2010-07,הצפון,530,עיילבון,יישוב,205,88,117,15,190,156,204,7,9.56%
2010-07,הצפון,511,עילוט,יישוב,337,142,195,5,332,244,336,11,14.48%
2010-07,הצפון,532,עין מאהל,יישוב,596,278,318,7,589,521,590,19,13.93%
2010-07,הצפון,7600,עכו,יישוב,3505,1565,1940,149,3356,2637,3485,136,14.30%
2010-07,הצפון,7700,עפולה,יישוב,2195,923,1272,212,1983,1064,2118,184,9.58%
2010-07,הצפון,531,עראבה,יישוב,1391,562,829,45,1346,1160,1390,33,17.16%
2010-07,הצפון,535,פסוטה,יישוב,147,62,85,9,138,98,147,11,9.78%
2010-07,הצפון,536,פקיעין (בוקייעה),יישוב,149,79,70,10,139,113,147,7,6.29%
2010-07,הצפון,8000,צפת,יישוב,1188,558,630,82,1106,722,1184,145,10.29%
2010-07,הצפון,4100,קצרין,יישוב,234,111,123,37,197,103,232,10,6.22%
2010-07,הצפון,2800,קריית שמונה,יישוב,874,427,447,58,816,341,863,115,7.00%
2010-07,הצפון,543,ראמה,יישוב,343,147,196,9,334,259,343,7,10.61%
2010-07,הצפון,26,ראש פינה,יישוב,55,25,30,7,48,17,55,8,4.00%
2010-07,הצפון,542,ריינה,יישוב,649,267,382,14,635,500,645,20,11.60%
2010-07,הצפון,122,רמת ישי,יישוב,133,52,81,33,100,8,133,13,3.61%
2010-07,הצפון,913,שבלי - אום אל-גנם,יישוב,238,109,129,7,231,187,237,1,11.11%
2010-07,הצפון,812,שלומי,יישוב,306,128,178,14,292,159,305,44,9.20%
2010-07,הצפון,538,שעב,יישוב,473,201,272,3,470,409,472,18,18.83%
2010-07,הצפון,8800,שפרעם,יישוב,2185,879,1306,33,2152,1757,2177,48,14.65%
2010-07,חיפה,2710,אום אל-פחם,יישוב,3522,1494,2028,10,3512,2982,3519,58,20.81%
2010-07,חיפה,1020,אור עקיבא,יישוב,678,308,370,47,631,232,666,61,7.30%
2010-07,חיפה,6000,באקה אל-גרביה,יישוב,587,308,279,10,577,361,586,44,NULL
2010-07,חיפה,9800,בנימינה-גבעת עדה*,יישוב,205,100,105,58,147,47,203,15,3.32%
2010-07,חיפה,1326,"בסמ""ה",יישוב,372,184,188,4,368,274,372,7,11.78%
2010-07,חיפה,541,ג'סר א-זרקא,יישוב,397,220,177,2,395,252,395,9,7.87%
2010-07,חיפה,628,ג'ת,יישוב,188,87,101,5,183,121,188,8,NULL
2010-07,חיפה,494,דאלית אל-כרמל,יישוב,536,214,322,12,524,292,535,35,7.87%
2010-07,חיפה,9300,זכרון יעקב,יישוב,261,110,151,67,194,48,260,20,2.88%
2010-07,חיפה,6500,חדרה,יישוב,2615,1038,1577,294,2321,974,2570,208,5.82%
2010-07,חיפה,4000,חיפה,יישוב,9138,3973,5165,1647,7491,5741,9085,633,6.90%
2010-07,חיפה,1247,חריש-קציר,יישוב,28,16,12,3,25,10,27,1,1.65%
2010-07,חיפה,2100,טירת כרמל,יישוב,845,375,470,21,824,542,835,68,8.69%
2010-07,חיפה,654,כפר קרע,יישוב,353,161,192,10,343,195,351,15,5.16%
2010-07,חיפה,1327,מעלה עירון,יישוב,843,327,516,3,840,704,841,18,17.81%
2010-07,חיפה,2500,נשר,יישוב,671,300,371,127,544,325,668,73,5.45%
2010-07,חיפה,534,עספיא,יישוב,377,163,214,11,366,213,377,22,7.87%
2010-07,חיפה,637,ערערה,יישוב,519,217,302,9,510,320,519,33,7.87%
2010-07,חיפה,537,פוריידיס,יישוב,421,187,234,2,419,258,419,15,8.86%
2010-07,חיפה,7800,פרדס חנה-כרכור,יישוב,913,380,533,148,765,268,905,85,5.37%
2010-07,חיפה,6800,קריית אתא,יישוב,2156,856,1300,152,2004,1291,2149,101,7.98%
2010-07,חיפה,9500,קריית ביאליק,יישוב,1333,556,777,156,1177,712,1329,78,6.65%
2010-07,חיפה,2300,קריית טבעון,יישוב,226,99,127,70,156,54,226,28,2.98%
2010-07,חיפה,9600,קריית ים,יישוב,1926,820,1106,164,1762,1254,1918,95,9.55%
2010-07,חיפה,8200,קריית מוצקין,יישוב,1306,520,786,190,1116,674,1293,81,6.20%
2010-07,חיפה,922,רכסים,יישוב,177,80,97,8,169,106,176,11,6.46%
2010-07,ירושלים,472,אבו גוש,יישוב,257,120,137,6,251,179,257,13,10.64%
2010-07,ירושלים,2610,בית שמש,יישוב,1560,644,916,129,1431,626,1544,183,6.18%
2010-07,ירושלים,3000,ירושלים,יישוב,11003,4781,6222,1298,9705,5718,10935,686,4.39%
2010-07,ירושלים,1015,מבשרת ציון,יישוב,403,202,201,81,322,142,400,32,3.41%
2010-07,ירושלים,1137,קריית יערים,יישוב,35,10,25,6,29,12,35,1,3.49%
2010-07,תל אביב,2400,אור יהודה,יישוב,999,444,555,51,948,330,979,105,5.58%
2010-07,תל אביב,565,אזור,יישוב,202,90,112,32,170,43,199,18,3.37%
2010-07,תל אביב,6100,בני ברק,יישוב,2478,1055,1423,128,2350,1319,2457,112,5.31%
2010-07,תל אביב,6200,בת ים,יישוב,3788,1738,2050,535,3253,1621,3724,277,5.32%
2010-07,תל אביב,6300,גבעתיים,יישוב,822,337,485,336,486,120,811,46,2.96%
2010-07,תל אביב,6400,הרצלייה,יישוב,1382,575,807,336,1046,180,1353,303,2.97%
2010-07,תל אביב,6600,חולון,יישוב,3503,1600,1903,535,2968,1085,3449,300,3.72%
2010-07,תל אביב,2620,קריית אונו,יישוב,485,211,274,148,337,59,482,51,2.97%
2010-07,תל אביב,8600,רמת גן,יישוב,2369,1085,1284,682,1687,556,2350,142,3.29%
2010-07,תל אביב,2650,רמת השרון,יישוב,507,233,274,158,349,45,500,114,2.44%
2010-07,תל אביב,5000,תל אביב -יפו,יישוב,8338,4015,4323,2253,6085,3024,8247,542,3.58%
2010-08,אזור יהודה והשומרון,3760,אורנית,יישוב,110,48,62,36,74,5,110,5,2.92%
2010-08,אזור יהודה והשומרון,3750,אלפי מנשה,יישוב,110,45,65,27,83,5,109,7,2.69%
2010-08,אזור יהודה והשומרון,3560,אלקנה,יישוב,42,18,24,18,24,3,41,2,2.40%
2010-08,אזור יהודה והשומרון,3650,אפרתה,יישוב,62,32,30,24,38,6,61,4,1.73%
2010-08,אזור יהודה והשומרון,3570,אריאל,יישוב,410,186,224,89,321,129,410,37,4.12%
2010-08,אזור יהודה והשומרון,3574,בית אל,יישוב,58,28,30,18,40,12,57,3,2.67%
2010-08,אזור יהודה והשומרון,3652,בית אריה,יישוב,71,31,40,10,61,5,71,7,3.33%
2010-08,אזור יהודה והשומרון,3780,ביתר עילית,יישוב,574,210,364,19,555,204,569,28,6.66%
2010-08,אזור יהודה והשומרון,3730,גבעת זאב,יישוב,182,86,96,27,155,41,182,28,3.02%
2010-08,אזור יהודה והשומרון,3769,הר אדר,יישוב,44,14,30,14,30,4,44,2,2.55%
2010-08,אזור יהודה והשומרון,3797,מודיעין עילית,יישוב,626,114,512,28,598,81,623,19,5.83%
2010-08,אזור יהודה והשומרון,3616,מעלה אדומים,יישוב,741,295,446,105,636,232,733,77,4.13%
2010-08,אזור יהודה והשומרון,3660,עמנואל,יישוב,98,51,47,2,96,62,98,2,10.29%
2010-08,אזור יהודה והשומרון,3557,קדומים,יישוב,31,16,15,12,19,8,30,1,1.87%
2010-08,אזור יהודה והשומרון,3611,קריית ארבע,יישוב,137,65,72,21,116,68,137,10,4.89%
2010-08,אזור יהודה והשומרון,3640,קרני שומרון,יישוב,91,44,47,24,67,22,90,10,2.76%
2010-08,הדרום,31,אופקים,יישוב,1543,621,922,94,1449,1037,1530,88,13.44%
2010-08,הדרום,2600,אילת,יישוב,1465,627,838,95,1370,667,1451,111,4.74%
2010-08,הדרום,70,אשדוד,יישוב,7699,2819,4880,913,6786,4496,7631,428,7.60%
2010-08,הדרום,7100,אשקלון,יישוב,4750,1758,2992,729,4021,2782,4648,315,7.97%
2010-08,הדרום,9000,באר שבע,יישוב,8165,3536,4629,1097,7068,5351,8110,805,8.57%
2010-08,הדרום,2200,דימונה,יישוב,2293,960,1333,144,2149,1569,2252,178,12.75%
2010-08,הדרום,1303,חורה,יישוב,723,307,416,0,723,668,723,10,23.77%
2010-08,הדרום,831,ירוחם,יישוב,511,234,277,22,489,289,507,85,12.07%
2010-08,הדרום,1059,כסיפה,יישוב,999,447,552,1,998,894,996,32,26.59%
2010-08,הדרום,1271,להבים,יישוב,37,19,18,22,15,3,37,13,1.21%
2010-08,הדרום,1060,לקיה,יישוב,939,426,513,3,936,852,937,21,29.02%
2010-08,הדרום,1268,מיתר,יישוב,68,20,48,23,45,6,68,26,1.84%
2010-08,הדרום,99,מצפה רמון,יישוב,300,111,189,24,276,138,274,55,12.05%
2010-08,הדרום,246,נתיבות,יישוב,1165,428,737,60,1105,570,1161,184,9.82%
2010-08,הדרום,666,עומר,יישוב,64,23,41,28,36,8,64,13,1.72%
2010-08,הדרום,2560,ערד,יישוב,1051,424,627,172,879,625,1021,176,8.23%
2010-08,הדרום,1192,ערערה-בנגב,יישוב,963,384,579,1,962,878,962,3,30.13%
2010-08,הדרום,2630,קריית גת,יישוב,2551,984,1567,207,2344,1639,2545,190,10.16%
2010-08,הדרום,1034,קריית מלאכי,יישוב,1387,626,761,44,1343,874,1368,215,12.57%
2010-08,הדרום,1161,רהט,יישוב,3088,1226,1862,6,3082,2662,3085,162,21.79%
2010-08,הדרום,1286,שגב-שלום,יישוב,571,241,330,2,569,508,569,15,27.24%
2010-08,הדרום,1031,שדרות,יישוב,1236,497,739,68,1168,665,1232,85,11.00%
2010-08,הדרום,1054,תל שבע,יישוב,1210,595,615,4,1206,1106,1207,13,31.08%
2010-08,המרכז,182,אבן יהודה,יישוב,156,66,90,59,97,21,156,12,2.62%
2010-08,המרכז,41,אליכין,יישוב,69,33,36,14,55,16,69,6,4.34%
2010-08,המרכז,1309,אלעד,יישוב,531,174,357,26,505,121,529,103,4.96%
2010-08,המרכז,2530,באר יעקב,יישוב,288,127,161,44,244,93,281,22,4.01%
2010-08,המרכז,466,בית דגן,יישוב,120,59,61,20,100,35,119,4,3.63%
2010-08,המרכז,1066,"בני עי""ש",יישוב,198,90,108,31,167,86,196,10,5.08%
2010-08,המרכז,681,גבעת שמואל,יישוב,278,130,148,108,170,52,278,15,2.67%
2010-08,המרכז,2550,גדרה,יישוב,359,143,216,67,292,111,353,23,3.53%
2010-08,המרכז,627,ג'לג'וליה,יישוב,64,32,32,4,60,28,64,3,2.27%
2010-08,המרכז,166,גן יבנה,יישוב,405,144,261,55,350,110,403,29,4.16%
2010-08,המרכז,229,גני תקווה,יישוב,197,79,118,45,152,28,197,7,2.82%
2010-08,המרכז,9700,הוד השרון,יישוב,626,274,352,193,433,64,623,37,2.50%
2010-08,המרכז,1290,זמר,יישוב,170,57,113,4,166,132,170,4,7.00%
2010-08,המרכז,2730,טייבה,יישוב,2083,870,1213,6,2077,1768,2071,44,14.13%
2010-08,המרכז,2720,טירה,יישוב,308,148,160,13,295,193,307,21,3.45%
2010-08,המרכז,2660,יבנה,יישוב,1024,445,579,77,947,451,1021,94,5.68%
2010-08,המרכז,9400,יהוד,יישוב,586,249,337,95,491,86,564,60,3.85%
2010-08,המרכז,1224,כוכב יאיר,יישוב,216,89,127,46,170,4,215,10,4.01%
2010-08,המרכז,633,כפר ברא,יישוב,16,4,12,0,16,9,16,1,1.58%
2010-08,המרכז,168,כפר יונה,יישוב,373,136,237,58,315,103,368,25,3.91%
2010-08,המרכז,6900,כפר סבא,יישוב,1279,551,728,361,918,240,1269,118,2.77%
2010-08,המרכז,634,כפר קאסם,יישוב,263,116,147,8,255,119,263,12,4.01%
2010-08,המרכז,7000,לוד,יישוב,2420,986,1434,203,2217,1337,2404,184,7.30%
2010-08,המרכז,1200,מודיעין-מכבים-רעות*,יישוב,1046,388,658,360,686,82,1035,120,2.82%
2010-08,המרכז,28,מזכרת בתיה,יישוב,177,55,122,35,142,40,174,7,3.15%
2010-08,המרכז,7200,נס ציונה,יישוב,716,300,416,141,575,208,708,21,3.56%
2010-08,המרכז,7400,נתניה,יישוב,5275,2240,3035,742,4533,2201,5218,541,5.55%
2010-08,המרכז,587,סביון*,יישוב,14,6,8,7,7,1,14,0,0.86%
2010-08,המרכז,171,פרדסייה,יישוב,76,39,37,18,58,8,75,4,2.22%
2010-08,המרכז,7900,פתח תקווה,יישוב,4454,1886,2568,813,3641,1309,4422,317,4.08%
2010-08,המרכז,195,קדימה-צורן,יישוב,279,126,153,87,192,44,277,21,3.22%
2010-08,המרכז,638,קלנסווה,יישוב,922,332,590,1,921,761,916,21,12.88%
2010-08,המרכז,469,קריית עקרון,יישוב,284,124,160,8,276,128,281,14,5.26%
2010-08,המרכז,2640,ראש העין,יישוב,866,376,490,98,768,193,851,91,4.22%
2010-08,המרכז,8300,ראשון לציון,יישוב,4763,2040,2723,913,3850,1795,4744,354,3.77%
2010-08,המרכז,8400,רחובות,יישוב,2892,1154,1738,552,2340,1038,2854,110,4.99%
2010-08,המרכז,8500,רמלה,יישוב,1935,873,1062,122,1813,893,1901,165,5.94%
2010-08,המרכז,8700,רעננה,יישוב,751,357,394,269,482,82,746,62,2.15%
2010-08,המרכז,1304,שוהם,יישוב,202,82,120,80,122,6,202,15,2.10%
2010-08,המרכז,154,תל מונד,יישוב,134,55,79,44,90,21,134,6,2.52%
2010-08,הצפון,473,אבו סנאן,יישוב,760,299,461,6,754,605,756,34,15.68%
2010-08,הצפון,478,אכסאל,יישוב,597,234,363,15,582,511,596,4,12.96%
2010-08,הצפון,529,אעבלין,יישוב,670,275,395,14,656,551,670,35,14.25%
2010-08,הצפון,482,בועיינה-נוג'ידאת,יישוב,516,226,290,9,507,420,511,4,16.11%
2010-08,הצפון,4001,בוקעאתא,יישוב,381,166,215,3,378,318,371,8,15.97%
2010-08,הצפון,998,ביר אל-מכסור,יישוב,421,162,259,1,420,337,421,8,14.11%
2010-08,הצפון,480,בית ג'ן,יישוב,309,97,212,2,307,239,306,7,7.51%
2010-08,הצפון,9200,בית שאן,יישוב,938,410,528,23,915,466,937,137,10.00%
2010-08,הצפון,944,בסמת טבעון,יישוב,303,122,181,3,300,240,303,15,11.18%
2010-08,הצפון,483,בענה,יישוב,480,192,288,3,477,407,480,10,17.00%
2010-08,הצפון,1292,ג'דיידה-מכר,יישוב,1487,596,891,7,1480,1276,1487,38,19.32%
2010-08,הצפון,485,ג'ולס,יישוב,242,69,173,2,240,135,242,24,10.14%
2010-08,הצפון,487,ג'ש (גוש חלב),יישוב,75,29,46,9,66,38,75,2,5.20%
2010-08,הצפון,489,דבורייה,יישוב,460,219,241,30,430,324,458,5,12.60%
2010-08,הצפון,490,דייר אל-אסד,יישוב,471,183,288,7,464,353,471,10,11.32%
2010-08,הצפון,492,דייר חנא,יישוב,666,285,381,15,651,537,666,16,16.97%
2010-08,הצפון,975,זרזיר,יישוב,296,135,161,2,294,191,292,9,12.10%
2010-08,הצפון,496,חורפיש,יישוב,147,60,87,4,143,99,147,7,7.07%
2010-08,הצפון,2034,חצור הגלילית,יישוב,313,138,175,15,298,145,304,27,6.98%
2010-08,הצפון,6700,טבריה,יישוב,1938,743,1195,121,1817,1224,1836,124,9.12%
2010-08,הצפון,962,טובא-זנגרייה,יישוב,380,157,223,7,373,259,376,15,14.11%
2010-08,הצפון,498,טורעאן,יישוב,567,197,370,11,556,458,563,17,12.29%
2010-08,הצפון,8900,טמרה,יישוב,2052,827,1225,35,2017,1788,2049,38,17.60%
2010-08,הצפון,1295,יאנוח-ג'ת,יישוב,169,52,117,4,165,116,169,2,7.98%
2010-08,הצפון,46,יבנאל,יישוב,143,79,64,7,136,103,137,1,10.27%
2010-08,הצפון,499,יפיע,יישוב,636,256,380,9,627,501,633,27,9.84%
2010-08,הצפון,240,יקנעם עילית,יישוב,532,202,330,101,431,211,529,36,5.19%
2010-08,הצפון,502,ירכא,יישוב,509,192,317,4,505,389,508,20,11.24%
2010-08,הצפון,504,כאבול,יישוב,757,310,447,18,739,642,753,19,18.21%
2010-08,הצפון,505,כאוכב אבו אל-היג'א,יישוב,198,74,124,1,197,170,198,11,14.18%
2010-08,הצפון,1296,כסרא-סמיע,יישוב,237,96,141,0,237,177,236,19,8.86%
2010-08,הצפון,978,כעביה-טבאש-חג'אג'רה,יישוב,216,100,116,2,214,149,214,8,11.46%
2010-08,הצפון,1263,כפר ורדים,יישוב,78,33,45,24,54,14,78,6,2.68%
2010-08,הצפון,507,כפר יאסיף,יישוב,490,206,284,8,482,390,488,20,11.48%
2010-08,הצפון,508,כפר כמא,יישוב,70,30,40,3,67,45,69,0,5.20%
2010-08,הצפון,509,כפר כנא,יישוב,1205,463,742,25,1180,1012,1194,27,16.46%
2010-08,הצפון,510,כפר מנדא,יישוב,888,383,505,11,877,722,880,30,14.97%
2010-08,הצפון,47,כפר תבור,יישוב,51,19,32,23,28,6,51,0,3.05%
2010-08,הצפון,1139,כרמיאל,יישוב,1829,696,1133,335,1494,995,1774,169,7.20%
2010-08,הצפון,481,מגאר,יישוב,1459,571,888,41,1418,1259,1456,51,19.70%
2010-08,הצפון,516,מג'ד אל-כרום,יישוב,677,272,405,7,670,529,676,17,12.79%
2010-08,הצפון,874,מגדל העמק,יישוב,1147,478,669,99,1048,531,1104,165,8.77%
2010-08,הצפון,4201,מג'דל שמס,יישוב,474,179,295,24,450,402,469,24,12.01%
2010-08,הצפון,517,מזרעה,יישוב,169,64,105,4,165,138,167,2,10.50%
2010-08,הצפון,4203,מסעדה,יישוב,208,77,131,6,202,179,207,4,14.18%
2010-08,הצפון,518,מעיליא,יישוב,68,31,37,6,62,31,68,0,4.88%
2010-08,הצפון,1063,מעלות-תרשיחא,יישוב,1062,443,619,138,924,646,1060,57,9.30%
2010-08,הצפון,520,משהד,יישוב,337,126,211,3,334,269,334,10,12.80%
2010-08,הצפון,9100,נהרייה,יישוב,2216,967,1249,271,1945,1368,2200,126,7.88%
2010-08,הצפון,522,נחף,יישוב,469,192,277,13,456,391,468,5,11.53%
2010-08,הצפון,7300,נצרת,יישוב,2834,1201,1633,89,2745,2126,2818,90,9.78%
2010-08,הצפון,1061,נצרת עילית,יישוב,1934,830,1104,257,1677,1116,1850,220,8.17%
2010-08,הצפון,525,סאג'ור,יישוב,115,42,73,1,114,85,114,4,8.14%
2010-08,הצפון,7500,סח'נין,יישוב,2002,878,1124,51,1951,1741,2002,54,17.49%
2010-08,הצפון,4501,ע'ג'ר,יישוב,101,42,59,1,100,79,101,7,11.88%
2010-08,הצפון,530,עיילבון,יישוב,203,84,119,12,191,159,202,10,9.47%
2010-08,הצפון,511,עילוט,יישוב,339,138,201,3,336,262,339,10,14.59%
2010-08,הצפון,532,עין מאהל,יישוב,589,263,326,8,581,521,580,18,13.72%
2010-08,הצפון,7600,עכו,יישוב,3429,1499,1930,148,3281,2620,3406,143,14.02%
2010-08,הצפון,7700,עפולה,יישוב,2119,883,1236,223,1896,1088,2038,201,9.25%
2010-08,הצפון,531,עראבה,יישוב,1373,551,822,42,1331,1155,1372,42,16.97%
2010-08,הצפון,535,פסוטה,יישוב,139,61,78,9,130,92,139,2,9.30%
2010-08,הצפון,536,פקיעין (בוקייעה),יישוב,136,67,69,7,129,108,135,12,5.80%
2010-08,הצפון,8000,צפת,יישוב,1136,542,594,88,1048,727,1130,95,9.86%
2010-08,הצפון,4100,קצרין,יישוב,221,95,126,38,183,111,218,17,5.86%
2010-08,הצפון,2800,קריית שמונה,יישוב,817,393,424,67,750,331,799,117,6.52%
2010-08,הצפון,543,ראמה,יישוב,330,138,192,11,319,253,330,10,10.25%
2010-08,הצפון,26,ראש פינה,יישוב,48,20,28,8,40,18,47,2,3.44%
2010-08,הצפון,542,ריינה,יישוב,629,245,384,14,615,502,624,16,11.27%
2010-08,הצפון,122,רמת ישי,יישוב,110,45,65,27,83,9,110,7,3.01%
2010-08,הצפון,913,שבלי - אום אל-גנם,יישוב,251,115,136,8,243,193,249,4,11.60%
2010-08,הצפון,812,שלומי,יישוב,277,119,158,15,262,166,275,23,8.37%
2010-08,הצפון,538,שעב,יישוב,482,202,280,3,479,417,481,9,19.13%
2010-08,הצפון,8800,שפרעם,יישוב,2144,846,1298,36,2108,1759,2136,113,14.41%
2010-08,חיפה,2710,אום אל-פחם,יישוב,3523,1471,2052,15,3508,2993,3519,73,20.81%
2010-08,חיפה,1020,אור עקיבא,יישוב,678,289,389,51,627,255,659,76,7.22%
2010-08,חיפה,6000,באקה אל-גרביה,יישוב,584,297,287,14,570,361,583,37,NULL
2010-08,חיפה,9800,בנימינה-גבעת עדה*,יישוב,208,96,112,62,146,51,207,20,3.38%
2010-08,חיפה,1326,"בסמ""ה",יישוב,369,181,188,4,365,276,369,11,11.70%
2010-08,חיפה,541,ג'סר א-זרקא,יישוב,406,226,180,2,404,265,402,21,8.00%
2010-08,חיפה,628,ג'ת,יישוב,167,77,90,5,162,118,167,11,NULL
2010-08,חיפה,494,דאלית אל-כרמל,יישוב,535,217,318,13,522,286,533,23,7.84%
2010-08,חיפה,9300,זכרון יעקב,יישוב,234,101,133,70,164,44,231,15,2.56%
2010-08,חיפה,6500,חדרה,יישוב,2482,963,1519,279,2203,954,2436,210,5.53%
2010-08,חיפה,4000,חיפה,יישוב,8855,3761,5094,1674,7181,5774,8797,602,6.70%
2010-08,חיפה,1247,חריש-קציר,יישוב,32,14,18,7,25,13,31,3,1.89%
2010-08,חיפה,2100,טירת כרמל,יישוב,811,352,459,26,785,544,802,58,8.37%
2010-08,חיפה,654,כפר קרע,יישוב,354,164,190,10,344,203,352,16,5.17%
2010-08,חיפה,1327,מעלה עירון,יישוב,832,322,510,4,828,699,830,11,17.62%
2010-08,חיפה,2500,נשר,יישוב,617,285,332,122,495,331,613,63,5.03%
2010-08,חיפה,534,עספיא,יישוב,366,160,206,11,355,210,366,17,7.66%
2010-08,חיפה,637,ערערה,יישוב,525,222,303,11,514,338,525,39,7.95%
2010-08,חיפה,537,פוריידיס,יישוב,392,177,215,2,390,265,390,39,8.30%
2010-08,חיפה,7800,פרדס חנה-כרכור,יישוב,874,341,533,149,725,260,863,88,5.13%
2010-08,חיפה,6800,קריית אתא,יישוב,2157,825,1332,170,1987,1321,2142,149,7.96%
2010-08,חיפה,9500,קריית ביאליק,יישוב,1333,532,801,164,1169,735,1327,98,6.64%
2010-08,חיפה,2300,קריית טבעון,יישוב,184,75,109,67,117,54,184,13,2.44%
2010-08,חיפה,9600,קריית ים,יישוב,1914,813,1101,156,1758,1274,1909,119,9.50%
2010-08,חיפה,8200,קריית מוצקין,יישוב,1252,478,774,184,1068,680,1238,66,5.95%
2010-08,חיפה,922,רכסים,יישוב,195,77,118,9,186,110,194,10,7.08%
2010-08,ירושלים,472,אבו גוש,יישוב,282,132,150,10,272,189,281,9,11.52%
2010-08,ירושלים,2610,בית שמש,יישוב,1428,535,893,118,1310,626,1406,197,5.65%
2010-08,ירושלים,3000,ירושלים,יישוב,10722,4576,6146,1294,9428,5843,10646,725,4.28%
2010-08,ירושלים,1015,מבשרת ציון,יישוב,467,220,247,79,388,140,464,24,3.94%
2010-08,ירושלים,1137,קריית יערים,יישוב,38,12,26,10,28,12,38,4,3.77%
2010-08,תל אביב,2400,אור יהודה,יישוב,969,385,584,47,922,330,954,102,5.45%
2010-08,תל אביב,565,אזור,יישוב,171,75,96,34,137,42,171,11,2.91%
2010-08,תל אביב,6100,בני ברק,יישוב,2602,1061,1541,131,2471,1351,2584,321,5.57%
2010-08,תל אביב,6200,בת ים,יישוב,3606,1620,1986,542,3064,1627,3545,310,5.08%
2010-08,תל אביב,6300,גבעתיים,יישוב,788,327,461,342,446,130,778,52,2.85%
2010-08,תל אביב,6400,הרצלייה,יישוב,1297,507,790,332,965,177,1272,230,2.79%
2010-08,תל אביב,6600,חולון,יישוב,3286,1468,1818,558,2728,1159,3226,313,3.49%
2010-08,תל אביב,2620,קריית אונו,יישוב,455,194,261,158,297,58,450,30,2.78%
2010-08,תל אביב,8600,רמת גן,יישוב,2300,988,1312,675,1625,565,2284,146,3.20%
2010-08,תל אביב,2650,רמת השרון,יישוב,432,194,238,152,280,45,426,60,2.09%
2010-08,תל אביב,5000,תל אביב -יפו,יישוב,8090,3883,4207,2276,5814,3033,8019,539,3.48%
2010-09,אזור יהודה והשומרון,3760,אורנית,יישוב,90,40,50,35,55,4,90,5,2.41%
2010-09,אזור יהודה והשומרון,3750,אלפי מנשה,יישוב,85,30,55,21,64,3,84,6,2.09%
2010-09,אזור יהודה והשומרון,3560,אלקנה,יישוב,35,17,18,17,18,3,35,4,2.06%
2010-09,אזור יהודה והשומרון,3650,אפרתה,יישוב,45,27,18,21,24,6,45,2,1.28%
2010-09,אזור יהודה והשומרון,3570,אריאל,יישוב,356,156,200,89,267,126,356,33,3.60%
2010-09,אזור יהודה והשומרון,3574,בית אל,יישוב,40,17,23,14,26,13,39,10,1.84%
2010-09,אזור יהודה והשומרון,3652,בית אריה,יישוב,65,28,37,10,55,6,65,2,3.06%
2010-09,אזור יהודה והשומרון,3780,ביתר עילית,יישוב,408,172,236,18,390,196,403,73,4.81%
2010-09,אזור יהודה והשומרון,3730,גבעת זאב,יישוב,149,66,83,20,129,40,149,11,2.49%
2010-09,אזור יהודה והשומרון,3769,הר אדר,יישוב,28,13,15,17,11,3,28,0,1.64%
2010-09,אזור יהודה והשומרון,3797,מודיעין עילית,יישוב,310,84,226,24,286,81,308,34,2.97%
2010-09,אזור יהודה והשומרון,3616,מעלה אדומים,יישוב,615,237,378,86,529,217,610,68,3.46%
2010-09,אזור יהודה והשומרון,3660,עמנואל,יישוב,79,39,40,2,77,60,79,12,8.47%
2010-09,אזור יהודה והשומרון,3557,קדומים,יישוב,27,12,15,12,15,9,27,5,1.69%
2010-09,אזור יהודה והשומרון,3611,קריית ארבע,יישוב,117,57,60,17,100,66,117,13,4.21%
2010-09,אזור יהודה והשומרון,3640,קרני שומרון,יישוב,79,38,41,23,56,24,79,10,2.43%
2010-09,הדרום,31,אופקים,יישוב,1391,556,835,88,1303,1000,1378,64,12.26%
2010-09,הדרום,2600,אילת,יישוב,1298,559,739,88,1210,646,1278,69,4.20%
2010-09,הדרום,70,אשדוד,יישוב,7031,2581,4450,845,6186,4326,6981,414,6.99%
2010-09,הדרום,7100,אשקלון,יישוב,4217,1532,2685,667,3550,2642,4121,255,7.13%
2010-09,הדרום,9000,באר שבע,יישוב,7378,3138,4240,1004,6374,5118,7344,406,7.83%
2010-09,הדרום,2200,דימונה,יישוב,2026,847,1179,121,1905,1476,1986,167,11.41%
2010-09,הדרום,1303,חורה,יישוב,708,304,404,1,707,659,708,11,23.39%
2010-09,הדרום,831,ירוחם,יישוב,437,203,234,19,418,276,434,50,10.51%
2010-09,הדרום,1059,כסיפה,יישוב,931,395,536,0,931,853,929,16,25.25%
2010-09,הדרום,1271,להבים,יישוב,34,20,14,24,10,3,34,3,1.12%
2010-09,הדרום,1060,לקיה,יישוב,888,405,483,3,885,824,886,10,27.88%
2010-09,הדרום,1268,מיתר,יישוב,54,17,37,19,35,6,54,9,1.47%
2010-09,הדרום,99,מצפה רמון,יישוב,246,83,163,23,223,132,225,20,10.12%
2010-09,הדרום,246,נתיבות,יישוב,1019,389,630,63,956,561,1014,99,8.68%
2010-09,הדרום,666,עומר,יישוב,55,18,37,25,30,8,55,5,1.48%
2010-09,הדרום,2560,ערד,יישוב,946,376,570,176,770,587,919,94,7.47%
2010-09,הדרום,1192,ערערה-בנגב,יישוב,957,380,577,1,956,882,956,5,30.00%
2010-09,הדרום,2630,קריית גת,יישוב,2298,871,1427,199,2099,1560,2289,117,9.23%
2010-09,הדרום,1034,קריית מלאכי,יישוב,1255,560,695,42,1213,834,1235,89,11.49%
2010-09,הדרום,1161,רהט,יישוב,2885,1104,1781,6,2879,2553,2883,81,20.66%
2010-09,הדרום,1286,שגב-שלום,יישוב,553,233,320,2,551,494,551,22,26.61%
2010-09,הדרום,1031,שדרות,יישוב,1070,394,676,63,1007,648,1067,72,9.67%
2010-09,הדרום,1054,תל שבע,יישוב,1175,570,605,3,1172,1077,1172,42,30.46%
2010-09,המרכז,182,אבן יהודה,יישוב,138,54,84,57,81,18,138,11,2.33%
2010-09,המרכז,41,אליכין,יישוב,54,26,28,13,41,16,54,4,3.43%
2010-09,המרכז,1309,אלעד,יישוב,364,161,203,22,342,111,363,14,3.46%
2010-09,המרכז,2530,באר יעקב,יישוב,266,110,156,40,226,88,259,18,3.71%
2010-09,המרכז,466,בית דגן,יישוב,106,60,46,20,86,32,105,6,3.22%
2010-09,המרכז,1066,"בני עי""ש",יישוב,170,77,93,25,145,85,169,10,4.41%
2010-09,המרכז,681,גבעת שמואל,יישוב,242,105,137,99,143,49,242,6,2.33%
2010-09,המרכז,2550,גדרה,יישוב,314,122,192,68,246,106,308,17,3.09%
2010-09,המרכז,627,ג'לג'וליה,יישוב,55,28,27,2,53,25,55,2,1.96%
2010-09,המרכז,166,גן יבנה,יישוב,338,119,219,45,293,100,337,20,3.50%
2010-09,המרכז,229,גני תקווה,יישוב,171,74,97,42,129,27,171,15,2.46%
2010-09,המרכז,9700,הוד השרון,יישוב,533,221,312,182,351,60,532,51,2.14%
2010-09,המרכז,1290,זמר,יישוב,162,54,108,4,158,131,162,3,6.70%
2010-09,המרכז,2730,טייבה,יישוב,2007,831,1176,4,2003,1751,1996,33,13.69%
2010-09,המרכז,2720,טירה,יישוב,277,132,145,9,268,186,276,10,3.11%
2010-09,המרכז,2660,יבנה,יישוב,866,380,486,75,791,443,865,65,4.86%
2010-09,המרכז,9400,יהוד,יישוב,513,211,302,88,425,88,494,39,3.39%
2010-09,המרכז,1224,כוכב יאיר,יישוב,81,34,47,43,38,4,81,16,1.55%
2010-09,המרכז,633,כפר ברא,יישוב,21,7,14,0,21,10,21,2,2.07%
2010-09,המרכז,168,כפר יונה,יישוב,323,114,209,51,272,100,321,39,3.42%
2010-09,המרכז,6900,כפר סבא,יישוב,1079,450,629,334,745,205,1074,94,2.35%
2010-09,המרכז,634,כפר קאסם,יישוב,209,107,102,2,207,114,209,35,3.21%
2010-09,המרכז,7000,לוד,יישוב,2132,873,1259,194,1938,1261,2116,184,6.48%
2010-09,המרכז,1200,מודיעין-מכבים-רעות*,יישוב,855,323,532,339,516,70,844,87,2.31%
2010-09,המרכז,28,מזכרת בתיה,יישוב,148,44,104,36,112,38,146,5,2.66%
2010-09,המרכז,7200,נס ציונה,יישוב,628,278,350,126,502,204,621,39,3.14%
2010-09,המרכז,7400,נתניה,יישוב,4447,1875,2572,648,3799,2056,4409,593,4.73%
2010-09,המרכז,587,סביון*,יישוב,13,8,5,6,7,1,13,1,0.80%
2010-09,המרכז,171,פרדסייה,יישוב,65,32,33,20,45,9,64,2,1.90%
2010-09,המרכז,7900,פתח תקווה,יישוב,3780,1541,2239,726,3054,1205,3755,273,3.48%
2010-09,המרכז,195,קדימה-צורן,יישוב,243,108,135,75,168,39,241,21,2.81%
2010-09,המרכז,638,קלנסווה,יישוב,864,313,551,0,864,753,859,25,12.18%
2010-09,המרכז,469,קריית עקרון,יישוב,258,115,143,12,246,115,255,13,4.80%
2010-09,המרכז,2640,ראש העין,יישוב,687,319,368,94,593,186,676,55,3.38%
2010-09,המרכז,8300,ראשון לציון,יישוב,4106,1713,2393,836,3270,1674,4089,306,3.26%
2010-09,המרכז,8400,רחובות,יישוב,2505,1010,1495,501,2004,1007,2466,123,4.34%
2010-09,המרכז,8500,רמלה,יישוב,1629,742,887,104,1525,817,1605,154,5.06%
2010-09,המרכז,8700,רעננה,יישוב,629,280,349,253,376,69,626,63,1.81%
2010-09,המרכז,1304,שוהם,יישוב,185,67,118,72,113,4,185,14,1.93%
2010-09,המרכז,154,תל מונד,יישוב,118,47,71,44,74,19,118,13,2.22%
2010-09,הצפון,473,אבו סנאן,יישוב,717,274,443,5,712,601,713,9,14.92%
2010-09,הצפון,478,אכסאל,יישוב,559,218,341,11,548,489,558,14,12.24%
2010-09,הצפון,529,אעבלין,יישוב,614,244,370,10,604,524,614,9,13.21%
2010-09,הצפון,482,בועיינה-נוג'ידאת,יישוב,493,211,282,12,481,406,489,10,15.53%
2010-09,הצפון,4001,בוקעאתא,יישוב,368,156,212,4,364,315,358,6,15.50%
2010-09,הצפון,998,ביר אל-מכסור,יישוב,404,149,255,1,403,332,404,1,13.62%
2010-09,הצפון,480,בית ג'ן,יישוב,292,91,201,1,291,231,290,5,7.14%
2010-09,הצפון,9200,בית שאן,יישוב,791,325,466,20,771,436,789,81,8.55%
2010-09,הצפון,944,בסמת טבעון,יישוב,277,104,173,3,274,220,277,8,10.32%
2010-09,הצפון,483,בענה,יישוב,462,186,276,2,460,404,462,17,16.47%
2010-09,הצפון,1292,ג'דיידה-מכר,יישוב,1450,584,866,6,1444,1271,1450,13,18.93%
2010-09,הצפון,485,ג'ולס,יישוב,212,54,158,2,210,132,212,6,9.00%
2010-09,הצפון,487,ג'ש (גוש חלב),יישוב,67,30,37,9,58,37,67,6,4.68%
2010-09,הצפון,489,דבורייה,יישוב,411,192,219,30,381,308,411,10,11.46%
2010-09,הצפון,490,דייר אל-אסד,יישוב,426,174,252,10,416,343,426,30,10.35%
2010-09,הצפון,492,דייר חנא,יישוב,644,276,368,16,628,529,644,15,16.50%
2010-09,הצפון,975,זרזיר,יישוב,261,112,149,1,260,187,258,11,10.84%
2010-09,הצפון,496,חורפיש,יישוב,129,50,79,3,126,90,129,4,6.26%
2010-09,הצפון,2034,חצור הגלילית,יישוב,292,127,165,12,280,146,287,20,6.62%
2010-09,הצפון,6700,טבריה,יישוב,1772,699,1073,115,1657,1178,1673,77,8.38%
2010-09,הצפון,962,טובא-זנגרייה,יישוב,341,142,199,8,333,252,336,9,12.80%
2010-09,הצפון,498,טורעאן,יישוב,524,191,333,11,513,456,521,20,11.48%
2010-09,הצפון,8900,טמרה,יישוב,1984,794,1190,29,1955,1760,1981,40,17.12%
2010-09,הצפון,1295,יאנוח-ג'ת,יישוב,165,51,114,3,162,112,165,14,7.80%
2010-09,הצפון,46,יבנאל,יישוב,131,69,62,9,122,94,125,2,9.46%
2010-09,הצפון,499,יפיע,יישוב,604,243,361,9,595,491,600,21,9.37%
2010-09,הצפון,240,יקנעם עילית,יישוב,486,187,299,88,398,209,484,32,4.77%
2010-09,הצפון,502,ירכא,יישוב,492,181,311,3,489,384,492,10,10.93%
2010-09,הצפון,504,כאבול,יישוב,705,288,417,12,693,622,701,14,17.17%
2010-09,הצפון,505,כאוכב אבו אל-היג'א,יישוב,191,72,119,2,189,168,191,1,13.75%
2010-09,הצפון,1296,כסרא-סמיע,יישוב,209,85,124,1,208,161,209,10,7.93%
2010-09,הצפון,978,כעביה-טבאש-חג'אג'רה,יישוב,196,85,111,2,194,143,193,2,10.45%
2010-09,הצפון,1263,כפר ורדים,יישוב,55,18,37,27,28,11,55,4,1.90%
2010-09,הצפון,507,כפר יאסיף,יישוב,470,197,273,4,466,392,468,2,11.06%
2010-09,הצפון,508,כפר כמא,יישוב,69,32,37,4,65,44,68,1,5.12%
2010-09,הצפון,509,כפר כנא,יישוב,1132,434,698,18,1114,992,1121,41,15.61%
2010-09,הצפון,510,כפר מנדא,יישוב,861,354,507,8,853,710,854,19,14.59%
2010-09,הצפון,47,כפר תבור,יישוב,42,13,29,20,22,5,42,3,2.52%
2010-09,הצפון,1139,כרמיאל,יישוב,1638,598,1040,323,1315,945,1579,79,6.46%
2010-09,הצפון,481,מגאר,יישוב,1363,523,840,29,1334,1232,1359,31,18.64%
2010-09,הצפון,516,מג'ד אל-כרום,יישוב,645,260,385,7,638,526,644,16,12.26%
2010-09,הצפון,874,מגדל העמק,יישוב,960,386,574,78,882,491,928,101,7.47%
2010-09,הצפון,4201,מג'דל שמס,יישוב,443,158,285,21,422,390,437,5,11.29%
2010-09,הצפון,517,מזרעה,יישוב,155,54,101,4,151,129,154,1,9.76%
2010-09,הצפון,4203,מסעדה,יישוב,201,77,124,7,194,175,200,8,13.76%
2010-09,הצפון,518,מעיליא,יישוב,67,29,38,7,60,32,67,3,4.81%
2010-09,הצפון,1063,מעלות-תרשיחא,יישוב,945,391,554,135,810,598,939,46,8.33%
2010-09,הצפון,520,משהד,יישוב,311,117,194,2,309,265,308,9,11.92%
2010-09,הצפון,9100,נהרייה,יישוב,2053,875,1178,259,1794,1324,2038,76,7.35%
2010-09,הצפון,522,נחף,יישוב,452,180,272,13,439,385,451,8,11.16%
2010-09,הצפון,7300,נצרת,יישוב,2718,1135,1583,89,2629,2094,2706,112,9.43%
2010-09,הצפון,1061,נצרת עילית,יישוב,1697,677,1020,229,1468,1070,1615,151,7.21%
2010-09,הצפון,525,סאג'ור,יישוב,103,32,71,2,101,81,102,1,7.35%
2010-09,הצפון,7500,סח'נין,יישוב,1970,867,1103,48,1922,1738,1970,44,17.26%
2010-09,הצפון,4501,ע'ג'ר,יישוב,87,33,54,1,86,73,87,6,10.41%
2010-09,הצפון,530,עיילבון,יישוב,192,79,113,7,185,155,191,2,9.00%
2010-09,הצפון,511,עילוט,יישוב,322,133,189,2,320,253,322,16,13.96%
2010-09,הצפון,532,עין מאהל,יישוב,541,240,301,9,532,486,533,7,12.75%
2010-09,הצפון,7600,עכו,יישוב,3170,1398,1772,137,3033,2542,3151,176,13.11%
2010-09,הצפון,7700,עפולה,יישוב,1804,713,1091,203,1601,1007,1743,149,8.02%
2010-09,הצפון,531,עראבה,יישוב,1331,537,794,44,1287,1157,1330,47,16.54%
2010-09,הצפון,535,פסוטה,יישוב,130,59,71,11,119,93,130,5,8.75%
2010-09,הצפון,536,פקיעין (בוקייעה),יישוב,125,66,59,7,118,93,125,5,5.40%
2010-09,הצפון,8000,צפת,יישוב,959,477,482,81,878,677,954,42,8.46%
2010-09,הצפון,4100,קצרין,יישוב,180,76,104,36,144,108,177,11,4.81%
2010-09,הצפון,2800,קריית שמונה,יישוב,703,318,385,58,645,297,692,73,5.70%
2010-09,הצפון,543,ראמה,יישוב,297,117,180,9,288,246,297,7,9.32%
2010-09,הצפון,26,ראש פינה,יישוב,45,20,25,7,38,18,45,2,3.29%
2010-09,הצפון,542,ריינה,יישוב,603,229,374,13,590,500,597,12,10.83%
2010-09,הצפון,122,רמת ישי,יישוב,105,36,69,25,80,11,103,5,2.82%
2010-09,הצפון,913,שבלי - אום אל-גנם,יישוב,234,102,132,8,226,192,233,2,10.94%
2010-09,הצפון,812,שלומי,יישוב,256,106,150,11,245,157,254,10,7.78%
2010-09,הצפון,538,שעב,יישוב,475,198,277,4,471,414,474,10,18.90%
2010-09,הצפון,8800,שפרעם,יישוב,2039,775,1264,34,2005,1713,2030,57,13.79%
2010-09,חיפה,2710,אום אל-פחם,יישוב,3366,1376,1990,9,3357,2959,3362,46,20.06%
2010-09,חיפה,1020,אור עקיבא,יישוב,586,241,345,42,544,229,576,62,6.37%
2010-09,חיפה,6000,באקה אל-גרביה,יישוב,554,280,274,14,540,359,553,22,NULL
2010-09,חיפה,9800,בנימינה-גבעת עדה*,יישוב,178,81,97,61,117,49,177,18,2.91%
2010-09,חיפה,1326,"בסמ""ה",יישוב,374,180,194,4,370,285,374,10,11.84%
2010-09,חיפה,541,ג'סר א-זרקא,יישוב,368,198,170,0,368,253,365,8,7.32%
2010-09,חיפה,628,ג'ת,יישוב,161,74,87,7,154,112,161,3,NULL
2010-09,חיפה,494,דאלית אל-כרמל,יישוב,487,200,287,13,474,292,485,33,7.19%
2010-09,חיפה,9300,זכרון יעקב,יישוב,203,79,124,76,127,43,201,22,2.24%
2010-09,חיפה,6500,חדרה,יישוב,2171,832,1339,267,1904,913,2138,202,4.89%
2010-09,חיפה,4000,חיפה,יישוב,8161,3418,4743,1604,6557,5503,8112,454,6.21%
2010-09,חיפה,1247,חריש-קציר,יישוב,27,10,17,3,24,11,27,2,1.65%
2010-09,חיפה,2100,טירת כרמל,יישוב,750,329,421,29,721,511,742,40,7.79%
2010-09,חיפה,654,כפר קרע,יישוב,359,163,196,11,348,201,357,8,5.24%
2010-09,חיפה,1327,מעלה עירון,יישוב,820,306,514,4,816,701,818,3,17.41%
2010-09,חיפה,2500,נשר,יישוב,546,233,313,105,441,308,543,38,4.48%
2010-09,חיפה,534,עספיא,יישוב,308,133,175,7,301,203,308,17,6.52%
2010-09,חיפה,637,ערערה,יישוב,508,207,301,13,495,331,508,46,7.71%
2010-09,חיפה,537,פוריידיס,יישוב,358,165,193,1,357,252,356,11,7.63%
2010-09,חיפה,7800,פרדס חנה-כרכור,יישוב,783,288,495,139,644,251,772,81,4.61%
2010-09,חיפה,6800,קריית אתא,יישוב,1893,737,1156,161,1732,1260,1881,105,7.05%
2010-09,חיפה,9500,קריית ביאליק,יישוב,1212,482,730,161,1051,691,1207,66,6.07%
2010-09,חיפה,2300,קריית טבעון,יישוב,166,71,95,58,108,50,166,11,2.21%
2010-09,חיפה,9600,קריית ים,יישוב,1728,713,1015,148,1580,1232,1724,74,8.66%
2010-09,חיפה,8200,קריית מוצקין,יישוב,1157,414,743,171,986,644,1145,50,5.53%
2010-09,חיפה,922,רכסים,יישוב,154,68,86,7,147,107,153,19,5.66%
2010-09,ירושלים,472,אבו גוש,יישוב,254,115,139,10,244,185,254,12,10.53%
2010-09,ירושלים,2610,בית שמש,יישוב,1142,433,709,112,1030,573,1125,125,4.58%
2010-09,ירושלים,3000,ירושלים,יישוב,9023,3801,5222,1152,7871,5584,8977,526,3.63%
2010-09,ירושלים,1015,מבשרת ציון,יישוב,312,144,168,69,243,127,309,17,2.66%
2010-09,ירושלים,1137,קריית יערים,יישוב,32,14,18,7,25,11,32,3,3.20%
2010-09,תל אביב,2400,אור יהודה,יישוב,797,323,474,39,758,327,785,61,4.53%
2010-09,תל אביב,565,אזור,יישוב,156,68,88,31,125,41,156,12,2.66%
2010-09,תל אביב,6100,בני ברק,יישוב,2068,967,1101,121,1947,1270,2062,100,4.49%
2010-09,תל אביב,6200,בת ים,יישוב,3148,1365,1783,472,2676,1508,3099,180,4.47%
2010-09,תל אביב,6300,גבעתיים,יישוב,682,276,406,301,381,126,673,37,2.47%
2010-09,תל אביב,6400,הרצלייה,יישוב,1027,403,624,313,714,151,1014,174,2.24%
2010-09,תל אביב,6600,חולון,יישוב,2772,1232,1540,475,2297,1032,2735,226,2.97%
2010-09,תל אביב,2620,קריית אונו,יישוב,408,169,239,162,246,59,407,15,2.52%
2010-09,תל אביב,8600,רמת גן,יישוב,1947,811,1136,591,1356,522,1931,139,2.72%
2010-09,תל אביב,2650,רמת השרון,יישוב,384,171,213,158,226,39,381,36,1.87%
2010-09,תל אביב,5000,תל אביב -יפו,יישוב,7221,3386,3835,2089,5132,2809,7166,370,3.12%
2010-10,אזור יהודה והשומרון,3760,אורנית,יישוב,98,49,49,40,58,4,98,7,2.61%
2010-10,אזור יהודה והשומרון,3750,אלפי מנשה,יישוב,98,43,55,23,75,4,97,10,2.40%
2010-10,אזור יהודה והשומרון,3560,אלקנה,יישוב,36,14,22,18,18,3,36,1,2.12%
2010-10,אזור יהודה והשומרון,3650,אפרתה,יישוב,50,29,21,25,25,6,49,4,1.40%
2010-10,אזור יהודה והשומרון,3570,אריאל,יישוב,402,176,226,91,311,128,401,49,4.04%
2010-10,אזור יהודה והשומרון,3574,בית אל,יישוב,48,18,30,16,32,13,47,3,2.21%
2010-10,אזור יהודה והשומרון,3652,בית אריה,יישוב,75,35,40,10,65,5,74,6,3.47%
2010-10,אזור יהודה והשומרון,3780,ביתר עילית,יישוב,433,184,249,19,414,194,430,28,5.12%
2010-10,אזור יהודה והשומרון,3730,גבעת זאב,יישוב,187,83,104,21,166,45,187,17,3.10%
2010-10,אזור יהודה והשומרון,3769,הר אדר,יישוב,31,16,15,17,14,2,31,2,1.81%
2010-10,אזור יהודה והשומרון,3797,מודיעין עילית,יישוב,339,104,235,21,318,85,336,29,3.23%
2010-10,אזור יהודה והשומרון,3616,מעלה אדומים,יישוב,708,279,429,101,607,231,701,62,3.96%
2010-10,אזור יהודה והשומרון,3660,עמנואל,יישוב,85,44,41,2,83,60,85,1,9.05%
2010-10,אזור יהודה והשומרון,3557,קדומים,יישוב,35,20,15,13,22,11,35,3,2.18%
2010-10,אזור יהודה והשומרון,3611,קריית ארבע,יישוב,107,52,55,18,89,64,107,9,3.86%
2010-10,אזור יהודה והשומרון,3640,קרני שומרון,יישוב,86,39,47,26,60,27,85,9,2.61%
2010-10,הדרום,31,אופקים,יישוב,1451,593,858,89,1362,1024,1435,98,12.71%
2010-10,הדרום,2600,אילת,יישוב,1453,657,796,103,1350,685,1432,101,4.68%
2010-10,הדרום,70,אשדוד,יישוב,7428,2816,4612,873,6555,4423,7371,422,7.36%
2010-10,הדרום,7100,אשקלון,יישוב,4690,1764,2926,721,3969,2823,4587,326,7.87%
2010-10,הדרום,9000,באר שבע,יישוב,7773,3326,4447,1052,6721,5216,7717,673,8.19%
2010-10,הדרום,2200,דימונה,יישוב,2215,961,1254,133,2082,1548,2171,229,12.34%
2010-10,הדרום,1303,חורה,יישוב,729,324,405,1,728,671,729,16,23.92%
2010-10,הדרום,831,ירוחם,יישוב,511,241,270,23,488,301,503,80,11.98%
2010-10,הדרום,1059,כסיפה,יישוב,973,422,551,1,972,882,971,24,26.10%
2010-10,הדרום,1271,להבים,יישוב,50,29,21,27,23,5,50,14,1.63%
2010-10,הדרום,1060,לקיה,יישוב,916,416,500,3,913,843,914,7,28.51%
2010-10,הדרום,1268,מיתר,יישוב,68,22,46,25,43,6,68,15,1.84%
2010-10,הדרום,99,מצפה רמון,יישוב,279,104,175,26,253,132,249,38,11.08%
2010-10,הדרום,246,נתיבות,יישוב,1085,408,677,65,1020,569,1078,130,9.18%
2010-10,הדרום,666,עומר,יישוב,64,20,44,32,32,10,62,9,1.67%
2010-10,הדרום,2560,ערד,יישוב,966,400,566,183,783,590,941,109,7.64%
2010-10,הדרום,1192,ערערה-בנגב,יישוב,991,403,588,3,988,898,990,12,30.74%
2010-10,הדרום,2630,קריית גת,יישוב,2543,1001,1542,218,2325,1648,2534,201,10.12%
2010-10,הדרום,1034,קריית מלאכי,יישוב,1354,605,749,46,1308,879,1335,141,12.31%
2010-10,הדרום,1161,רהט,יישוב,3037,1194,1843,7,3030,2674,3035,200,21.51%
2010-10,הדרום,1286,שגב-שלום,יישוב,559,233,326,3,556,497,558,29,26.85%
2010-10,הדרום,1031,שדרות,יישוב,1148,453,695,72,1076,654,1145,100,10.30%
2010-10,הדרום,1054,תל שבע,יישוב,1195,581,614,4,1191,1091,1193,46,30.83%
2010-10,המרכז,182,אבן יהודה,יישוב,158,68,90,55,103,19,158,22,2.66%
2010-10,המרכז,41,אליכין,יישוב,62,26,36,15,47,17,62,4,3.92%
2010-10,המרכז,1309,אלעד,יישוב,412,190,222,26,386,122,411,28,3.90%
2010-10,המרכז,2530,באר יעקב,יישוב,271,123,148,35,236,83,266,31,3.80%
2010-10,המרכז,466,בית דגן,יישוב,116,63,53,20,96,34,115,3,3.51%
2010-10,המרכז,1066,"בני עי""ש",יישוב,197,95,102,29,168,85,195,7,5.05%
2010-10,המרכז,681,גבעת שמואל,יישוב,273,118,155,112,161,51,271,13,2.61%
2010-10,המרכז,2550,גדרה,יישוב,350,153,197,63,287,110,343,25,3.43%
2010-10,המרכז,627,ג'לג'וליה,יישוב,66,31,35,5,61,32,66,8,2.34%
2010-10,המרכז,166,גן יבנה,יישוב,358,129,229,43,315,102,356,41,3.69%
2010-10,המרכז,229,גני תקווה,יישוב,192,86,106,47,145,31,192,10,2.75%
2010-10,המרכז,9700,הוד השרון,יישוב,585,252,333,193,392,66,583,50,2.34%
2010-10,המרכז,1290,זמר,יישוב,163,54,109,5,158,131,163,4,6.74%
2010-10,המרכז,2730,טייבה,יישוב,2084,879,1205,3,2081,1787,2070,38,14.12%
2010-10,המרכז,2720,טירה,יישוב,307,135,172,10,297,201,306,12,3.44%
2010-10,המרכז,2660,יבנה,יישוב,1018,443,575,84,934,448,1017,81,5.66%
2010-10,המרכז,9400,יהוד,יישוב,613,249,364,103,510,92,585,45,3.98%
2010-10,המרכז,1224,כוכב יאיר,יישוב,82,33,49,43,39,5,82,10,1.57%
2010-10,המרכז,633,כפר ברא,יישוב,24,12,12,0,24,9,24,1,2.36%
2010-10,המרכז,168,כפר יונה,יישוב,362,137,225,52,310,102,360,51,3.82%
2010-10,המרכז,6900,כפר סבא,יישוב,1220,509,711,358,862,226,1208,110,2.64%
2010-10,המרכז,634,כפר קאסם,יישוב,216,111,105,1,215,125,214,19,3.28%
2010-10,המרכז,7000,לוד,יישוב,2262,977,1285,205,2057,1299,2246,199,6.85%
2010-10,המרכז,1200,מודיעין-מכבים-רעות*,יישוב,934,378,556,343,591,75,921,109,2.52%
2010-10,המרכז,28,מזכרת בתיה,יישוב,163,48,115,39,124,38,162,6,2.94%
2010-10,המרכז,7200,נס ציונה,יישוב,679,303,376,131,548,207,672,32,3.39%
2010-10,המרכז,7400,נתניה,יישוב,4975,2172,2803,711,4264,2194,4918,624,5.25%
2010-10,המרכז,587,סביון*,יישוב,15,6,9,9,6,1,15,0,0.92%
2010-10,המרכז,171,פרדסייה,יישוב,78,36,42,25,53,8,77,5,2.28%
2010-10,המרכז,7900,פתח תקווה,יישוב,4248,1808,2440,815,3433,1280,4219,342,3.90%
2010-10,המרכז,195,קדימה-צורן,יישוב,261,102,159,73,188,42,259,32,3.02%
2010-10,המרכז,638,קלנסווה,יישוב,898,342,556,0,898,770,894,14,12.61%
2010-10,המרכז,469,קריית עקרון,יישוב,297,135,162,13,284,123,293,13,5.47%
2010-10,המרכז,2640,ראש העין,יישוב,798,369,429,93,705,188,780,87,3.88%
2010-10,המרכז,8300,ראשון לציון,יישוב,4553,1929,2624,915,3638,1771,4531,307,3.60%
2010-10,המרכז,8400,רחובות,יישוב,2711,1112,1599,548,2163,1068,2664,157,4.68%
2010-10,המרכז,8500,רמלה,יישוב,1843,838,1005,107,1736,870,1807,197,5.66%
2010-10,המרכז,8700,רעננה,יישוב,696,311,385,268,428,79,693,55,2.00%
2010-10,המרכז,1304,שוהם,יישוב,200,83,117,80,120,5,200,19,2.08%
2010-10,המרכז,154,תל מונד,יישוב,140,58,82,50,90,19,140,9,2.63%
2010-10,הצפון,473,אבו סנאן,יישוב,750,292,458,4,746,610,746,18,15.50%
2010-10,הצפון,478,אכסאל,יישוב,556,215,341,12,544,495,556,11,12.20%
2010-10,הצפון,529,אעבלין,יישוב,653,263,390,11,642,545,653,14,13.94%
2010-10,הצפון,482,בועיינה-נוג'ידאת,יישוב,487,206,281,9,478,407,483,7,15.37%
2010-10,הצפון,4001,בוקעאתא,יישוב,379,160,219,5,374,322,369,6,15.90%
2010-10,הצפון,998,ביר אל-מכסור,יישוב,423,151,272,2,421,340,423,7,14.17%
2010-10,הצפון,480,בית ג'ן,יישוב,312,98,214,2,310,236,310,10,7.60%
2010-10,הצפון,9200,בית שאן,יישוב,870,372,498,18,852,462,869,119,9.34%
2010-10,הצפון,944,בסמת טבעון,יישוב,293,109,184,4,289,227,293,24,10.85%
2010-10,הצפון,483,בענה,יישוב,469,189,280,3,466,409,469,8,16.68%
2010-10,הצפון,1292,ג'דיידה-מכר,יישוב,1474,607,867,5,1469,1281,1474,29,19.18%
2010-10,הצפון,485,ג'ולס,יישוב,217,56,161,3,214,131,217,13,9.19%
2010-10,הצפון,487,ג'ש (גוש חלב),יישוב,60,28,32,6,54,35,60,3,4.21%
2010-10,הצפון,489,דבורייה,יישוב,435,206,229,31,404,325,435,3,12.05%
2010-10,הצפון,490,דייר אל-אסד,יישוב,436,178,258,9,427,351,436,9,10.57%
2010-10,הצפון,492,דייר חנא,יישוב,653,287,366,14,639,541,653,25,16.69%
2010-10,הצפון,975,זרזיר,יישוב,294,126,168,3,291,218,289,10,11.99%
2010-10,הצפון,496,חורפיש,יישוב,139,55,84,4,135,94,139,1,6.71%
2010-10,הצפון,2034,חצור הגלילית,יישוב,323,142,181,16,307,160,317,29,7.26%
2010-10,הצפון,6700,טבריה,יישוב,1933,792,1141,127,1806,1216,1835,136,9.12%
2010-10,הצפון,962,טובא-זנגרייה,יישוב,339,147,192,6,333,255,334,18,12.74%
2010-10,הצפון,498,טורעאן,יישוב,540,202,338,12,528,463,538,15,11.81%
2010-10,הצפון,8900,טמרה,יישוב,2030,835,1195,29,2001,1812,2027,42,17.45%
2010-10,הצפון,1295,יאנוח-ג'ת,יישוב,173,61,112,3,170,116,173,7,8.15%
2010-10,הצפון,46,יבנאל,יישוב,139,73,66,8,131,102,132,4,9.93%
2010-10,הצפון,499,יפיע,יישוב,620,248,372,8,612,497,618,27,9.62%
2010-10,הצפון,240,יקנעם עילית,יישוב,556,214,342,88,468,221,552,52,5.41%
2010-10,הצפון,502,ירכא,יישוב,491,182,309,2,489,385,491,12,10.91%
2010-10,הצפון,504,כאבול,יישוב,727,309,418,11,716,635,725,12,17.65%
2010-10,הצפון,505,כאוכב אבו אל-היג'א,יישוב,200,81,119,7,193,175,200,7,14.31%
2010-10,הצפון,1296,כסרא-סמיע,יישוב,214,89,125,1,213,160,214,10,8.10%
2010-10,הצפון,978,כעביה-טבאש-חג'אג'רה,יישוב,203,85,118,2,201,147,200,1,10.79%
2010-10,הצפון,1263,כפר ורדים,יישוב,61,20,41,25,36,10,60,6,2.07%
2010-10,הצפון,507,כפר יאסיף,יישוב,489,212,277,6,483,399,487,9,11.46%
2010-10,הצפון,508,כפר כמא,יישוב,75,34,41,3,72,43,74,0,5.55%
2010-10,הצפון,509,כפר כנא,יישוב,1160,456,704,23,1137,1012,1148,32,15.93%
2010-10,הצפון,510,כפר מנדא,יישוב,887,365,522,7,880,721,875,33,14.89%
2010-10,הצפון,47,כפר תבור,יישוב,46,15,31,19,27,7,46,5,2.76%
2010-10,הצפון,1139,כרמיאל,יישוב,1810,672,1138,372,1438,979,1743,140,7.08%
2010-10,הצפון,481,מגאר,יישוב,1355,518,837,27,1328,1209,1351,40,18.55%
2010-10,הצפון,516,מג'ד אל-כרום,יישוב,663,277,386,8,655,537,662,24,12.56%
2010-10,הצפון,874,מגדל העמק,יישוב,1048,443,605,82,966,522,1012,145,8.10%
2010-10,הצפון,4201,מג'דל שמס,יישוב,471,169,302,21,450,407,466,12,11.95%
2010-10,הצפון,517,מזרעה,יישוב,172,65,107,4,168,136,170,11,10.66%
2010-10,הצפון,4203,מסעדה,יישוב,203,81,122,6,197,170,202,3,13.88%
2010-10,הצפון,518,מעיליא,יישוב,71,31,40,7,64,33,71,1,5.09%
2010-10,הצפון,1063,מעלות-תרשיחא,יישוב,978,421,557,131,847,588,971,67,8.59%
2010-10,הצפון,520,משהד,יישוב,308,111,197,2,306,267,305,15,11.82%
2010-10,הצפון,9100,נהרייה,יישוב,2180,948,1232,270,1910,1358,2162,149,7.76%
2010-10,הצפון,522,נחף,יישוב,466,185,281,17,449,388,465,13,11.46%
2010-10,הצפון,7300,נצרת,יישוב,2847,1194,1653,93,2754,2163,2835,101,9.84%
2010-10,הצפון,1061,נצרת עילית,יישוב,1898,791,1107,243,1655,1130,1804,268,7.98%
2010-10,הצפון,525,סאג'ור,יישוב,110,38,72,2,108,87,109,3,7.81%
2010-10,הצפון,7500,סח'נין,יישוב,1994,879,1115,42,1952,1756,1994,58,17.43%
2010-10,הצפון,4501,ע'ג'ר,יישוב,88,36,52,1,87,70,88,3,10.51%
2010-10,הצפון,530,עיילבון,יישוב,198,81,117,6,192,155,197,11,9.26%
2010-10,הצפון,511,עילוט,יישוב,332,137,195,2,330,265,332,11,14.33%
2010-10,הצפון,532,עין מאהל,יישוב,576,255,321,7,569,507,570,17,13.52%
2010-10,הצפון,7600,עכו,יישוב,3300,1465,1835,142,3158,2597,3280,165,13.57%
2010-10,הצפון,7700,עפולה,יישוב,2006,814,1192,208,1798,1058,1920,196,8.76%
2010-10,הצפון,531,עראבה,יישוב,1358,569,789,34,1324,1190,1357,47,16.82%
2010-10,הצפון,535,פסוטה,יישוב,132,61,71,8,124,97,132,4,8.87%
2010-10,הצפון,536,פקיעין (בוקייעה),יישוב,143,76,67,8,135,95,142,3,6.09%
2010-10,הצפון,8000,צפת,יישוב,1029,520,509,82,947,715,1020,49,8.99%
2010-10,הצפון,4100,קצרין,יישוב,198,86,112,38,160,108,194,14,5.25%
2010-10,הצפון,2800,קריית שמונה,יישוב,779,361,418,59,720,326,754,113,6.17%
2010-10,הצפון,543,ראמה,יישוב,323,137,186,11,312,260,323,3,10.06%
2010-10,הצפון,26,ראש פינה,יישוב,45,15,30,7,38,19,45,2,3.29%
2010-10,הצפון,542,ריינה,יישוב,636,251,385,14,622,516,630,27,11.36%
2010-10,הצפון,122,רמת ישי,יישוב,106,39,67,28,78,12,105,8,2.87%
2010-10,הצפון,913,שבלי - אום אל-גנם,יישוב,250,109,141,7,243,201,248,3,11.56%
2010-10,הצפון,812,שלומי,יישוב,271,111,160,16,255,160,269,17,8.20%
2010-10,הצפון,538,שעב,יישוב,495,212,283,3,492,421,494,12,19.54%
2010-10,הצפון,8800,שפרעם,יישוב,2072,799,1273,30,2042,1714,2064,59,13.99%
2010-10,חיפה,2710,אום אל-פחם,יישוב,3450,1439,2011,10,3440,2994,3446,68,20.46%
2010-10,חיפה,1020,אור עקיבא,יישוב,632,261,371,42,590,245,616,71,6.78%
2010-10,חיפה,6000,באקה אל-גרביה,יישוב,579,303,276,11,568,370,578,48,NULL
2010-10,חיפה,9800,בנימינה-גבעת עדה*,יישוב,201,89,112,72,129,48,199,13,3.26%
2010-10,חיפה,1326,"בסמ""ה",יישוב,380,182,198,5,375,292,380,10,12.00%
2010-10,חיפה,541,ג'סר א-זרקא,יישוב,374,212,162,0,374,257,370,30,7.41%
2010-10,חיפה,628,ג'ת,יישוב,174,81,93,9,165,116,174,12,NULL
2010-10,חיפה,494,דאלית אל-כרמל,יישוב,489,202,287,13,476,291,488,13,7.23%
2010-10,חיפה,9300,זכרון יעקב,יישוב,227,89,138,81,146,49,225,15,2.50%
2010-10,חיפה,6500,חדרה,יישוב,2399,933,1466,296,2103,957,2357,268,5.36%
2010-10,חיפה,4000,חיפה,יישוב,8708,3694,5014,1679,7029,5659,8655,563,6.60%
2010-10,חיפה,1247,חריש-קציר,יישוב,25,8,17,1,24,10,24,5,1.47%
2010-10,חיפה,2100,טירת כרמל,יישוב,796,346,450,33,763,525,785,54,8.21%
2010-10,חיפה,654,כפר קרע,יישוב,369,163,206,13,356,208,367,22,5.38%
2010-10,חיפה,1327,מעלה עירון,יישוב,840,322,518,5,835,708,838,25,17.76%
2010-10,חיפה,2500,נשר,יישוב,596,271,325,114,482,319,592,41,4.86%
2010-10,חיפה,534,עספיא,יישוב,319,146,173,8,311,209,319,26,6.74%
2010-10,חיפה,637,ערערה,יישוב,509,206,303,10,499,341,509,22,7.73%
2010-10,חיפה,537,פוריידיס,יישוב,384,183,201,1,383,258,382,24,8.14%
2010-10,חיפה,7800,פרדס חנה-כרכור,יישוב,850,334,516,132,718,268,835,113,4.97%
2010-10,חיפה,6800,קריית אתא,יישוב,1975,776,1199,178,1797,1275,1963,113,7.34%
2010-10,חיפה,9500,קריית ביאליק,יישוב,1267,503,764,174,1093,697,1263,95,6.34%
2010-10,חיפה,2300,קריית טבעון,יישוב,178,74,104,62,116,51,177,16,2.35%
2010-10,חיפה,9600,קריית ים,יישוב,1838,773,1065,166,1672,1243,1831,131,9.15%
2010-10,חיפה,8200,קריית מוצקין,יישוב,1240,459,781,177,1063,668,1227,91,5.90%
2010-10,חיפה,922,רכסים,יישוב,154,68,86,7,147,106,153,11,5.66%
2010-10,ירושלים,472,אבו גוש,יישוב,287,137,150,11,276,198,287,14,11.73%
2010-10,ירושלים,2610,בית שמש,יישוב,1274,499,775,112,1162,610,1256,171,5.08%
2010-10,ירושלים,3000,ירושלים,יישוב,10272,4376,5896,1308,8964,5933,10191,761,4.10%
2010-10,ירושלים,1015,מבשרת ציון,יישוב,352,164,188,82,270,127,349,29,2.99%
2010-10,ירושלים,1137,קריית יערים,יישוב,37,15,22,5,32,12,37,4,3.68%
2010-10,תל אביב,2400,אור יהודה,יישוב,881,366,515,43,838,337,866,85,4.97%
2010-10,תל אביב,565,אזור,יישוב,182,91,91,27,155,45,179,25,3.04%
2010-10,תל אביב,6100,בני ברק,יישוב,2318,1084,1234,130,2188,1370,2305,172,4.99%
2010-10,תל אביב,6200,בת ים,יישוב,3635,1613,2022,531,3104,1622,3569,331,5.11%
2010-10,תל אביב,6300,גבעתיים,יישוב,735,302,433,311,424,129,728,51,2.67%
2010-10,תל אביב,6400,הרצלייה,יישוב,1122,465,657,311,811,156,1109,177,2.45%
2010-10,תל אביב,6600,חולון,יישוב,3219,1455,1764,519,2700,1051,3169,317,3.43%
2010-10,תל אביב,2620,קריית אונו,יישוב,458,191,267,182,276,53,451,21,2.78%
2010-10,תל אביב,8600,רמת גן,יישוב,2158,923,1235,643,1515,580,2139,194,3.00%
2010-10,תל אביב,2650,רמת השרון,יישוב,434,188,246,165,269,42,431,44,2.11%
2010-10,תל אביב,5000,תל אביב -יפו,יישוב,8111,3850,4261,2225,5886,3013,8039,601,3.49%
2010-11,אזור יהודה והשומרון,3760,אורנית,יישוב,86,42,44,32,54,4,86,13,2.30%
2010-11,אזור יהודה והשומרון,3750,אלפי מנשה,יישוב,91,38,53,24,67,5,90,10,2.23%
2010-11,אזור יהודה והשומרון,3560,אלקנה,יישוב,40,19,21,21,19,3,40,2,2.34%
2010-11,אזור יהודה והשומרון,3650,אפרתה,יישוב,56,29,27,32,24,8,55,4,1.56%
2010-11,אזור יהודה והשומרון,3570,אריאל,יישוב,381,168,213,96,285,132,381,42,3.84%
2010-11,אזור יהודה והשומרון,3574,בית אל,יישוב,51,23,28,16,35,14,50,5,2.35%
2010-11,אזור יהודה והשומרון,3652,בית אריה,יישוב,63,28,35,11,52,6,63,4,2.97%
2010-11,אזור יהודה והשומרון,3780,ביתר עילית,יישוב,437,190,247,18,419,196,432,18,5.14%
2010-11,אזור יהודה והשומרון,3730,גבעת זאב,יישוב,187,84,103,22,165,45,187,14,3.10%
2010-11,אזור יהודה והשומרון,3769,הר אדר,יישוב,28,17,11,13,15,3,28,3,1.64%
2010-11,אזור יהודה והשומרון,3797,מודיעין עילית,יישוב,309,114,195,21,288,88,307,22,2.96%
2010-11,אזור יהודה והשומרון,3616,מעלה אדומים,יישוב,674,263,411,98,576,221,666,68,3.77%
2010-11,אזור יהודה והשומרון,3660,עמנואל,יישוב,91,49,42,4,87,59,90,6,9.53%
2010-11,אזור יהודה והשומרון,3557,קדומים,יישוב,26,18,8,9,17,8,26,3,1.63%
2010-11,אזור יהודה והשומרון,3611,קריית ארבע,יישוב,112,52,60,17,95,68,112,8,4.03%
2010-11,אזור יהודה והשומרון,3640,קרני שומרון,יישוב,86,48,38,23,63,25,84,4,2.58%
2010-11,הדרום,31,אופקים,יישוב,1429,592,837,95,1334,1018,1413,63,12.54%
2010-11,הדרום,2600,אילת,יישוב,1429,649,780,99,1330,668,1408,115,4.61%
2010-11,הדרום,70,אשדוד,יישוב,7282,2804,4478,817,6465,4455,7224,454,7.22%
2010-11,הדרום,7100,אשקלון,יישוב,4488,1718,2770,673,3815,2836,4383,269,7.55%
2010-11,הדרום,9000,באר שבע,יישוב,7621,3282,4339,1006,6615,5136,7559,604,8.04%
2010-11,הדרום,2200,דימונה,יישוב,2141,936,1205,125,2016,1506,2097,163,11.97%
2010-11,הדרום,1303,חורה,יישוב,725,321,404,1,724,668,725,12,23.82%
2010-11,הדרום,831,ירוחם,יישוב,487,236,251,28,459,287,476,84,11.41%
2010-11,הדרום,1059,כסיפה,יישוב,967,416,551,2,965,889,964,29,25.96%
2010-11,הדרום,1271,להבים,יישוב,34,19,15,19,15,4,34,1,1.12%
2010-11,הדרום,1060,לקיה,יישוב,914,414,500,3,911,849,912,12,28.46%
2010-11,הדרום,1268,מיתר,יישוב,57,20,37,20,37,6,57,5,1.55%
2010-11,הדרום,99,מצפה רמון,יישוב,288,99,189,22,266,132,257,30,11.39%
2010-11,הדרום,246,נתיבות,יישוב,1028,399,629,64,964,562,1022,131,8.75%
2010-11,הדרום,666,עומר,יישוב,60,21,39,31,29,10,60,5,1.62%
2010-11,הדרום,2560,ערד,יישוב,906,368,538,176,730,582,883,113,7.20%
2010-11,הדרום,1192,ערערה-בנגב,יישוב,968,383,585,2,966,898,968,7,30.26%
2010-11,הדרום,2630,קריית גת,יישוב,2408,940,1468,207,2201,1595,2400,144,9.64%
2010-11,הדרום,1034,קריית מלאכי,יישוב,1326,600,726,50,1276,872,1303,134,12.05%
2010-11,הדרום,1161,רהט,יישוב,2850,1104,1746,5,2845,2559,2849,120,20.46%
2010-11,הדרום,1286,שגב-שלום,יישוב,541,215,326,2,539,489,540,9,26.21%
2010-11,הדרום,1031,שדרות,יישוב,1100,437,663,71,1029,652,1097,72,9.91%
2010-11,הדרום,1054,תל שבע,יישוב,1171,560,611,2,1169,1081,1169,22,30.40%
2010-11,המרכז,182,אבן יהודה,יישוב,139,64,75,49,90,16,138,14,2.33%
2010-11,המרכז,41,אליכין,יישוב,65,27,38,13,52,19,65,4,4.10%
2010-11,המרכז,1309,אלעד,יישוב,409,187,222,23,386,127,405,14,3.84%
2010-11,המרכז,2530,באר יעקב,יישוב,254,105,149,36,218,83,250,25,3.58%
2010-11,המרכז,466,בית דגן,יישוב,111,58,53,24,87,34,110,11,3.37%
2010-11,המרכז,1066,"בני עי""ש",יישוב,190,90,100,28,162,87,188,8,4.88%
2010-11,המרכז,681,גבעת שמואל,יישוב,277,124,153,117,160,51,273,14,2.62%
2010-11,המרכז,2550,גדרה,יישוב,317,136,181,53,264,101,315,13,3.16%
2010-11,המרכז,627,ג'לג'וליה,יישוב,60,31,29,3,57,28,60,4,2.13%
2010-11,המרכז,166,גן יבנה,יישוב,326,129,197,33,293,101,325,17,3.38%
2010-11,המרכז,229,גני תקווה,יישוב,191,91,100,47,144,32,190,5,2.73%
2010-11,המרכז,9700,הוד השרון,יישוב,558,237,321,179,379,66,553,44,2.22%
2010-11,המרכז,1290,זמר,יישוב,164,57,107,5,159,133,164,8,6.77%
2010-11,המרכז,2730,טייבה,יישוב,2052,860,1192,2,2050,1769,2043,42,13.96%
2010-11,המרכז,2720,טירה,יישוב,319,144,175,6,313,200,315,25,3.54%
2010-11,המרכז,2660,יבנה,יישוב,1016,434,582,83,933,441,1013,89,5.64%
2010-11,המרכז,9400,יהוד,יישוב,591,236,355,103,488,88,562,42,3.83%
2010-11,המרכז,1224,כוכב יאיר,יישוב,84,32,52,47,37,5,84,6,1.61%
2010-11,המרכז,633,כפר ברא,יישוב,20,8,12,0,20,8,20,1,1.97%
2010-11,המרכז,168,כפר יונה,יישוב,340,134,206,55,285,95,333,26,3.55%
2010-11,המרכז,6900,כפר סבא,יישוב,1152,473,679,346,806,211,1145,105,2.50%
2010-11,המרכז,634,כפר קאסם,יישוב,194,96,98,2,192,120,194,17,2.99%
2010-11,המרכז,7000,לוד,יישוב,2174,950,1224,192,1982,1296,2160,178,6.61%
2010-11,המרכז,1200,מודיעין-מכבים-רעות*,יישוב,915,375,540,344,571,74,900,76,2.46%
2010-11,המרכז,28,מזכרת בתיה,יישוב,152,50,102,37,115,40,151,3,2.75%
2010-11,המרכז,7200,נס ציונה,יישוב,625,270,355,131,494,205,620,42,3.13%
2010-11,המרכז,7400,נתניה,יישוב,4727,2115,2612,681,4046,2057,4665,500,4.99%
2010-11,המרכז,587,סביון*,יישוב,16,8,8,9,7,1,16,0,0.99%
2010-11,המרכז,171,פרדסייה,יישוב,82,41,41,30,52,8,82,3,2.43%
2010-11,המרכז,7900,פתח תקווה,יישוב,4067,1722,2345,814,3253,1251,4031,312,3.73%
2010-11,המרכז,195,קדימה-צורן,יישוב,235,100,135,64,171,37,234,25,2.73%
2010-11,המרכז,638,קלנסווה,יישוב,890,344,546,0,890,763,886,10,12.51%
2010-11,המרכז,469,קריית עקרון,יישוב,277,125,152,11,266,116,273,15,5.12%
2010-11,המרכז,2640,ראש העין,יישוב,744,359,385,96,648,182,733,79,3.66%
2010-11,המרכז,8300,ראשון לציון,יישוב,4483,1915,2568,918,3565,1759,4460,318,3.55%
2010-11,המרכז,8400,רחובות,יישוב,2608,1075,1533,539,2069,1039,2575,134,4.53%
2010-11,המרכז,8500,רמלה,יישוב,1727,785,942,85,1642,843,1701,163,5.35%
2010-11,המרכז,8700,רעננה,יישוב,663,299,364,280,383,75,662,30,1.91%
2010-11,המרכז,1304,שוהם,יישוב,186,77,109,76,110,4,186,24,1.94%
2010-11,המרכז,154,תל מונד,יישוב,130,59,71,47,83,23,130,5,2.44%
2010-11,הצפון,473,אבו סנאן,יישוב,721,274,447,4,717,603,717,13,14.99%
2010-11,הצפון,478,אכסאל,יישוב,539,208,331,6,533,491,539,10,11.87%
2010-11,הצפון,529,אעבלין,יישוב,638,247,391,9,629,547,638,9,13.66%
2010-11,הצפון,482,בועיינה-נוג'ידאת,יישוב,480,202,278,7,473,413,476,5,15.18%
2010-11,הצפון,4001,בוקעאתא,יישוב,377,154,223,5,372,325,367,13,15.83%
2010-11,הצפון,998,ביר אל-מכסור,יישוב,430,156,274,2,428,349,430,3,14.37%
2010-11,הצפון,480,בית ג'ן,יישוב,316,90,226,1,315,242,313,5,7.66%
2010-11,הצפון,9200,בית שאן,יישוב,827,361,466,20,807,454,827,102,8.93%
2010-11,הצפון,944,בסמת טבעון,יישוב,265,101,164,2,263,208,265,6,9.92%
2010-11,הצפון,483,בענה,יישוב,472,187,285,4,468,410,472,11,16.77%
2010-11,הצפון,1292,ג'דיידה-מכר,יישוב,1453,594,859,6,1447,1271,1453,25,18.96%
2010-11,הצפון,485,ג'ולס,יישוב,239,60,179,3,236,138,239,8,10.03%
2010-11,הצפון,487,ג'ש (גוש חלב),יישוב,55,23,32,4,51,33,55,2,3.87%
2010-11,הצפון,489,דבורייה,יישוב,415,195,220,27,388,314,414,5,11.53%
2010-11,הצפון,490,דייר אל-אסד,יישוב,432,174,258,8,424,354,432,12,10.49%
2010-11,הצפון,492,דייר חנא,יישוב,639,275,364,13,626,531,639,15,16.39%
2010-11,הצפון,975,זרזיר,יישוב,297,120,177,2,295,223,292,15,12.10%
2010-11,הצפון,496,חורפיש,יישוב,149,59,90,4,145,103,149,8,7.16%
2010-11,הצפון,2034,חצור הגלילית,יישוב,316,131,185,16,300,149,308,36,7.07%
2010-11,הצפון,6700,טבריה,יישוב,1925,810,1115,122,1803,1209,1825,152,9.07%
2010-11,הצפון,962,טובא-זנגרייה,יישוב,344,151,193,6,338,255,341,10,12.97%
2010-11,הצפון,498,טורעאן,יישוב,529,198,331,10,519,461,527,14,11.60%
2010-11,הצפון,8900,טמרה,יישוב,2007,812,1195,24,1983,1797,2005,26,17.29%
2010-11,הצפון,1295,יאנוח-ג'ת,יישוב,165,54,111,3,162,115,165,4,7.80%
2010-11,הצפון,46,יבנאל,יישוב,122,66,56,7,115,92,115,4,8.77%
2010-11,הצפון,499,יפיע,יישוב,609,259,350,7,602,491,607,26,9.47%
2010-11,הצפון,240,יקנעם עילית,יישוב,511,195,316,84,427,208,508,62,5.00%
2010-11,הצפון,502,ירכא,יישוב,491,190,301,1,490,385,491,13,10.91%
2010-11,הצפון,504,כאבול,יישוב,725,309,416,11,714,632,723,15,17.61%
2010-11,הצפון,505,כאוכב אבו אל-היג'א,יישוב,201,80,121,8,193,176,201,4,14.37%
2010-11,הצפון,1296,כסרא-סמיע,יישוב,202,79,123,1,201,157,202,5,7.68%
2010-11,הצפון,978,כעביה-טבאש-חג'אג'רה,יישוב,194,80,114,3,191,147,192,1,10.40%
2010-11,הצפון,1263,כפר ורדים,יישוב,72,25,47,27,45,10,72,7,2.48%
2010-11,הצפון,507,כפר יאסיף,יישוב,492,211,281,6,486,392,491,19,11.54%
2010-11,הצפון,508,כפר כמא,יישוב,73,33,40,3,70,41,72,2,5.41%
2010-11,הצפון,509,כפר כנא,יישוב,1143,446,697,24,1119,1002,1133,35,15.75%
2010-11,הצפון,510,כפר מנדא,יישוב,874,374,500,5,869,722,865,27,14.75%
2010-11,הצפון,47,כפר תבור,יישוב,46,16,30,17,29,6,46,2,2.76%
2010-11,הצפון,1139,כרמיאל,יישוב,1767,650,1117,365,1402,975,1712,118,6.96%
2010-11,הצפון,481,מגאר,יישוב,1361,510,851,28,1333,1234,1358,27,18.63%
2010-11,הצפון,516,מג'ד אל-כרום,יישוב,645,268,377,8,637,524,644,17,12.26%
2010-11,הצפון,874,מגדל העמק,יישוב,988,413,575,71,917,506,952,162,7.65%
2010-11,הצפון,4201,מג'דל שמס,יישוב,475,178,297,23,452,411,470,17,12.04%
2010-11,הצפון,517,מזרעה,יישוב,166,60,106,5,161,137,164,1,10.33%
2010-11,הצפון,4203,מסעדה,יישוב,197,77,120,6,191,168,196,6,13.53%
2010-11,הצפון,518,מעיליא,יישוב,65,28,37,7,58,34,65,5,4.68%
2010-11,הצפון,1063,מעלות-תרשיחא,יישוב,931,399,532,125,806,567,928,51,8.24%
2010-11,הצפון,520,משהד,יישוב,305,113,192,3,302,269,302,5,11.71%
2010-11,הצפון,9100,נהרייה,יישוב,2089,906,1183,254,1835,1322,2075,138,7.47%
2010-11,הצפון,522,נחף,יישוב,472,195,277,15,457,388,471,11,11.60%
2010-11,הצפון,7300,נצרת,יישוב,2812,1187,1625,76,2736,2150,2796,85,9.72%
2010-11,הצפון,1061,נצרת עילית,יישוב,1815,748,1067,229,1586,1128,1723,255,7.65%
2010-11,הצפון,525,סאג'ור,יישוב,105,36,69,2,103,82,104,1,7.48%
2010-11,הצפון,7500,סח'נין,יישוב,1983,877,1106,40,1943,1746,1983,38,17.35%
2010-11,הצפון,4501,ע'ג'ר,יישוב,87,36,51,1,86,73,87,3,10.41%
2010-11,הצפון,530,עיילבון,יישוב,196,79,117,3,193,157,195,8,9.17%
2010-11,הצפון,511,עילוט,יישוב,322,122,200,2,320,261,322,13,13.96%
2010-11,הצפון,532,עין מאהל,יישוב,575,247,328,8,567,515,569,16,13.50%
2010-11,הצפון,7600,עכו,יישוב,3283,1451,1832,141,3142,2577,3264,152,13.51%
2010-11,הצפון,7700,עפולה,יישוב,1899,771,1128,203,1696,1049,1831,190,8.39%
2010-11,הצפון,531,עראבה,יישוב,1341,554,787,29,1312,1188,1340,27,16.64%
2010-11,הצפון,535,פסוטה,יישוב,131,58,73,9,122,93,131,5,8.81%
2010-11,הצפון,536,פקיעין (בוקייעה),יישוב,131,64,67,5,126,93,130,8,5.60%
2010-11,הצפון,8000,צפת,יישוב,983,486,497,85,898,696,975,32,8.63%
2010-11,הצפון,4100,קצרין,יישוב,192,85,107,43,149,103,189,10,5.12%
2010-11,הצפון,2800,קריית שמונה,יישוב,758,365,393,57,701,308,739,104,6.06%
2010-11,הצפון,543,ראמה,יישוב,304,125,179,10,294,249,302,15,9.46%
2010-11,הצפון,26,ראש פינה,יישוב,42,13,29,8,34,19,42,4,3.08%
2010-11,הצפון,542,ריינה,יישוב,608,241,367,8,600,508,604,25,10.94%
2010-11,הצפון,122,רמת ישי,יישוב,96,41,55,25,71,10,95,9,2.61%
2010-11,הצפון,913,שבלי - אום אל-גנם,יישוב,255,110,145,5,250,200,252,3,11.73%
2010-11,הצפון,812,שלומי,יישוב,267,109,158,20,247,160,263,16,8.04%
2010-11,הצפון,538,שעב,יישוב,489,207,282,3,486,416,488,8,19.35%
2010-11,הצפון,8800,שפרעם,יישוב,2013,747,1266,32,1981,1697,2007,50,13.66%
2010-11,חיפה,2710,אום אל-פחם,יישוב,3413,1398,2015,9,3404,2989,3409,72,20.29%
2010-11,חיפה,1020,אור עקיבא,יישוב,620,259,361,44,576,249,605,85,6.67%
2010-11,חיפה,6000,באקה אל-גרביה,יישוב,551,289,262,10,541,365,550,27,NULL
2010-11,חיפה,9800,בנימינה-גבעת עדה*,יישוב,196,87,109,70,126,49,195,28,3.19%
2010-11,חיפה,1326,"בסמ""ה",יישוב,382,175,207,4,378,301,382,10,12.06%
2010-11,חיפה,541,ג'סר א-זרקא,יישוב,362,208,154,0,362,253,359,20,7.21%
2010-11,חיפה,628,ג'ת,יישוב,168,73,95,7,161,116,168,4,NULL
2010-11,חיפה,494,דאלית אל-כרמל,יישוב,493,200,293,12,481,297,491,22,7.27%
2010-11,חיפה,9300,זכרון יעקב,יישוב,228,91,137,82,146,44,225,19,2.50%
2010-11,חיפה,6500,חדרה,יישוב,2414,955,1459,287,2127,1001,2370,265,5.39%
2010-11,חיפה,4000,חיפה,יישוב,8390,3592,4798,1598,6792,5577,8337,588,6.37%
2010-11,חיפה,1247,חריש-קציר,יישוב,25,9,16,1,24,11,25,2,1.53%
2010-11,חיפה,2100,טירת כרמל,יישוב,789,345,444,36,753,517,780,61,8.16%
2010-11,חיפה,654,כפר קרע,יישוב,359,154,205,11,348,210,357,26,5.24%
2010-11,חיפה,1327,מעלה עירון,יישוב,828,317,511,5,823,700,826,12,17.55%
2010-11,חיפה,2500,נשר,יישוב,563,253,310,105,458,305,560,58,4.61%
2010-11,חיפה,534,עספיא,יישוב,327,147,180,7,320,204,327,12,6.90%
2010-11,חיפה,637,ערערה,יישוב,525,207,318,9,516,350,525,31,7.95%
2010-11,חיפה,537,פוריידיס,יישוב,379,183,196,2,377,255,376,13,8.02%
2010-11,חיפה,7800,פרדס חנה-כרכור,יישוב,834,339,495,131,703,276,820,99,4.89%
2010-11,חיפה,6800,קריית אתא,יישוב,1958,765,1193,169,1789,1259,1945,119,7.28%
2010-11,חיפה,9500,קריית ביאליק,יישוב,1247,488,759,172,1075,693,1244,83,6.25%
2010-11,חיפה,2300,קריית טבעון,יישוב,180,69,111,61,119,48,180,14,2.39%
2010-11,חיפה,9600,קריית ים,יישוב,1794,754,1040,167,1627,1204,1786,95,8.95%
2010-11,חיפה,8200,קריית מוצקין,יישוב,1189,427,762,169,1020,657,1175,93,5.67%
2010-11,חיפה,922,רכסים,יישוב,154,69,85,8,146,101,153,7,5.66%
2010-11,ירושלים,472,אבו גוש,יישוב,266,114,152,8,258,195,266,7,10.97%
2010-11,ירושלים,2610,בית שמש,יישוב,1184,470,714,106,1078,599,1162,109,4.72%
2010-11,ירושלים,3000,ירושלים,יישוב,10182,4308,5874,1253,8929,5980,10104,729,4.07%
2010-11,ירושלים,1015,מבשרת ציון,יישוב,337,156,181,71,266,132,332,19,2.85%
2010-11,ירושלים,1137,קריית יערים,יישוב,40,16,24,8,32,15,40,3,3.96%
2010-11,תל אביב,2400,אור יהודה,יישוב,865,367,498,40,825,317,852,78,4.89%
2010-11,תל אביב,565,אזור,יישוב,178,82,96,24,154,44,176,23,2.99%
2010-11,תל אביב,6100,בני ברק,יישוב,2236,1045,1191,126,2110,1353,2225,132,4.83%
2010-11,תל אביב,6200,בת ים,יישוב,3553,1560,1993,530,3023,1609,3480,308,4.99%
2010-11,תל אביב,6300,גבעתיים,יישוב,695,304,391,291,404,130,689,54,2.53%
2010-11,תל אביב,6400,הרצלייה,יישוב,1100,466,634,326,774,152,1078,177,2.38%
2010-11,תל אביב,6600,חולון,יישוב,3130,1428,1702,518,2612,1078,3062,306,3.32%
2010-11,תל אביב,2620,קריית אונו,יישוב,448,184,264,178,270,58,442,36,2.73%
2010-11,תל אביב,8600,רמת גן,יישוב,2123,911,1212,628,1495,572,2107,142,2.96%
2010-11,תל אביב,2650,רמת השרון,יישוב,431,193,238,176,255,38,426,58,2.09%
2010-11,תל אביב,5000,תל אביב -יפו,יישוב,7956,3855,4101,2212,5744,2927,7881,568,3.42%
2010-12,אזור יהודה והשומרון,3760,אורנית,יישוב,88,34,54,35,53,3,87,9,2.33%
2010-12,אזור יהודה והשומרון,3750,אלפי מנשה,יישוב,86,41,45,25,61,2,85,10,2.11%
2010-12,אזור יהודה והשומרון,3560,אלקנה,יישוב,32,13,19,16,16,2,32,1,1.88%
2010-12,אזור יהודה והשומרון,3650,אפרתה,יישוב,55,29,26,27,28,9,55,2,1.56%
2010-12,אזור יהודה והשומרון,3570,אריאל,יישוב,365,168,197,89,276,124,364,34,3.68%
2010-12,אזור יהודה והשומרון,3574,בית אל,יישוב,49,20,29,15,34,15,48,9,2.26%
2010-12,אזור יהודה והשומרון,3652,בית אריה,יישוב,56,21,35,9,47,7,56,5,2.65%
2010-12,אזור יהודה והשומרון,3780,ביתר עילית,יישוב,401,180,221,17,384,198,396,30,4.73%
2010-12,אזור יהודה והשומרון,3730,גבעת זאב,יישוב,162,75,87,17,145,43,162,13,2.70%
2010-12,אזור יהודה והשומרון,3769,הר אדר,יישוב,22,13,9,10,12,2,22,0,1.29%
2010-12,אזור יהודה והשומרון,3797,מודיעין עילית,יישוב,305,115,190,18,287,85,301,18,2.91%
2010-12,אזור יהודה והשומרון,3616,מעלה אדומים,יישוב,678,282,396,99,579,237,665,73,3.76%
2010-12,אזור יהודה והשומרון,3660,עמנואל,יישוב,87,46,41,4,83,58,86,8,9.15%
2010-12,אזור יהודה והשומרון,3557,קדומים,יישוב,22,16,6,7,15,7,22,0,1.38%
2010-12,אזור יהודה והשומרון,3611,קריית ארבע,יישוב,106,50,56,18,88,64,106,12,3.83%
2010-12,אזור יהודה והשומרון,3640,קרני שומרון,יישוב,79,42,37,23,56,28,79,8,2.43%
2010-12,הדרום,31,אופקים,יישוב,1377,569,808,94,1283,1015,1362,56,12.14%
2010-12,הדרום,2600,אילת,יישוב,1409,644,765,94,1315,658,1393,90,4.56%
2010-12,הדרום,70,אשדוד,יישוב,6986,2716,4270,793,6193,4341,6922,445,6.94%
2010-12,הדרום,7100,אשקלון,יישוב,4311,1651,2660,657,3654,2799,4208,264,7.27%
2010-12,הדרום,9000,באר שבע,יישוב,7452,3203,4249,984,6468,5067,7394,593,7.87%
2010-12,הדרום,2200,דימונה,יישוב,2005,886,1119,111,1894,1447,1976,119,11.36%
2010-12,הדרום,1303,חורה,יישוב,724,319,405,1,723,669,724,17,23.79%
2010-12,הדרום,831,ירוחם,יישוב,429,219,210,22,407,265,424,50,10.30%
2010-12,הדרום,1059,כסיפה,יישוב,970,417,553,2,968,895,967,23,26.02%
2010-12,הדרום,1271,להבים,יישוב,31,16,15,19,12,4,31,3,1.02%
2010-12,הדרום,1060,לקיה,יישוב,916,416,500,3,913,857,914,17,28.51%
2010-12,הדרום,1268,מיתר,יישוב,60,23,37,24,36,5,60,9,1.63%
2010-12,הדרום,99,מצפה רמון,יישוב,258,95,163,21,237,136,242,32,10.80%
2010-12,הדרום,246,נתיבות,יישוב,959,369,590,61,898,549,952,94,8.20%
2010-12,הדרום,666,עומר,יישוב,63,23,40,33,30,9,63,6,1.70%
2010-12,הדרום,2560,ערד,יישוב,899,375,524,168,731,567,872,87,7.12%
2010-12,הדרום,1192,ערערה-בנגב,יישוב,978,387,591,3,975,909,978,14,30.48%
2010-12,הדרום,2630,קריית גת,יישוב,2298,908,1390,201,2097,1565,2292,165,9.25%
2010-12,הדרום,1034,קריית מלאכי,יישוב,1281,565,716,45,1236,859,1260,132,11.70%
2010-12,הדרום,1161,רהט,יישוב,2891,1142,1749,4,2887,2624,2889,63,20.69%
2010-12,הדרום,1286,שגב-שלום,יישוב,553,223,330,2,551,504,551,10,26.61%
2010-12,הדרום,1031,שדרות,יישוב,1027,409,618,58,969,633,1024,74,9.32%
2010-12,הדרום,1054,תל שבע,יישוב,1155,549,606,2,1153,1082,1153,18,30.11%
2010-12,המרכז,182,אבן יהודה,יישוב,130,66,64,50,80,14,129,7,2.18%
2010-12,המרכז,41,אליכין,יישוב,62,26,36,10,52,18,60,6,3.80%
2010-12,המרכז,1309,אלעד,יישוב,386,182,204,24,362,117,381,15,3.62%
2010-12,המרכז,2530,באר יעקב,יישוב,260,109,151,41,219,79,256,20,3.67%
2010-12,המרכז,466,בית דגן,יישוב,100,46,54,19,81,33,99,10,3.04%
2010-12,המרכז,1066,"בני עי""ש",יישוב,181,84,97,29,152,89,178,8,4.63%
2010-12,המרכז,681,גבעת שמואל,יישוב,269,128,141,114,155,57,269,19,2.59%
2010-12,המרכז,2550,גדרה,יישוב,317,143,174,55,262,106,316,15,3.17%
2010-12,המרכז,627,ג'לג'וליה,יישוב,63,30,33,2,61,29,63,1,2.24%
2010-12,המרכז,166,גן יבנה,יישוב,305,120,185,36,269,99,304,24,3.17%
2010-12,המרכז,229,גני תקווה,יישוב,184,78,106,51,133,28,183,11,2.63%
2010-12,המרכז,9700,הוד השרון,יישוב,544,230,314,176,368,62,542,50,2.18%
2010-12,המרכז,1290,זמר,יישוב,163,54,109,5,158,133,163,7,6.74%
2010-12,המרכז,2730,טייבה,יישוב,2075,871,1204,3,2072,1800,2065,46,14.09%
2010-12,המרכז,2720,טירה,יישוב,311,143,168,6,305,197,310,17,3.48%
2010-12,המרכז,2660,יבנה,יישוב,949,417,532,88,861,441,947,85,5.29%
2010-12,המרכז,9400,יהוד,יישוב,535,210,325,94,441,85,512,31,3.50%
2010-12,המרכז,1224,כוכב יאיר,יישוב,88,36,52,48,40,5,88,4,1.68%
2010-12,המרכז,633,כפר ברא,יישוב,30,15,15,0,30,10,30,1,2.93%
2010-12,המרכז,168,כפר יונה,יישוב,331,140,191,48,283,92,327,33,3.49%
2010-12,המרכז,6900,כפר סבא,יישוב,1087,461,626,335,752,215,1081,87,2.37%
2010-12,המרכז,634,כפר קאסם,יישוב,207,104,103,0,207,120,205,8,3.15%
2010-12,המרכז,7000,לוד,יישוב,2143,945,1198,193,1950,1279,2132,160,6.53%
2010-12,המרכז,1200,מודיעין-מכבים-רעות*,יישוב,872,364,508,336,536,73,861,90,2.36%
2010-12,המרכז,28,מזכרת בתיה,יישוב,148,54,94,35,113,39,148,2,2.69%
2010-12,המרכז,7200,נס ציונה,יישוב,598,257,341,123,475,193,592,18,3.00%
2010-12,המרכז,7400,נתניה,יישוב,4500,2047,2453,636,3864,2019,4439,421,4.76%
2010-12,המרכז,587,סביון*,יישוב,16,9,7,10,6,1,16,0,0.99%
2010-12,המרכז,171,פרדסייה,יישוב,82,39,43,31,51,10,82,6,2.43%
2010-12,המרכז,7900,פתח תקווה,יישוב,3850,1681,2169,784,3066,1189,3820,306,3.54%
2010-12,המרכז,195,קדימה-צורן,יישוב,240,108,132,70,170,42,238,21,2.78%
2010-12,המרכז,638,קלנסווה,יישוב,871,337,534,0,871,753,867,19,12.28%
2010-12,המרכז,469,קריית עקרון,יישוב,268,134,134,11,257,119,264,9,4.96%
2010-12,המרכז,2640,ראש העין,יישוב,731,352,379,86,645,186,719,70,3.59%
2010-12,המרכז,8300,ראשון לציון,יישוב,4359,1854,2505,904,3455,1746,4340,346,3.46%
2010-12,המרכז,8400,רחובות,יישוב,2490,1018,1472,528,1962,1049,2454,116,4.32%
2010-12,המרכז,8500,רמלה,יישוב,1687,759,928,90,1597,854,1666,144,5.25%
2010-12,המרכז,8700,רעננה,יישוב,654,302,352,277,377,80,652,43,1.88%
2010-12,המרכז,1304,שוהם,יישוב,180,66,114,72,108,5,179,16,1.87%
2010-12,המרכז,154,תל מונד,יישוב,140,63,77,52,88,22,140,6,2.63%
2010-12,הצפון,473,אבו סנאן,יישוב,727,285,442,4,723,605,723,34,15.10%
2010-12,הצפון,478,אכסאל,יישוב,556,220,336,7,549,507,556,14,12.20%
2010-12,הצפון,529,אעבלין,יישוב,635,246,389,9,626,543,635,12,13.60%
2010-12,הצפון,482,בועיינה-נוג'ידאת,יישוב,505,213,292,6,499,417,500,4,15.82%
2010-12,הצפון,4001,בוקעאתא,יישוב,370,152,218,6,364,315,361,10,15.61%
2010-12,הצפון,998,ביר אל-מכסור,יישוב,432,156,276,2,430,348,432,6,14.43%
2010-12,הצפון,480,בית ג'ן,יישוב,308,93,215,3,305,241,305,5,7.48%
2010-12,הצפון,9200,בית שאן,יישוב,801,355,446,18,783,464,799,98,8.65%
2010-12,הצפון,944,בסמת טבעון,יישוב,269,111,158,4,265,213,269,11,10.05%
2010-12,הצפון,483,בענה,יישוב,471,189,282,3,468,415,471,11,16.74%
2010-12,הצפון,1292,ג'דיידה-מכר,יישוב,1453,602,851,7,1446,1278,1453,52,18.96%
2010-12,הצפון,485,ג'ולס,יישוב,238,61,177,3,235,141,238,30,9.99%
2010-12,הצפון,487,ג'ש (גוש חלב),יישוב,54,26,28,4,50,33,54,1,3.80%
2010-12,הצפון,489,דבורייה,יישוב,426,205,221,23,403,316,426,9,11.83%
2010-12,הצפון,490,דייר אל-אסד,יישוב,420,173,247,8,412,347,420,6,10.22%
2010-12,הצפון,492,דייר חנא,יישוב,642,276,366,10,632,535,642,25,16.46%
2010-12,הצפון,975,זרזיר,יישוב,291,118,173,3,288,214,288,11,11.96%
2010-12,הצפון,496,חורפיש,יישוב,149,60,89,4,145,98,149,5,7.16%
2010-12,הצפון,2034,חצור הגלילית,יישוב,306,135,171,15,291,146,296,29,6.81%
2010-12,הצפון,6700,טבריה,יישוב,1859,792,1067,120,1739,1211,1762,108,8.78%
2010-12,הצפון,962,טובא-זנגרייה,יישוב,351,166,185,5,346,257,345,16,13.10%
2010-12,הצפון,498,טורעאן,יישוב,540,208,332,11,529,467,538,13,11.81%
2010-12,הצפון,8900,טמרה,יישוב,2011,814,1197,23,1988,1806,2008,39,17.31%
2010-12,הצפון,1295,יאנוח-ג'ת,יישוב,163,60,103,4,159,114,163,3,7.71%
2010-12,הצפון,46,יבנאל,יישוב,129,71,58,7,122,96,122,6,9.25%
2010-12,הצפון,499,יפיע,יישוב,612,263,349,10,602,488,611,28,9.53%
2010-12,הצפון,240,יקנעם עילית,יישוב,480,177,303,81,399,218,477,66,4.71%
2010-12,הצפון,502,ירכא,יישוב,494,191,303,1,493,385,494,31,10.97%
2010-12,הצפון,504,כאבול,יישוב,720,305,415,14,706,629,718,16,17.51%
2010-12,הצפון,505,כאוכב אבו אל-היג'א,יישוב,197,78,119,6,191,174,197,8,14.12%
2010-12,הצפון,1296,כסרא-סמיע,יישוב,205,83,122,3,202,158,205,10,7.79%
2010-12,הצפון,978,כעביה-טבאש-חג'אג'רה,יישוב,202,87,115,3,199,150,200,7,10.79%
2010-12,הצפון,1263,כפר ורדים,יישוב,66,26,40,24,42,9,66,3,2.28%
2010-12,הצפון,507,כפר יאסיף,יישוב,488,209,279,5,483,395,486,19,11.44%
2010-12,הצפון,508,כפר כמא,יישוב,65,27,38,3,62,41,64,3,4.84%
2010-12,הצפון,509,כפר כנא,יישוב,1148,457,691,20,1128,1004,1139,24,15.82%
2010-12,הצפון,510,כפר מנדא,יישוב,919,399,520,5,914,754,913,38,15.44%
2010-12,הצפון,47,כפר תבור,יישוב,47,18,29,16,31,6,47,6,2.82%
2010-12,הצפון,1139,כרמיאל,יישוב,1777,667,1110,359,1418,961,1719,132,6.99%
2010-12,הצפון,481,מגאר,יישוב,1416,550,866,26,1390,1260,1411,30,19.21%
2010-12,הצפון,516,מג'ד אל-כרום,יישוב,647,265,382,7,640,529,647,19,12.31%
2010-12,הצפון,874,מגדל העמק,יישוב,932,392,540,63,869,479,904,112,7.30%
2010-12,הצפון,4201,מג'דל שמס,יישוב,467,176,291,23,444,403,463,10,11.88%
2010-12,הצפון,517,מזרעה,יישוב,165,60,105,4,161,132,163,5,10.27%
2010-12,הצפון,4203,מסעדה,יישוב,187,72,115,6,181,158,186,1,12.93%
2010-12,הצפון,518,מעיליא,יישוב,61,25,36,7,54,33,61,7,4.40%
2010-12,הצפון,1063,מעלות-תרשיחא,יישוב,902,409,493,118,784,567,898,53,7.99%
2010-12,הצפון,520,משהד,יישוב,312,113,199,3,309,277,308,8,11.92%
2010-12,הצפון,9100,נהרייה,יישוב,2041,891,1150,249,1792,1319,2025,130,7.30%
2010-12,הצפון,522,נחף,יישוב,463,191,272,12,451,380,462,15,11.40%
2010-12,הצפון,7300,נצרת,יישוב,2840,1212,1628,75,2765,2200,2822,111,9.80%
2010-12,הצפון,1061,נצרת עילית,יישוב,1738,732,1006,221,1517,1117,1656,184,7.38%
2010-12,הצפון,525,סאג'ור,יישוב,113,40,73,2,111,81,111,2,7.95%
2010-12,הצפון,7500,סח'נין,יישוב,1991,876,1115,40,1951,1746,1991,44,17.41%
2010-12,הצפון,4501,ע'ג'ר,יישוב,91,39,52,2,89,71,91,5,10.83%
2010-12,הצפון,530,עיילבון,יישוב,186,75,111,3,183,149,186,6,8.79%
2010-12,הצפון,511,עילוט,יישוב,325,129,196,3,322,267,325,11,14.07%
2010-12,הצפון,532,עין מאהל,יישוב,579,243,336,10,569,525,572,10,13.56%
2010-12,הצפון,7600,עכו,יישוב,3262,1465,1797,127,3135,2590,3246,171,13.45%
2010-12,הצפון,7700,עפולה,יישוב,1806,714,1092,207,1599,1005,1746,159,8.03%
2010-12,הצפון,531,עראבה,יישוב,1351,559,792,26,1325,1194,1350,32,16.75%
2010-12,הצפון,535,פסוטה,יישוב,126,56,70,9,117,96,126,3,8.50%
2010-12,הצפון,536,פקיעין (בוקייעה),יישוב,128,60,68,5,123,90,127,6,5.48%
2010-12,הצפון,8000,צפת,יישוב,971,492,479,80,891,693,964,35,8.54%
2010-12,הצפון,4100,קצרין,יישוב,202,87,115,45,157,109,198,15,5.35%
2010-12,הצפון,2800,קריית שמונה,יישוב,734,335,399,57,677,300,718,78,5.90%
2010-12,הצפון,543,ראמה,יישוב,305,120,185,7,298,252,303,6,9.49%
2010-12,הצפון,26,ראש פינה,יישוב,44,14,30,8,36,19,44,1,3.22%
2010-12,הצפון,542,ריינה,יישוב,620,247,373,9,611,513,616,25,11.14%
2010-12,הצפון,122,רמת ישי,יישוב,90,37,53,19,71,10,89,9,2.45%
2010-12,הצפון,913,שבלי - אום אל-גנם,יישוב,263,111,152,4,259,200,262,5,12.14%
2010-12,הצפון,812,שלומי,יישוב,285,124,161,22,263,167,282,18,8.57%
2010-12,הצפון,538,שעב,יישוב,496,212,284,2,494,422,495,22,19.57%
2010-12,הצפון,8800,שפרעם,יישוב,2016,776,1240,30,1986,1700,2009,48,13.67%
2010-12,חיפה,2710,אום אל-פחם,יישוב,3480,1437,2043,10,3470,3041,3476,52,20.60%
2010-12,חיפה,1020,אור עקיבא,יישוב,599,260,339,39,560,253,583,74,6.44%
2010-12,חיפה,6000,באקה אל-גרביה,יישוב,595,311,284,11,584,379,595,21,NULL
2010-12,חיפה,9800,בנימינה-גבעת עדה*,יישוב,197,86,111,70,127,46,197,21,3.23%
2010-12,חיפה,1326,"בסמ""ה",יישוב,379,173,206,4,375,302,379,17,11.97%
2010-12,חיפה,541,ג'סר א-זרקא,יישוב,368,217,151,0,368,256,365,10,7.32%
2010-12,חיפה,628,ג'ת,יישוב,185,88,97,8,177,120,184,7,NULL
2010-12,חיפה,494,דאלית אל-כרמל,יישוב,504,210,294,10,494,306,502,17,7.42%
2010-12,חיפה,9300,זכרון יעקב,יישוב,226,84,142,79,147,47,223,21,2.48%
2010-12,חיפה,6500,חדרה,יישוב,2317,923,1394,279,2038,982,2274,212,5.19%
2010-12,חיפה,4000,חיפה,יישוב,8143,3478,4665,1540,6603,5445,8091,583,6.19%
2010-12,חיפה,1247,חריש-קציר,יישוב,33,12,21,4,29,12,33,2,2.01%
2010-12,חיפה,2100,טירת כרמל,יישוב,756,333,423,37,719,505,748,62,7.85%
2010-12,חיפה,654,כפר קרע,יישוב,366,162,204,12,354,221,364,21,5.34%
2010-12,חיפה,1327,מעלה עירון,יישוב,829,314,515,5,824,712,827,14,17.57%
2010-12,חיפה,2500,נשר,יישוב,547,240,307,106,441,306,545,45,4.49%
2010-12,חיפה,534,עספיא,יישוב,320,141,179,4,316,197,320,14,6.76%
2010-12,חיפה,637,ערערה,יישוב,527,209,318,5,522,360,527,31,7.98%
2010-12,חיפה,537,פוריידיס,יישוב,391,189,202,2,389,256,390,9,8.30%
2010-12,חיפה,7800,פרדס חנה-כרכור,יישוב,822,331,491,127,695,278,811,97,4.84%
2010-12,חיפה,6800,קריית אתא,יישוב,1931,762,1169,170,1761,1246,1921,103,7.19%
2010-12,חיפה,9500,קריית ביאליק,יישוב,1228,478,750,174,1054,692,1221,82,6.14%
2010-12,חיפה,2300,קריית טבעון,יישוב,190,75,115,64,126,50,190,10,2.52%
2010-12,חיפה,9600,קריית ים,יישוב,1724,731,993,164,1560,1191,1718,116,8.64%
2010-12,חיפה,8200,קריית מוצקין,יישוב,1169,437,732,156,1013,641,1154,82,5.57%
2010-12,חיפה,922,רכסים,יישוב,148,66,82,7,141,102,148,8,5.49%
2010-12,ירושלים,472,אבו גוש,יישוב,264,123,141,7,257,188,264,9,10.90%
2010-12,ירושלים,2610,בית שמש,יישוב,1124,464,660,91,1033,590,1108,118,4.51%
2010-12,ירושלים,3000,ירושלים,יישוב,9941,4287,5654,1214,8727,6016,9878,722,3.98%
2010-12,ירושלים,1015,מבשרת ציון,יישוב,333,158,175,68,265,138,329,30,2.82%
2010-12,ירושלים,1137,קריית יערים,יישוב,34,13,21,7,27,13,34,2,3.39%
2010-12,תל אביב,2400,אור יהודה,יישוב,843,346,497,38,805,329,829,94,4.77%
2010-12,תל אביב,565,אזור,יישוב,165,79,86,22,143,42,164,14,2.80%
2010-12,תל אביב,6100,בני ברק,יישוב,2203,1047,1156,112,2091,1354,2191,161,4.76%
2010-12,תל אביב,6200,בת ים,יישוב,3419,1513,1906,514,2905,1594,3350,283,4.81%
2010-12,תל אביב,6300,גבעתיים,יישוב,670,303,367,278,392,126,666,44,2.45%
2010-12,תל אביב,6400,הרצלייה,יישוב,1073,461,612,312,761,143,1058,144,2.34%
2010-12,תל אביב,6600,חולון,יישוב,2916,1305,1611,517,2399,1081,2870,342,3.12%
2010-12,תל אביב,2620,קריית אונו,יישוב,427,181,246,166,261,57,426,28,2.63%
2010-12,תל אביב,8600,רמת גן,יישוב,2018,892,1126,615,1403,552,1995,161,2.81%
2010-12,תל אביב,2650,רמת השרון,יישוב,402,177,225,171,231,35,397,41,1.95%
2010-12,תל אביב,5000,תל אביב -יפו,יישוב,7662,3729,3933,2178,5484,2859,7586,540,3.30%
2011-01,אזור יהודה והשומרון,3760,אורנית,יישוב,85,41,44,36,49,3,84,9,2.25%
2011-01,אזור יהודה והשומרון,3750,אלפי מנשה,יישוב,81,34,47,21,60,4,80,9,1.99%
2011-01,אזור יהודה והשומרון,3560,אלקנה,יישוב,35,16,19,17,18,2,35,2,2.06%
2011-01,אזור יהודה והשומרון,3650,אפרתה,יישוב,57,33,24,28,29,11,57,10,1.62%
2011-01,אזור יהודה והשומרון,3570,אריאל,יישוב,376,176,200,86,290,120,373,44,3.77%
2011-01,אזור יהודה והשומרון,3574,בית אל,יישוב,52,22,30,15,37,15,51,4,2.40%
2011-01,אזור יהודה והשומרון,3652,בית אריה,יישוב,53,18,35,5,48,6,53,4,2.51%
2011-01,אזור יהודה והשומרון,3780,ביתר עילית,יישוב,423,194,229,21,402,213,417,39,4.97%
2011-01,אזור יהודה והשומרון,3730,גבעת זאב,יישוב,168,87,81,21,147,48,167,20,2.78%
2011-01,אזור יהודה והשומרון,3769,הר אדר,יישוב,26,13,13,11,15,2,26,2,1.52%
2011-01,אזור יהודה והשומרון,3797,מודיעין עילית,יישוב,301,118,183,21,280,86,299,11,2.89%
2011-01,אזור יהודה והשומרון,3616,מעלה אדומים,יישוב,688,281,407,107,581,233,682,66,3.85%
2011-01,אזור יהודה והשומרון,3660,עמנואל,יישוב,80,39,41,5,75,57,80,3,8.57%
2011-01,אזור יהודה והשומרון,3557,קדומים,יישוב,24,15,9,10,14,6,24,2,1.50%
2011-01,אזור יהודה והשומרון,3611,קריית ארבע,יישוב,102,47,55,18,84,65,102,5,3.69%
2011-01,אזור יהודה והשומרון,3640,קרני שומרון,יישוב,75,39,36,22,53,23,74,4,2.28%
2011-01,הדרום,31,אופקים,יישוב,1374,583,791,103,1271,997,1360,51,12.12%
2011-01,הדרום,2600,אילת,יישוב,1551,699,852,106,1445,688,1536,114,5.00%
2011-01,הדרום,70,אשדוד,יישוב,7004,2739,4265,809,6195,4319,6944,456,6.96%
2011-01,הדרום,7100,אשקלון,יישוב,4284,1642,2642,649,3635,2772,4189,252,7.24%
2011-01,הדרום,9000,באר שבע,יישוב,7460,3176,4284,983,6477,5102,7397,681,7.88%
2011-01,הדרום,2200,דימונה,יישוב,2099,940,1159,113,1986,1476,2067,154,11.82%
2011-01,הדרום,1303,חורה,יישוב,735,321,414,1,734,684,735,20,24.07%
2011-01,הדרום,831,ירוחם,יישוב,424,203,221,21,403,267,418,70,10.17%
2011-01,הדרום,1059,כסיפה,יישוב,970,406,564,2,968,894,968,24,26.04%
2011-01,הדרום,1271,להבים,יישוב,44,23,21,21,23,4,43,2,1.41%
2011-01,הדרום,1060,לקיה,יישוב,925,425,500,3,922,860,922,18,28.69%
2011-01,הדרום,1268,מיתר,יישוב,62,25,37,27,35,6,62,4,1.68%
2011-01,הדרום,99,מצפה רמון,יישוב,238,89,149,18,220,130,220,50,9.91%
2011-01,הדרום,246,נתיבות,יישוב,909,396,513,58,851,530,901,63,7.79%
2011-01,הדרום,666,עומר,יישוב,67,28,39,34,33,7,67,3,1.80%
2011-01,הדרום,2560,ערד,יישוב,900,373,527,172,728,570,879,114,7.17%
2011-01,הדרום,1192,ערערה-בנגב,יישוב,998,396,602,3,995,913,998,38,30.91%
2011-01,הדרום,2630,קריית גת,יישוב,2298,909,1389,197,2101,1564,2287,136,9.23%
2011-01,הדרום,1034,קריית מלאכי,יישוב,1279,564,715,37,1242,862,1252,125,11.63%
2011-01,הדרום,1161,רהט,יישוב,2979,1193,1786,5,2974,2670,2977,144,21.19%
2011-01,הדרום,1286,שגב-שלום,יישוב,560,225,335,1,559,508,559,14,26.89%
2011-01,הדרום,1031,שדרות,יישוב,1038,424,614,58,980,634,1035,78,9.41%
2011-01,הדרום,1054,תל שבע,יישוב,1162,550,612,1,1161,1084,1161,29,30.26%
2011-01,המרכז,182,אבן יהודה,יישוב,136,70,66,44,92,15,135,15,2.28%
2011-01,המרכז,41,אליכין,יישוב,60,26,34,9,51,22,60,2,3.80%
2011-01,המרכז,1309,אלעד,יישוב,385,182,203,26,359,121,384,22,3.65%
2011-01,המרכז,2530,באר יעקב,יישוב,250,110,140,46,204,74,248,22,3.56%
2011-01,המרכז,466,בית דגן,יישוב,97,46,51,15,82,35,97,7,2.98%
2011-01,המרכז,1066,"בני עי""ש",יישוב,181,87,94,27,154,85,178,1,4.63%
2011-01,המרכז,681,גבעת שמואל,יישוב,266,129,137,115,151,57,266,17,2.56%
2011-01,המרכז,2550,גדרה,יישוב,323,148,175,58,265,108,317,5,3.18%
2011-01,המרכז,627,ג'לג'וליה,יישוב,60,28,32,3,57,29,60,4,2.13%
2011-01,המרכז,166,גן יבנה,יישוב,302,123,179,34,268,109,300,18,3.13%
2011-01,המרכז,229,גני תקווה,יישוב,180,73,107,50,130,27,180,9,2.59%
2011-01,המרכז,9700,הוד השרון,יישוב,566,242,324,189,377,60,563,48,2.26%
2011-01,המרכז,1290,זמר,יישוב,164,57,107,5,159,135,164,3,6.77%
2011-01,המרכז,2730,טייבה,יישוב,2109,890,1219,4,2105,1807,2096,67,14.28%
2011-01,המרכז,2720,טירה,יישוב,351,161,190,5,346,213,350,12,3.91%
2011-01,המרכז,2660,יבנה,יישוב,928,422,506,74,854,445,925,87,5.18%
2011-01,המרכז,9400,יהוד,יישוב,569,232,337,95,474,92,549,43,3.75%
2011-01,המרכז,1224,כוכב יאיר,יישוב,88,42,46,48,40,4,88,7,1.68%
2011-01,המרכז,633,כפר ברא,יישוב,22,9,13,0,22,9,22,1,2.17%
2011-01,המרכז,168,כפר יונה,יישוב,343,146,197,53,290,87,339,35,3.61%
2011-01,המרכז,6900,כפר סבא,יישוב,1186,526,660,340,846,223,1176,111,2.57%
2011-01,המרכז,634,כפר קאסם,יישוב,212,107,105,1,211,121,211,13,3.24%
2011-01,המרכז,7000,לוד,יישוב,2265,964,1301,199,2066,1368,2249,175,6.86%
2011-01,המרכז,1200,מודיעין-מכבים-רעות*,יישוב,915,401,514,357,558,72,906,89,2.48%
2011-01,המרכז,28,מזכרת בתיה,יישוב,156,59,97,36,120,43,156,3,2.84%
2011-01,המרכז,7200,נס ציונה,יישוב,610,262,348,133,477,196,601,13,3.04%
2011-01,המרכז,7400,נתניה,יישוב,4618,2061,2557,649,3969,2060,4561,490,4.89%
2011-01,המרכז,587,סביון*,יישוב,14,8,6,9,5,0,14,1,0.86%
2011-01,המרכז,171,פרדסייה,יישוב,79,39,40,22,57,9,79,13,2.34%
2011-01,המרכז,7900,פתח תקווה,יישוב,3921,1727,2194,783,3138,1201,3890,332,3.60%
2011-01,המרכז,195,קדימה-צורן,יישוב,234,108,126,61,173,34,234,27,2.73%
2011-01,המרכז,638,קלנסווה,יישוב,887,345,542,1,886,752,883,16,12.48%
2011-01,המרכז,469,קריית עקרון,יישוב,261,130,131,12,249,123,257,5,4.83%
2011-01,המרכז,2640,ראש העין,יישוב,756,359,397,80,676,192,745,94,3.71%
2011-01,המרכז,8300,ראשון לציון,יישוב,4410,1894,2516,904,3506,1733,4386,343,3.49%
2011-01,המרכז,8400,רחובות,יישוב,2489,1028,1461,527,1962,1050,2455,65,4.32%
2011-01,המרכז,8500,רמלה,יישוב,1815,820,995,97,1718,902,1774,197,5.57%
2011-01,המרכז,8700,רעננה,יישוב,698,327,371,282,416,84,696,53,2.01%
2011-01,המרכז,1304,שוהם,יישוב,166,64,102,65,101,6,165,19,1.73%
2011-01,המרכז,154,תל מונד,יישוב,133,61,72,41,92,25,133,10,2.50%
2011-01,הצפון,473,אבו סנאן,יישוב,740,292,448,4,736,621,736,20,15.33%
2011-01,הצפון,478,אכסאל,יישוב,563,223,340,7,556,513,563,23,12.33%
2011-01,הצפון,529,אעבלין,יישוב,638,254,384,10,628,540,638,28,13.66%
2011-01,הצפון,482,בועיינה-נוג'ידאת,יישוב,492,214,278,9,483,416,487,11,15.48%
2011-01,הצפון,4001,בוקעאתא,יישוב,375,152,223,10,365,315,367,7,15.83%
2011-01,הצפון,998,ביר אל-מכסור,יישוב,446,170,276,2,444,355,445,9,14.80%
2011-01,הצפון,480,בית ג'ן,יישוב,324,94,230,5,319,244,318,6,7.78%
2011-01,הצפון,9200,בית שאן,יישוב,781,338,443,14,767,457,780,97,8.47%
2011-01,הצפון,944,בסמת טבעון,יישוב,268,114,154,4,264,215,268,11,10.02%
2011-01,הצפון,483,בענה,יישוב,480,192,288,3,477,421,480,10,17.00%
2011-01,הצפון,1292,ג'דיידה-מכר,יישוב,1483,612,871,5,1478,1302,1482,25,19.26%
2011-01,הצפון,485,ג'ולס,יישוב,234,61,173,4,230,146,234,14,9.84%
2011-01,הצפון,487,ג'ש (גוש חלב),יישוב,60,30,30,4,56,33,60,5,4.21%
2011-01,הצפון,489,דבורייה,יישוב,453,215,238,23,430,330,452,8,12.46%
2011-01,הצפון,490,דייר אל-אסד,יישוב,427,177,250,8,419,351,427,11,10.38%
2011-01,הצפון,492,דייר חנא,יישוב,648,282,366,12,636,526,648,19,16.59%
2011-01,הצפון,975,זרזיר,יישוב,304,117,187,3,301,220,297,8,12.28%
2011-01,הצפון,496,חורפיש,יישוב,148,59,89,6,142,98,148,5,7.12%
2011-01,הצפון,2034,חצור הגלילית,יישוב,303,124,179,14,289,149,292,41,6.73%
2011-01,הצפון,6700,טבריה,יישוב,1917,835,1082,114,1803,1252,1805,114,8.98%
2011-01,הצפון,962,טובא-זנגרייה,יישוב,346,163,183,5,341,258,343,10,13.04%
2011-01,הצפון,498,טורעאן,יישוב,545,214,331,10,535,467,543,19,11.91%
2011-01,הצפון,8900,טמרה,יישוב,2023,820,1203,23,2000,1798,2019,54,17.39%
2011-01,הצפון,1295,יאנוח-ג'ת,יישוב,184,61,123,3,181,130,184,8,8.62%
2011-01,הצפון,46,יבנאל,יישוב,121,63,58,7,114,94,113,1,8.63%
2011-01,הצפון,499,יפיע,יישוב,637,268,369,10,627,513,635,25,9.86%
2011-01,הצפון,240,יקנעם עילית,יישוב,498,187,311,83,415,219,496,52,4.88%
2011-01,הצפון,502,ירכא,יישוב,507,215,292,1,506,390,507,16,11.22%
2011-01,הצפון,504,כאבול,יישוב,710,294,416,13,697,625,708,23,17.31%
2011-01,הצפון,505,כאוכב אבו אל-היג'א,יישוב,211,86,125,6,205,181,211,7,14.98%
2011-01,הצפון,1296,כסרא-סמיע,יישוב,245,95,150,2,243,196,244,11,9.14%
2011-01,הצפון,978,כעביה-טבאש-חג'אג'רה,יישוב,199,81,118,4,195,147,198,3,10.69%
2011-01,הצפון,1263,כפר ורדים,יישוב,68,29,39,26,42,11,68,4,2.34%
2011-01,הצפון,507,כפר יאסיף,יישוב,508,213,295,5,503,403,507,16,11.87%
2011-01,הצפון,508,כפר כמא,יישוב,73,24,49,5,68,42,71,4,5.34%
2011-01,הצפון,509,כפר כנא,יישוב,1144,456,688,18,1126,998,1137,29,15.80%
2011-01,הצפון,510,כפר מנדא,יישוב,932,408,524,9,923,762,923,46,15.58%
2011-01,הצפון,47,כפר תבור,יישוב,47,17,30,16,31,5,47,4,2.82%
2011-01,הצפון,1139,כרמיאל,יישוב,1824,703,1121,364,1460,987,1764,132,7.16%
2011-01,הצפון,481,מגאר,יישוב,1442,562,880,24,1418,1284,1438,47,19.51%
2011-01,הצפון,516,מג'ד אל-כרום,יישוב,661,276,385,10,651,528,660,22,12.53%
2011-01,הצפון,874,מגדל העמק,יישוב,976,422,554,78,898,480,937,118,7.54%
2011-01,הצפון,4201,מג'דל שמס,יישוב,477,179,298,23,454,405,472,17,12.08%
2011-01,הצפון,517,מזרעה,יישוב,170,62,108,4,166,133,169,5,10.61%
2011-01,הצפון,4203,מסעדה,יישוב,197,77,120,6,191,163,196,2,13.53%
2011-01,הצפון,518,מעיליא,יישוב,58,25,33,7,51,30,58,1,4.19%
2011-01,הצפון,1063,מעלות-תרשיחא,יישוב,1003,448,555,124,879,628,999,63,8.81%
2011-01,הצפון,520,משהד,יישוב,316,115,201,3,313,277,311,10,12.02%
2011-01,הצפון,9100,נהרייה,יישוב,2066,914,1152,244,1822,1322,2053,121,7.40%
2011-01,הצפון,522,נחף,יישוב,462,191,271,12,450,386,461,15,11.38%
2011-01,הצפון,7300,נצרת,יישוב,2945,1263,1682,76,2869,2284,2931,99,10.14%
2011-01,הצפון,1061,נצרת עילית,יישוב,1930,816,1114,249,1681,1164,1843,201,8.14%
2011-01,הצפון,525,סאג'ור,יישוב,118,44,74,2,116,82,115,1,8.21%
2011-01,הצפון,7500,סח'נין,יישוב,2033,909,1124,35,1998,1766,2033,51,17.71%
2011-01,הצפון,4501,ע'ג'ר,יישוב,98,41,57,3,95,70,97,4,11.47%
2011-01,הצפון,530,עיילבון,יישוב,189,77,112,4,185,145,189,3,8.92%
2011-01,הצפון,511,עילוט,יישוב,328,133,195,3,325,269,328,13,14.18%
2011-01,הצפון,532,עין מאהל,יישוב,613,269,344,14,599,544,606,33,14.25%
2011-01,הצפון,7600,עכו,יישוב,3328,1499,1829,147,3181,2611,3305,184,13.66%
2011-01,הצפון,7700,עפולה,יישוב,1834,734,1100,210,1624,983,1759,168,8.09%
2011-01,הצפון,531,עראבה,יישוב,1366,574,792,26,1340,1193,1364,30,16.89%
2011-01,הצפון,535,פסוטה,יישוב,128,52,76,7,121,99,128,3,8.63%
2011-01,הצפון,536,פקיעין (בוקייעה),יישוב,133,69,64,2,131,94,132,7,5.68%
2011-01,הצפון,8000,צפת,יישוב,989,503,486,85,904,688,982,43,8.68%
2011-01,הצפון,4100,קצרין,יישוב,207,92,115,44,163,108,204,13,5.51%
2011-01,הצפון,2800,קריית שמונה,יישוב,798,376,422,53,745,316,770,101,6.30%
2011-01,הצפון,543,ראמה,יישוב,312,123,189,8,304,246,310,7,9.69%
2011-01,הצפון,26,ראש פינה,יישוב,51,16,35,8,43,22,51,4,3.72%
2011-01,הצפון,542,ריינה,יישוב,623,246,377,9,614,508,619,26,11.19%
2011-01,הצפון,122,רמת ישי,יישוב,90,39,51,22,68,11,89,4,2.45%
2011-01,הצפון,913,שבלי - אום אל-גנם,יישוב,276,123,153,5,271,206,274,7,12.62%
2011-01,הצפון,812,שלומי,יישוב,272,120,152,20,252,164,269,23,8.20%
2011-01,הצפון,538,שעב,יישוב,491,208,283,2,489,419,490,14,19.41%
2011-01,הצפון,8800,שפרעם,יישוב,2025,793,1232,28,1997,1693,2018,95,13.72%
2011-01,חיפה,2710,אום אל-פחם,יישוב,3501,1440,2061,8,3493,3047,3497,73,20.70%
2011-01,חיפה,1020,אור עקיבא,יישוב,590,243,347,37,553,239,571,63,6.32%
2011-01,חיפה,6000,באקה אל-גרביה,יישוב,628,328,300,12,616,392,628,44,NULL
2011-01,חיפה,9800,בנימינה-גבעת עדה*,יישוב,181,77,104,61,120,47,181,13,2.97%
2011-01,חיפה,1326,"בסמ""ה",יישוב,385,174,211,3,382,308,385,14,12.14%
2011-01,חיפה,541,ג'סר א-זרקא,יישוב,379,226,153,0,379,262,377,19,7.54%
2011-01,חיפה,628,ג'ת,יישוב,186,91,95,5,181,121,185,11,NULL
2011-01,חיפה,494,דאלית אל-כרמל,יישוב,508,213,295,10,498,307,505,19,7.46%
2011-01,חיפה,9300,זכרון יעקב,יישוב,235,91,144,74,161,46,232,21,2.57%
2011-01,חיפה,6500,חדרה,יישוב,2301,937,1364,269,2032,960,2271,241,5.18%
2011-01,חיפה,4000,חיפה,יישוב,8130,3532,4598,1573,6557,5339,8072,514,6.18%
2011-01,חיפה,1247,חריש-קציר,יישוב,30,11,19,2,28,11,29,1,1.77%
2011-01,חיפה,2100,טירת כרמל,יישוב,750,336,414,40,710,498,741,48,7.79%
2011-01,חיפה,654,כפר קרע,יישוב,372,156,216,11,361,225,370,24,5.42%
2011-01,חיפה,1327,מעלה עירון,יישוב,853,339,514,5,848,719,851,14,17.98%
2011-01,חיפה,2500,נשר,יישוב,552,247,305,106,446,307,550,33,4.53%
2011-01,חיפה,534,עספיא,יישוב,346,156,190,6,340,206,344,19,7.23%
2011-01,חיפה,637,ערערה,יישוב,552,216,336,5,547,373,552,47,8.32%
2011-01,חיפה,537,פוריידיס,יישוב,388,195,193,3,385,258,387,19,8.24%
2011-01,חיפה,7800,פרדס חנה-כרכור,יישוב,862,377,485,131,731,278,851,104,5.06%
2011-01,חיפה,6800,קריית אתא,יישוב,2009,794,1215,175,1834,1261,1998,108,7.46%
2011-01,חיפה,9500,קריית ביאליק,יישוב,1233,486,747,172,1061,693,1224,92,6.15%
2011-01,חיפה,2300,קריית טבעון,יישוב,192,82,110,64,128,48,192,15,2.55%
2011-01,חיפה,9600,קריית ים,יישוב,1787,751,1036,170,1617,1210,1781,105,8.92%
2011-01,חיפה,8200,קריית מוצקין,יישוב,1191,452,739,166,1025,643,1180,93,5.69%
2011-01,חיפה,922,רכסים,יישוב,149,69,80,8,141,102,148,10,5.49%
2011-01,ירושלים,472,אבו גוש,יישוב,259,123,136,7,252,188,259,10,10.71%
2011-01,ירושלים,2610,בית שמש,יישוב,1098,475,623,87,1011,571,1090,121,4.44%
2011-01,ירושלים,3000,ירושלים,יישוב,10082,4424,5658,1227,8855,6048,10018,710,4.03%
2011-01,ירושלים,1015,מבשרת ציון,יישוב,346,164,182,67,279,143,341,37,2.92%
2011-01,ירושלים,1137,קריית יערים,יישוב,34,16,18,6,28,12,34,6,3.39%
2011-01,תל אביב,2400,אור יהודה,יישוב,840,365,475,42,798,313,825,79,4.75%
2011-01,תל אביב,565,אזור,יישוב,175,86,89,22,153,41,173,16,2.94%
2011-01,תל אביב,6100,בני ברק,יישוב,2226,1071,1155,112,2114,1344,2207,108,4.79%
2011-01,תל אביב,6200,בת ים,יישוב,3574,1555,2019,536,3038,1615,3495,309,5.01%
2011-01,תל אביב,6300,גבעתיים,יישוב,705,321,384,289,416,124,702,73,2.58%
2011-01,תל אביב,6400,הרצלייה,יישוב,1071,483,588,305,766,134,1051,151,2.32%
2011-01,תל אביב,6600,חולון,יישוב,2933,1321,1612,507,2426,1036,2884,303,3.13%
2011-01,תל אביב,2620,קריית אונו,יישוב,396,167,229,159,237,53,394,28,2.44%
2011-01,תל אביב,8600,רמת גן,יישוב,2075,949,1126,623,1452,545,2062,198,2.90%
2011-01,תל אביב,2650,רמת השרון,יישוב,438,190,248,180,258,37,434,38,2.13%
2011-01,תל אביב,5000,תל אביב -יפו,יישוב,7879,3898,3981,2234,5645,2898,7813,728,3.40%
2011-02,אזור יהודה והשומרון,3760,אורנית,יישוב,82,39,43,36,46,3,81,6,2.17%
2011-02,אזור יהודה והשומרון,3750,אלפי מנשה,יישוב,85,35,50,22,63,6,85,6,2.11%
2011-02,אזור יהודה והשומרון,3560,אלקנה,יישוב,34,15,19,20,14,2,33,2,1.94%
2011-02,אזור יהודה והשומרון,3650,אפרתה,יישוב,50,26,24,22,28,13,50,7,1.42%
2011-02,אזור יהודה והשומרון,3570,אריאל,יישוב,361,169,192,83,278,112,360,46,3.64%
2011-02,אזור יהודה והשומרון,3574,בית אל,יישוב,48,23,25,13,35,14,48,4,2.26%
2011-02,אזור יהודה והשומרון,3652,בית אריה,יישוב,56,18,38,7,49,6,55,2,2.60%
2011-02,אזור יהודה והשומרון,3780,ביתר עילית,יישוב,389,196,193,19,370,208,383,31,4.58%
2011-02,אזור יהודה והשומרון,3730,גבעת זאב,יישוב,160,84,76,18,142,47,160,16,2.67%
2011-02,אזור יהודה והשומרון,3769,הר אדר,יישוב,30,13,17,13,17,2,30,1,1.75%
2011-02,אזור יהודה והשומרון,3797,מודיעין עילית,יישוב,309,110,199,20,289,90,306,20,2.95%
2011-02,אזור יהודה והשומרון,3616,מעלה אדומים,יישוב,626,255,371,107,519,226,622,62,3.53%
2011-02,אזור יהודה והשומרון,3660,עמנואל,יישוב,76,37,39,4,72,54,76,6,8.17%
2011-02,אזור יהודה והשומרון,3557,קדומים,יישוב,22,12,10,6,16,6,22,6,1.38%
2011-02,אזור יהודה והשומרון,3611,קריית ארבע,יישוב,106,50,56,16,90,64,106,6,3.83%
2011-02,אזור יהודה והשומרון,3640,קרני שומרון,יישוב,70,35,35,20,50,23,70,6,2.16%
2011-02,הדרום,31,אופקים,יישוב,1304,557,747,101,1203,969,1292,58,11.59%
2011-02,הדרום,2600,אילת,יישוב,1490,692,798,105,1385,662,1480,97,4.83%
2011-02,הדרום,70,אשדוד,יישוב,6915,2736,4179,797,6118,4210,6863,393,6.88%
2011-02,הדרום,7100,אשקלון,יישוב,4185,1620,2565,662,3523,2742,4091,250,7.08%
2011-02,הדרום,9000,באר שבע,יישוב,7207,3084,4123,931,6276,4876,7153,562,7.64%
2011-02,הדרום,2200,דימונה,יישוב,2050,936,1114,118,1932,1464,2025,145,11.61%
2011-02,הדרום,1303,חורה,יישוב,724,313,411,1,723,669,724,12,23.79%
2011-02,הדרום,831,ירוחם,יישוב,428,206,222,24,404,271,420,68,10.21%
2011-02,הדרום,1059,כסיפה,יישוב,974,409,565,2,972,895,972,17,26.11%
2011-02,הדרום,1271,להבים,יישוב,42,22,20,22,20,3,42,6,1.37%
2011-02,הדרום,1060,לקיה,יישוב,917,417,500,3,914,857,916,17,28.55%
2011-02,הדרום,1268,מיתר,יישוב,64,24,40,27,37,6,64,5,1.74%
2011-02,הדרום,99,מצפה רמון,יישוב,238,91,147,18,220,127,221,34,9.95%
2011-02,הדרום,246,נתיבות,יישוב,978,411,567,55,923,542,966,117,8.31%
2011-02,הדרום,666,עומר,יישוב,70,29,41,40,30,7,70,4,1.88%
2011-02,הדרום,2560,ערד,יישוב,881,388,493,175,706,558,859,100,7.02%
2011-02,הדרום,1192,ערערה-בנגב,יישוב,960,394,566,2,958,873,960,13,30.08%
2011-02,הדרום,2630,קריית גת,יישוב,2258,907,1351,194,2064,1546,2248,107,9.08%
2011-02,הדרום,1034,קריית מלאכי,יישוב,1282,582,700,37,1245,844,1254,126,11.65%
2011-02,הדרום,1161,רהט,יישוב,2894,1139,1755,7,2887,2614,2893,80,20.71%
2011-02,הדרום,1286,שגב-שלום,יישוב,545,222,323,1,544,496,544,6,26.36%
2011-02,הדרום,1031,שדרות,יישוב,1038,431,607,53,985,643,1034,63,9.40%
2011-02,הדרום,1054,תל שבע,יישוב,1148,536,612,1,1147,1078,1147,15,30.00%
2011-02,המרכז,182,אבן יהודה,יישוב,132,62,70,46,86,15,131,19,2.21%
2011-02,המרכז,41,אליכין,יישוב,51,23,28,2,49,20,50,5,3.18%
2011-02,המרכז,1309,אלעד,יישוב,353,155,198,21,332,114,351,17,3.35%
2011-02,המרכז,2530,באר יעקב,יישוב,259,118,141,49,210,78,258,16,3.69%
2011-02,המרכז,466,בית דגן,יישוב,99,52,47,12,87,35,99,10,3.04%
2011-02,המרכז,1066,"בני עי""ש",יישוב,190,90,100,26,164,88,187,2,4.85%
2011-02,המרכז,681,גבעת שמואל,יישוב,269,133,136,117,152,55,266,13,2.56%
2011-02,המרכז,2550,גדרה,יישוב,340,156,184,54,286,112,337,2,3.37%
2011-02,המרכז,627,ג'לג'וליה,יישוב,60,28,32,5,55,33,60,1,2.13%
2011-02,המרכז,166,גן יבנה,יישוב,304,124,180,34,270,100,303,22,3.16%
2011-02,המרכז,229,גני תקווה,יישוב,165,68,97,46,119,25,165,13,2.38%
2011-02,המרכז,9700,הוד השרון,יישוב,538,244,294,175,363,58,534,36,2.15%
2011-02,המרכז,1290,זמר,יישוב,170,59,111,10,160,134,170,12,7.00%
2011-02,המרכז,2730,טייבה,יישוב,2065,853,1212,3,2062,1787,2052,43,14.02%
2011-02,המרכז,2720,טירה,יישוב,325,149,176,7,318,210,323,22,3.62%
2011-02,המרכז,2660,יבנה,יישוב,883,410,473,70,813,434,881,72,4.94%
2011-02,המרכז,9400,יהוד,יישוב,565,234,331,109,456,82,545,31,3.72%
2011-02,המרכז,1224,כוכב יאיר,יישוב,78,44,34,39,39,5,78,4,1.49%
2011-02,המרכז,633,כפר ברא,יישוב,34,19,15,0,34,9,34,1,3.31%
2011-02,המרכז,168,כפר יונה,יישוב,343,142,201,57,286,81,339,32,3.61%
2011-02,המרכז,6900,כפר סבא,יישוב,1123,503,620,321,802,209,1114,97,2.44%
2011-02,המרכז,634,כפר קאסם,יישוב,209,100,109,1,208,124,208,8,3.20%
2011-02,המרכז,7000,לוד,יישוב,2134,945,1189,196,1938,1255,2119,149,6.49%
2011-02,המרכז,1200,מודיעין-מכבים-רעות*,יישוב,912,399,513,369,543,74,897,85,2.45%
2011-02,המרכז,28,מזכרת בתיה,יישוב,148,63,85,34,114,39,148,1,2.69%
2011-02,המרכז,7200,נס ציונה,יישוב,616,265,351,126,490,192,609,5,3.08%
2011-02,המרכז,7400,נתניה,יישוב,4495,2083,2412,626,3869,1950,4443,439,4.77%
2011-02,המרכז,587,סביון*,יישוב,16,7,9,7,9,1,16,0,0.99%
2011-02,המרכז,171,פרדסייה,יישוב,71,31,40,16,55,8,71,4,2.11%
2011-02,המרכז,7900,פתח תקווה,יישוב,3909,1703,2206,803,3106,1209,3875,351,3.59%
2011-02,המרכז,195,קדימה-צורן,יישוב,227,103,124,65,162,36,226,17,2.64%
2011-02,המרכז,638,קלנסווה,יישוב,895,350,545,2,893,759,891,21,12.57%
2011-02,המרכז,469,קריית עקרון,יישוב,271,133,138,14,257,115,268,3,5.03%
2011-02,המרכז,2640,ראש העין,יישוב,684,330,354,68,616,187,674,80,3.37%
2011-02,המרכז,8300,ראשון לציון,יישוב,4363,1851,2512,904,3459,1724,4338,325,3.46%
2011-02,המרכז,8400,רחובות,יישוב,2501,1073,1428,531,1970,1046,2472,20,4.35%
2011-02,המרכז,8500,רמלה,יישוב,1774,829,945,91,1683,863,1744,157,5.48%
2011-02,המרכז,8700,רעננה,יישוב,713,320,393,285,428,85,711,52,2.05%
2011-02,המרכז,1304,שוהם,יישוב,169,67,102,66,103,8,167,17,1.75%
2011-02,המרכז,154,תל מונד,יישוב,128,58,70,43,85,22,128,8,2.41%
2011-02,הצפון,473,אבו סנאן,יישוב,715,280,435,4,711,617,711,16,14.88%
2011-02,הצפון,478,אכסאל,יישוב,544,217,327,8,536,491,543,14,11.95%
2011-02,הצפון,529,אעבלין,יישוב,640,258,382,11,629,541,639,21,13.68%
2011-02,הצפון,482,בועיינה-נוג'ידאת,יישוב,498,212,286,7,491,411,493,2,15.64%
2011-02,הצפון,4001,בוקעאתא,יישוב,376,148,228,9,367,317,369,1,15.90%
2011-02,הצפון,998,ביר אל-מכסור,יישוב,431,165,266,2,429,345,430,13,14.37%
2011-02,הצפון,480,בית ג'ן,יישוב,335,99,236,3,332,254,330,3,8.05%
2011-02,הצפון,9200,בית שאן,יישוב,777,331,446,17,760,455,777,100,8.44%
2011-02,הצפון,944,בסמת טבעון,יישוב,262,112,150,4,258,205,262,20,9.82%
2011-02,הצפון,483,בענה,יישוב,467,193,274,4,463,408,467,8,16.62%
2011-02,הצפון,1292,ג'דיידה-מכר,יישוב,1468,605,863,6,1462,1283,1468,24,19.12%
2011-02,הצפון,485,ג'ולס,יישוב,213,60,153,2,211,152,213,14,9.04%
2011-02,הצפון,487,ג'ש (גוש חלב),יישוב,53,28,25,3,50,31,53,2,3.74%
2011-02,הצפון,489,דבורייה,יישוב,462,215,247,22,440,338,461,7,12.68%
2011-02,הצפון,490,דייר אל-אסד,יישוב,417,172,245,7,410,343,417,11,10.16%
2011-02,הצפון,492,דייר חנא,יישוב,669,298,371,10,659,523,669,18,17.03%
2011-02,הצפון,975,זרזיר,יישוב,304,126,178,3,301,218,299,8,12.36%
2011-02,הצפון,496,חורפיש,יישוב,139,51,88,6,133,96,138,5,6.67%
2011-02,הצפון,2034,חצור הגלילית,יישוב,275,111,164,12,263,140,266,32,6.16%
2011-02,הצפון,6700,טבריה,יישוב,1880,833,1047,111,1769,1218,1773,140,8.83%
2011-02,הצפון,962,טובא-זנגרייה,יישוב,350,163,187,5,345,254,346,12,13.14%
2011-02,הצפון,498,טורעאן,יישוב,522,199,323,8,514,448,519,19,11.44%
2011-02,הצפון,8900,טמרה,יישוב,2002,819,1183,22,1980,1796,1995,61,17.22%
2011-02,הצפון,1295,יאנוח-ג'ת,יישוב,181,62,119,3,178,128,181,5,8.49%
2011-02,הצפון,46,יבנאל,יישוב,116,62,54,6,110,91,108,2,8.28%
2011-02,הצפון,499,יפיע,יישוב,612,259,353,7,605,494,609,21,9.50%
2011-02,הצפון,240,יקנעם עילית,יישוב,478,181,297,79,399,204,476,53,4.70%
2011-02,הצפון,502,ירכא,יישוב,507,212,295,1,506,402,507,22,11.22%
2011-02,הצפון,504,כאבול,יישוב,705,302,403,8,697,621,702,21,17.19%
2011-02,הצפון,505,כאוכב אבו אל-היג'א,יישוב,205,85,120,6,199,175,205,6,14.61%
2011-02,הצפון,1296,כסרא-סמיע,יישוב,239,99,140,3,236,187,239,9,8.96%
2011-02,הצפון,978,כעביה-טבאש-חג'אג'רה,יישוב,202,83,119,5,197,149,201,5,10.84%
2011-02,הצפון,1263,כפר ורדים,יישוב,68,29,39,28,40,13,68,5,2.34%
2011-02,הצפון,507,כפר יאסיף,יישוב,513,217,296,5,508,400,512,18,11.97%
2011-02,הצפון,508,כפר כמא,יישוב,74,22,52,4,70,44,72,2,5.41%
2011-02,הצפון,509,כפר כנא,יישוב,1119,444,675,21,1098,972,1111,26,15.49%
2011-02,הצפון,510,כפר מנדא,יישוב,961,427,534,12,949,767,952,53,15.99%
2011-02,הצפון,47,כפר תבור,יישוב,43,14,29,18,25,3,43,1,2.58%
2011-02,הצפון,1139,כרמיאל,יישוב,1747,675,1072,359,1388,938,1690,124,6.88%
2011-02,הצפון,481,מגאר,יישוב,1434,556,878,21,1413,1280,1429,40,19.41%
2011-02,הצפון,516,מג'ד אל-כרום,יישוב,644,278,366,10,634,514,644,21,12.26%
2011-02,הצפון,874,מגדל העמק,יישוב,936,402,534,71,865,472,898,125,7.25%
2011-02,הצפון,4201,מג'דל שמס,יישוב,472,180,292,24,448,402,468,12,11.99%
2011-02,הצפון,517,מזרעה,יישוב,177,69,108,5,172,142,176,8,11.00%
2011-02,הצפון,4203,מסעדה,יישוב,195,79,116,6,189,159,194,6,13.41%
2011-02,הצפון,518,מעיליא,יישוב,62,28,34,6,56,32,62,6,4.47%
2011-02,הצפון,1063,מעלות-תרשיחא,יישוב,938,414,524,115,823,583,937,59,8.31%
2011-02,הצפון,520,משהד,יישוב,323,119,204,3,320,280,320,7,12.33%
2011-02,הצפון,9100,נהרייה,יישוב,2066,906,1160,234,1832,1331,2056,118,7.41%
2011-02,הצפון,522,נחף,יישוב,442,186,256,10,432,364,441,11,10.94%
2011-02,הצפון,7300,נצרת,יישוב,2935,1276,1659,67,2868,2282,2923,93,10.11%
2011-02,הצפון,1061,נצרת עילית,יישוב,1916,854,1062,250,1666,1127,1822,172,8.06%
2011-02,הצפון,525,סאג'ור,יישוב,130,50,80,2,128,91,128,3,9.05%
2011-02,הצפון,7500,סח'נין,יישוב,2029,911,1118,31,1998,1736,2029,39,17.68%
2011-02,הצפון,4501,ע'ג'ר,יישוב,106,46,60,4,102,75,105,7,12.30%
2011-02,הצפון,530,עיילבון,יישוב,189,80,109,6,183,143,189,5,8.92%
2011-02,הצפון,511,עילוט,יישוב,316,124,192,2,314,259,316,9,13.73%
2011-02,הצפון,532,עין מאהל,יישוב,584,253,331,14,570,507,577,15,13.66%
2011-02,הצפון,7600,עכו,יישוב,3249,1475,1774,138,3111,2572,3231,142,13.39%
2011-02,הצפון,7700,עפולה,יישוב,1789,745,1044,207,1582,954,1722,170,7.93%
2011-02,הצפון,531,עראבה,יישוב,1362,572,790,30,1332,1186,1360,31,16.85%
2011-02,הצפון,535,פסוטה,יישוב,134,59,75,8,126,95,134,2,8.99%
2011-02,הצפון,536,פקיעין (בוקייעה),יישוב,128,60,68,2,126,95,127,8,5.48%
2011-02,הצפון,8000,צפת,יישוב,989,511,478,78,911,699,981,50,8.68%
2011-02,הצפון,4100,קצרין,יישוב,208,91,117,44,164,103,205,17,5.53%
2011-02,הצפון,2800,קריית שמונה,יישוב,801,363,438,63,738,310,777,74,6.35%
2011-02,הצפון,543,ראמה,יישוב,312,124,188,6,306,248,311,9,9.72%
2011-02,הצפון,26,ראש פינה,יישוב,53,17,36,7,46,22,53,3,3.86%
2011-02,הצפון,542,ריינה,יישוב,603,237,366,10,593,502,598,23,10.85%
2011-02,הצפון,122,רמת ישי,יישוב,92,32,60,27,65,12,91,2,2.50%
2011-02,הצפון,913,שבלי - אום אל-גנם,יישוב,273,126,147,7,266,197,272,8,12.54%
2011-02,הצפון,812,שלומי,יישוב,261,109,152,16,245,164,259,14,7.92%
2011-02,הצפון,538,שעב,יישוב,486,205,281,3,483,418,485,9,19.25%
2011-02,הצפון,8800,שפרעם,יישוב,2010,802,1208,28,1982,1689,2003,68,13.64%
2011-02,חיפה,2710,אום אל-פחם,יישוב,3511,1442,2069,8,3503,3066,3507,58,20.75%
2011-02,חיפה,1020,אור עקיבא,יישוב,583,238,345,41,542,234,570,83,6.31%
2011-02,חיפה,6000,באקה אל-גרביה,יישוב,633,331,302,12,621,394,633,36,NULL
2011-02,חיפה,9800,בנימינה-גבעת עדה*,יישוב,184,85,99,62,122,49,184,14,3.02%
2011-02,חיפה,1326,"בסמ""ה",יישוב,383,167,216,2,381,311,383,12,12.09%
2011-02,חיפה,541,ג'סר א-זרקא,יישוב,373,216,157,0,373,263,370,11,7.41%
2011-02,חיפה,628,ג'ת,יישוב,190,90,100,8,182,126,189,9,NULL
2011-02,חיפה,494,דאלית אל-כרמל,יישוב,496,201,295,9,487,305,493,28,7.30%
2011-02,חיפה,9300,זכרון יעקב,יישוב,234,91,143,74,160,48,231,17,2.56%
2011-02,חיפה,6500,חדרה,יישוב,2265,941,1324,261,2004,932,2227,231,5.08%
2011-02,חיפה,4000,חיפה,יישוב,8029,3488,4541,1573,6456,5248,7973,504,6.11%
2011-02,חיפה,1247,חריש-קציר,יישוב,24,7,17,2,22,8,24,4,1.47%
2011-02,חיפה,2100,טירת כרמל,יישוב,747,337,410,40,707,495,736,61,7.74%
2011-02,חיפה,654,כפר קרע,יישוב,364,161,203,10,354,220,362,21,5.31%
2011-02,חיפה,1327,מעלה עירון,יישוב,851,345,506,3,848,716,850,20,17.97%
2011-02,חיפה,2500,נשר,יישוב,567,260,307,104,463,305,564,36,4.64%
2011-02,חיפה,534,עספיא,יישוב,337,156,181,6,331,203,335,13,7.06%
2011-02,חיפה,637,ערערה,יישוב,531,205,326,7,524,364,530,22,8.02%
2011-02,חיפה,537,פוריידיס,יישוב,398,204,194,4,394,266,396,18,8.41%
2011-02,חיפה,7800,פרדס חנה-כרכור,יישוב,859,369,490,127,732,272,848,110,5.05%
2011-02,חיפה,6800,קריית אתא,יישוב,1949,775,1174,167,1782,1223,1943,113,7.27%
2011-02,חיפה,9500,קריית ביאליק,יישוב,1215,493,722,164,1051,688,1210,86,6.09%
2011-02,חיפה,2300,קריית טבעון,יישוב,192,80,112,65,127,50,192,8,2.55%
2011-02,חיפה,9600,קריית ים,יישוב,1779,758,1021,174,1605,1205,1773,99,8.89%
2011-02,חיפה,8200,קריית מוצקין,יישוב,1220,473,747,170,1050,671,1211,77,5.83%
2011-02,חיפה,922,רכסים,יישוב,138,67,71,7,131,100,138,5,5.14%
2011-02,ירושלים,472,אבו גוש,יישוב,260,116,144,8,252,191,260,13,10.75%
2011-02,ירושלים,2610,בית שמש,יישוב,1043,457,586,88,955,548,1033,120,4.22%
2011-02,ירושלים,3000,ירושלים,יישוב,9877,4315,5562,1197,8680,5976,9825,694,3.96%
2011-02,ירושלים,1015,מבשרת ציון,יישוב,351,164,187,61,290,166,350,28,3.00%
2011-02,ירושלים,1137,קריית יערים,יישוב,30,15,15,5,25,12,29,3,2.91%
2011-02,תל אביב,2400,אור יהודה,יישוב,817,354,463,39,778,301,809,93,4.66%
2011-02,תל אביב,565,אזור,יישוב,168,85,83,20,148,42,167,15,2.84%
2011-02,תל אביב,6100,בני ברק,יישוב,2190,1076,1114,113,2077,1364,2172,138,4.72%
2011-02,תל אביב,6200,בת ים,יישוב,3494,1561,1933,490,3004,1549,3421,293,4.91%
2011-02,תל אביב,6300,גבעתיים,יישוב,677,313,364,270,407,116,676,56,2.48%
2011-02,תל אביב,6400,הרצלייה,יישוב,1004,457,547,293,711,126,990,148,2.19%
2011-02,תל אביב,6600,חולון,יישוב,2931,1317,1614,519,2412,1044,2873,329,3.12%
2011-02,תל אביב,2620,קריית אונו,יישוב,391,164,227,156,235,50,389,12,2.41%
2011-02,תל אביב,8600,רמת גן,יישוב,2026,909,1117,617,1409,533,2012,196,2.83%
2011-02,תל אביב,2650,רמת השרון,יישוב,406,170,236,164,242,26,405,46,1.99%
2011-02,תל אביב,5000,תל אביב -יפו,יישוב,7575,3759,3816,2138,5437,2817,7507,699,3.27%
2011-03,אזור יהודה והשומרון,3760,אורנית,יישוב,86,41,45,31,55,3,86,2,2.30%
2011-03,אזור יהודה והשומרון,3750,אלפי מנשה,יישוב,98,41,57,24,74,3,98,5,2.43%
2011-03,אזור יהודה והשומרון,3560,אלקנה,יישוב,39,18,21,22,17,2,39,1,2.29%
2011-03,אזור יהודה והשומרון,3650,אפרתה,יישוב,42,21,21,21,21,10,42,2,1.20%
2011-03,אזור יהודה והשומרון,3570,אריאל,יישוב,351,158,193,84,267,109,350,40,3.54%
2011-03,אזור יהודה והשומרון,3574,בית אל,יישוב,47,22,25,11,36,15,47,5,2.21%
2011-03,אזור יהודה והשומרון,3652,בית אריה,יישוב,52,20,32,5,47,5,52,7,2.46%
2011-03,אזור יהודה והשומרון,3780,ביתר עילית,יישוב,380,193,187,17,363,214,375,24,4.49%
2011-03,אזור יהודה והשומרון,3730,גבעת זאב,יישוב,168,87,81,17,151,49,168,14,2.80%
2011-03,אזור יהודה והשומרון,3769,הר אדר,יישוב,29,14,15,13,16,1,29,2,1.69%
2011-03,אזור יהודה והשומרון,3797,מודיעין עילית,יישוב,297,117,180,18,279,94,295,12,2.85%
2011-03,אזור יהודה והשומרון,3616,מעלה אדומים,יישוב,595,237,358,94,501,210,594,57,3.37%
2011-03,אזור יהודה והשומרון,3660,עמנואל,יישוב,74,38,36,4,70,52,74,0,7.97%
2011-03,אזור יהודה והשומרון,3557,קדומים,יישוב,23,12,11,6,17,6,23,0,1.44%
2011-03,אזור יהודה והשומרון,3611,קריית ארבע,יישוב,110,55,55,19,91,64,110,11,3.96%
2011-03,אזור יהודה והשומרון,3640,קרני שומרון,יישוב,76,41,35,20,56,20,76,3,2.34%
2011-03,הדרום,31,אופקים,יישוב,1316,560,756,100,1216,975,1303,70,11.67%
2011-03,הדרום,2600,אילת,יישוב,1501,692,809,93,1408,668,1483,135,4.84%
2011-03,הדרום,70,אשדוד,יישוב,6746,2669,4077,790,5956,4107,6680,381,6.71%
2011-03,הדרום,7100,אשקלון,יישוב,4200,1625,2575,644,3556,2699,4113,286,7.12%
2011-03,הדרום,9000,באר שבע,יישוב,7234,3044,4190,939,6295,4933,7180,610,7.66%
2011-03,הדרום,2200,דימונה,יישוב,2079,958,1121,127,1952,1478,2038,146,11.68%
2011-03,הדרום,1303,חורה,יישוב,713,306,407,1,712,665,713,9,23.52%
2011-03,הדרום,831,ירוחם,יישוב,433,212,221,28,405,274,425,60,10.32%
2011-03,הדרום,1059,כסיפה,יישוב,980,406,574,2,978,907,979,22,26.25%
2011-03,הדרום,1271,להבים,יישוב,39,19,20,20,19,4,39,5,1.28%
2011-03,הדרום,1060,לקיה,יישוב,914,409,505,3,911,856,913,17,28.49%
2011-03,הדרום,1268,מיתר,יישוב,62,25,37,27,35,4,61,7,1.66%
2011-03,הדרום,99,מצפה רמון,יישוב,239,88,151,18,221,128,220,38,9.91%
2011-03,הדרום,246,נתיבות,יישוב,996,412,584,56,940,528,988,214,8.48%
2011-03,הדרום,666,עומר,יישוב,67,29,38,36,31,9,67,5,1.80%
2011-03,הדרום,2560,ערד,יישוב,875,402,473,174,701,552,847,92,6.93%
2011-03,הדרום,1192,ערערה-בנגב,יישוב,989,394,595,3,986,908,987,13,30.67%
2011-03,הדרום,2630,קריית גת,יישוב,2266,916,1350,192,2074,1529,2260,153,9.13%
2011-03,הדרום,1034,קריית מלאכי,יישוב,1268,575,693,34,1234,836,1241,105,11.54%
2011-03,הדרום,1161,רהט,יישוב,2909,1136,1773,8,2901,2604,2908,69,20.80%
2011-03,הדרום,1286,שגב-שלום,יישוב,563,232,331,1,562,505,562,14,26.99%
2011-03,הדרום,1031,שדרות,יישוב,1048,443,605,59,989,643,1045,75,9.49%
2011-03,הדרום,1054,תל שבע,יישוב,1173,549,624,2,1171,1096,1171,26,30.44%
2011-03,המרכז,182,אבן יהודה,יישוב,119,55,64,40,79,15,119,10,2.01%
2011-03,המרכז,41,אליכין,יישוב,50,27,23,4,46,20,49,7,3.12%
2011-03,המרכז,1309,אלעד,יישוב,345,155,190,19,326,114,342,14,3.26%
2011-03,המרכז,2530,באר יעקב,יישוב,253,119,134,49,204,80,252,18,3.61%
2011-03,המרכז,466,בית דגן,יישוב,90,42,48,14,76,32,89,5,2.74%
2011-03,המרכז,1066,"בני עי""ש",יישוב,200,96,104,27,173,90,199,2,5.15%
2011-03,המרכז,681,גבעת שמואל,יישוב,270,140,130,109,161,50,270,13,2.60%
2011-03,המרכז,2550,גדרה,יישוב,351,157,194,58,293,111,345,4,3.45%
2011-03,המרכז,627,ג'לג'וליה,יישוב,62,28,34,4,58,36,62,5,2.20%
2011-03,המרכז,166,גן יבנה,יישוב,310,129,181,36,274,100,310,12,3.23%
2011-03,המרכז,229,גני תקווה,יישוב,159,67,92,42,117,28,159,10,2.29%
2011-03,המרכז,9700,הוד השרון,יישוב,577,261,316,199,378,61,571,26,2.29%
2011-03,המרכז,1290,זמר,יישוב,169,59,110,8,161,131,169,10,6.97%
2011-03,המרכז,2730,טייבה,יישוב,2109,860,1249,6,2103,1813,2094,48,14.26%
2011-03,המרכז,2720,טירה,יישוב,322,148,174,7,315,198,320,15,3.59%
2011-03,המרכז,2660,יבנה,יישוב,899,429,470,79,820,441,896,86,5.02%
2011-03,המרכז,9400,יהוד,יישוב,558,246,312,96,462,82,541,38,3.70%
2011-03,המרכז,1224,כוכב יאיר,יישוב,85,45,40,40,45,5,85,4,1.62%
2011-03,המרכז,633,כפר ברא,יישוב,26,15,11,0,26,7,26,2,2.55%
2011-03,המרכז,168,כפר יונה,יישוב,320,143,177,45,275,73,318,35,3.39%
2011-03,המרכז,6900,כפר סבא,יישוב,1104,508,596,307,797,213,1097,77,2.40%
2011-03,המרכז,634,כפר קאסם,יישוב,208,92,116,0,208,126,207,10,3.18%
2011-03,המרכז,7000,לוד,יישוב,2184,974,1210,200,1984,1282,2171,179,6.64%
2011-03,המרכז,1200,מודיעין-מכבים-רעות*,יישוב,894,381,513,365,529,71,883,91,2.41%
2011-03,המרכז,28,מזכרת בתיה,יישוב,141,55,86,33,108,40,141,2,2.57%
2011-03,המרכז,7200,נס ציונה,יישוב,640,266,374,128,512,206,632,4,3.19%
2011-03,המרכז,7400,נתניה,יישוב,4463,2087,2376,608,3855,1918,4417,489,4.74%
2011-03,המרכז,587,סביון*,יישוב,15,4,11,10,5,1,15,0,0.92%
2011-03,המרכז,171,פרדסייה,יישוב,81,35,46,16,65,8,80,8,2.37%
2011-03,המרכז,7900,פתח תקווה,יישוב,3913,1710,2203,813,3100,1211,3871,329,3.59%
2011-03,המרכז,195,קדימה-צורן,יישוב,232,109,123,70,162,35,232,25,2.71%
2011-03,המרכז,638,קלנסווה,יישוב,898,352,546,3,895,760,893,14,12.60%
2011-03,המרכז,469,קריית עקרון,יישוב,269,133,136,14,255,116,268,2,5.03%
2011-03,המרכז,2640,ראש העין,יישוב,637,303,334,66,571,181,631,78,3.16%
2011-03,המרכז,8300,ראשון לציון,יישוב,4425,1905,2520,922,3503,1724,4406,331,3.51%
2011-03,המרכז,8400,רחובות,יישוב,2523,1086,1437,551,1972,1043,2484,18,4.37%
2011-03,המרכז,8500,רמלה,יישוב,1796,844,952,88,1708,862,1772,161,5.56%
2011-03,המרכז,8700,רעננה,יישוב,698,319,379,276,422,92,694,42,2.00%
2011-03,המרכז,1304,שוהם,יישוב,168,72,96,69,99,9,167,21,1.75%
2011-03,המרכז,154,תל מונד,יישוב,124,53,71,36,88,24,124,13,2.33%
2011-03,הצפון,473,אבו סנאן,יישוב,723,281,442,4,719,618,719,18,15.03%
2011-03,הצפון,478,אכסאל,יישוב,551,222,329,7,544,494,551,18,12.10%
2011-03,הצפון,529,אעבלין,יישוב,622,244,378,11,611,530,622,24,13.36%
2011-03,הצפון,482,בועיינה-נוג'ידאת,יישוב,499,200,299,5,494,407,495,6,15.69%
2011-03,הצפון,4001,בוקעאתא,יישוב,384,152,232,10,374,324,376,3,16.15%
2011-03,הצפון,998,ביר אל-מכסור,יישוב,447,169,278,3,444,352,446,12,14.83%
2011-03,הצפון,480,בית ג'ן,יישוב,349,108,241,5,344,261,345,6,8.38%
2011-03,הצפון,9200,בית שאן,יישוב,823,357,466,14,809,461,821,96,8.87%
2011-03,הצפון,944,בסמת טבעון,יישוב,250,110,140,3,247,195,250,11,9.41%
2011-03,הצפון,483,בענה,יישוב,474,196,278,5,469,407,474,18,16.83%
2011-03,הצפון,1292,ג'דיידה-מכר,יישוב,1468,613,855,6,1462,1285,1468,47,19.12%
2011-03,הצפון,485,ג'ולס,יישוב,208,64,144,1,207,150,207,9,8.80%
2011-03,הצפון,487,ג'ש (גוש חלב),יישוב,58,31,27,2,56,32,57,1,4.01%
2011-03,הצפון,489,דבורייה,יישוב,452,209,243,20,432,335,451,12,12.43%
2011-03,הצפון,490,דייר אל-אסד,יישוב,409,171,238,4,405,342,409,13,9.98%
2011-03,הצפון,492,דייר חנא,יישוב,657,288,369,7,650,520,657,24,16.78%
2011-03,הצפון,975,זרזיר,יישוב,321,135,186,6,315,223,314,17,12.90%
2011-03,הצפון,496,חורפיש,יישוב,147,54,93,5,142,97,147,7,7.07%
2011-03,הצפון,2034,חצור הגלילית,יישוב,270,114,156,10,260,142,263,27,6.10%
2011-03,הצפון,6700,טבריה,יישוב,1853,820,1033,114,1739,1203,1749,132,8.73%
2011-03,הצפון,962,טובא-זנגרייה,יישוב,335,153,182,6,329,250,330,14,12.61%
2011-03,הצפון,498,טורעאן,יישוב,523,201,322,9,514,456,520,15,11.46%
2011-03,הצפון,8900,טמרה,יישוב,2014,827,1187,20,1994,1793,2009,46,17.32%
2011-03,הצפון,1295,יאנוח-ג'ת,יישוב,167,57,110,4,163,120,167,8,7.89%
2011-03,הצפון,46,יבנאל,יישוב,122,64,58,6,116,93,114,3,8.70%
2011-03,הצפון,499,יפיע,יישוב,632,262,370,7,625,510,630,30,9.79%
2011-03,הצפון,240,יקנעם עילית,יישוב,487,192,295,73,414,200,485,49,4.78%
2011-03,הצפון,502,ירכא,יישוב,510,207,303,1,509,408,510,23,11.28%
2011-03,הצפון,504,כאבול,יישוב,701,293,408,8,693,622,697,20,17.09%
2011-03,הצפון,505,כאוכב אבו אל-היג'א,יישוב,205,85,120,7,198,173,205,3,14.61%
2011-03,הצפון,1296,כסרא-סמיע,יישוב,223,95,128,3,220,173,223,12,8.42%
2011-03,הצפון,978,כעביה-טבאש-חג'אג'רה,יישוב,194,75,119,4,190,148,193,4,10.45%
2011-03,הצפון,1263,כפר ורדים,יישוב,79,37,42,32,47,12,79,4,2.71%
2011-03,הצפון,507,כפר יאסיף,יישוב,509,215,294,5,504,399,508,15,11.89%
2011-03,הצפון,508,כפר כמא,יישוב,79,25,54,4,75,43,77,7,5.76%
2011-03,הצפון,509,כפר כנא,יישוב,1149,465,684,20,1129,992,1140,33,15.83%
2011-03,הצפון,510,כפר מנדא,יישוב,958,416,542,12,946,751,949,54,15.95%
2011-03,הצפון,47,כפר תבור,יישוב,43,13,30,15,28,3,43,3,2.58%
2011-03,הצפון,1139,כרמיאל,יישוב,1809,694,1115,372,1437,967,1751,132,7.11%
2011-03,הצפון,481,מגאר,יישוב,1477,583,894,26,1451,1309,1473,40,19.89%
2011-03,הצפון,516,מג'ד אל-כרום,יישוב,632,271,361,10,622,506,632,31,12.06%
2011-03,הצפון,874,מגדל העמק,יישוב,940,414,526,71,869,473,891,109,7.20%
2011-03,הצפון,4201,מג'דל שמס,יישוב,464,171,293,25,439,400,460,11,11.81%
2011-03,הצפון,517,מזרעה,יישוב,174,69,105,2,172,140,173,4,10.83%
2011-03,הצפון,4203,מסעדה,יישוב,189,72,117,3,186,160,188,0,13.05%
2011-03,הצפון,518,מעיליא,יישוב,51,23,28,6,45,28,51,4,3.71%
2011-03,הצפון,1063,מעלות-תרשיחא,יישוב,906,397,509,113,793,576,903,57,8.03%
2011-03,הצפון,520,משהד,יישוב,323,117,206,2,321,280,320,11,12.33%
2011-03,הצפון,9100,נהרייה,יישוב,2088,915,1173,242,1846,1345,2074,146,7.47%
2011-03,הצפון,522,נחף,יישוב,443,187,256,10,433,362,442,10,10.96%
2011-03,הצפון,7300,נצרת,יישוב,2944,1273,1671,78,2866,2282,2931,115,10.14%
2011-03,הצפון,1061,נצרת עילית,יישוב,1920,844,1076,253,1667,1143,1822,220,8.06%
2011-03,הצפון,525,סאג'ור,יישוב,132,51,81,1,131,91,131,6,9.24%
2011-03,הצפון,7500,סח'נין,יישוב,2037,912,1125,31,2006,1742,2037,59,17.74%
2011-03,הצפון,4501,ע'ג'ר,יישוב,97,41,56,2,95,71,97,3,11.47%
2011-03,הצפון,530,עיילבון,יישוב,187,81,106,6,181,143,187,8,8.83%
2011-03,הצפון,511,עילוט,יישוב,335,130,205,4,331,274,335,14,14.44%
2011-03,הצפון,532,עין מאהל,יישוב,586,257,329,13,573,512,580,14,13.72%
2011-03,הצפון,7600,עכו,יישוב,3229,1472,1757,137,3092,2558,3210,165,13.32%
2011-03,הצפון,7700,עפולה,יישוב,1798,745,1053,199,1599,940,1735,162,7.98%
2011-03,הצפון,531,עראבה,יישוב,1354,549,805,28,1326,1179,1352,37,16.77%
2011-03,הצפון,535,פסוטה,יישוב,135,58,77,8,127,95,135,2,9.05%
2011-03,הצפון,536,פקיעין (בוקייעה),יישוב,126,60,66,2,124,91,125,7,5.40%
2011-03,הצפון,8000,צפת,יישוב,974,488,486,70,904,706,965,38,8.55%
2011-03,הצפון,4100,קצרין,יישוב,209,94,115,43,166,99,207,19,5.58%
2011-03,הצפון,2800,קריית שמונה,יישוב,792,361,431,62,730,318,774,104,6.33%
2011-03,הצפון,543,ראמה,יישוב,317,131,186,7,310,250,316,7,9.86%
2011-03,הצפון,26,ראש פינה,יישוב,53,18,35,7,46,21,53,1,3.86%
2011-03,הצפון,542,ריינה,יישוב,596,241,355,10,586,495,591,27,10.73%
2011-03,הצפון,122,רמת ישי,יישוב,98,35,63,28,70,12,97,9,2.66%
2011-03,הצפון,913,שבלי - אום אל-גנם,יישוב,274,126,148,9,265,193,273,4,12.58%
2011-03,הצפון,812,שלומי,יישוב,260,107,153,17,243,171,257,20,7.87%
2011-03,הצפון,538,שעב,יישוב,479,197,282,5,474,411,478,13,19.03%
2011-03,הצפון,8800,שפרעם,יישוב,2017,810,1207,30,1987,1671,2011,98,13.68%
2011-03,חיפה,2710,אום אל-פחם,יישוב,3545,1457,2088,10,3535,3089,3541,69,20.91%
2011-03,חיפה,1020,אור עקיבא,יישוב,574,241,333,41,533,237,563,82,6.24%
2011-03,חיפה,6000,באקה אל-גרביה,יישוב,647,338,309,12,635,400,647,42,NULL
2011-03,חיפה,9800,בנימינה-גבעת עדה*,יישוב,196,87,109,65,131,49,196,18,3.21%
2011-03,חיפה,1326,"בסמ""ה",יישוב,383,169,214,3,380,306,383,8,12.09%
2011-03,חיפה,541,ג'סר א-זרקא,יישוב,366,209,157,0,366,271,364,21,7.30%
2011-03,חיפה,628,ג'ת,יישוב,199,94,105,6,193,127,198,13,NULL
2011-03,חיפה,494,דאלית אל-כרמל,יישוב,490,200,290,9,481,305,488,25,7.23%
2011-03,חיפה,9300,זכרון יעקב,יישוב,236,104,132,79,157,49,231,22,2.56%
2011-03,חיפה,6500,חדרה,יישוב,2218,951,1267,262,1956,924,2188,241,5.00%
2011-03,חיפה,4000,חיפה,יישוב,8004,3522,4482,1566,6438,5234,7946,481,6.09%
2011-03,חיפה,1247,חריש-קציר,יישוב,24,8,16,2,22,7,24,2,1.47%
2011-03,חיפה,2100,טירת כרמל,יישוב,765,347,418,39,726,506,754,85,7.91%
2011-03,חיפה,654,כפר קרע,יישוב,372,168,204,11,361,225,370,16,5.42%
2011-03,חיפה,1327,מעלה עירון,יישוב,871,350,521,3,868,721,871,15,18.33%
2011-03,חיפה,2500,נשר,יישוב,558,256,302,105,453,304,555,46,4.57%
2011-03,חיפה,534,עספיא,יישוב,343,147,196,6,337,210,339,18,7.13%
2011-03,חיפה,637,ערערה,יישוב,553,220,333,8,545,379,553,37,8.34%
2011-03,חיפה,537,פוריידיס,יישוב,384,193,191,4,380,265,383,19,8.16%
2011-03,חיפה,7800,פרדס חנה-כרכור,יישוב,846,366,480,124,722,280,838,116,4.99%
2011-03,חיפה,6800,קריית אתא,יישוב,1982,799,1183,164,1818,1232,1970,130,7.36%
2011-03,חיפה,9500,קריית ביאליק,יישוב,1228,499,729,162,1066,702,1221,73,6.14%
2011-03,חיפה,2300,קריית טבעון,יישוב,176,73,103,55,121,50,174,22,2.31%
2011-03,חיפה,9600,קריית ים,יישוב,1780,774,1006,167,1613,1226,1774,122,8.89%
2011-03,חיפה,8200,קריית מוצקין,יישוב,1210,488,722,176,1034,659,1201,95,5.79%
2011-03,חיפה,922,רכסים,יישוב,144,68,76,6,138,101,144,8,5.35%
2011-03,ירושלים,472,אבו גוש,יישוב,255,115,140,9,246,189,255,8,10.56%
2011-03,ירושלים,2610,בית שמש,יישוב,1033,451,582,92,941,556,1026,114,4.19%
2011-03,ירושלים,3000,ירושלים,יישוב,9933,4372,5561,1221,8712,6015,9883,708,3.98%
2011-03,ירושלים,1015,מבשרת ציון,יישוב,333,158,175,55,278,159,330,37,2.83%
2011-03,ירושלים,1137,קריית יערים,יישוב,29,12,17,5,24,11,29,3,2.91%
2011-03,תל אביב,2400,אור יהודה,יישוב,836,371,465,38,798,297,826,95,4.75%
2011-03,תל אביב,565,אזור,יישוב,159,86,73,19,140,38,156,21,2.66%
2011-03,תל אביב,6100,בני ברק,יישוב,2177,1080,1097,117,2060,1371,2162,136,4.70%
2011-03,תל אביב,6200,בת ים,יישוב,3441,1553,1888,495,2946,1532,3373,337,4.84%
2011-03,תל אביב,6300,גבעתיים,יישוב,714,324,390,283,431,127,709,55,2.60%
2011-03,תל אביב,6400,הרצלייה,יישוב,980,447,533,297,683,108,964,155,2.13%
2011-03,תל אביב,6600,חולון,יישוב,2945,1340,1605,492,2453,997,2899,330,3.15%
2011-03,תל אביב,2620,קריית אונו,יישוב,398,168,230,161,237,53,391,19,2.42%
2011-03,תל אביב,8600,רמת גן,יישוב,2033,903,1130,634,1399,522,2014,184,2.83%
2011-03,תל אביב,2650,רמת השרון,יישוב,371,156,215,153,218,18,368,46,1.81%
2011-03,תל אביב,5000,תל אביב -יפו,יישוב,7670,3786,3884,2200,5470,2827,7605,611,3.31%
2011-04,אזור יהודה והשומרון,3760,אורנית,יישוב,84,44,40,32,52,3,84,7,2.25%
2011-04,אזור יהודה והשומרון,3750,אלפי מנשה,יישוב,84,37,47,22,62,2,84,3,2.09%
2011-04,אזור יהודה והשומרון,3560,אלקנה,יישוב,36,19,17,20,16,2,36,1,2.12%
2011-04,אזור יהודה והשומרון,3650,אפרתה,יישוב,47,24,23,25,22,9,47,1,1.34%
2011-04,אזור יהודה והשומרון,3570,אריאל,יישוב,326,144,182,91,235,104,325,25,3.30%
2011-04,אזור יהודה והשומרון,3574,בית אל,יישוב,44,20,24,12,32,17,44,2,2.07%
2011-04,אזור יהודה והשומרון,3652,בית אריה,יישוב,55,19,36,7,48,7,55,3,2.60%
2011-04,אזור יהודה והשומרון,3780,ביתר עילית,יישוב,334,171,163,15,319,206,330,13,3.97%
2011-04,אזור יהודה והשומרון,3730,גבעת זאב,יישוב,147,75,72,13,134,47,147,7,2.46%
2011-04,אזור יהודה והשומרון,3769,הר אדר,יישוב,29,13,16,14,15,1,29,1,1.69%
2011-04,אזור יהודה והשומרון,3797,מודיעין עילית,יישוב,264,108,156,18,246,88,264,5,2.56%
2011-04,אזור יהודה והשומרון,3616,מעלה אדומים,יישוב,558,223,335,88,470,219,556,51,3.16%
2011-04,אזור יהודה והשומרון,3660,עמנואל,יישוב,73,38,35,5,68,52,73,4,7.87%
2011-04,אזור יהודה והשומרון,3557,קדומים,יישוב,19,13,6,7,12,4,19,0,1.19%
2011-04,אזור יהודה והשומרון,3611,קריית ארבע,יישוב,98,46,52,15,83,65,98,3,3.55%
2011-04,אזור יהודה והשומרון,3640,קרני שומרון,יישוב,65,38,27,18,47,19,65,6,2.01%
2011-04,הדרום,31,אופקים,יישוב,1249,525,724,95,1154,950,1243,23,11.20%
2011-04,הדרום,2600,אילת,יישוב,1278,586,692,75,1203,619,1264,74,4.15%
2011-04,הדרום,70,אשדוד,יישוב,6368,2497,3871,748,5620,4006,6315,271,6.37%
2011-04,הדרום,7100,אשקלון,יישוב,3970,1541,2429,613,3357,2600,3885,213,6.75%
2011-04,הדרום,9000,באר שבע,יישוב,6839,2905,3934,902,5937,4730,6788,417,7.28%
2011-04,הדרום,2200,דימונה,יישוב,1914,854,1060,117,1797,1414,1893,93,10.94%
2011-04,הדרום,1303,חורה,יישוב,711,307,404,0,711,662,711,5,23.47%
2011-04,הדרום,831,ירוחם,יישוב,385,191,194,19,366,261,380,43,9.33%
2011-04,הדרום,1059,כסיפה,יישוב,973,392,581,2,971,892,970,43,26.08%
2011-04,הדרום,1271,להבים,יישוב,33,15,18,16,17,3,33,3,1.08%
2011-04,הדרום,1060,לקיה,יישוב,893,396,497,4,889,836,892,14,28.02%
2011-04,הדרום,1268,מיתר,יישוב,53,19,34,25,28,5,53,5,1.44%
2011-04,הדרום,99,מצפה רמון,יישוב,214,86,128,16,198,124,203,20,9.22%
2011-04,הדרום,246,נתיבות,יישוב,879,381,498,48,831,482,875,58,7.58%
2011-04,הדרום,666,עומר,יישוב,59,22,37,34,25,7,59,4,1.59%
2011-04,הדרום,2560,ערד,יישוב,803,363,440,164,639,539,778,62,6.40%
2011-04,הדרום,1192,ערערה-בנגב,יישוב,963,379,584,3,960,890,962,21,30.13%
2011-04,הדרום,2630,קריית גת,יישוב,2110,836,1274,175,1935,1470,2105,80,8.56%
2011-04,הדרום,1034,קריית מלאכי,יישוב,1179,526,653,33,1146,820,1162,84,10.89%
2011-04,הדרום,1161,רהט,יישוב,2873,1093,1780,9,2864,2609,2871,39,20.59%
2011-04,הדרום,1286,שגב-שלום,יישוב,579,249,330,1,578,492,578,104,27.55%
2011-04,הדרום,1031,שדרות,יישוב,992,401,591,47,945,619,990,36,9.03%
2011-04,הדרום,1054,תל שבע,יישוב,1151,527,624,3,1148,1075,1149,26,30.04%
2011-04,המרכז,182,אבן יהודה,יישוב,116,60,56,37,79,12,116,11,1.96%
2011-04,המרכז,41,אליכין,יישוב,51,23,28,5,46,18,50,1,3.18%
2011-04,המרכז,1309,אלעד,יישוב,328,161,167,20,308,115,328,9,3.13%
2011-04,המרכז,2530,באר יעקב,יישוב,231,113,118,42,189,74,229,13,3.29%
2011-04,המרכז,466,בית דגן,יישוב,82,41,41,12,70,34,82,4,2.53%
2011-04,המרכז,1066,"בני עי""ש",יישוב,187,87,100,21,166,87,186,1,4.83%
2011-04,המרכז,681,גבעת שמואל,יישוב,246,122,124,93,153,47,246,6,2.37%
2011-04,המרכז,2550,גדרה,יישוב,324,143,181,62,262,105,319,2,3.20%
2011-04,המרכז,627,ג'לג'וליה,יישוב,59,28,31,5,54,32,59,1,2.10%
2011-04,המרכז,166,גן יבנה,יישוב,281,108,173,36,245,95,280,8,2.93%
2011-04,המרכז,229,גני תקווה,יישוב,148,65,83,39,109,28,148,3,2.14%
2011-04,המרכז,9700,הוד השרון,יישוב,540,251,289,198,342,55,536,27,2.16%
2011-04,המרכז,1290,זמר,יישוב,167,57,110,9,158,130,167,6,6.89%
2011-04,המרכז,2730,טייבה,יישוב,2068,843,1225,7,2061,1800,2052,33,14.02%
2011-04,המרכז,2720,טירה,יישוב,296,126,170,6,290,195,295,12,3.32%
2011-04,המרכז,2660,יבנה,יישוב,794,389,405,75,719,413,792,45,4.47%
2011-04,המרכז,9400,יהוד,יישוב,475,194,281,86,389,76,465,22,3.19%
2011-04,המרכז,1224,כוכב יאיר,יישוב,76,39,37,38,38,4,76,4,1.46%
2011-04,המרכז,633,כפר ברא,יישוב,21,12,9,0,21,7,21,3,2.07%
2011-04,המרכז,168,כפר יונה,יישוב,304,141,163,54,250,71,302,32,3.23%
2011-04,המרכז,6900,כפר סבא,יישוב,1032,452,580,306,726,197,1025,48,2.25%
2011-04,המרכז,634,כפר קאסם,יישוב,203,96,107,0,203,122,201,6,3.09%
2011-04,המרכז,7000,לוד,יישוב,2004,890,1114,181,1823,1242,1999,84,6.15%
2011-04,המרכז,1200,מודיעין-מכבים-רעות*,יישוב,832,367,465,352,480,64,823,42,2.25%
2011-04,המרכז,28,מזכרת בתיה,יישוב,137,58,79,29,108,37,135,0,2.46%
2011-04,המרכז,7200,נס ציונה,יישוב,638,269,369,130,508,207,631,2,3.19%
2011-04,המרכז,7400,נתניה,יישוב,4132,1903,2229,575,3557,1837,4097,291,4.41%
2011-04,המרכז,587,סביון*,יישוב,13,4,9,7,6,1,13,0,0.80%
2011-04,המרכז,171,פרדסייה,יישוב,65,27,38,14,51,7,65,4,1.93%
2011-04,המרכז,7900,פתח תקווה,יישוב,3653,1596,2057,745,2908,1140,3623,168,3.36%
2011-04,המרכז,195,קדימה-צורן,יישוב,208,99,109,62,146,39,208,6,2.44%
2011-04,המרכז,638,קלנסווה,יישוב,869,331,538,2,867,738,865,8,12.25%
2011-04,המרכז,469,קריית עקרון,יישוב,249,125,124,21,228,106,248,2,4.67%
2011-04,המרכז,2640,ראש העין,יישוב,580,266,314,63,517,168,578,32,2.90%
2011-04,המרכז,8300,ראשון לציון,יישוב,4117,1756,2361,867,3250,1655,4104,148,3.28%
2011-04,המרכז,8400,רחובות,יישוב,2339,1029,1310,518,1821,1010,2302,12,4.07%
2011-04,המרכז,8500,רמלה,יישוב,1629,766,863,87,1542,828,1601,105,5.05%
2011-04,המרכז,8700,רעננה,יישוב,683,323,360,266,417,79,681,29,1.97%
2011-04,המרכז,1304,שוהם,יישוב,148,59,89,61,87,10,148,14,1.55%
2011-04,המרכז,154,תל מונד,יישוב,118,50,68,38,80,23,118,6,2.22%
2011-04,הצפון,473,אבו סנאן,יישוב,711,271,440,4,707,611,707,11,14.81%
2011-04,הצפון,478,אכסאל,יישוב,538,211,327,10,528,483,538,11,11.85%
2011-04,הצפון,529,אעבלין,יישוב,612,238,374,9,603,521,612,18,13.18%
2011-04,הצפון,482,בועיינה-נוג'ידאת,יישוב,478,196,282,5,473,397,475,6,15.15%
2011-04,הצפון,4001,בוקעאתא,יישוב,368,142,226,7,361,321,360,4,15.57%
2011-04,הצפון,998,ביר אל-מכסור,יישוב,424,156,268,3,421,338,423,12,14.17%
2011-04,הצפון,480,בית ג'ן,יישוב,327,97,230,3,324,240,323,5,7.89%
2011-04,הצפון,9200,בית שאן,יישוב,746,311,435,17,729,446,744,61,8.11%
2011-04,הצפון,944,בסמת טבעון,יישוב,231,97,134,5,226,190,231,13,8.76%
2011-04,הצפון,483,בענה,יישוב,451,180,271,4,447,398,451,9,16.14%
2011-04,הצפון,1292,ג'דיידה-מכר,יישוב,1440,596,844,4,1436,1270,1440,23,18.82%
2011-04,הצפון,485,ג'ולס,יישוב,191,57,134,1,190,145,190,6,8.14%
2011-04,הצפון,487,ג'ש (גוש חלב),יישוב,56,31,25,3,53,32,55,2,3.87%
2011-04,הצפון,489,דבורייה,יישוב,429,195,234,16,413,326,428,5,11.88%
2011-04,הצפון,490,דייר אל-אסד,יישוב,397,161,236,3,394,330,397,13,9.72%
2011-04,הצפון,492,דייר חנא,יישוב,637,269,368,6,631,512,637,11,16.35%
2011-04,הצפון,975,זרזיר,יישוב,288,111,177,3,285,216,286,5,11.88%
2011-04,הצפון,496,חורפיש,יישוב,136,49,87,3,133,93,136,5,6.58%
2011-04,הצפון,2034,חצור הגלילית,יישוב,229,94,135,7,222,130,223,17,5.22%
2011-04,הצפון,6700,טבריה,יישוב,1737,767,970,116,1621,1186,1628,76,8.17%
2011-04,הצפון,962,טובא-זנגרייה,יישוב,327,143,184,5,322,249,324,8,12.40%
2011-04,הצפון,498,טורעאן,יישוב,507,191,316,6,501,450,504,13,11.15%
2011-04,הצפון,8900,טמרה,יישוב,1971,814,1157,18,1953,1764,1965,54,17.00%
2011-04,הצפון,1295,יאנוח-ג'ת,יישוב,163,49,114,3,160,117,163,5,7.71%
2011-04,הצפון,46,יבנאל,יישוב,117,64,53,6,111,90,108,1,8.28%
2011-04,הצפון,499,יפיע,יישוב,605,250,355,9,596,493,603,25,9.41%
2011-04,הצפון,240,יקנעם עילית,יישוב,450,186,264,70,380,194,450,41,4.45%
2011-04,הצפון,502,ירכא,יישוב,477,189,288,1,476,396,477,10,10.63%
2011-04,הצפון,504,כאבול,יישוב,676,280,396,6,670,603,675,14,16.64%
2011-04,הצפון,505,כאוכב אבו אל-היג'א,יישוב,202,81,121,6,196,171,202,3,14.43%
2011-04,הצפון,1296,כסרא-סמיע,יישוב,192,74,118,4,188,156,192,8,7.33%
2011-04,הצפון,978,כעביה-טבאש-חג'אג'רה,יישוב,182,75,107,3,179,140,180,4,9.81%
2011-04,הצפון,1263,כפר ורדים,יישוב,73,35,38,27,46,12,73,3,2.51%
2011-04,הצפון,507,כפר יאסיף,יישוב,496,205,291,5,491,387,495,18,11.62%
2011-04,הצפון,508,כפר כמא,יישוב,68,20,48,3,65,41,66,4,4.98%
2011-04,הצפון,509,כפר כנא,יישוב,1125,449,676,21,1104,985,1117,37,15.56%
2011-04,הצפון,510,כפר מנדא,יישוב,959,430,529,12,947,742,952,28,15.99%
2011-04,הצפון,47,כפר תבור,יישוב,43,17,26,13,30,2,41,2,2.47%
2011-04,הצפון,1139,כרמיאל,יישוב,1608,612,996,323,1285,905,1573,74,6.44%
2011-04,הצפון,481,מגאר,יישוב,1450,538,912,23,1427,1290,1446,11,19.60%
2011-04,הצפון,516,מג'ד אל-כרום,יישוב,610,256,354,9,601,499,610,16,11.69%
2011-04,הצפון,874,מגדל העמק,יישוב,819,354,465,68,751,428,784,72,6.39%
2011-04,הצפון,4201,מג'דל שמס,יישוב,454,164,290,17,437,397,450,7,11.58%
2011-04,הצפון,517,מזרעה,יישוב,169,65,104,2,167,141,168,5,10.55%
2011-04,הצפון,4203,מסעדה,יישוב,191,72,119,3,188,162,190,2,13.17%
2011-04,הצפון,518,מעיליא,יישוב,45,20,25,6,39,24,45,1,3.28%
2011-04,הצפון,1063,מעלות-תרשיחא,יישוב,837,379,458,109,728,551,834,47,7.47%
2011-04,הצפון,520,משהד,יישוב,312,109,203,2,310,271,309,7,11.95%
2011-04,הצפון,9100,נהרייה,יישוב,1939,843,1096,220,1719,1295,1929,86,6.98%
2011-04,הצפון,522,נחף,יישוב,429,180,249,9,420,354,428,14,10.65%
2011-04,הצפון,7300,נצרת,יישוב,2893,1251,1642,68,2825,2247,2884,97,9.99%
2011-04,הצפון,1061,נצרת עילית,יישוב,1848,757,1091,260,1588,1153,1755,144,7.78%
2011-04,הצפון,525,סאג'ור,יישוב,126,50,76,2,124,86,124,6,8.79%
2011-04,הצפון,7500,סח'נין,יישוב,1992,877,1115,32,1960,1725,1992,35,17.42%
2011-04,הצפון,4501,ע'ג'ר,יישוב,99,41,58,2,97,71,99,7,11.67%
2011-04,הצפון,530,עיילבון,יישוב,179,73,106,5,174,138,179,5,8.48%
2011-04,הצפון,511,עילוט,יישוב,329,130,199,6,323,270,329,8,14.22%
2011-04,הצפון,532,עין מאהל,יישוב,582,253,329,12,570,510,576,15,13.64%
2011-04,הצפון,7600,עכו,יישוב,3093,1412,1681,130,2963,2489,3074,95,12.83%
2011-04,הצפון,7700,עפולה,יישוב,1604,661,943,182,1422,872,1551,108,7.20%
2011-04,הצפון,531,עראבה,יישוב,1325,540,785,24,1301,1169,1323,32,16.47%
2011-04,הצפון,535,פסוטה,יישוב,129,54,75,6,123,91,129,4,8.69%
2011-04,הצפון,536,פקיעין (בוקייעה),יישוב,135,69,66,1,134,97,134,5,5.76%
2011-04,הצפון,8000,צפת,יישוב,889,444,445,73,816,669,882,19,7.87%
2011-04,הצפון,4100,קצרין,יישוב,202,85,117,42,160,97,200,6,5.41%
2011-04,הצפון,2800,קריית שמונה,יישוב,688,313,375,51,637,293,669,63,5.52%
2011-04,הצפון,543,ראמה,יישוב,296,122,174,8,288,238,295,2,9.27%
2011-04,הצפון,26,ראש פינה,יישוב,50,19,31,6,44,20,50,3,3.65%
2011-04,הצפון,542,ריינה,יישוב,575,228,347,9,566,483,570,16,10.39%
2011-04,הצפון,122,רמת ישי,יישוב,85,27,58,23,62,8,84,3,2.31%
2011-04,הצפון,913,שבלי - אום אל-גנם,יישוב,244,107,137,4,240,187,243,11,11.36%
2011-04,הצפון,812,שלומי,יישוב,241,97,144,14,227,166,238,14,7.33%
2011-04,הצפון,538,שעב,יישוב,478,205,273,4,474,405,477,9,19.00%
2011-04,הצפון,8800,שפרעם,יישוב,1913,740,1173,29,1884,1617,1909,63,13.08%
2011-04,חיפה,2710,אום אל-פחם,יישוב,3518,1424,2094,11,3507,3074,3514,44,20.78%
2011-04,חיפה,1020,אור עקיבא,יישוב,519,224,295,39,480,228,507,61,5.65%
2011-04,חיפה,6000,באקה אל-גרביה,יישוב,650,325,325,10,640,412,650,40,NULL
2011-04,חיפה,9800,בנימינה-גבעת עדה*,יישוב,179,77,102,62,117,46,179,11,2.94%
2011-04,חיפה,1326,"בסמ""ה",יישוב,383,167,216,3,380,309,383,7,12.09%
2011-04,חיפה,541,ג'סר א-זרקא,יישוב,363,205,158,0,363,273,361,7,7.24%
2011-04,חיפה,628,ג'ת,יישוב,203,98,105,8,195,123,202,17,NULL
2011-04,חיפה,494,דאלית אל-כרמל,יישוב,443,180,263,10,433,289,440,8,6.56%
2011-04,חיפה,9300,זכרון יעקב,יישוב,223,107,116,68,155,49,221,13,2.46%
2011-04,חיפה,6500,חדרה,יישוב,2085,856,1229,260,1825,880,2057,155,4.71%
2011-04,חיפה,4000,חיפה,יישוב,7424,3246,4178,1458,5966,5003,7380,349,5.68%
2011-04,חיפה,1247,חריש-קציר,יישוב,28,8,20,2,26,9,27,1,1.65%
2011-04,חיפה,2100,טירת כרמל,יישוב,740,336,404,37,703,489,732,54,7.70%
2011-04,חיפה,654,כפר קרע,יישוב,347,152,195,8,339,224,345,20,5.07%
2011-04,חיפה,1327,מעלה עירון,יישוב,880,359,521,2,878,715,880,15,18.48%
2011-04,חיפה,2500,נשר,יישוב,513,236,277,98,415,285,510,31,4.22%
2011-04,חיפה,534,עספיא,יישוב,310,133,177,5,305,206,310,13,6.56%
2011-04,חיפה,637,ערערה,יישוב,530,195,335,7,523,372,530,19,8.02%
2011-04,חיפה,537,פוריידיס,יישוב,379,191,188,3,376,262,378,18,8.06%
2011-04,חיפה,7800,פרדס חנה-כרכור,יישוב,756,318,438,110,646,276,753,54,4.51%
2011-04,חיפה,6800,קריית אתא,יישוב,1841,752,1089,147,1694,1197,1834,84,6.89%
2011-04,חיפה,9500,קריית ביאליק,יישוב,1163,471,692,147,1016,678,1158,61,5.84%
2011-04,חיפה,2300,קריית טבעון,יישוב,173,78,95,50,123,50,172,7,2.29%
2011-04,חיפה,9600,קריית ים,יישוב,1664,731,933,162,1502,1169,1658,65,8.36%
2011-04,חיפה,8200,קריית מוצקין,יישוב,1107,438,669,161,946,627,1101,55,5.33%
2011-04,חיפה,922,רכסים,יישוב,137,64,73,5,132,97,137,3,5.10%
2011-04,ירושלים,472,אבו גוש,יישוב,232,105,127,5,227,183,232,2,9.70%
2011-04,ירושלים,2610,בית שמש,יישוב,945,413,532,88,857,517,936,32,3.84%
2011-04,ירושלים,3000,ירושלים,יישוב,9123,3956,5167,1060,8063,5819,9089,347,3.67%
2011-04,ירושלים,1015,מבשרת ציון,יישוב,318,144,174,62,256,156,318,21,2.73%
2011-04,ירושלים,1137,קריית יערים,יישוב,26,11,15,5,21,12,26,3,2.61%
2011-04,תל אביב,2400,אור יהודה,יישוב,732,322,410,35,697,290,725,46,4.19%
2011-04,תל אביב,565,אזור,יישוב,151,82,69,18,133,38,150,11,2.56%
2011-04,תל אביב,6100,בני ברק,יישוב,2062,1022,1040,119,1943,1321,2044,97,4.45%
2011-04,תל אביב,6200,בת ים,יישוב,3161,1420,1741,447,2714,1488,3113,231,4.49%
2011-04,תל אביב,6300,גבעתיים,יישוב,666,301,365,278,388,111,665,31,2.44%
2011-04,תל אביב,6400,הרצלייה,יישוב,889,406,483,260,629,96,878,90,1.95%
2011-04,תל אביב,6600,חולון,יישוב,2663,1210,1453,466,2197,958,2630,193,2.86%
2011-04,תל אביב,2620,קריית אונו,יישוב,357,152,205,145,212,45,354,14,2.20%
2011-04,תל אביב,8600,רמת גן,יישוב,1857,840,1017,572,1285,496,1843,102,2.60%
2011-04,תל אביב,2650,רמת השרון,יישוב,331,138,193,135,196,22,329,32,1.62%
2011-04,תל אביב,5000,תל אביב -יפו,יישוב,7085,3522,3563,2087,4998,2717,7033,380,3.07%
2011-05,אזור יהודה והשומרון,3760,אורנית,יישוב,88,46,42,35,53,3,88,5,2.35%
2011-05,אזור יהודה והשומרון,3750,אלפי מנשה,יישוב,103,46,57,31,72,3,102,10,2.52%
2011-05,אזור יהודה והשומרון,3560,אלקנה,יישוב,38,20,18,22,16,2,38,4,2.23%
2011-05,אזור יהודה והשומרון,3650,אפרתה,יישוב,44,24,20,27,17,6,44,1,1.26%
2011-05,אזור יהודה והשומרון,3570,אריאל,יישוב,377,162,215,98,279,109,376,44,3.79%
2011-05,אזור יהודה והשומרון,3574,בית אל,יישוב,53,25,28,14,39,16,53,6,2.49%
2011-05,אזור יהודה והשומרון,3652,בית אריה,יישוב,61,21,40,9,52,5,61,1,2.87%
2011-05,אזור יהודה והשומרון,3780,ביתר עילית,יישוב,387,188,199,14,373,216,383,30,4.58%
2011-05,אזור יהודה והשומרון,3730,גבעת זאב,יישוב,189,92,97,30,159,50,188,15,3.12%
2011-05,אזור יהודה והשומרון,3769,הר אדר,יישוב,26,12,14,13,13,1,26,1,1.52%
2011-05,אזור יהודה והשומרון,3797,מודיעין עילית,יישוב,287,104,183,19,268,95,285,11,2.76%
2011-05,אזור יהודה והשומרון,3616,מעלה אדומים,יישוב,744,306,438,110,634,230,739,63,4.16%
2011-05,אזור יהודה והשומרון,3660,עמנואל,יישוב,78,36,42,5,73,51,77,2,8.27%
2011-05,אזור יהודה והשומרון,3557,קדומים,יישוב,24,11,13,5,19,6,24,1,1.50%
2011-05,אזור יהודה והשומרון,3611,קריית ארבע,יישוב,113,54,59,16,97,70,113,10,4.07%
2011-05,אזור יהודה והשומרון,3640,קרני שומרון,יישוב,74,43,31,21,53,20,73,5,2.25%
2011-05,הדרום,31,אופקים,יישוב,1363,584,779,98,1265,981,1351,56,12.05%
2011-05,הדרום,2600,אילת,יישוב,1351,628,723,80,1271,646,1339,115,4.39%
2011-05,הדרום,70,אשדוד,יישוב,6819,2640,4179,799,6020,4102,6760,523,6.79%
2011-05,הדרום,7100,אשקלון,יישוב,4294,1658,2636,675,3619,2689,4203,240,7.26%
2011-05,הדרום,9000,באר שבע,יישוב,7198,3036,4162,944,6254,4838,7140,574,7.62%
2011-05,הדרום,2200,דימונה,יישוב,2052,910,1142,116,1936,1452,2026,144,11.61%
2011-05,הדרום,1303,חורה,יישוב,711,303,408,0,711,668,710,4,23.44%
2011-05,הדרום,831,ירוחם,יישוב,433,208,225,20,413,267,429,71,10.41%
2011-05,הדרום,1059,כסיפה,יישוב,967,400,567,2,965,894,966,28,26.00%
2011-05,הדרום,1271,להבים,יישוב,41,17,24,22,19,4,41,5,1.34%
2011-05,הדרום,1060,לקיה,יישוב,898,399,499,6,892,838,897,12,28.13%
2011-05,הדרום,1268,מיתר,יישוב,57,21,36,22,35,5,57,5,1.55%
2011-05,הדרום,99,מצפה רמון,יישוב,229,95,134,14,215,127,218,40,9.83%
2011-05,הדרום,246,נתיבות,יישוב,986,407,579,49,937,523,981,127,8.42%
2011-05,הדרום,666,עומר,יישוב,57,19,38,32,25,7,57,5,1.54%
2011-05,הדרום,2560,ערד,יישוב,879,398,481,172,707,538,841,127,6.88%
2011-05,הדרום,1192,ערערה-בנגב,יישוב,972,391,581,3,969,895,971,18,30.32%
2011-05,הדרום,2630,קריית גת,יישוב,2254,902,1352,176,2078,1517,2246,144,9.08%
2011-05,הדרום,1034,קריית מלאכי,יישוב,1292,577,715,31,1261,843,1268,131,11.76%
2011-05,הדרום,1161,רהט,יישוב,2948,1150,1798,8,2940,2635,2947,87,21.02%
2011-05,הדרום,1286,שגב-שלום,יישוב,604,259,345,0,604,462,602,118,28.37%
2011-05,הדרום,1031,שדרות,יישוב,1084,451,633,51,1033,650,1081,95,9.78%
2011-05,הדרום,1054,תל שבע,יישוב,1166,549,617,3,1163,1080,1164,36,30.31%
2011-05,המרכז,182,אבן יהודה,יישוב,128,63,65,45,83,15,128,14,2.16%
2011-05,המרכז,41,אליכין,יישוב,54,26,28,6,48,18,53,2,3.37%
2011-05,המרכז,1309,אלעד,יישוב,362,180,182,19,343,124,361,22,3.44%
2011-05,המרכז,2530,באר יעקב,יישוב,233,109,124,48,185,74,230,28,3.31%
2011-05,המרכז,466,בית דגן,יישוב,88,46,42,13,75,34,87,6,2.68%
2011-05,המרכז,1066,"בני עי""ש",יישוב,200,93,107,22,178,86,196,1,5.08%
2011-05,המרכז,681,גבעת שמואל,יישוב,276,143,133,109,167,57,276,14,2.65%
2011-05,המרכז,2550,גדרה,יישוב,346,159,187,61,285,106,340,4,3.40%
2011-05,המרכז,627,ג'לג'וליה,יישוב,66,31,35,4,62,36,66,2,2.34%
2011-05,המרכז,166,גן יבנה,יישוב,318,115,203,42,276,102,317,33,3.30%
2011-05,המרכז,229,גני תקווה,יישוב,175,74,101,50,125,25,174,7,2.50%
2011-05,המרכז,9700,הוד השרון,יישוב,588,285,303,204,384,64,584,41,2.34%
2011-05,המרכז,1290,זמר,יישוב,168,57,111,9,159,125,168,11,6.93%
2011-05,המרכז,2730,טייבה,יישוב,2087,864,1223,6,2081,1807,2076,44,14.16%
2011-05,המרכז,2720,טירה,יישוב,323,150,173,8,315,202,321,18,3.60%
2011-05,המרכז,2660,יבנה,יישוב,872,427,445,78,794,430,871,83,4.89%
2011-05,המרכז,9400,יהוד,יישוב,587,250,337,101,486,79,566,45,3.86%
2011-05,המרכז,1224,כוכב יאיר,יישוב,84,39,45,42,42,6,84,4,1.61%
2011-05,המרכז,633,כפר ברא,יישוב,26,14,12,0,26,8,26,2,2.55%
2011-05,המרכז,168,כפר יונה,יישוב,315,147,168,55,260,78,312,30,3.33%
2011-05,המרכז,6900,כפר סבא,יישוב,1152,506,646,340,812,207,1143,81,2.50%
2011-05,המרכז,634,כפר קאסם,יישוב,222,117,105,2,220,122,221,9,3.39%
2011-05,המרכז,7000,לוד,יישוב,2182,988,1194,194,1988,1255,2175,145,6.65%
2011-05,המרכז,1200,מודיעין-מכבים-רעות*,יישוב,934,415,519,389,545,68,924,88,2.52%
2011-05,המרכז,28,מזכרת בתיה,יישוב,143,62,81,32,111,40,141,1,2.57%
2011-05,המרכז,7200,נס ציונה,יישוב,653,271,382,139,514,209,641,3,3.23%
2011-05,המרכז,7400,נתניה,יישוב,4592,2135,2457,653,3939,1920,4537,486,4.86%
2011-05,המרכז,587,סביון*,יישוב,19,6,13,7,12,1,19,0,1.17%
2011-05,המרכז,171,פרדסייה,יישוב,78,35,43,17,61,7,78,10,2.31%
2011-05,המרכז,7900,פתח תקווה,יישוב,4149,1777,2372,849,3300,1191,4111,337,3.80%
2011-05,המרכז,195,קדימה-צורן,יישוב,236,115,121,73,163,43,236,19,2.76%
2011-05,המרכז,638,קלנסווה,יישוב,892,351,541,1,891,753,888,19,12.54%
2011-05,המרכז,469,קריית עקרון,יישוב,278,138,140,25,253,114,276,7,5.17%
2011-05,המרכז,2640,ראש העין,יישוב,749,353,396,85,664,181,736,62,3.67%
2011-05,המרכז,8300,ראשון לציון,יישוב,4553,1938,2615,898,3655,1728,4529,439,3.60%
2011-05,המרכז,8400,רחובות,יישוב,2541,1096,1445,560,1981,1058,2493,12,4.39%
2011-05,המרכז,8500,רמלה,יישוב,1821,852,969,103,1718,872,1781,180,5.59%
2011-05,המרכז,8700,רעננה,יישוב,748,360,388,274,474,87,747,50,2.15%
2011-05,המרכז,1304,שוהם,יישוב,162,69,93,73,89,8,162,20,1.70%
2011-05,המרכז,154,תל מונד,יישוב,125,56,69,39,86,23,125,7,2.35%
2011-05,הצפון,473,אבו סנאן,יישוב,714,269,445,4,710,613,710,25,14.87%
2011-05,הצפון,478,אכסאל,יישוב,536,210,326,9,527,482,536,10,11.81%
2011-05,הצפון,529,אעבלין,יישוב,614,244,370,10,604,521,614,30,13.21%
2011-05,הצפון,482,בועיינה-נוג'ידאת,יישוב,485,197,288,4,481,396,481,20,15.31%
2011-05,הצפון,4001,בוקעאתא,יישוב,380,151,229,8,372,324,371,10,15.97%
2011-05,הצפון,998,ביר אל-מכסור,יישוב,429,162,267,3,426,332,428,10,14.31%
2011-05,הצפון,480,בית ג'ן,יישוב,352,92,260,1,351,258,348,20,8.45%
2011-05,הצפון,9200,בית שאן,יישוב,804,329,475,21,783,457,802,77,8.68%
2011-05,הצפון,944,בסמת טבעון,יישוב,233,98,135,4,229,191,232,7,8.79%
2011-05,הצפון,483,בענה,יישוב,456,179,277,3,453,395,456,16,16.29%
2011-05,הצפון,1292,ג'דיידה-מכר,יישוב,1464,609,855,6,1458,1292,1463,30,19.06%
2011-05,הצפון,485,ג'ולס,יישוב,190,56,134,1,189,144,189,8,8.10%
2011-05,הצפון,487,ג'ש (גוש חלב),יישוב,55,28,27,3,52,33,54,5,3.80%
2011-05,הצפון,489,דבורייה,יישוב,434,193,241,15,419,332,433,13,12.00%
2011-05,הצפון,490,דייר אל-אסד,יישוב,409,171,238,5,404,340,409,7,9.98%
2011-05,הצפון,492,דייר חנא,יישוב,632,270,362,5,627,510,632,20,16.24%
2011-05,הצפון,975,זרזיר,יישוב,296,118,178,3,293,213,291,9,12.06%
2011-05,הצפון,496,חורפיש,יישוב,163,55,108,5,158,96,163,13,7.78%
2011-05,הצפון,2034,חצור הגלילית,יישוב,273,110,163,7,266,130,264,46,6.12%
2011-05,הצפון,6700,טבריה,יישוב,1850,817,1033,120,1730,1237,1738,130,8.68%
2011-05,הצפון,962,טובא-זנגרייה,יישוב,371,150,221,4,367,251,366,14,13.79%
2011-05,הצפון,498,טורעאן,יישוב,503,187,316,5,498,453,500,14,11.07%
2011-05,הצפון,8900,טמרה,יישוב,1968,835,1133,21,1947,1734,1963,64,16.99%
2011-05,הצפון,1295,יאנוח-ג'ת,יישוב,167,53,114,3,164,121,167,6,7.89%
2011-05,הצפון,46,יבנאל,יישוב,127,74,53,6,121,99,119,3,9.04%
2011-05,הצפון,499,יפיע,יישוב,614,251,363,7,607,500,611,22,9.53%
2011-05,הצפון,240,יקנעם עילית,יישוב,505,211,294,73,432,208,504,51,4.96%
2011-05,הצפון,502,ירכא,יישוב,488,197,291,1,487,408,488,15,10.85%
2011-05,הצפון,504,כאבול,יישוב,674,276,398,7,667,596,673,16,16.60%
2011-05,הצפון,505,כאוכב אבו אל-היג'א,יישוב,197,78,119,5,192,170,197,6,14.12%
2011-05,הצפון,1296,כסרא-סמיע,יישוב,218,80,138,3,215,164,218,13,8.24%
2011-05,הצפון,978,כעביה-טבאש-חג'אג'רה,יישוב,191,81,110,2,189,143,189,9,10.26%
2011-05,הצפון,1263,כפר ורדים,יישוב,77,37,40,33,44,9,77,1,2.64%
2011-05,הצפון,507,כפר יאסיף,יישוב,490,203,287,5,485,389,489,19,11.50%
2011-05,הצפון,508,כפר כמא,יישוב,66,23,43,4,62,43,64,2,4.84%
2011-05,הצפון,509,כפר כנא,יישוב,1122,439,683,20,1102,984,1114,36,15.53%
2011-05,הצפון,510,כפר מנדא,יישוב,1002,453,549,12,990,758,993,40,16.57%
2011-05,הצפון,47,כפר תבור,יישוב,44,17,27,15,29,2,42,1,2.52%
2011-05,הצפון,1139,כרמיאל,יישוב,1758,664,1094,350,1408,952,1700,116,6.92%
2011-05,הצפון,481,מגאר,יישוב,1489,578,911,24,1465,1314,1485,72,20.02%
2011-05,הצפון,516,מג'ד אל-כרום,יישוב,623,259,364,11,612,505,623,20,11.91%
2011-05,הצפון,874,מגדל העמק,יישוב,967,412,555,83,884,462,918,125,7.40%
2011-05,הצפון,4201,מג'דל שמס,יישוב,472,176,296,22,450,404,467,7,11.97%
2011-05,הצפון,517,מזרעה,יישוב,172,64,108,2,170,145,171,4,10.72%
2011-05,הצפון,4203,מסעדה,יישוב,201,73,128,4,197,172,200,3,13.76%
2011-05,הצפון,518,מעיליא,יישוב,43,20,23,4,39,25,43,2,3.14%
2011-05,הצפון,1063,מעלות-תרשיחא,יישוב,893,399,494,112,781,579,891,52,7.94%
2011-05,הצפון,520,משהד,יישוב,317,109,208,1,316,273,314,9,12.12%
2011-05,הצפון,9100,נהרייה,יישוב,2071,893,1178,238,1833,1323,2059,125,7.42%
2011-05,הצפון,522,נחף,יישוב,436,191,245,10,426,357,435,13,10.80%
2011-05,הצפון,7300,נצרת,יישוב,2883,1233,1650,61,2822,2237,2871,99,9.95%
2011-05,הצפון,1061,נצרת עילית,יישוב,2007,840,1167,261,1746,1160,1912,254,8.42%
2011-05,הצפון,525,סאג'ור,יישוב,131,47,84,2,129,92,130,2,9.18%
2011-05,הצפון,7500,סח'נין,יישוב,1992,885,1107,33,1959,1708,1992,52,17.42%
2011-05,הצפון,4501,ע'ג'ר,יישוב,94,33,61,2,92,67,94,6,11.15%
2011-05,הצפון,530,עיילבון,יישוב,178,71,107,7,171,144,178,11,8.44%
2011-05,הצפון,511,עילוט,יישוב,327,121,206,7,320,276,327,16,14.14%
2011-05,הצפון,532,עין מאהל,יישוב,581,256,325,11,570,511,572,25,13.56%
2011-05,הצפון,7600,עכו,יישוב,3213,1454,1759,136,3077,2549,3195,142,13.27%
2011-05,הצפון,7700,עפולה,יישוב,1803,738,1065,192,1611,909,1738,166,8.00%
2011-05,הצפון,531,עראבה,יישוב,1334,540,794,26,1308,1162,1332,38,16.56%
2011-05,הצפון,535,פסוטה,יישוב,134,53,81,6,128,96,134,6,8.99%
2011-05,הצפון,536,פקיעין (בוקייעה),יישוב,132,66,66,3,129,94,131,3,5.64%
2011-05,הצפון,8000,צפת,יישוב,969,484,485,73,896,709,958,30,8.49%
2011-05,הצפון,4100,קצרין,יישוב,205,88,117,47,158,96,203,13,5.48%
2011-05,הצפון,2800,קריית שמונה,יישוב,765,354,411,51,714,305,742,100,6.08%
2011-05,הצפון,543,ראמה,יישוב,310,135,175,8,302,240,308,5,9.63%
2011-05,הצפון,26,ראש פינה,יישוב,48,17,31,5,43,20,48,6,3.51%
2011-05,הצפון,542,ריינה,יישוב,593,238,355,9,584,489,588,32,10.69%
2011-05,הצפון,122,רמת ישי,יישוב,87,27,60,25,62,11,86,12,2.37%
2011-05,הצפון,913,שבלי - אום אל-גנם,יישוב,239,107,132,6,233,184,238,9,11.15%
2011-05,הצפון,812,שלומי,יישוב,260,108,152,15,245,172,256,18,7.84%
2011-05,הצפון,538,שעב,יישוב,482,207,275,2,480,409,481,9,19.13%
2011-05,הצפון,8800,שפרעם,יישוב,1930,760,1170,26,1904,1613,1922,90,13.16%
2011-05,חיפה,2710,אום אל-פחם,יישוב,3566,1434,2132,10,3556,3107,3562,47,21.01%
2011-05,חיפה,1020,אור עקיבא,יישוב,598,244,354,46,552,244,579,91,6.40%
2011-05,חיפה,6000,באקה אל-גרביה,יישוב,680,337,343,11,669,417,680,51,NULL
2011-05,חיפה,9800,בנימינה-גבעת עדה*,יישוב,194,83,111,61,133,51,194,19,3.18%
2011-05,חיפה,1326,"בסמ""ה",יישוב,380,159,221,3,377,313,380,13,12.00%
2011-05,חיפה,541,ג'סר א-זרקא,יישוב,428,244,184,0,428,287,426,15,8.44%
2011-05,חיפה,628,ג'ת,יישוב,208,98,110,5,203,129,207,11,NULL
2011-05,חיפה,494,דאלית אל-כרמל,יישוב,457,183,274,10,447,293,454,22,6.76%
2011-05,חיפה,9300,זכרון יעקב,יישוב,226,106,120,73,153,47,224,19,2.49%
2011-05,חיפה,6500,חדרה,יישוב,2404,972,1432,281,2123,945,2362,240,5.38%
2011-05,חיפה,4000,חיפה,יישוב,7746,3380,4366,1501,6245,5053,7699,563,5.91%
2011-05,חיפה,1247,חריש-קציר,יישוב,26,9,17,2,24,8,26,1,1.59%
2011-05,חיפה,2100,טירת כרמל,יישוב,801,361,440,37,764,508,797,78,8.32%
2011-05,חיפה,654,כפר קרע,יישוב,356,157,199,5,351,231,354,22,5.20%
2011-05,חיפה,1327,מעלה עירון,יישוב,881,355,526,3,878,727,881,16,18.50%
2011-05,חיפה,2500,נשר,יישוב,559,266,293,104,455,284,554,57,4.57%
2011-05,חיפה,534,עספיא,יישוב,326,137,189,8,318,204,326,19,6.88%
2011-05,חיפה,637,ערערה,יישוב,540,200,340,8,532,376,539,26,8.14%
2011-05,חיפה,537,פוריידיס,יישוב,373,187,186,5,368,260,371,19,7.92%
2011-05,חיפה,7800,פרדס חנה-כרכור,יישוב,856,377,479,128,728,296,849,105,5.05%
2011-05,חיפה,6800,קריית אתא,יישוב,1939,812,1127,158,1781,1195,1929,146,7.22%
2011-05,חיפה,9500,קריית ביאליק,יישוב,1266,494,772,157,1109,699,1262,90,6.33%
2011-05,חיפה,2300,קריית טבעון,יישוב,183,82,101,62,121,48,182,13,2.42%
2011-05,חיפה,9600,קריית ים,יישוב,1749,774,975,165,1584,1176,1740,112,8.74%
2011-05,חיפה,8200,קריית מוצקין,יישוב,1212,498,714,171,1041,643,1205,93,5.80%
2011-05,חיפה,922,רכסים,יישוב,150,67,83,5,145,103,149,14,5.52%
2011-05,ירושלים,472,אבו גוש,יישוב,237,110,127,4,233,185,237,11,9.89%
2011-05,ירושלים,2610,בית שמש,יישוב,1149,506,643,92,1057,567,1141,117,4.64%
2011-05,ירושלים,3000,ירושלים,יישוב,9904,4299,5605,1195,8709,6061,9837,704,3.96%
2011-05,ירושלים,1015,מבשרת ציון,יישוב,379,171,208,68,311,182,378,22,3.23%
2011-05,ירושלים,1137,קריית יערים,יישוב,27,9,18,3,24,10,27,3,2.71%
2011-05,תל אביב,2400,אור יהודה,יישוב,1024,479,545,45,979,301,1014,78,5.77%
2011-05,תל אביב,565,אזור,יישוב,175,86,89,20,155,37,171,21,2.91%
2011-05,תל אביב,6100,בני ברק,יישוב,2180,1082,1098,137,2043,1380,2167,153,4.71%
2011-05,תל אביב,6200,בת ים,יישוב,3385,1516,1869,462,2923,1502,3326,326,4.78%
2011-05,תל אביב,6300,גבעתיים,יישוב,744,329,415,313,431,121,742,75,2.72%
2011-05,תל אביב,6400,הרצלייה,יישוב,968,447,521,279,689,94,954,119,2.11%
2011-05,תל אביב,6600,חולון,יישוב,3041,1393,1648,492,2549,998,3007,308,3.26%
2011-05,תל אביב,2620,קריית אונו,יישוב,422,183,239,152,270,47,420,29,2.60%
2011-05,תל אביב,8600,רמת גן,יישוב,2196,1014,1182,636,1560,508,2182,183,3.06%
2011-05,תל אביב,2650,רמת השרון,יישוב,383,169,214,150,233,20,382,42,1.88%
2011-05,תל אביב,5000,תל אביב -יפו,יישוב,7812,3869,3943,2290,5522,2839,7739,686,3.36%
2011-06,אזור יהודה והשומרון,3760,אורנית,יישוב,238,124,114,34,204,4,238,5,6.12%
2011-06,אזור יהודה והשומרון,3750,אלפי מנשה,יישוב,104,43,61,29,75,4,103,6,2.55%
2011-06,אזור יהודה והשומרון,3560,אלקנה,יישוב,39,18,21,23,16,2,39,6,2.29%
2011-06,אזור יהודה והשומרון,3650,אפרתה,יישוב,61,33,28,26,35,9,61,1,1.73%
2011-06,אזור יהודה והשומרון,3570,אריאל,יישוב,457,206,251,97,360,105,456,44,4.57%
2011-06,אזור יהודה והשומרון,3574,בית אל,יישוב,57,28,29,14,43,15,56,5,2.62%
2011-06,אזור יהודה והשומרון,3652,בית אריה,יישוב,76,30,46,11,65,5,76,6,3.56%
2011-06,אזור יהודה והשומרון,3780,ביתר עילית,יישוב,424,199,225,17,407,226,420,18,5.00%
2011-06,אזור יהודה והשומרון,3730,גבעת זאב,יישוב,218,111,107,31,187,47,217,14,3.58%
2011-06,אזור יהודה והשומרון,3769,הר אדר,יישוב,43,24,19,15,28,1,43,0,2.49%
2011-06,אזור יהודה והשומרון,3797,מודיעין עילית,יישוב,369,123,246,18,351,97,365,9,3.50%
2011-06,אזור יהודה והשומרון,3616,מעלה אדומים,יישוב,656,280,376,92,564,224,646,56,3.66%
2011-06,אזור יהודה והשומרון,3660,עמנואל,יישוב,90,43,47,5,85,55,90,2,9.53%
2011-06,אזור יהודה והשומרון,3557,קדומים,יישוב,35,19,16,6,29,6,35,1,2.18%
2011-06,אזור יהודה והשומרון,3611,קריית ארבע,יישוב,118,60,58,21,97,63,118,4,4.24%
2011-06,אזור יהודה והשומרון,3640,קרני שומרון,יישוב,97,56,41,22,75,19,95,6,2.91%
2011-06,הדרום,31,אופקים,יישוב,1450,637,813,99,1351,974,1438,49,12.73%
2011-06,הדרום,2600,אילת,יישוב,1621,756,865,83,1538,646,1608,145,5.23%
2011-06,הדרום,70,אשדוד,יישוב,7428,2988,4440,788,6640,4072,7377,541,7.36%
2011-06,הדרום,7100,אשקלון,יישוב,4689,1860,2829,662,4027,2662,4596,405,7.89%
2011-06,הדרום,9000,באר שבע,יישוב,8002,3513,4489,956,7046,4784,7939,1003,8.41%
2011-06,הדרום,2200,דימונה,יישוב,2214,1004,1210,128,2086,1450,2192,211,12.45%
2011-06,הדרום,1303,חורה,יישוב,715,308,407,0,715,664,714,15,23.54%
2011-06,הדרום,831,ירוחם,יישוב,498,248,250,19,479,267,489,101,11.69%
2011-06,הדרום,1059,כסיפה,יישוב,975,410,565,2,973,904,973,38,26.13%
2011-06,הדרום,1271,להבים,יישוב,77,39,38,19,58,3,77,30,2.49%
2011-06,הדרום,1060,לקיה,יישוב,887,391,496,5,882,832,886,10,27.88%
2011-06,הדרום,1268,מיתר,יישוב,109,54,55,23,86,4,109,30,2.92%
2011-06,הדרום,99,מצפה רמון,יישוב,279,116,163,16,263,124,268,64,11.82%
2011-06,הדרום,246,נתיבות,יישוב,1214,511,703,52,1162,534,1208,163,10.18%
2011-06,הדרום,666,עומר,יישוב,83,40,43,36,47,5,83,25,2.22%
2011-06,הדרום,2560,ערד,יישוב,898,406,492,159,739,523,878,190,7.16%
2011-06,הדרום,1192,ערערה-בנגב,יישוב,979,393,586,3,976,901,979,4,30.50%
2011-06,הדרום,2630,קריית גת,יישוב,2348,962,1386,172,2176,1505,2342,124,9.43%
2011-06,הדרום,1034,קריית מלאכי,יישוב,1374,633,741,26,1348,831,1349,219,12.42%
2011-06,הדרום,1161,רהט,יישוב,2969,1188,1781,8,2961,2597,2967,90,21.13%
2011-06,הדרום,1286,שגב-שלום,יישוב,467,189,278,0,467,417,467,148,23.50%
2011-06,הדרום,1031,שדרות,יישוב,1234,514,720,51,1183,648,1232,150,11.00%
2011-06,הדרום,1054,תל שבע,יישוב,1171,547,624,3,1168,1084,1171,41,30.44%
2011-06,המרכז,182,אבן יהודה,יישוב,165,81,84,44,121,19,165,15,2.77%
2011-06,המרכז,41,אליכין,יישוב,72,34,38,5,67,15,71,5,4.46%
2011-06,המרכז,1309,אלעד,יישוב,349,173,176,19,330,118,348,20,3.32%
2011-06,המרכז,2530,באר יעקב,יישוב,270,124,146,40,230,73,266,13,3.80%
2011-06,המרכז,466,בית דגן,יישוב,174,80,94,18,156,35,174,11,5.22%
2011-06,המרכז,1066,"בני עי""ש",יישוב,190,85,105,23,167,85,190,2,4.93%
2011-06,המרכז,681,גבעת שמואל,יישוב,422,219,203,108,314,55,421,19,3.99%
2011-06,המרכז,2550,גדרה,יישוב,387,178,209,60,327,104,384,7,3.83%
2011-06,המרכז,627,ג'לג'וליה,יישוב,74,38,36,4,70,35,74,4,2.62%
2011-06,המרכז,166,גן יבנה,יישוב,377,152,225,37,340,100,376,17,3.89%
2011-06,המרכז,229,גני תקווה,יישוב,239,106,133,47,192,26,239,8,3.41%
2011-06,המרכז,9700,הוד השרון,יישוב,690,361,329,200,490,58,688,40,2.75%
2011-06,המרכז,1290,זמר,יישוב,157,52,105,7,150,122,157,9,6.50%
2011-06,המרכז,2730,טייבה,יישוב,2135,899,1236,5,2130,1812,2123,30,14.43%
2011-06,המרכז,2720,טירה,יישוב,326,167,159,9,317,194,324,19,3.63%
2011-06,המרכז,2660,יבנה,יישוב,973,468,505,75,898,428,969,83,5.41%
2011-06,המרכז,9400,יהוד,יישוב,631,270,361,88,543,73,611,49,4.15%
2011-06,המרכז,1224,כוכב יאיר,יישוב,125,54,71,32,93,4,125,4,2.37%
2011-06,המרכז,633,כפר ברא,יישוב,24,15,9,0,24,6,24,0,2.36%
2011-06,המרכז,168,כפר יונה,יישוב,340,159,181,56,284,74,339,26,3.61%
2011-06,המרכז,6900,כפר סבא,יישוב,1240,567,673,339,901,195,1229,87,2.68%
2011-06,המרכז,634,כפר קאסם,יישוב,209,101,108,3,206,119,208,11,3.20%
2011-06,המרכז,7000,לוד,יישוב,2469,1144,1325,178,2291,1246,2461,137,7.46%
2011-06,המרכז,1200,מודיעין-מכבים-רעות*,יישוב,1298,593,705,365,933,74,1289,103,3.49%
2011-06,המרכז,28,מזכרת בתיה,יישוב,154,64,90,33,121,36,154,4,2.80%
2011-06,המרכז,7200,נס ציונה,יישוב,672,289,383,145,527,204,663,7,3.34%
2011-06,המרכז,7400,נתניה,יישוב,5124,2424,2700,673,4451,1821,5079,419,5.41%
2011-06,המרכז,587,סביון*,יישוב,17,10,7,4,13,1,17,0,1.05%
2011-06,המרכז,171,פרדסייה,יישוב,84,30,54,12,72,10,84,7,2.48%
2011-06,המרכז,7900,פתח תקווה,יישוב,5087,2318,2769,825,4262,1167,5049,282,4.63%
2011-06,המרכז,195,קדימה-צורן,יישוב,294,140,154,66,228,40,294,19,3.41%
2011-06,המרכז,638,קלנסווה,יישוב,914,360,554,1,913,764,909,18,12.80%
2011-06,המרכז,469,קריית עקרון,יישוב,265,127,138,25,240,110,261,3,4.90%
2011-06,המרכז,2640,ראש העין,יישוב,1001,512,489,92,909,174,992,71,4.88%
2011-06,המרכז,8300,ראשון לציון,יישוב,5944,2623,3321,850,5094,1702,5926,365,4.66%
2011-06,המרכז,8400,רחובות,יישוב,2582,1143,1439,529,2053,1044,2534,23,4.46%
2011-06,המרכז,8500,רמלה,יישוב,2002,945,1057,117,1885,857,1961,165,6.12%
2011-06,המרכז,8700,רעננה,יישוב,856,427,429,280,576,78,854,49,2.45%
2011-06,המרכז,1304,שוהם,יישוב,295,157,138,62,233,6,295,19,3.04%
2011-06,המרכז,154,תל מונד,יישוב,156,71,85,43,113,22,156,5,2.92%
2011-06,הצפון,473,אבו סנאן,יישוב,715,267,448,4,711,611,711,17,14.88%
2011-06,הצפון,478,אכסאל,יישוב,536,214,322,9,527,478,535,17,11.79%
2011-06,הצפון,529,אעבלין,יישוב,605,240,365,12,593,517,605,17,13.04%
2011-06,הצפון,482,בועיינה-נוג'ידאת,יישוב,484,197,287,4,480,398,480,18,15.29%
2011-06,הצפון,4001,בוקעאתא,יישוב,368,145,223,6,362,318,359,11,15.53%
2011-06,הצפון,998,ביר אל-מכסור,יישוב,432,162,270,3,429,325,432,14,14.43%
2011-06,הצפון,480,בית ג'ן,יישוב,328,90,238,1,327,244,324,10,7.91%
2011-06,הצפון,9200,בית שאן,יישוב,912,376,536,23,889,453,909,125,9.73%
2011-06,הצפון,944,בסמת טבעון,יישוב,246,97,149,3,243,195,245,9,9.24%
2011-06,הצפון,483,בענה,יישוב,458,181,277,4,454,392,458,8,16.35%
2011-06,הצפון,1292,ג'דיידה-מכר,יישוב,1490,641,849,5,1485,1274,1489,37,19.34%
2011-06,הצפון,485,ג'ולס,יישוב,200,61,139,1,199,148,199,10,8.49%
2011-06,הצפון,487,ג'ש (גוש חלב),יישוב,58,29,29,3,55,30,57,2,4.01%
2011-06,הצפון,489,דבורייה,יישוב,429,191,238,16,413,318,428,4,11.88%
2011-06,הצפון,490,דייר אל-אסד,יישוב,428,186,242,3,425,338,428,11,10.40%
2011-06,הצפון,492,דייר חנא,יישוב,647,285,362,7,640,507,647,26,16.56%
2011-06,הצפון,975,זרזיר,יישוב,299,122,177,6,293,208,291,17,12.06%
2011-06,הצפון,496,חורפיש,יישוב,166,59,107,7,159,99,165,9,7.87%
2011-06,הצפון,2034,חצור הגלילית,יישוב,313,144,169,6,307,131,308,40,7.07%
2011-06,הצפון,6700,טבריה,יישוב,1948,847,1101,122,1826,1221,1834,140,9.11%
2011-06,הצפון,962,טובא-זנגרייה,יישוב,369,151,218,3,366,247,366,15,13.79%
2011-06,הצפון,498,טורעאן,יישוב,507,195,312,5,502,448,504,14,11.15%
2011-06,הצפון,8900,טמרה,יישוב,1963,823,1140,25,1938,1715,1957,61,16.95%
2011-06,הצפון,1295,יאנוח-ג'ת,יישוב,173,60,113,2,171,116,173,12,8.15%
2011-06,הצפון,46,יבנאל,יישוב,129,78,51,6,123,100,120,5,9.11%
2011-06,הצפון,499,יפיע,יישוב,622,266,356,9,613,483,620,25,9.65%
2011-06,הצפון,240,יקנעם עילית,יישוב,562,247,315,86,476,214,562,56,5.50%
2011-06,הצפון,502,ירכא,יישוב,487,202,285,1,486,391,487,11,10.83%
2011-06,הצפון,504,כאבול,יישוב,690,279,411,7,683,604,689,14,16.92%
2011-06,הצפון,505,כאוכב אבו אל-היג'א,יישוב,219,91,128,5,214,178,219,8,15.46%
2011-06,הצפון,1296,כסרא-סמיע,יישוב,214,78,136,1,213,157,214,16,8.10%
2011-06,הצפון,978,כעביה-טבאש-חג'אג'רה,יישוב,187,77,110,2,185,141,185,8,10.06%
2011-06,הצפון,1263,כפר ורדים,יישוב,115,55,60,35,80,7,115,47,3.90%
2011-06,הצפון,507,כפר יאסיף,יישוב,494,216,278,4,490,383,494,21,11.60%
2011-06,הצפון,508,כפר כמא,יישוב,74,31,43,4,70,41,71,3,5.34%
2011-06,הצפון,509,כפר כנא,יישוב,1139,454,685,18,1121,978,1130,41,15.72%
2011-06,הצפון,510,כפר מנדא,יישוב,1005,458,547,12,993,742,997,41,16.62%
2011-06,הצפון,47,כפר תבור,יישוב,57,22,35,13,44,2,56,1,3.34%
2011-06,הצפון,1139,כרמיאל,יישוב,1936,798,1138,352,1584,922,1880,126,7.60%
2011-06,הצפון,481,מגאר,יישוב,1479,582,897,29,1450,1282,1474,77,19.90%
2011-06,הצפון,516,מג'ד אל-כרום,יישוב,628,264,364,10,618,503,628,26,11.99%
2011-06,הצפון,874,מגדל העמק,יישוב,1087,482,605,77,1010,450,1037,136,8.28%
2011-06,הצפון,4201,מג'דל שמס,יישוב,478,182,296,20,458,396,474,5,12.13%
2011-06,הצפון,517,מזרעה,יישוב,188,73,115,2,186,146,187,15,11.61%
2011-06,הצפון,4203,מסעדה,יישוב,210,78,132,3,207,177,209,4,14.30%
2011-06,הצפון,518,מעיליא,יישוב,37,20,17,3,34,21,37,3,2.72%
2011-06,הצפון,1063,מעלות-תרשיחא,יישוב,927,417,510,111,816,566,924,78,8.21%
2011-06,הצפון,520,משהד,יישוב,318,117,201,1,317,265,314,10,12.12%
2011-06,הצפון,9100,נהרייה,יישוב,2135,954,1181,234,1901,1272,2127,160,7.64%
2011-06,הצפון,522,נחף,יישוב,445,199,246,9,436,363,444,12,11.00%
2011-06,הצפון,7300,נצרת,יישוב,3017,1352,1665,75,2942,2260,3003,108,10.36%
2011-06,הצפון,1061,נצרת עילית,יישוב,2142,954,1188,261,1881,1127,2043,206,8.95%
2011-06,הצפון,525,סאג'ור,יישוב,133,54,79,1,132,94,131,4,9.24%
2011-06,הצפון,7500,סח'נין,יישוב,1990,905,1085,35,1955,1704,1990,69,17.40%
2011-06,הצפון,4501,ע'ג'ר,יישוב,86,32,54,2,84,64,86,1,10.30%
2011-06,הצפון,530,עיילבון,יישוב,193,84,109,5,188,146,193,15,9.09%
2011-06,הצפון,511,עילוט,יישוב,333,142,191,8,325,257,332,6,14.33%
2011-06,הצפון,532,עין מאהל,יישוב,577,255,322,12,565,498,570,13,13.52%
2011-06,הצפון,7600,עכו,יישוב,3308,1525,1783,137,3171,2516,3291,175,13.61%
2011-06,הצפון,7700,עפולה,יישוב,1887,796,1091,189,1698,907,1819,168,8.34%
2011-06,הצפון,531,עראבה,יישוב,1345,538,807,22,1323,1179,1344,34,16.68%
2011-06,הצפון,535,פסוטה,יישוב,132,53,79,8,124,91,132,6,8.87%
2011-06,הצפון,536,פקיעין (בוקייעה),יישוב,129,68,61,3,126,92,128,2,5.52%
2011-06,הצפון,8000,צפת,יישוב,1070,528,542,78,992,735,1060,100,9.31%
2011-06,הצפון,4100,קצרין,יישוב,234,107,127,39,195,95,233,68,6.24%
2011-06,הצפון,2800,קריית שמונה,יישוב,855,400,455,54,801,302,831,93,6.76%
2011-06,הצפון,543,ראמה,יישוב,317,133,184,8,309,240,316,3,9.86%
2011-06,הצפון,26,ראש פינה,יישוב,70,30,40,7,63,23,70,12,5.03%
2011-06,הצפון,542,ריינה,יישוב,597,246,351,7,590,489,592,19,10.75%
2011-06,הצפון,122,רמת ישי,יישוב,114,44,70,26,88,8,113,12,3.08%
2011-06,הצפון,913,שבלי - אום אל-גנם,יישוב,238,109,129,5,233,187,237,7,11.11%
2011-06,הצפון,812,שלומי,יישוב,284,122,162,14,270,169,279,34,8.48%
2011-06,הצפון,538,שעב,יישוב,477,203,274,1,476,412,476,13,18.96%
2011-06,הצפון,8800,שפרעם,יישוב,1971,789,1182,28,1943,1603,1968,83,13.43%
2011-06,חיפה,2710,אום אל-פחם,יישוב,3581,1466,2115,9,3572,3089,3578,56,21.08%
2011-06,חיפה,1020,אור עקיבא,יישוב,626,250,376,44,582,241,611,82,6.73%
2011-06,חיפה,6000,באקה אל-גרביה,יישוב,691,347,344,7,684,416,691,54,NULL
2011-06,חיפה,9800,בנימינה-גבעת עדה*,יישוב,240,106,134,68,172,52,240,27,3.90%
2011-06,חיפה,1326,"בסמ""ה",יישוב,392,172,220,3,389,311,392,17,12.33%
2011-06,חיפה,541,ג'סר א-זרקא,יישוב,452,262,190,0,452,284,450,10,8.87%
2011-06,חיפה,628,ג'ת,יישוב,218,104,114,5,213,127,217,12,NULL
2011-06,חיפה,494,דאלית אל-כרמל,יישוב,453,187,266,8,445,290,448,41,6.67%
2011-06,חיפה,9300,זכרון יעקב,יישוב,307,160,147,79,228,51,305,14,3.36%
2011-06,חיפה,6500,חדרה,יישוב,2732,1125,1607,272,2460,953,2698,261,6.09%
2011-06,חיפה,4000,חיפה,יישוב,8083,3561,4522,1422,6661,4929,8038,632,6.15%
2011-06,חיפה,1247,חריש-קציר,יישוב,21,8,13,2,19,7,21,3,1.29%
2011-06,חיפה,2100,טירת כרמל,יישוב,841,404,437,37,804,494,836,75,8.70%
2011-06,חיפה,654,כפר קרע,יישוב,364,169,195,3,361,229,362,10,5.31%
2011-06,חיפה,1327,מעלה עירון,יישוב,877,350,527,2,875,725,877,12,18.43%
2011-06,חיפה,2500,נשר,יישוב,599,286,313,93,506,272,597,47,4.90%
2011-06,חיפה,534,עספיא,יישוב,330,146,184,7,323,201,330,20,6.96%
2011-06,חיפה,637,ערערה,יישוב,556,218,338,7,549,379,555,39,8.37%
2011-06,חיפה,537,פוריידיס,יישוב,375,192,183,5,370,250,374,18,7.98%
2011-06,חיפה,7800,פרדס חנה-כרכור,יישוב,911,404,507,136,775,289,904,96,5.36%
2011-06,חיפה,6800,קריית אתא,יישוב,1987,846,1141,143,1844,1165,1978,107,7.39%
2011-06,חיפה,9500,קריית ביאליק,יישוב,1292,530,762,155,1137,678,1286,84,6.44%
2011-06,חיפה,2300,קריית טבעון,יישוב,254,115,139,61,193,50,253,18,3.33%
2011-06,חיפה,9600,קריית ים,יישוב,1732,771,961,160,1572,1150,1726,104,8.67%
2011-06,חיפה,8200,קריית מוצקין,יישוב,1238,505,733,177,1061,641,1230,99,5.92%
2011-06,חיפה,922,רכסים,יישוב,148,70,78,5,143,95,147,7,5.45%
2011-06,ירושלים,472,אבו גוש,יישוב,247,115,132,3,244,186,247,3,10.27%
2011-06,ירושלים,2610,בית שמש,יישוב,1333,581,752,102,1231,544,1323,142,5.34%
2011-06,ירושלים,3000,ירושלים,יישוב,10498,4628,5870,1153,9345,5984,10426,667,4.19%
2011-06,ירושלים,1015,מבשרת ציון,יישוב,422,206,216,73,349,167,421,31,3.59%
2011-06,ירושלים,1137,קריית יערים,יישוב,34,12,22,2,32,14,34,4,3.39%
2011-06,תל אביב,2400,אור יהודה,יישוב,911,426,485,41,870,299,901,71,5.16%
2011-06,תל אביב,565,אזור,יישוב,217,107,110,17,200,41,216,19,3.65%
2011-06,תל אביב,6100,בני ברק,יישוב,2235,1082,1153,124,2111,1360,2222,125,4.82%
2011-06,תל אביב,6200,בת ים,יישוב,3932,1812,2120,460,3472,1477,3885,295,5.54%
2011-06,תל אביב,6300,גבעתיים,יישוב,797,331,466,278,519,115,790,76,2.89%
2011-06,תל אביב,6400,הרצלייה,יישוב,1504,735,769,285,1219,100,1483,377,3.24%
2011-06,תל אביב,6600,חולון,יישוב,3706,1734,1972,475,3231,973,3668,294,3.95%
2011-06,תל אביב,2620,קריית אונו,יישוב,519,249,270,127,392,46,517,32,3.18%
2011-06,תל אביב,8600,רמת גן,יישוב,2296,1028,1268,623,1673,500,2283,170,3.20%
2011-06,תל אביב,2650,רמת השרון,יישוב,639,307,332,138,501,23,637,195,3.09%
2011-06,תל אביב,5000,תל אביב -יפו,יישוב,8231,4102,4129,2205,6026,2797,8162,673,3.54%
2011-07,אזור יהודה והשומרון,3760,אורנית,יישוב,98,50,48,33,65,5,98,7,2.61%
2011-07,אזור יהודה והשומרון,3750,אלפי מנשה,יישוב,137,66,71,24,113,3,137,6,3.36%
2011-07,אזור יהודה והשומרון,3560,אלקנה,יישוב,48,25,23,22,26,2,48,1,2.80%
2011-07,אזור יהודה והשומרון,3650,אפרתה,יישוב,71,38,33,27,44,10,71,1,2.01%
2011-07,אזור יהודה והשומרון,3570,אריאל,יישוב,421,201,220,101,320,103,420,34,4.22%
2011-07,אזור יהודה והשומרון,3574,בית אל,יישוב,67,39,28,14,53,15,65,1,3.03%
2011-07,אזור יהודה והשומרון,3652,בית אריה,יישוב,73,31,42,12,61,6,73,8,3.42%
2011-07,אזור יהודה והשומרון,3780,ביתר עילית,יישוב,533,243,290,16,517,235,526,31,6.19%
2011-07,אזור יהודה והשומרון,3730,גבעת זאב,יישוב,227,109,118,31,196,51,227,23,3.74%
2011-07,אזור יהודה והשומרון,3769,הר אדר,יישוב,37,16,21,15,22,1,37,2,2.15%
2011-07,אזור יהודה והשומרון,3797,מודיעין עילית,יישוב,581,138,443,27,554,93,578,14,5.44%
2011-07,אזור יהודה והשומרון,3616,מעלה אדומים,יישוב,678,291,387,98,580,226,674,59,3.81%
2011-07,אזור יהודה והשומרון,3660,עמנואל,יישוב,107,56,51,5,102,58,107,5,11.13%
2011-07,אזור יהודה והשומרון,3557,קדומים,יישוב,107,56,51,7,100,6,106,6,6.31%
2011-07,אזור יהודה והשומרון,3611,קריית ארבע,יישוב,137,72,65,22,115,66,137,5,4.89%
2011-07,אזור יהודה והשומרון,3640,קרני שומרון,יישוב,89,50,39,19,70,18,88,1,2.70%
2011-07,הדרום,31,אופקים,יישוב,1524,629,895,106,1418,986,1513,52,13.31%
2011-07,הדרום,2600,אילת,יישוב,1451,636,815,84,1367,618,1437,92,4.70%
2011-07,הדרום,70,אשדוד,יישוב,7704,3019,4685,839,6865,4062,7643,458,7.61%
2011-07,הדרום,7100,אשקלון,יישוב,4713,1839,2874,679,4034,2669,4608,358,7.91%
2011-07,הדרום,9000,באר שבע,יישוב,8098,3443,4655,991,7107,4866,8039,928,8.50%
2011-07,הדרום,2200,דימונה,יישוב,2278,1001,1277,140,2138,1490,2254,123,12.76%
2011-07,הדרום,1303,חורה,יישוב,747,322,425,0,747,677,746,17,24.34%
2011-07,הדרום,831,ירוחם,יישוב,519,248,271,24,495,270,508,90,12.09%
2011-07,הדרום,1059,כסיפה,יישוב,992,416,576,4,988,897,991,16,26.49%
2011-07,הדרום,1271,להבים,יישוב,84,41,43,24,60,5,83,33,2.68%
2011-07,הדרום,1060,לקיה,יישוב,916,402,514,5,911,841,915,17,28.53%
2011-07,הדרום,1268,מיתר,יישוב,117,52,65,25,92,7,117,46,3.13%
2011-07,הדרום,99,מצפה רמון,יישוב,252,103,149,15,237,125,241,40,10.76%
2011-07,הדרום,246,נתיבות,יישוב,1156,466,690,67,1089,543,1147,71,9.71%
2011-07,הדרום,666,עומר,יישוב,77,30,47,34,43,8,77,18,2.06%
2011-07,הדרום,2560,ערד,יישוב,945,421,524,180,765,525,914,113,7.43%
2011-07,הדרום,1192,ערערה-בנגב,יישוב,956,382,574,4,952,893,955,20,29.97%
2011-07,הדרום,2630,קריית גת,יישוב,2463,990,1473,190,2273,1518,2458,104,9.85%
2011-07,הדרום,1034,קריית מלאכי,יישוב,1371,641,730,29,1342,825,1346,170,12.40%
2011-07,הדרום,1161,רהט,יישוב,3002,1128,1874,9,2993,2584,3000,117,21.32%
2011-07,הדרום,1286,שגב-שלום,יישוב,480,180,300,0,480,433,479,114,23.96%
2011-07,הדרום,1031,שדרות,יישוב,1159,483,676,59,1100,641,1156,72,10.39%
2011-07,הדרום,1054,תל שבע,יישוב,1207,571,636,3,1204,1102,1207,64,31.08%
2011-07,המרכז,182,אבן יהודה,יישוב,142,70,72,44,98,18,142,19,2.39%
2011-07,המרכז,41,אליכין,יישוב,65,28,37,6,59,15,64,6,4.04%
2011-07,המרכז,1309,אלעד,יישוב,402,179,223,18,384,120,400,18,3.80%
2011-07,המרכז,2530,באר יעקב,יישוב,272,118,154,41,231,77,267,22,3.82%
2011-07,המרכז,466,בית דגן,יישוב,140,72,68,15,125,30,140,36,4.24%
2011-07,המרכז,1066,"בני עי""ש",יישוב,191,85,106,27,164,85,188,2,4.88%
2011-07,המרכז,681,גבעת שמואל,יישוב,313,165,148,111,202,53,313,17,3.00%
2011-07,המרכז,2550,גדרה,יישוב,386,178,208,75,311,106,382,6,3.81%
2011-07,המרכז,627,ג'לג'וליה,יישוב,84,42,42,3,81,40,84,5,2.96%
2011-07,המרכז,166,גן יבנה,יישוב,439,164,275,48,391,103,436,19,4.49%
2011-07,המרכז,229,גני תקווה,יישוב,204,89,115,48,156,24,203,8,2.91%
2011-07,המרכז,9700,הוד השרון,יישוב,752,388,364,217,535,57,746,27,2.98%
2011-07,המרכז,1290,זמר,יישוב,152,45,107,7,145,120,152,6,6.31%
2011-07,המרכז,2730,טייבה,יישוב,2157,900,1257,4,2153,1826,2145,40,14.56%
2011-07,המרכז,2720,טירה,יישוב,343,170,173,11,332,194,343,12,3.84%
2011-07,המרכז,2660,יבנה,יישוב,983,479,504,86,897,422,977,100,5.45%
2011-07,המרכז,9400,יהוד,יישוב,639,280,359,90,549,76,617,41,4.19%
2011-07,המרכז,1224,כוכב יאיר,יישוב,193,94,99,41,152,4,193,2,3.61%
2011-07,המרכז,633,כפר ברא,יישוב,25,13,12,0,25,7,25,2,2.45%
2011-07,המרכז,168,כפר יונה,יישוב,366,158,208,67,299,75,364,25,3.87%
2011-07,המרכז,6900,כפר סבא,יישוב,1435,643,792,338,1097,194,1423,76,3.09%
2011-07,המרכז,634,כפר קאסם,יישוב,250,110,140,9,241,113,250,9,3.82%
2011-07,המרכז,7000,לוד,יישוב,2395,1024,1371,194,2201,1314,2382,114,7.24%
2011-07,המרכז,1200,מודיעין-מכבים-רעות*,יישוב,1103,480,623,371,732,79,1090,64,2.96%
2011-07,המרכז,28,מזכרת בתיה,יישוב,174,68,106,48,126,41,172,1,3.12%
2011-07,המרכז,7200,נס ציונה,יישוב,693,301,392,159,534,199,687,2,3.46%
2011-07,המרכז,7400,נתניה,יישוב,5214,2291,2923,746,4468,1907,5171,392,5.51%
2011-07,המרכז,587,סביון*,יישוב,18,10,8,6,12,0,18,1,1.11%
2011-07,המרכז,171,פרדסייה,יישוב,103,40,63,16,87,9,102,6,3.00%
2011-07,המרכז,7900,פתח תקווה,יישוב,4584,2041,2543,870,3714,1160,4542,320,4.18%
2011-07,המרכז,195,קדימה-צורן,יישוב,286,125,161,66,220,41,285,11,3.31%
2011-07,המרכז,638,קלנסווה,יישוב,961,358,603,3,958,780,957,15,13.38%
2011-07,המרכז,469,קריית עקרון,יישוב,281,130,151,21,260,116,279,1,5.22%
2011-07,המרכז,2640,ראש העין,יישוב,934,444,490,93,841,171,925,77,4.57%
2011-07,המרכז,8300,ראשון לציון,יישוב,5026,2203,2823,898,4128,1674,5000,334,3.96%
2011-07,המרכז,8400,רחובות,יישוב,2748,1147,1601,547,2201,1050,2696,17,4.73%
2011-07,המרכז,8500,רמלה,יישוב,1928,894,1034,121,1807,850,1884,110,5.89%
2011-07,המרכז,8700,רעננה,יישוב,1020,500,520,300,720,87,1014,36,2.90%
2011-07,המרכז,1304,שוהם,יישוב,196,84,112,59,137,10,196,14,2.04%
2011-07,המרכז,154,תל מונד,יישוב,145,64,81,49,96,23,145,9,2.72%
2011-07,הצפון,473,אבו סנאן,יישוב,734,276,458,5,729,613,730,18,15.22%
2011-07,הצפון,478,אכסאל,יישוב,541,215,326,11,530,481,541,12,11.91%
2011-07,הצפון,529,אעבלין,יישוב,615,241,374,12,603,511,615,18,13.23%
2011-07,הצפון,482,בועיינה-נוג'ידאת,יישוב,494,211,283,6,488,406,490,7,15.56%
2011-07,הצפון,4001,בוקעאתא,יישוב,356,135,221,8,348,312,347,8,15.09%
2011-07,הצפון,998,ביר אל-מכסור,יישוב,436,161,275,8,428,335,436,6,14.54%
2011-07,הצפון,480,בית ג'ן,יישוב,334,90,244,3,331,248,331,10,8.07%
2011-07,הצפון,9200,בית שאן,יישוב,934,370,564,21,913,458,932,91,9.95%
2011-07,הצפון,944,בסמת טבעון,יישוב,247,98,149,5,242,202,246,10,9.27%
2011-07,הצפון,483,בענה,יישוב,469,175,294,4,465,390,469,17,16.68%
2011-07,הצפון,1292,ג'דיידה-מכר,יישוב,1513,644,869,8,1505,1268,1512,35,19.58%
2011-07,הצפון,485,ג'ולס,יישוב,222,65,157,3,219,151,221,4,9.34%
2011-07,הצפון,487,ג'ש (גוש חלב),יישוב,63,31,32,2,61,28,62,11,4.34%
2011-07,הצפון,489,דבורייה,יישוב,428,190,238,16,412,319,427,6,11.85%
2011-07,הצפון,490,דייר אל-אסד,יישוב,424,172,252,6,418,332,424,21,10.31%
2011-07,הצפון,492,דייר חנא,יישוב,637,268,369,6,631,509,636,13,16.33%
2011-07,הצפון,975,זרזיר,יישוב,294,116,178,4,290,204,288,13,11.96%
2011-07,הצפון,496,חורפיש,יישוב,186,76,110,7,179,93,186,29,8.79%
2011-07,הצפון,2034,חצור הגלילית,יישוב,302,115,187,9,293,123,297,38,6.83%
2011-07,הצפון,6700,טבריה,יישוב,1965,810,1155,119,1846,1217,1848,108,9.17%
2011-07,הצפון,962,טובא-זנגרייה,יישוב,362,149,213,3,359,244,359,12,13.56%
2011-07,הצפון,498,טורעאן,יישוב,534,185,349,10,524,431,532,13,11.69%
2011-07,הצפון,8900,טמרה,יישוב,2014,826,1188,35,1979,1710,2009,50,17.32%
2011-07,הצפון,1295,יאנוח-ג'ת,יישוב,199,70,129,5,194,125,199,17,9.26%
2011-07,הצפון,46,יבנאל,יישוב,154,97,57,9,145,111,143,8,10.67%
2011-07,הצפון,499,יפיע,יישוב,635,259,376,13,622,489,632,12,9.82%
2011-07,הצפון,240,יקנעם עילית,יישוב,577,254,323,93,484,224,577,61,5.64%
2011-07,הצפון,502,ירכא,יישוב,522,216,306,2,520,412,522,12,11.52%
2011-07,הצפון,504,כאבול,יישוב,694,271,423,13,681,596,692,21,16.99%
2011-07,הצפון,505,כאוכב אבו אל-היג'א,יישוב,221,89,132,7,214,180,221,10,15.57%
2011-07,הצפון,1296,כסרא-סמיע,יישוב,259,95,164,3,256,190,258,12,9.61%
2011-07,הצפון,978,כעביה-טבאש-חג'אג'רה,יישוב,195,81,114,2,193,145,193,5,10.45%
2011-07,הצפון,1263,כפר ורדים,יישוב,102,41,61,37,65,7,102,22,3.47%
2011-07,הצפון,507,כפר יאסיף,יישוב,490,203,287,3,487,388,490,15,11.52%
2011-07,הצפון,508,כפר כמא,יישוב,71,25,46,3,68,41,69,2,5.20%
2011-07,הצפון,509,כפר כנא,יישוב,1177,440,737,25,1152,987,1170,44,16.18%
2011-07,הצפון,510,כפר מנדא,יישוב,1007,453,554,14,993,744,999,28,16.65%
2011-07,הצפון,47,כפר תבור,יישוב,65,24,41,13,52,4,64,2,3.80%
2011-07,הצפון,1139,כרמיאל,יישוב,1903,747,1156,358,1545,935,1849,116,7.48%
2011-07,הצפון,481,מגאר,יישוב,1481,564,917,35,1446,1266,1478,73,19.94%
2011-07,הצפון,516,מג'ד אל-כרום,יישוב,639,256,383,7,632,498,639,28,12.18%
2011-07,הצפון,874,מגדל העמק,יישוב,1102,491,611,77,1025,468,1051,131,8.38%
2011-07,הצפון,4201,מג'דל שמס,יישוב,454,166,288,19,435,383,452,11,11.63%
2011-07,הצפון,517,מזרעה,יישוב,194,81,113,2,192,146,193,21,11.94%
2011-07,הצפון,4203,מסעדה,יישוב,196,69,127,2,194,171,195,8,13.47%
2011-07,הצפון,518,מעיליא,יישוב,37,16,21,2,35,20,37,6,2.72%
2011-07,הצפון,1063,מעלות-תרשיחא,יישוב,1053,434,619,122,931,613,1049,98,9.21%
2011-07,הצפון,520,משהד,יישוב,320,115,205,1,319,264,316,11,12.19%
2011-07,הצפון,9100,נהרייה,יישוב,2140,982,1158,237,1903,1264,2127,120,7.64%
2011-07,הצפון,522,נחף,יישוב,457,200,257,11,446,357,456,12,11.27%
2011-07,הצפון,7300,נצרת,יישוב,3009,1305,1704,91,2918,2251,2993,97,10.33%
2011-07,הצפון,1061,נצרת עילית,יישוב,2100,924,1176,282,1818,1150,2002,171,8.78%
2011-07,הצפון,525,סאג'ור,יישוב,135,55,80,1,134,94,133,2,9.37%
2011-07,הצפון,7500,סח'נין,יישוב,1999,880,1119,39,1960,1700,1999,59,17.47%
2011-07,הצפון,4501,ע'ג'ר,יישוב,86,33,53,2,84,65,86,2,10.30%
2011-07,הצפון,530,עיילבון,יישוב,187,80,107,4,183,141,186,12,8.79%
2011-07,הצפון,511,עילוט,יישוב,335,130,205,7,328,257,335,5,14.44%
2011-07,הצפון,532,עין מאהל,יישוב,578,252,326,9,569,503,569,10,13.50%
2011-07,הצפון,7600,עכו,יישוב,3443,1545,1898,152,3291,2567,3417,163,14.06%
2011-07,הצפון,7700,עפולה,יישוב,2030,838,1192,210,1820,948,1964,185,8.94%
2011-07,הצפון,531,עראבה,יישוב,1378,549,829,33,1345,1174,1377,30,17.02%
2011-07,הצפון,535,פסוטה,יישוב,149,59,90,8,141,94,149,7,9.90%
2011-07,הצפון,536,פקיעין (בוקייעה),יישוב,138,71,67,5,133,95,137,1,5.88%
2011-07,הצפון,8000,צפת,יישוב,1128,563,565,80,1048,719,1121,99,9.79%
2011-07,הצפון,4100,קצרין,יישוב,229,103,126,38,191,101,228,23,6.12%
2011-07,הצפון,2800,קריית שמונה,יישוב,868,416,452,68,800,307,854,106,6.94%
2011-07,הצפון,543,ראמה,יישוב,334,151,183,6,328,244,332,10,10.31%
2011-07,הצפון,26,ראש פינה,יישוב,67,27,40,9,58,23,67,5,4.83%
2011-07,הצפון,542,ריינה,יישוב,629,255,374,15,614,496,623,18,11.25%
2011-07,הצפון,122,רמת ישי,יישוב,110,47,63,29,81,8,110,4,3.01%
2011-07,הצפון,913,שבלי - אום אל-גנם,יישוב,233,99,134,6,227,181,232,1,10.90%
2011-07,הצפון,812,שלומי,יישוב,303,130,173,14,289,165,299,36,9.04%
2011-07,הצפון,538,שעב,יישוב,460,192,268,1,459,409,459,8,18.41%
2011-07,הצפון,8800,שפרעם,יישוב,1952,753,1199,39,1913,1592,1948,72,13.31%
2011-07,חיפה,2710,אום אל-פחם,יישוב,3720,1550,2170,10,3710,3092,3717,65,21.72%
2011-07,חיפה,1020,אור עקיבא,יישוב,612,254,358,47,565,227,597,76,6.59%
2011-07,חיפה,6000,באקה אל-גרביה,יישוב,701,340,361,10,691,445,701,46,NULL
2011-07,חיפה,9800,בנימינה-גבעת עדה*,יישוב,220,97,123,63,157,49,220,12,3.59%
2011-07,חיפה,1326,"בסמ""ה",יישוב,410,179,231,3,407,325,410,10,12.83%
2011-07,חיפה,541,ג'סר א-זרקא,יישוב,465,269,196,0,465,280,463,16,9.11%
2011-07,חיפה,628,ג'ת,יישוב,204,90,114,5,199,126,203,17,NULL
2011-07,חיפה,494,דאלית אל-כרמל,יישוב,499,191,308,10,489,295,495,43,7.32%
2011-07,חיפה,9300,זכרון יעקב,יישוב,275,127,148,77,198,48,272,20,3.01%
2011-07,חיפה,6500,חדרה,יישוב,2589,1041,1548,276,2313,919,2552,220,5.78%
2011-07,חיפה,4000,חיפה,יישוב,7854,3522,4332,1434,6420,4841,7814,589,5.99%
2011-07,חיפה,1247,חריש-קציר,יישוב,23,11,12,1,22,7,23,2,1.41%
2011-07,חיפה,2100,טירת כרמל,יישוב,782,358,424,39,743,482,776,76,8.12%
2011-07,חיפה,654,כפר קרע,יישוב,380,166,214,4,376,226,378,15,5.53%
2011-07,חיפה,1327,מעלה עירון,יישוב,888,357,531,1,887,731,888,16,18.62%
2011-07,חיפה,2500,נשר,יישוב,590,273,317,108,482,267,587,54,4.82%
2011-07,חיפה,534,עספיא,יישוב,410,173,237,8,402,200,410,69,8.50%
2011-07,חיפה,637,ערערה,יישוב,569,218,351,8,561,383,568,31,8.55%
2011-07,חיפה,537,פוריידיס,יישוב,425,194,231,9,416,255,424,23,8.95%
2011-07,חיפה,7800,פרדס חנה-כרכור,יישוב,949,418,531,138,811,285,942,101,5.57%
2011-07,חיפה,6800,קריית אתא,יישוב,2045,835,1210,149,1896,1169,2038,134,7.60%
2011-07,חיפה,9500,קריית ביאליק,יישוב,1300,548,752,159,1141,668,1293,75,6.48%
2011-07,חיפה,2300,קריית טבעון,יישוב,204,99,105,67,137,46,202,11,2.68%
2011-07,חיפה,9600,קריית ים,יישוב,1750,781,969,162,1588,1142,1743,111,8.75%
2011-07,חיפה,8200,קריית מוצקין,יישוב,1238,503,735,177,1061,634,1232,73,5.93%
2011-07,חיפה,922,רכסים,יישוב,184,77,107,8,176,102,183,7,6.70%
2011-07,ירושלים,472,אבו גוש,יישוב,255,128,127,6,249,185,255,6,10.56%
2011-07,ירושלים,2610,בית שמש,יישוב,1583,632,951,120,1463,574,1575,182,6.29%
2011-07,ירושלים,3000,ירושלים,יישוב,11220,4857,6363,1233,9987,6117,11147,634,4.47%
2011-07,ירושלים,1015,מבשרת ציון,יישוב,412,197,215,74,338,164,411,27,3.50%
2011-07,ירושלים,1137,קריית יערים,יישוב,32,11,21,3,29,12,32,1,3.20%
2011-07,תל אביב,2400,אור יהודה,יישוב,899,390,509,39,860,287,890,109,5.10%
2011-07,תל אביב,565,אזור,יישוב,219,109,110,21,198,42,216,19,3.65%
2011-07,תל אביב,6100,בני ברק,יישוב,2580,1097,1483,137,2443,1378,2563,88,5.52%
2011-07,תל אביב,6200,בת ים,יישוב,3599,1640,1959,472,3127,1470,3543,260,5.08%
2011-07,תל אביב,6300,גבעתיים,יישוב,760,317,443,285,475,112,755,56,2.76%
2011-07,תל אביב,6400,הרצלייה,יישוב,1229,559,670,314,915,93,1206,275,2.65%
2011-07,תל אביב,6600,חולון,יישוב,3315,1481,1834,491,2824,969,3272,264,3.54%
2011-07,תל אביב,2620,קריית אונו,יישוב,443,188,255,138,305,48,441,22,2.72%
2011-07,תל אביב,8600,רמת גן,יישוב,2219,1010,1209,638,1581,506,2200,140,3.09%
2011-07,תל אביב,2650,רמת השרון,יישוב,451,196,255,137,314,25,448,109,2.20%
2011-07,תל אביב,5000,תל אביב -יפו,יישוב,8069,3965,4104,2296,5773,2769,7999,557,3.47%
2011-08,אזור יהודה והשומרון,3760,אורנית,יישוב,99,46,53,37,62,5,98,3,2.61%
2011-08,אזור יהודה והשומרון,3750,אלפי מנשה,יישוב,98,47,51,26,72,0,98,5,2.43%
2011-08,אזור יהודה והשומרון,3560,אלקנה,יישוב,37,16,21,22,15,2,36,0,2.12%
2011-08,אזור יהודה והשומרון,3650,אפרתה,יישוב,62,32,30,29,33,11,62,2,1.76%
2011-08,אזור יהודה והשומרון,3570,אריאל,יישוב,423,201,222,103,320,101,422,50,4.24%
2011-08,אזור יהודה והשומרון,3574,בית אל,יישוב,58,34,24,11,47,14,57,2,2.67%
2011-08,אזור יהודה והשומרון,3652,בית אריה,יישוב,57,21,36,9,48,5,57,3,2.69%
2011-08,אזור יהודה והשומרון,3780,ביתר עילית,יישוב,548,213,335,14,534,220,544,16,6.39%
2011-08,אזור יהודה והשומרון,3730,גבעת זאב,יישוב,204,98,106,26,178,50,204,12,3.38%
2011-08,אזור יהודה והשומרון,3769,הר אדר,יישוב,39,19,20,17,22,1,38,3,2.21%
2011-08,אזור יהודה והשומרון,3797,מודיעין עילית,יישוב,709,148,561,25,684,100,704,40,6.54%
2011-08,אזור יהודה והשומרון,3616,מעלה אדומים,יישוב,742,298,444,94,648,223,731,73,4.12%
2011-08,אזור יהודה והשומרון,3660,עמנואל,יישוב,92,43,49,4,88,58,92,1,9.73%
2011-08,אזור יהודה והשומרון,3557,קדומים,יישוב,38,15,23,8,30,7,38,1,2.36%
2011-08,אזור יהודה והשומרון,3611,קריית ארבע,יישוב,130,65,65,22,108,66,130,8,4.65%
2011-08,אזור יהודה והשומרון,3640,קרני שומרון,יישוב,71,40,31,19,52,19,70,2,2.16%
2011-08,הדרום,31,אופקים,יישוב,1535,627,908,108,1427,1006,1529,63,13.43%
2011-08,הדרום,2600,אילת,יישוב,1388,592,796,85,1303,619,1372,105,4.49%
2011-08,הדרום,70,אשדוד,יישוב,7567,2905,4662,874,6693,4095,7501,523,7.48%
2011-08,הדרום,7100,אשקלון,יישוב,4613,1788,2825,700,3913,2679,4498,247,7.73%
2011-08,הדרום,9000,באר שבע,יישוב,7695,3236,4459,1006,6689,4877,7638,660,8.11%
2011-08,הדרום,2200,דימונה,יישוב,2248,946,1302,141,2107,1479,2208,98,12.53%
2011-08,הדרום,1303,חורה,יישוב,734,310,424,0,734,677,733,9,24.02%
2011-08,הדרום,831,ירוחם,יישוב,485,238,247,23,462,281,476,49,11.41%
2011-08,הדרום,1059,כסיפה,יישוב,995,410,585,5,990,904,994,12,26.55%
2011-08,הדרום,1271,להבים,יישוב,60,30,30,25,35,5,60,20,1.95%
2011-08,הדרום,1060,לקיה,יישוב,928,405,523,6,922,846,925,18,28.75%
2011-08,הדרום,1268,מיתר,יישוב,89,35,54,28,61,7,88,26,2.37%
2011-08,הדרום,99,מצפה רמון,יישוב,242,80,162,16,226,123,230,33,10.32%
2011-08,הדרום,246,נתיבות,יישוב,1153,437,716,69,1084,561,1142,98,9.67%
2011-08,הדרום,666,עומר,יישוב,59,21,38,25,34,7,59,16,1.59%
2011-08,הדרום,2560,ערד,יישוב,936,399,537,174,762,523,916,126,7.45%
2011-08,הדרום,1192,ערערה-בנגב,יישוב,958,382,576,5,953,899,957,10,30.02%
2011-08,הדרום,2630,קריית גת,יישוב,2447,991,1456,196,2251,1545,2441,110,9.79%
2011-08,הדרום,1034,קריית מלאכי,יישוב,1314,603,711,34,1280,832,1291,143,11.95%
2011-08,הדרום,1161,רהט,יישוב,2983,1153,1830,11,2972,2601,2981,142,21.21%
2011-08,הדרום,1286,שגב-שלום,יישוב,457,156,301,0,457,424,456,32,23.08%
2011-08,הדרום,1031,שדרות,יישוב,1129,449,680,63,1066,654,1125,48,10.14%
2011-08,הדרום,1054,תל שבע,יישוב,1184,547,637,3,1181,1094,1184,28,30.67%
2011-08,המרכז,182,אבן יהודה,יישוב,123,62,61,42,81,17,123,13,2.08%
2011-08,המרכז,41,אליכין,יישוב,67,29,38,6,61,17,66,5,4.16%
2011-08,המרכז,1309,אלעד,יישוב,537,185,352,18,519,113,535,134,5.01%
2011-08,המרכז,2530,באר יעקב,יישוב,250,114,136,40,210,75,245,20,3.51%
2011-08,המרכז,466,בית דגן,יישוב,105,51,54,14,91,34,104,8,3.19%
2011-08,המרכז,1066,"בני עי""ש",יישוב,192,82,110,25,167,80,188,3,4.88%
2011-08,המרכז,681,גבעת שמואל,יישוב,263,144,119,99,164,54,261,11,2.51%
2011-08,המרכז,2550,גדרה,יישוב,370,146,224,71,299,103,365,4,3.64%
2011-08,המרכז,627,ג'לג'וליה,יישוב,67,30,37,3,64,34,67,4,2.38%
2011-08,המרכז,166,גן יבנה,יישוב,367,121,246,53,314,102,363,23,3.76%
2011-08,המרכז,229,גני תקווה,יישוב,199,81,118,53,146,28,199,11,2.85%
2011-08,המרכז,9700,הוד השרון,יישוב,797,386,411,231,566,57,793,32,3.16%
2011-08,המרכז,1290,זמר,יישוב,155,47,108,7,148,124,155,2,6.43%
2011-08,המרכז,2730,טייבה,יישוב,2133,882,1251,4,2129,1840,2121,50,14.42%
2011-08,המרכז,2720,טירה,יישוב,318,154,164,14,304,194,318,8,3.57%
2011-08,המרכז,2660,יבנה,יישוב,974,469,505,93,881,424,971,90,5.42%
2011-08,המרכז,9400,יהוד,יישוב,580,255,325,89,491,84,560,43,3.82%
2011-08,המרכז,1224,כוכב יאיר,יישוב,130,62,68,43,87,5,130,2,2.46%
2011-08,המרכז,633,כפר ברא,יישוב,24,13,11,0,24,9,24,3,2.36%
2011-08,המרכז,168,כפר יונה,יישוב,351,143,208,71,280,78,347,36,3.69%
2011-08,המרכז,6900,כפר סבא,יישוב,1356,596,760,364,992,206,1340,74,2.92%
2011-08,המרכז,634,כפר קאסם,יישוב,234,95,139,8,226,117,234,8,3.58%
2011-08,המרכז,7000,לוד,יישוב,2352,986,1366,200,2152,1282,2337,146,7.11%
2011-08,המרכז,1200,מודיעין-מכבים-רעות*,יישוב,1064,420,644,376,688,73,1045,94,2.84%
2011-08,המרכז,28,מזכרת בתיה,יישוב,178,65,113,47,131,45,176,0,3.19%
2011-08,המרכז,7200,נס ציונה,יישוב,684,280,404,154,530,192,678,4,3.42%
2011-08,המרכז,7400,נתניה,יישוב,5005,2154,2851,732,4273,1881,4965,478,5.30%
2011-08,המרכז,587,סביון*,יישוב,15,7,8,8,7,0,15,3,0.92%
2011-08,המרכז,171,פרדסייה,יישוב,95,40,55,16,79,10,94,5,2.77%
2011-08,המרכז,7900,פתח תקווה,יישוב,4301,1794,2507,890,3411,1146,4262,262,3.93%
2011-08,המרכז,195,קדימה-צורן,יישוב,244,112,132,64,180,44,243,25,2.84%
2011-08,המרכז,638,קלנסווה,יישוב,937,334,603,2,935,770,934,8,13.10%
2011-08,המרכז,469,קריית עקרון,יישוב,286,130,156,22,264,121,284,3,5.31%
2011-08,המרכז,2640,ראש העין,יישוב,819,363,456,88,731,174,802,107,3.99%
2011-08,המרכז,8300,ראשון לציון,יישוב,4577,1972,2605,900,3677,1642,4560,335,3.63%
2011-08,המרכז,8400,רחובות,יישוב,2823,1153,1670,543,2280,1069,2773,32,4.86%
2011-08,המרכז,8500,רמלה,יישוב,1880,863,1017,119,1761,846,1844,166,5.77%
2011-08,המרכז,8700,רעננה,יישוב,1014,489,525,329,685,91,1009,42,2.89%
2011-08,המרכז,1304,שוהם,יישוב,158,65,93,59,99,8,158,10,1.65%
2011-08,המרכז,154,תל מונד,יישוב,134,58,76,49,85,25,134,5,2.52%
2011-08,הצפון,473,אבו סנאן,יישוב,725,269,456,6,719,621,721,17,15.06%
2011-08,הצפון,478,אכסאל,יישוב,549,219,330,15,534,479,548,14,12.04%
2011-08,הצפון,529,אעבלין,יישוב,634,251,383,12,622,520,634,37,13.58%
2011-08,הצפון,482,בועיינה-נוג'ידאת,יישוב,473,199,274,6,467,398,469,4,14.99%
2011-08,הצפון,4001,בוקעאתא,יישוב,358,130,228,8,350,316,350,3,15.20%
2011-08,הצפון,998,ביר אל-מכסור,יישוב,438,160,278,7,431,334,438,7,14.60%
2011-08,הצפון,480,בית ג'ן,יישוב,331,94,237,3,328,253,328,11,8.00%
2011-08,הצפון,9200,בית שאן,יישוב,986,385,601,24,962,458,984,125,10.45%
2011-08,הצפון,944,בסמת טבעון,יישוב,250,100,150,5,245,194,250,5,9.41%
2011-08,הצפון,483,בענה,יישוב,450,167,283,3,447,381,450,9,16.11%
2011-08,הצפון,1292,ג'דיידה-מכר,יישוב,1473,610,863,7,1466,1277,1472,38,19.16%
2011-08,הצפון,485,ג'ולס,יישוב,208,57,151,2,206,149,207,18,8.80%
2011-08,הצפון,487,ג'ש (גוש חלב),יישוב,55,29,26,2,53,28,54,1,3.80%
2011-08,הצפון,489,דבורייה,יישוב,411,174,237,17,394,305,410,11,11.43%
2011-08,הצפון,490,דייר אל-אסד,יישוב,421,165,256,7,414,335,421,10,10.25%
2011-08,הצפון,492,דייר חנא,יישוב,632,263,369,6,626,509,632,16,16.24%
2011-08,הצפון,975,זרזיר,יישוב,277,114,163,4,273,185,273,16,11.40%
2011-08,הצפון,496,חורפיש,יישוב,149,59,90,7,142,87,149,12,7.16%
2011-08,הצפון,2034,חצור הגלילית,יישוב,302,117,185,8,294,130,295,26,6.79%
2011-08,הצפון,6700,טבריה,יישוב,1948,803,1145,116,1832,1223,1827,145,9.08%
2011-08,הצפון,962,טובא-זנגרייה,יישוב,341,140,201,3,338,245,337,12,12.84%
2011-08,הצפון,498,טורעאן,יישוב,527,180,347,10,517,432,525,9,11.56%
2011-08,הצפון,8900,טמרה,יישוב,1974,800,1174,28,1946,1707,1968,39,17.02%
2011-08,הצפון,1295,יאנוח-ג'ת,יישוב,159,53,106,4,155,112,159,6,7.54%
2011-08,הצפון,46,יבנאל,יישוב,142,89,53,8,134,112,132,5,9.93%
2011-08,הצפון,499,יפיע,יישוב,631,264,367,11,620,483,629,12,9.78%
2011-08,הצפון,240,יקנעם עילית,יישוב,621,274,347,94,527,213,621,61,6.04%
2011-08,הצפון,502,ירכא,יישוב,509,216,293,4,505,419,509,18,11.26%
2011-08,הצפון,504,כאבול,יישוב,683,258,425,18,665,592,680,14,16.74%
2011-08,הצפון,505,כאוכב אבו אל-היג'א,יישוב,211,83,128,8,203,181,211,9,14.98%
2011-08,הצפון,1296,כסרא-סמיע,יישוב,235,91,144,2,233,174,234,17,8.79%
2011-08,הצפון,978,כעביה-טבאש-חג'אג'רה,יישוב,194,81,113,1,193,141,192,9,10.40%
2011-08,הצפון,1263,כפר ורדים,יישוב,89,43,46,35,54,7,89,3,3.04%
2011-08,הצפון,507,כפר יאסיף,יישוב,477,192,285,3,474,391,477,13,11.25%
2011-08,הצפון,508,כפר כמא,יישוב,74,26,48,2,72,40,72,1,5.41%
2011-08,הצפון,509,כפר כנא,יישוב,1163,420,743,23,1140,978,1158,35,16.04%
2011-08,הצפון,510,כפר מנדא,יישוב,1017,455,562,14,1003,758,1009,25,16.79%
2011-08,הצפון,47,כפר תבור,יישוב,48,21,27,13,35,4,47,0,2.82%
2011-08,הצפון,1139,כרמיאל,יישוב,1834,708,1126,375,1459,909,1772,130,7.19%
2011-08,הצפון,481,מגאר,יישוב,1438,553,885,38,1400,1259,1435,55,19.48%
2011-08,הצפון,516,מג'ד אל-כרום,יישוב,614,245,369,8,606,495,614,23,11.76%
2011-08,הצפון,874,מגדל העמק,יישוב,1163,504,659,93,1070,466,1111,140,8.82%
2011-08,הצפון,4201,מג'דל שמס,יישוב,448,164,284,19,429,374,446,9,11.49%
2011-08,הצפון,517,מזרעה,יישוב,171,60,111,2,169,148,170,8,10.66%
2011-08,הצפון,4203,מסעדה,יישוב,186,62,124,3,183,163,185,1,12.87%
2011-08,הצפון,518,מעיליא,יישוב,41,19,22,6,35,19,41,3,3.00%
2011-08,הצפון,1063,מעלות-תרשיחא,יישוב,961,413,548,119,842,589,958,51,8.48%
2011-08,הצפון,520,משהד,יישוב,311,109,202,1,310,263,308,9,11.92%
2011-08,הצפון,9100,נהרייה,יישוב,2061,916,1145,237,1824,1281,2052,105,7.39%
2011-08,הצפון,522,נחף,יישוב,443,194,249,14,429,360,442,14,10.96%
2011-08,הצפון,7300,נצרת,יישוב,2938,1223,1715,83,2855,2255,2924,105,10.11%
2011-08,הצפון,1061,נצרת עילית,יישוב,2076,875,1201,308,1768,1126,1975,198,8.67%
2011-08,הצפון,525,סאג'ור,יישוב,126,50,76,1,125,92,124,3,8.79%
2011-08,הצפון,7500,סח'נין,יישוב,1939,837,1102,36,1903,1695,1939,47,17.03%
2011-08,הצפון,4501,ע'ג'ר,יישוב,79,28,51,2,77,66,79,2,9.54%
2011-08,הצפון,530,עיילבון,יישוב,184,77,107,6,178,143,183,5,8.66%
2011-08,הצפון,511,עילוט,יישוב,332,121,211,6,326,260,332,15,14.33%
2011-08,הצפון,532,עין מאהל,יישוב,591,266,325,8,583,502,581,8,13.74%
2011-08,הצפון,7600,עכו,יישוב,3369,1489,1880,162,3207,2540,3344,166,13.80%
2011-08,הצפון,7700,עפולה,יישוב,1933,801,1132,210,1723,923,1868,186,8.54%
2011-08,הצפון,531,עראבה,יישוב,1370,532,838,36,1334,1181,1369,25,16.94%
2011-08,הצפון,535,פסוטה,יישוב,134,51,83,5,129,89,134,4,8.99%
2011-08,הצפון,536,פקיעין (בוקייעה),יישוב,126,63,63,5,121,90,125,4,5.40%
2011-08,הצפון,8000,צפת,יישוב,1080,521,559,78,1002,722,1073,42,9.41%
2011-08,הצפון,4100,קצרין,יישוב,202,84,118,38,164,98,201,17,5.43%
2011-08,הצפון,2800,קריית שמונה,יישוב,799,361,438,73,726,295,786,97,6.42%
2011-08,הצפון,543,ראמה,יישוב,318,133,185,6,312,240,318,5,9.92%
2011-08,הצפון,26,ראש פינה,יישוב,59,22,37,9,50,24,59,4,4.28%
2011-08,הצפון,542,ריינה,יישוב,607,227,380,18,589,497,604,17,10.94%
2011-08,הצפון,122,רמת ישי,יישוב,96,44,52,27,69,9,96,8,2.63%
2011-08,הצפון,913,שבלי - אום אל-גנם,יישוב,218,90,128,6,212,179,216,5,10.22%
2011-08,הצפון,812,שלומי,יישוב,258,104,154,12,246,155,252,14,7.73%
2011-08,הצפון,538,שעב,יישוב,457,188,269,2,455,411,457,13,18.35%
2011-08,הצפון,8800,שפרעם,יישוב,1984,751,1233,37,1947,1634,1977,65,13.48%
2011-08,חיפה,2710,אום אל-פחם,יישוב,3677,1471,2206,12,3665,3139,3674,36,21.53%
2011-08,חיפה,1020,אור עקיבא,יישוב,599,249,350,44,555,226,589,52,6.51%
2011-08,חיפה,6000,באקה אל-גרביה,יישוב,666,312,354,8,658,446,666,28,NULL
2011-08,חיפה,9800,בנימינה-גבעת עדה*,יישוב,188,77,111,61,127,50,186,14,3.05%
2011-08,חיפה,1326,"בסמ""ה",יישוב,405,175,230,3,402,332,405,10,12.69%
2011-08,חיפה,541,ג'סר א-זרקא,יישוב,449,256,193,0,449,279,446,12,8.80%
2011-08,חיפה,628,ג'ת,יישוב,193,77,116,6,187,128,192,4,NULL
2011-08,חיפה,494,דאלית אל-כרמל,יישוב,491,183,308,12,479,293,485,23,7.19%
2011-08,חיפה,9300,זכרון יעקב,יישוב,236,105,131,72,164,49,234,21,2.60%
2011-08,חיפה,6500,חדרה,יישוב,2487,999,1488,287,2200,930,2441,209,5.55%
2011-08,חיפה,4000,חיפה,יישוב,7512,3322,4190,1450,6062,4761,7466,557,5.74%
2011-08,חיפה,1247,חריש-קציר,יישוב,23,12,11,2,21,7,23,5,1.41%
2011-08,חיפה,2100,טירת כרמל,יישוב,768,349,419,37,731,482,761,88,7.98%
2011-08,חיפה,654,כפר קרע,יישוב,362,168,194,6,356,228,361,10,5.30%
2011-08,חיפה,1327,מעלה עירון,יישוב,885,343,542,1,884,742,885,13,18.57%
2011-08,חיפה,2500,נשר,יישוב,543,262,281,102,441,268,539,38,4.45%
2011-08,חיפה,534,עספיא,יישוב,359,153,206,8,351,200,356,25,7.46%
2011-08,חיפה,637,ערערה,יישוב,533,189,344,8,525,384,532,23,8.05%
2011-08,חיפה,537,פוריידיס,יישוב,401,183,218,8,393,258,400,12,8.49%
2011-08,חיפה,7800,פרדס חנה-כרכור,יישוב,869,378,491,131,738,289,857,93,5.10%
2011-08,חיפה,6800,קריית אתא,יישוב,1979,791,1188,155,1824,1163,1972,151,7.37%
2011-08,חיפה,9500,קריית ביאליק,יישוב,1234,508,726,141,1093,680,1230,97,6.18%
2011-08,חיפה,2300,קריית טבעון,יישוב,210,104,106,71,139,48,208,16,2.75%
2011-08,חיפה,9600,קריית ים,יישוב,1719,766,953,173,1546,1122,1712,116,8.61%
2011-08,חיפה,8200,קריית מוצקין,יישוב,1162,467,695,170,992,618,1154,95,5.57%
2011-08,חיפה,922,רכסים,יישוב,196,70,126,11,185,102,195,10,7.11%
2011-08,ירושלים,472,אבו גוש,יישוב,241,116,125,8,233,184,241,6,10.04%
2011-08,ירושלים,2610,בית שמש,יישוב,1442,558,884,120,1322,583,1435,122,5.76%
2011-08,ירושלים,3000,ירושלים,יישוב,11093,4627,6466,1273,9820,6119,11016,479,4.42%
2011-08,ירושלים,1015,מבשרת ציון,יישוב,400,185,215,74,326,159,398,28,3.40%
2011-08,ירושלים,1137,קריית יערים,יישוב,35,11,24,4,31,14,35,1,3.49%
2011-08,תל אביב,2400,אור יהודה,יישוב,941,382,559,44,897,299,931,101,5.32%
2011-08,תל אביב,565,אזור,יישוב,170,88,82,20,150,39,169,18,2.88%
2011-08,תל אביב,6100,בני ברק,יישוב,2835,1123,1712,142,2693,1447,2818,400,6.04%
2011-08,תל אביב,6200,בת ים,יישוב,3396,1518,1878,467,2929,1442,3339,279,4.80%
2011-08,תל אביב,6300,גבעתיים,יישוב,709,283,426,270,439,122,704,56,2.58%
2011-08,תל אביב,6400,הרצלייה,יישוב,1127,471,656,334,793,82,1105,202,2.44%
2011-08,תל אביב,6600,חולון,יישוב,3072,1365,1707,506,2566,982,3014,288,3.27%
2011-08,תל אביב,2620,קריית אונו,יישוב,417,165,252,137,280,47,415,24,2.57%
2011-08,תל אביב,8600,רמת גן,יישוב,2180,942,1238,645,1535,496,2163,192,3.04%
2011-08,תל אביב,2650,רמת השרון,יישוב,427,178,249,147,280,24,425,70,2.08%
2011-08,תל אביב,5000,תל אביב -יפו,יישוב,7852,3842,4010,2304,5548,2767,7790,557,3.39%
2011-09,אזור יהודה והשומרון,3760,אורנית,יישוב,87,37,50,38,49,5,86,5,2.30%
2011-09,אזור יהודה והשומרון,3750,אלפי מנשה,יישוב,80,37,43,25,55,1,80,5,1.99%
2011-09,אזור יהודה והשומרון,3560,אלקנה,יישוב,36,17,19,18,18,2,36,3,2.12%
2011-09,אזור יהודה והשומרון,3650,אפרתה,יישוב,55,30,25,26,29,7,55,3,1.56%
2011-09,אזור יהודה והשומרון,3570,אריאל,יישוב,381,184,197,87,294,105,378,41,3.81%
2011-09,אזור יהודה והשומרון,3574,בית אל,יישוב,49,28,21,11,38,14,49,7,2.30%
2011-09,אזור יהודה והשומרון,3652,בית אריה,יישוב,56,25,31,9,47,5,56,7,2.65%
2011-09,אזור יהודה והשומרון,3780,ביתר עילית,יישוב,475,213,262,14,461,231,468,84,5.54%
2011-09,אזור יהודה והשומרון,3730,גבעת זאב,יישוב,184,88,96,25,159,50,184,14,3.05%
2011-09,אזור יהודה והשומרון,3769,הר אדר,יישוב,29,11,18,16,13,0,29,3,1.69%
2011-09,אזור יהודה והשומרון,3797,מודיעין עילית,יישוב,368,121,247,20,348,99,364,24,3.49%
2011-09,אזור יהודה והשומרון,3616,מעלה אדומים,יישוב,630,253,377,86,544,220,626,63,3.55%
2011-09,אזור יהודה והשומרון,3660,עמנואל,יישוב,71,36,35,3,68,56,71,15,7.68%
2011-09,אזור יהודה והשומרון,3557,קדומים,יישוב,30,11,19,9,21,7,30,7,1.87%
2011-09,אזור יהודה והשומרון,3611,קריית ארבע,יישוב,123,65,58,23,100,63,123,15,4.41%
2011-09,אזור יהודה והשומרון,3640,קרני שומרון,יישוב,76,39,37,20,56,20,76,9,2.34%
2011-09,הדרום,31,אופקים,יישוב,1411,554,857,113,1298,978,1402,52,12.45%
2011-09,הדרום,2600,אילת,יישוב,1330,570,760,92,1238,608,1311,118,4.30%
2011-09,הדרום,70,אשדוד,יישוב,6886,2708,4178,824,6062,3939,6832,482,6.86%
2011-09,הדרום,7100,אשקלון,יישוב,4325,1667,2658,662,3663,2652,4216,252,7.28%
2011-09,הדרום,9000,באר שבע,יישוב,7255,3022,4233,997,6258,4752,7203,584,7.69%
2011-09,הדרום,2200,דימונה,יישוב,2115,898,1217,140,1975,1452,2083,145,11.90%
2011-09,הדרום,1303,חורה,יישוב,736,312,424,1,735,680,735,14,24.07%
2011-09,הדרום,831,ירוחם,יישוב,470,220,250,21,449,268,463,71,11.14%
2011-09,הדרום,1059,כסיפה,יישוב,1001,420,581,4,997,921,999,27,26.65%
2011-09,הדרום,1271,להבים,יישוב,39,16,23,20,19,3,39,8,1.28%
2011-09,הדרום,1060,לקיה,יישוב,932,403,529,5,927,858,930,16,28.86%
2011-09,הדרום,1268,מיתר,יישוב,72,27,45,25,47,7,71,10,1.92%
2011-09,הדרום,99,מצפה רמון,יישוב,241,86,155,18,223,119,229,26,10.28%
2011-09,הדרום,246,נתיבות,יישוב,1027,398,629,63,964,545,1019,97,8.72%
2011-09,הדרום,666,עומר,יישוב,56,17,39,26,30,11,56,6,1.51%
2011-09,הדרום,2560,ערד,יישוב,867,367,500,176,691,503,854,108,6.98%
2011-09,הדרום,1192,ערערה-בנגב,יישוב,973,400,573,4,969,896,972,15,30.35%
2011-09,הדרום,2630,קריית גת,יישוב,2275,917,1358,200,2075,1514,2270,89,9.16%
2011-09,הדרום,1034,קריית מלאכי,יישוב,1206,517,689,33,1173,820,1185,116,11.08%
2011-09,הדרום,1161,רהט,יישוב,2876,1076,1800,11,2865,2576,2876,135,20.62%
2011-09,הדרום,1286,שגב-שלום,יישוב,452,160,292,0,452,426,451,15,22.88%
2011-09,הדרום,1031,שדרות,יישוב,1059,425,634,61,998,647,1056,49,9.58%
2011-09,הדרום,1054,תל שבע,יישוב,1191,553,638,3,1188,1104,1190,34,30.78%
2011-09,המרכז,182,אבן יהודה,יישוב,132,68,64,46,86,18,132,11,2.23%
2011-09,המרכז,41,אליכין,יישוב,57,26,31,6,51,17,55,12,3.49%
2011-09,המרכז,1309,אלעד,יישוב,360,152,208,16,344,105,357,21,3.40%
2011-09,המרכז,2530,באר יעקב,יישוב,219,90,129,41,178,73,213,22,3.07%
2011-09,המרכז,466,בית דגן,יישוב,101,52,49,16,85,32,101,8,3.10%
2011-09,המרכז,1066,"בני עי""ש",יישוב,190,85,105,29,161,77,187,1,4.85%
2011-09,המרכז,681,גבעת שמואל,יישוב,239,128,111,90,149,53,238,15,2.30%
2011-09,המרכז,2550,גדרה,יישוב,381,150,231,77,304,110,374,3,3.73%
2011-09,המרכז,627,ג'לג'וליה,יישוב,82,41,41,4,78,35,82,7,2.89%
2011-09,המרכז,166,גן יבנה,יישוב,347,124,223,48,299,104,344,29,3.57%
2011-09,המרכז,229,גני תקווה,יישוב,171,71,100,49,122,30,171,13,2.46%
2011-09,המרכז,9700,הוד השרון,יישוב,603,264,339,223,380,63,598,65,2.40%
2011-09,המרכז,1290,זמר,יישוב,152,50,102,7,145,119,152,3,6.31%
2011-09,המרכז,2730,טייבה,יישוב,2118,879,1239,5,2113,1843,2104,40,14.32%
2011-09,המרכז,2720,טירה,יישוב,309,153,156,13,296,188,308,17,3.46%
2011-09,המרכז,2660,יבנה,יישוב,869,399,470,74,795,421,865,92,4.86%
2011-09,המרכז,9400,יהוד,יישוב,526,218,308,75,451,89,507,42,3.47%
2011-09,המרכז,1224,כוכב יאיר,יישוב,91,42,49,42,49,5,91,17,1.74%
2011-09,המרכז,633,כפר ברא,יישוב,25,15,10,0,25,9,25,3,2.45%
2011-09,המרכז,168,כפר יונה,יישוב,319,138,181,67,252,74,319,33,3.40%
2011-09,המרכז,6900,כפר סבא,יישוב,1115,470,645,349,766,194,1108,117,2.42%
2011-09,המרכז,634,כפר קאסם,יישוב,191,89,102,3,188,113,190,39,2.93%
2011-09,המרכז,7000,לוד,יישוב,2149,917,1232,174,1975,1269,2142,219,6.56%
2011-09,המרכז,1200,מודיעין-מכבים-רעות*,יישוב,909,390,519,377,532,79,899,91,2.46%
2011-09,המרכז,28,מזכרת בתיה,יישוב,158,63,95,43,115,43,156,0,2.84%
2011-09,המרכז,7200,נס ציונה,יישוב,647,271,376,143,504,195,643,6,3.24%
2011-09,המרכז,7400,נתניה,יישוב,4394,1930,2464,651,3743,1807,4350,588,4.67%
2011-09,המרכז,587,סביון*,יישוב,12,5,7,7,5,0,12,0,0.74%
2011-09,המרכז,171,פרדסייה,יישוב,86,39,47,14,72,8,86,8,2.54%
2011-09,המרכז,7900,פתח תקווה,יישוב,3927,1690,2237,813,3114,1121,3895,367,3.61%
2011-09,המרכז,195,קדימה-צורן,יישוב,223,94,129,65,158,38,222,22,2.60%
2011-09,המרכז,638,קלנסווה,יישוב,919,329,590,2,917,774,916,27,12.88%
2011-09,המרכז,469,קריית עקרון,יישוב,256,120,136,22,234,113,255,1,4.80%
2011-09,המרכז,2640,ראש העין,יישוב,700,324,376,76,624,167,688,73,3.44%
2011-09,המרכז,8300,ראשון לציון,יישוב,4213,1767,2446,876,3337,1619,4192,316,3.34%
2011-09,המרכז,8400,רחובות,יישוב,2667,1116,1551,552,2115,1055,2622,13,4.61%
2011-09,המרכז,8500,רמלה,יישוב,1704,762,942,101,1603,833,1669,215,5.25%
2011-09,המרכז,8700,רעננה,יישוב,755,354,401,305,450,92,752,100,2.17%
2011-09,המרכז,1304,שוהם,יישוב,146,61,85,67,79,3,145,19,1.52%
2011-09,המרכז,154,תל מונד,יישוב,128,61,67,49,79,23,127,18,2.39%
2011-09,הצפון,473,אבו סנאן,יישוב,720,259,461,5,715,619,716,18,14.97%
2011-09,הצפון,478,אכסאל,יישוב,525,204,321,14,511,467,525,15,11.60%
2011-09,הצפון,529,אעבלין,יישוב,610,241,369,16,594,506,609,24,13.12%
2011-09,הצפון,482,בועיינה-נוג'ידאת,יישוב,450,189,261,4,446,389,446,19,14.36%
2011-09,הצפון,4001,בוקעאתא,יישוב,351,125,226,7,344,317,343,5,14.95%
2011-09,הצפון,998,ביר אל-מכסור,יישוב,426,154,272,8,418,325,426,13,14.26%
2011-09,הצפון,480,בית ג'ן,יישוב,320,92,228,3,317,240,319,7,7.80%
2011-09,הצפון,9200,בית שאן,יישוב,853,333,520,17,836,448,851,147,9.17%
2011-09,הצפון,944,בסמת טבעון,יישוב,258,105,153,4,254,193,258,11,9.68%
2011-09,הצפון,483,בענה,יישוב,428,167,261,2,426,377,428,26,15.45%
2011-09,הצפון,1292,ג'דיידה-מכר,יישוב,1452,594,858,8,1444,1281,1451,30,18.94%
2011-09,הצפון,485,ג'ולס,יישוב,199,55,144,2,197,152,198,4,8.45%
2011-09,הצפון,487,ג'ש (גוש חלב),יישוב,52,28,24,2,50,27,51,3,3.60%
2011-09,הצפון,489,דבורייה,יישוב,408,179,229,12,396,308,407,13,11.36%
2011-09,הצפון,490,דייר אל-אסד,יישוב,394,160,234,7,387,329,394,16,9.65%
2011-09,הצפון,492,דייר חנא,יישוב,631,265,366,7,624,518,631,38,16.22%
2011-09,הצפון,975,זרזיר,יישוב,285,114,171,6,279,192,282,13,11.74%
2011-09,הצפון,496,חורפיש,יישוב,144,55,89,6,138,89,143,8,6.89%
2011-09,הצפון,2034,חצור הגלילית,יישוב,263,94,169,7,256,120,257,54,5.97%
2011-09,הצפון,6700,טבריה,יישוב,1820,724,1096,117,1703,1210,1704,155,8.52%
2011-09,הצפון,962,טובא-זנגרייה,יישוב,334,140,194,4,330,241,329,17,12.57%
2011-09,הצפון,498,טורעאן,יישוב,482,178,304,9,473,421,480,40,10.67%
2011-09,הצפון,8900,טמרה,יישוב,1949,789,1160,19,1930,1709,1942,101,16.84%
2011-09,הצפון,1295,יאנוח-ג'ת,יישוב,152,48,104,4,148,110,152,5,7.23%
2011-09,הצפון,46,יבנאל,יישוב,137,89,48,8,129,106,128,7,9.66%
2011-09,הצפון,499,יפיע,יישוב,614,259,355,15,599,474,612,28,9.54%
2011-09,הצפון,240,יקנעם עילית,יישוב,524,233,291,92,432,200,524,53,5.15%
2011-09,הצפון,502,ירכא,יישוב,482,194,288,3,479,409,482,14,10.73%
2011-09,הצפון,504,כאבול,יישוב,646,251,395,12,634,583,644,25,16.00%
2011-09,הצפון,505,כאוכב אבו אל-היג'א,יישוב,209,83,126,6,203,184,209,12,14.85%
2011-09,הצפון,1296,כסרא-סמיע,יישוב,231,93,138,3,228,174,230,13,8.66%
2011-09,הצפון,978,כעביה-טבאש-חג'אג'רה,יישוב,187,74,113,2,185,134,187,7,10.16%
2011-09,הצפון,1263,כפר ורדים,יישוב,75,34,41,32,43,6,75,7,2.58%
2011-09,הצפון,507,כפר יאסיף,יישוב,470,194,276,4,466,396,470,13,11.10%
2011-09,הצפון,508,כפר כמא,יישוב,68,27,41,1,67,39,67,5,5.05%
2011-09,הצפון,509,כפר כנא,יישוב,1091,398,693,21,1070,966,1083,49,15.16%
2011-09,הצפון,510,כפר מנדא,יישוב,958,432,526,12,946,728,949,45,15.95%
2011-09,הצפון,47,כפר תבור,יישוב,51,18,33,15,36,5,51,2,3.05%
2011-09,הצפון,1139,כרמיאל,יישוב,1781,684,1097,367,1414,902,1729,115,7.03%
2011-09,הצפון,481,מגאר,יישוב,1374,524,850,28,1346,1242,1371,67,18.77%
2011-09,הצפון,516,מג'ד אל-כרום,יישוב,581,239,342,10,571,483,581,23,11.20%
2011-09,הצפון,874,מגדל העמק,יישוב,1003,419,584,83,920,432,965,179,7.75%
2011-09,הצפון,4201,מג'דל שמס,יישוב,445,156,289,15,430,375,443,12,11.42%
2011-09,הצפון,517,מזרעה,יישוב,167,61,106,2,165,146,166,0,10.44%
2011-09,הצפון,4203,מסעדה,יישוב,191,71,120,4,187,164,190,2,13.17%
2011-09,הצפון,518,מעיליא,יישוב,42,21,21,5,37,22,42,4,3.07%
2011-09,הצפון,1063,מעלות-תרשיחא,יישוב,908,383,525,119,789,583,906,62,8.06%
2011-09,הצפון,520,משהד,יישוב,298,102,196,2,296,259,296,14,11.51%
2011-09,הצפון,9100,נהרייה,יישוב,1992,878,1114,227,1765,1296,1977,101,7.14%
2011-09,הצפון,522,נחף,יישוב,421,181,240,12,409,351,420,13,10.47%
2011-09,הצפון,7300,נצרת,יישוב,2855,1173,1682,69,2786,2259,2838,146,9.85%
2011-09,הצפון,1061,נצרת עילית,יישוב,1987,847,1140,312,1675,1127,1880,210,8.29%
2011-09,הצפון,525,סאג'ור,יישוב,112,46,66,0,112,91,111,3,7.95%
2011-09,הצפון,7500,סח'נין,יישוב,1936,837,1099,38,1898,1705,1936,70,17.01%
2011-09,הצפון,4501,ע'ג'ר,יישוב,82,29,53,3,79,66,82,1,9.87%
2011-09,הצפון,530,עיילבון,יישוב,178,71,107,7,171,145,177,12,8.40%
2011-09,הצפון,511,עילוט,יישוב,312,119,193,4,308,251,312,20,13.58%
2011-09,הצפון,532,עין מאהל,יישוב,586,266,320,11,575,500,578,18,13.68%
2011-09,הצפון,7600,עכו,יישוב,3165,1399,1766,161,3004,2457,3143,234,13.08%
2011-09,הצפון,7700,עפולה,יישוב,1830,721,1109,218,1612,902,1773,191,8.14%
2011-09,הצפון,531,עראבה,יישוב,1341,525,816,34,1307,1199,1340,52,16.64%
2011-09,הצפון,535,פסוטה,יישוב,120,46,74,5,115,87,120,11,8.13%
2011-09,הצפון,536,פקיעין (בוקייעה),יישוב,123,61,62,4,119,87,122,7,5.27%
2011-09,הצפון,8000,צפת,יישוב,1027,492,535,78,949,716,1021,68,9.00%
2011-09,הצפון,4100,קצרין,יישוב,201,83,118,36,165,95,200,12,5.41%
2011-09,הצפון,2800,קריית שמונה,יישוב,708,299,409,66,642,263,697,99,5.73%
2011-09,הצפון,543,ראמה,יישוב,314,132,182,4,310,244,314,11,9.80%
2011-09,הצפון,26,ראש פינה,יישוב,44,15,29,7,37,19,44,5,3.22%
2011-09,הצפון,542,ריינה,יישוב,596,216,380,15,581,504,592,28,10.75%
2011-09,הצפון,122,רמת ישי,יישוב,87,40,47,29,58,7,87,9,2.39%
2011-09,הצפון,913,שבלי - אום אל-גנם,יישוב,224,92,132,4,220,177,223,3,10.52%
2011-09,הצפון,812,שלומי,יישוב,238,91,147,13,225,153,235,15,7.24%
2011-09,הצפון,538,שעב,יישוב,449,183,266,1,448,408,449,8,18.08%
2011-09,הצפון,8800,שפרעם,יישוב,1966,739,1227,42,1924,1653,1960,87,13.38%
2011-09,חיפה,2710,אום אל-פחם,יישוב,3644,1461,2183,13,3631,3149,3640,70,21.37%
2011-09,חיפה,1020,אור עקיבא,יישוב,573,221,352,45,528,216,562,95,6.23%
2011-09,חיפה,6000,באקה אל-גרביה,יישוב,651,305,346,9,642,430,651,42,NULL
2011-09,חיפה,9800,בנימינה-גבעת עדה*,יישוב,186,78,108,62,124,48,185,24,3.04%
2011-09,חיפה,1326,"בסמ""ה",יישוב,400,172,228,3,397,329,400,16,12.55%
2011-09,חיפה,541,ג'סר א-זרקא,יישוב,467,277,190,0,467,285,462,27,9.09%
2011-09,חיפה,628,ג'ת,יישוב,198,83,115,5,193,128,197,8,NULL
2011-09,חיפה,494,דאלית אל-כרמל,יישוב,464,182,282,8,456,295,458,46,6.81%
2011-09,חיפה,9300,זכרון יעקב,יישוב,212,89,123,85,127,47,211,30,2.35%
2011-09,חיפה,6500,חדרה,יישוב,2334,924,1410,278,2056,936,2292,272,5.22%
2011-09,חיפה,4000,חיפה,יישוב,7332,3213,4119,1426,5906,4675,7288,571,5.61%
2011-09,חיפה,1247,חריש-קציר,יישוב,17,9,8,2,15,4,17,4,1.04%
2011-09,חיפה,2100,טירת כרמל,יישוב,728,320,408,34,694,464,725,62,7.63%
2011-09,חיפה,654,כפר קרע,יישוב,363,170,193,6,357,227,362,17,5.31%
2011-09,חיפה,1327,מעלה עירון,יישוב,887,341,546,2,885,738,887,9,18.60%
2011-09,חיפה,2500,נשר,יישוב,501,225,276,90,411,267,498,48,4.12%
2011-09,חיפה,534,עספיא,יישוב,321,142,179,8,313,209,320,37,6.76%
2011-09,חיפה,637,ערערה,יישוב,553,197,356,9,544,385,553,29,8.34%
2011-09,חיפה,537,פוריידיס,יישוב,371,179,192,7,364,252,370,39,7.90%
2011-09,חיפה,7800,פרדס חנה-כרכור,יישוב,810,332,478,127,683,284,804,110,4.80%
2011-09,חיפה,6800,קריית אתא,יישוב,1787,732,1055,150,1637,1156,1778,160,6.69%
2011-09,חיפה,9500,קריית ביאליק,יישוב,1160,464,696,129,1031,659,1156,75,5.83%
2011-09,חיפה,2300,קריית טבעון,יישוב,171,74,97,68,103,41,168,13,2.24%
2011-09,חיפה,9600,קריית ים,יישוב,1617,705,912,164,1453,1097,1612,95,8.15%
2011-09,חיפה,8200,קריית מוצקין,יישוב,1152,433,719,185,967,620,1143,84,5.52%
2011-09,חיפה,922,רכסים,יישוב,161,62,99,11,150,95,161,45,5.94%
2011-09,ירושלים,472,אבו גוש,יישוב,248,121,127,7,241,183,247,4,10.27%
2011-09,ירושלים,2610,בית שמש,יישוב,1255,499,756,122,1133,564,1242,225,5.03%
2011-09,ירושלים,3000,ירושלים,יישוב,10379,4376,6003,1330,9049,6167,10299,739,4.14%
2011-09,ירושלים,1015,מבשרת ציון,יישוב,342,160,182,76,266,157,341,23,2.92%
2011-09,ירושלים,1137,קריית יערים,יישוב,29,8,21,3,26,13,29,2,2.91%
2011-09,תל אביב,2400,אור יהודה,יישוב,831,361,470,35,796,303,820,93,4.72%
2011-09,תל אביב,565,אזור,יישוב,130,60,70,19,111,32,127,17,2.18%
2011-09,תל אביב,6100,בני ברק,יישוב,2351,1077,1274,125,2226,1398,2331,137,5.05%
2011-09,תל אביב,6200,בת ים,יישוב,3179,1400,1779,431,2748,1435,3119,335,4.50%
2011-09,תל אביב,6300,גבעתיים,יישוב,657,271,386,271,386,116,652,58,2.40%
2011-09,תל אביב,6400,הרצלייה,יישוב,976,435,541,305,671,83,959,192,2.12%
2011-09,תל אביב,6600,חולון,יישוב,2766,1226,1540,451,2315,923,2715,310,2.95%
2011-09,תל אביב,2620,קריית אונו,יישוב,398,160,238,139,259,49,394,29,2.44%
2011-09,תל אביב,8600,רמת גן,יישוב,1949,854,1095,603,1346,491,1928,200,2.71%
2011-09,תל אביב,2650,רמת השרון,יישוב,373,161,212,157,216,26,370,43,1.82%
2011-09,תל אביב,5000,תל אביב -יפו,יישוב,7328,3580,3748,2190,5138,2704,7271,509,3.17%
2011-10,אזור יהודה והשומרון,3760,אורנית,יישוב,83,34,49,37,46,4,82,6,2.20%
2011-10,אזור יהודה והשומרון,3750,אלפי מנשה,יישוב,83,36,47,26,57,1,83,3,2.06%
2011-10,אזור יהודה והשומרון,3560,אלקנה,יישוב,32,14,18,16,16,3,32,0,1.88%
2011-10,אזור יהודה והשומרון,3650,אפרתה,יישוב,52,27,25,27,25,6,51,0,1.45%
2011-10,אזור יהודה והשומרון,3570,אריאל,יישוב,380,182,198,91,289,105,378,32,3.81%
2011-10,אזור יהודה והשומרון,3574,בית אל,יישוב,50,25,25,14,36,18,50,6,2.35%
2011-10,אזור יהודה והשומרון,3652,בית אריה,יישוב,56,21,35,10,46,5,56,0,2.65%
2011-10,אזור יהודה והשומרון,3780,ביתר עילית,יישוב,417,197,220,15,402,208,411,29,4.90%
2011-10,אזור יהודה והשומרון,3730,גבעת זאב,יישוב,185,90,95,26,159,50,185,9,3.07%
2011-10,אזור יהודה והשומרון,3769,הר אדר,יישוב,24,7,17,11,13,1,24,1,1.41%
2011-10,אזור יהודה והשומרון,3797,מודיעין עילית,יישוב,358,118,240,22,336,96,353,13,3.39%
2011-10,אזור יהודה והשומרון,3616,מעלה אדומים,יישוב,618,251,367,97,521,206,613,32,3.48%
2011-10,אזור יהודה והשומרון,3660,עמנואל,יישוב,72,36,36,3,69,60,72,0,7.78%
2011-10,אזור יהודה והשומרון,3557,קדומים,יישוב,25,13,12,11,14,7,25,3,1.56%
2011-10,אזור יהודה והשומרון,3611,קריית ארבע,יישוב,110,48,62,17,93,65,110,8,3.96%
2011-10,אזור יהודה והשומרון,3640,קרני שומרון,יישוב,76,39,37,19,57,20,75,4,2.31%
2011-10,הדרום,31,אופקים,יישוב,1370,558,812,96,1274,981,1365,81,12.16%
2011-10,הדרום,2600,אילת,יישוב,1325,571,754,78,1247,590,1314,75,4.31%
2011-10,הדרום,70,אשדוד,יישוב,6671,2643,4028,766,5905,3927,6625,267,6.66%
2011-10,הדרום,7100,אשקלון,יישוב,4225,1655,2570,645,3580,2624,4116,190,7.12%
2011-10,הדרום,9000,באר שבע,יישוב,7086,2992,4094,975,6111,4659,7044,360,7.53%
2011-10,הדרום,2200,דימונה,יישוב,2065,892,1173,128,1937,1457,2037,61,11.67%
2011-10,הדרום,1303,חורה,יישוב,727,308,419,1,726,677,726,12,23.84%
2011-10,הדרום,831,ירוחם,יישוב,436,218,218,19,417,272,430,47,10.43%
2011-10,הדרום,1059,כסיפה,יישוב,996,424,572,4,992,915,993,16,26.53%
2011-10,הדרום,1271,להבים,יישוב,40,20,20,21,19,4,40,3,1.31%
2011-10,הדרום,1060,לקיה,יישוב,925,409,516,5,920,863,923,15,28.71%
2011-10,הדרום,1268,מיתר,יישוב,59,21,38,26,33,5,58,5,1.58%
2011-10,הדרום,99,מצפה רמון,יישוב,241,87,154,21,220,123,222,26,10.00%
2011-10,הדרום,246,נתיבות,יישוב,1008,413,595,62,946,524,1001,110,8.58%
2011-10,הדרום,666,עומר,יישוב,55,15,40,22,33,9,55,6,1.48%
2011-10,הדרום,2560,ערד,יישוב,867,386,481,169,698,505,848,62,6.93%
2011-10,הדרום,1192,ערערה-בנגב,יישוב,942,386,556,2,940,879,942,39,29.69%
2011-10,הדרום,2630,קריית גת,יישוב,2270,927,1343,189,2081,1496,2265,70,9.15%
2011-10,הדרום,1034,קריית מלאכי,יישוב,1239,528,711,28,1211,817,1220,108,11.37%
2011-10,הדרום,1161,רהט,יישוב,2796,1062,1734,10,2786,2542,2796,113,20.16%
2011-10,הדרום,1286,שגב-שלום,יישוב,461,162,299,0,461,435,460,36,23.23%
2011-10,הדרום,1031,שדרות,יישוב,1045,431,614,64,981,643,1042,64,9.46%
2011-10,הדרום,1054,תל שבע,יישוב,1156,529,627,4,1152,1082,1156,48,30.17%
2011-10,המרכז,182,אבן יהודה,יישוב,131,67,64,44,87,17,131,9,2.21%
2011-10,המרכז,41,אליכין,יישוב,51,22,29,4,47,15,50,4,3.18%
2011-10,המרכז,1309,אלעד,יישוב,381,167,214,20,361,105,380,14,3.61%
2011-10,המרכז,2530,באר יעקב,יישוב,219,96,123,41,178,68,214,11,3.08%
2011-10,המרכז,466,בית דגן,יישוב,94,47,47,16,78,31,94,1,2.89%
2011-10,המרכז,1066,"בני עי""ש",יישוב,186,89,97,28,158,67,185,2,4.80%
2011-10,המרכז,681,גבעת שמואל,יישוב,229,119,110,91,138,56,228,16,2.20%
2011-10,המרכז,2550,גדרה,יישוב,371,150,221,75,296,105,362,5,3.62%
2011-10,המרכז,627,ג'לג'וליה,יישוב,81,44,37,5,76,38,81,2,2.86%
2011-10,המרכז,166,גן יבנה,יישוב,333,131,202,47,286,102,330,18,3.43%
2011-10,המרכז,229,גני תקווה,יישוב,172,68,104,46,126,25,171,9,2.46%
2011-10,המרכז,9700,הוד השרון,יישוב,566,247,319,220,346,60,563,28,2.26%
2011-10,המרכז,1290,זמר,יישוב,150,48,102,9,141,119,150,4,6.23%
2011-10,המרכז,2730,טייבה,יישוב,2142,890,1252,4,2138,1850,2127,36,14.46%
2011-10,המרכז,2720,טירה,יישוב,290,138,152,10,280,177,289,14,3.25%
2011-10,המרכז,2660,יבנה,יישוב,821,403,418,72,749,411,818,48,4.61%
2011-10,המרכז,9400,יהוד,יישוב,494,197,297,73,421,83,477,42,3.27%
2011-10,המרכז,1224,כוכב יאיר,יישוב,88,43,45,38,50,4,88,6,1.68%
2011-10,המרכז,633,כפר ברא,יישוב,25,16,9,0,25,7,25,2,2.45%
2011-10,המרכז,168,כפר יונה,יישוב,336,148,188,76,260,78,335,26,3.57%
2011-10,המרכז,6900,כפר סבא,יישוב,1076,446,630,352,724,182,1070,61,2.34%
2011-10,המרכז,634,כפר קאסם,יישוב,203,106,97,0,203,117,203,8,3.12%
2011-10,המרכז,7000,לוד,יישוב,2098,921,1177,167,1931,1231,2089,90,6.41%
2011-10,המרכז,1200,מודיעין-מכבים-רעות*,יישוב,893,376,517,371,522,74,881,46,2.41%
2011-10,המרכז,28,מזכרת בתיה,יישוב,151,64,87,40,111,39,151,0,2.75%
2011-10,המרכז,7200,נס ציונה,יישוב,627,273,354,125,502,196,621,3,3.14%
2011-10,המרכז,7400,נתניה,יישוב,4271,1909,2362,635,3636,1781,4228,318,4.55%
2011-10,המרכז,587,סביון*,יישוב,12,4,8,7,5,0,12,0,0.74%
2011-10,המרכז,171,פרדסייה,יישוב,76,34,42,8,68,8,76,2,2.25%
2011-10,המרכז,7900,פתח תקווה,יישוב,3720,1631,2089,771,2949,1094,3692,173,3.43%
2011-10,המרכז,195,קדימה-צורן,יישוב,212,87,125,55,157,42,212,14,2.48%
2011-10,המרכז,638,קלנסווה,יישוב,893,317,576,0,893,774,891,21,12.57%
2011-10,המרכז,469,קריית עקרון,יישוב,272,136,136,20,252,116,272,2,5.10%
2011-10,המרכז,2640,ראש העין,יישוב,663,310,353,81,582,164,655,39,3.28%
2011-10,המרכז,8300,ראשון לציון,יישוב,4102,1739,2363,865,3237,1595,4082,188,3.26%
2011-10,המרכז,8400,רחובות,יישוב,2470,1077,1393,523,1947,1041,2426,13,4.28%
2011-10,המרכז,8500,רמלה,יישוב,1649,766,883,101,1548,802,1623,91,5.12%
2011-10,המרכז,8700,רעננה,יישוב,736,342,394,294,442,86,736,42,2.12%
2011-10,המרכז,1304,שוהם,יישוב,164,72,92,76,88,3,163,14,1.71%
2011-10,המרכז,154,תל מונד,יישוב,136,67,69,50,86,26,135,6,2.54%
2011-10,הצפון,473,אבו סנאן,יישוב,707,260,447,6,701,614,703,20,14.74%
2011-10,הצפון,478,אכסאל,יישוב,517,209,308,14,503,458,517,13,11.44%
2011-10,הצפון,529,אעבלין,יישוב,620,248,372,10,610,524,620,17,13.32%
2011-10,הצפון,482,בועיינה-נוג'ידאת,יישוב,436,175,261,2,434,385,432,18,13.97%
2011-10,הצפון,4001,בוקעאתא,יישוב,350,128,222,6,344,312,342,2,14.91%
2011-10,הצפון,998,ביר אל-מכסור,יישוב,420,156,264,7,413,325,420,4,14.08%
2011-10,הצפון,480,בית ג'ן,יישוב,326,105,221,3,323,235,324,7,7.91%
2011-10,הצפון,9200,בית שאן,יישוב,786,309,477,20,766,432,785,71,8.52%
2011-10,הצפון,944,בסמת טבעון,יישוב,249,105,144,2,247,189,249,6,9.38%
2011-10,הצפון,483,בענה,יישוב,402,152,250,3,399,362,402,13,14.64%
2011-10,הצפון,1292,ג'דיידה-מכר,יישוב,1446,592,854,7,1439,1269,1445,28,18.87%
2011-10,הצפון,485,ג'ולס,יישוב,193,56,137,2,191,147,192,7,8.22%
2011-10,הצפון,487,ג'ש (גוש חלב),יישוב,52,28,24,2,50,26,51,2,3.60%
2011-10,הצפון,489,דבורייה,יישוב,386,163,223,9,377,302,384,7,10.79%
2011-10,הצפון,490,דייר אל-אסד,יישוב,371,153,218,6,365,314,371,10,9.14%
2011-10,הצפון,492,דייר חנא,יישוב,619,255,364,10,609,513,619,15,15.96%
2011-10,הצפון,975,זרזיר,יישוב,268,104,164,2,266,191,265,11,11.11%
2011-10,הצפון,496,חורפיש,יישוב,136,57,79,6,130,86,135,7,6.53%
2011-10,הצפון,2034,חצור הגלילית,יישוב,270,94,176,10,260,130,263,16,6.10%
2011-10,הצפון,6700,טבריה,יישוב,1811,736,1075,115,1696,1212,1697,109,8.49%
2011-10,הצפון,962,טובא-זנגרייה,יישוב,332,145,187,4,328,242,327,7,12.50%
2011-10,הצפון,498,טורעאן,יישוב,470,162,308,10,460,418,468,14,10.43%
2011-10,הצפון,8900,טמרה,יישוב,1900,765,1135,17,1883,1696,1897,51,16.51%
2011-10,הצפון,1295,יאנוח-ג'ת,יישוב,143,44,99,3,140,107,143,6,6.83%
2011-10,הצפון,46,יבנאל,יישוב,137,88,49,7,130,104,128,3,9.66%
2011-10,הצפון,499,יפיע,יישוב,592,246,346,12,580,473,588,24,9.20%
2011-10,הצפון,240,יקנעם עילית,יישוב,483,212,271,89,394,183,483,39,4.76%
2011-10,הצפון,502,ירכא,יישוב,470,186,284,3,467,405,470,7,10.49%
2011-10,הצפון,504,כאבול,יישוב,659,256,403,10,649,600,656,15,16.25%
2011-10,הצפון,505,כאוכב אבו אל-היג'א,יישוב,209,83,126,6,203,186,209,7,14.85%
2011-10,הצפון,1296,כסרא-סמיע,יישוב,219,87,132,1,218,163,217,17,8.21%
2011-10,הצפון,978,כעביה-טבאש-חג'אג'רה,יישוב,181,73,108,2,179,133,180,6,9.81%
2011-10,הצפון,1263,כפר ורדים,יישוב,70,37,33,31,39,4,70,4,2.41%
2011-10,הצפון,507,כפר יאסיף,יישוב,472,184,288,4,468,403,472,19,11.14%
2011-10,הצפון,508,כפר כמא,יישוב,67,24,43,1,66,38,66,1,4.98%
2011-10,הצפון,509,כפר כנא,יישוב,1094,402,692,22,1072,969,1083,39,15.16%
2011-10,הצפון,510,כפר מנדא,יישוב,948,435,513,9,939,723,943,30,15.87%
2011-10,הצפון,47,כפר תבור,יישוב,50,22,28,13,37,5,50,3,2.99%
2011-10,הצפון,1139,כרמיאל,יישוב,1765,702,1063,349,1416,905,1704,77,6.93%
2011-10,הצפון,481,מגאר,יישוב,1342,500,842,25,1317,1226,1338,62,18.40%
2011-10,הצפון,516,מג'ד אל-כרום,יישוב,569,246,323,10,559,462,569,19,10.99%
2011-10,הצפון,874,מגדל העמק,יישוב,995,426,569,85,910,439,959,107,7.71%
2011-10,הצפון,4201,מג'דל שמס,יישוב,457,163,294,13,444,384,455,2,11.70%
2011-10,הצפון,517,מזרעה,יישוב,163,59,104,2,161,143,162,3,10.21%
2011-10,הצפון,4203,מסעדה,יישוב,178,61,117,3,175,156,177,5,12.38%
2011-10,הצפון,518,מעיליא,יישוב,42,23,19,3,39,20,42,3,3.07%
2011-10,הצפון,1063,מעלות-תרשיחא,יישוב,865,382,483,109,756,559,861,45,7.69%
2011-10,הצפון,520,משהד,יישוב,283,102,181,2,281,251,280,13,10.95%
2011-10,הצפון,9100,נהרייה,יישוב,2007,889,1118,220,1787,1291,1994,90,7.20%
2011-10,הצפון,522,נחף,יישוב,399,170,229,12,387,335,399,13,10.00%
2011-10,הצפון,7300,נצרת,יישוב,2825,1161,1664,69,2756,2258,2814,77,9.77%
2011-10,הצפון,1061,נצרת עילית,יישוב,1923,831,1092,286,1637,1101,1825,198,8.07%
2011-10,הצפון,525,סאג'ור,יישוב,112,45,67,0,112,91,111,3,7.95%
2011-10,הצפון,7500,סח'נין,יישוב,1925,825,1100,31,1894,1695,1925,42,16.93%
2011-10,הצפון,4501,ע'ג'ר,יישוב,79,31,48,4,75,69,79,1,9.54%
2011-10,הצפון,530,עיילבון,יישוב,177,67,110,6,171,143,176,9,8.35%
2011-10,הצפון,511,עילוט,יישוב,314,128,186,6,308,252,313,6,13.62%
2011-10,הצפון,532,עין מאהל,יישוב,572,251,321,8,564,496,565,7,13.42%
2011-10,הצפון,7600,עכו,יישוב,3128,1399,1729,157,2971,2440,3106,126,12.94%
2011-10,הצפון,7700,עפולה,יישוב,1759,697,1062,206,1553,901,1707,137,7.86%
2011-10,הצפון,531,עראבה,יישוב,1340,529,811,34,1306,1214,1339,26,16.63%
2011-10,הצפון,535,פסוטה,יישוב,110,45,65,2,108,84,110,4,7.50%
2011-10,הצפון,536,פקיעין (בוקייעה),יישוב,117,57,60,3,114,89,115,2,4.99%
2011-10,הצפון,8000,צפת,יישוב,1013,495,518,71,942,705,1007,31,8.88%
2011-10,הצפון,4100,קצרין,יישוב,182,73,109,27,155,90,181,9,4.92%
2011-10,הצפון,2800,קריית שמונה,יישוב,692,309,383,63,629,267,674,71,5.56%
2011-10,הצפון,543,ראמה,יישוב,303,126,177,4,299,239,303,3,9.49%
2011-10,הצפון,26,ראש פינה,יישוב,42,12,30,9,33,19,42,2,3.08%
2011-10,הצפון,542,ריינה,יישוב,596,223,373,13,583,502,593,26,10.77%
2011-10,הצפון,122,רמת ישי,יישוב,84,36,48,30,54,7,83,5,2.28%
2011-10,הצפון,913,שבלי - אום אל-גנם,יישוב,230,96,134,7,223,180,229,5,10.77%
2011-10,הצפון,812,שלומי,יישוב,245,92,153,15,230,152,243,10,7.47%
2011-10,הצפון,538,שעב,יישוב,446,179,267,5,441,406,446,7,17.98%
2011-10,הצפון,8800,שפרעם,יישוב,1979,762,1217,39,1940,1653,1974,56,13.46%
2011-10,חיפה,2710,אום אל-פחם,יישוב,3611,1457,2154,13,3598,3125,3608,41,21.22%
2011-10,חיפה,1020,אור עקיבא,יישוב,576,236,340,44,532,221,565,49,6.26%
2011-10,חיפה,6000,באקה אל-גרביה,יישוב,633,298,335,8,625,429,633,28,NULL
2011-10,חיפה,9800,בנימינה-גבעת עדה*,יישוב,165,70,95,59,106,43,164,8,2.70%
2011-10,חיפה,1326,"בסמ""ה",יישוב,397,169,228,1,396,337,397,5,12.47%
2011-10,חיפה,541,ג'סר א-זרקא,יישוב,441,260,181,0,441,279,440,37,8.69%
2011-10,חיפה,628,ג'ת,יישוב,187,83,104,7,180,121,186,7,NULL
2011-10,חיפה,494,דאלית אל-כרמל,יישוב,450,183,267,8,442,289,447,16,6.66%
2011-10,חיפה,9300,זכרון יעקב,יישוב,207,91,116,79,128,45,207,22,2.30%
2011-10,חיפה,6500,חדרה,יישוב,2275,946,1329,276,1999,932,2238,198,5.11%
2011-10,חיפה,4000,חיפה,יישוב,7180,3186,3994,1368,5812,4590,7145,415,5.51%
2011-10,חיפה,1247,חריש-קציר,יישוב,13,6,7,2,11,5,12,5,0.74%
2011-10,חיפה,2100,טירת כרמל,יישוב,725,326,399,36,689,468,720,41,7.58%
2011-10,חיפה,654,כפר קרע,יישוב,350,158,192,6,344,226,349,14,5.13%
2011-10,חיפה,1327,מעלה עירון,יישוב,894,348,546,3,891,739,894,17,18.72%
2011-10,חיפה,2500,נשר,יישוב,506,231,275,97,409,261,503,40,4.16%
2011-10,חיפה,534,עספיא,יישוב,332,145,187,5,327,210,332,12,7.00%
2011-10,חיפה,637,ערערה,יישוב,543,200,343,6,537,386,542,24,8.19%
2011-10,חיפה,537,פוריידיס,יישוב,371,185,186,2,369,266,370,14,7.90%
2011-10,חיפה,7800,פרדס חנה-כרכור,יישוב,792,336,456,131,661,281,787,76,4.70%
2011-10,חיפה,6800,קריית אתא,יישוב,1750,732,1018,135,1615,1109,1746,91,6.58%
2011-10,חיפה,9500,קריית ביאליק,יישוב,1142,481,661,121,1021,642,1137,61,5.74%
2011-10,חיפה,2300,קריית טבעון,יישוב,180,80,100,69,111,43,176,14,2.34%
2011-10,חיפה,9600,קריית ים,יישוב,1616,706,910,166,1450,1096,1610,65,8.14%
2011-10,חיפה,8200,קריית מוצקין,יישוב,1111,432,679,175,936,572,1103,77,5.34%
2011-10,חיפה,922,רכסים,יישוב,146,62,84,11,135,93,146,5,5.42%
2011-10,ירושלים,472,אבו גוש,יישוב,249,114,135,8,241,178,248,8,10.30%
2011-10,ירושלים,2610,בית שמש,יישוב,1104,451,653,107,997,533,1096,107,4.46%
2011-10,ירושלים,3000,ירושלים,יישוב,10023,4266,5757,1270,8753,6122,9965,475,4.01%
2011-10,ירושלים,1015,מבשרת ציון,יישוב,324,139,185,67,257,152,322,18,2.77%
2011-10,ירושלים,1137,קריית יערים,יישוב,24,10,14,2,22,11,24,2,2.42%
2011-10,תל אביב,2400,אור יהודה,יישוב,788,362,426,35,753,287,773,64,4.46%
2011-10,תל אביב,565,אזור,יישוב,137,63,74,18,119,35,135,9,2.31%
2011-10,תל אביב,6100,בני ברק,יישוב,2276,1085,1191,115,2161,1367,2264,83,4.91%
2011-10,תל אביב,6200,בת ים,יישוב,3197,1447,1750,421,2776,1414,3152,174,4.54%
2011-10,תל אביב,6300,גבעתיים,יישוב,656,279,377,290,366,118,650,34,2.39%
2011-10,תל אביב,6400,הרצלייה,יישוב,957,433,524,309,648,80,943,154,2.09%
2011-10,תל אביב,6600,חולון,יישוב,2822,1286,1536,464,2358,935,2770,155,3.01%
2011-10,תל אביב,2620,קריית אונו,יישוב,379,151,228,134,245,48,376,21,2.33%
2011-10,תל אביב,8600,רמת גן,יישוב,1958,869,1089,619,1339,490,1940,99,2.73%
2011-10,תל אביב,2650,רמת השרון,יישוב,377,153,224,162,215,25,373,40,1.83%
2011-10,תל אביב,5000,תל אביב -יפו,יישוב,7355,3636,3719,2189,5166,2690,7292,386,3.18%
2011-11,אזור יהודה והשומרון,3760,אורנית,יישוב,93,42,51,40,53,4,92,6,2.46%
2011-11,אזור יהודה והשומרון,3750,אלפי מנשה,יישוב,80,31,49,23,57,0,80,4,1.99%
2011-11,אזור יהודה והשומרון,3560,אלקנה,יישוב,29,15,14,14,15,2,28,2,1.65%
2011-11,אזור יהודה והשומרון,3650,אפרתה,יישוב,56,29,27,27,29,9,56,5,1.59%
2011-11,אזור יהודה והשומרון,3570,אריאל,יישוב,388,181,207,93,295,106,386,38,3.89%
2011-11,אזור יהודה והשומרון,3574,בית אל,יישוב,54,29,25,11,43,20,54,2,2.53%
2011-11,אזור יהודה והשומרון,3652,בית אריה,יישוב,64,26,38,14,50,6,64,2,3.01%
2011-11,אזור יהודה והשומרון,3780,ביתר עילית,יישוב,414,191,223,18,396,202,408,47,4.87%
2011-11,אזור יהודה והשומרון,3730,גבעת זאב,יישוב,182,84,98,22,160,48,182,17,3.02%
2011-11,אזור יהודה והשומרון,3769,הר אדר,יישוב,23,7,16,10,13,0,23,2,1.35%
2011-11,אזור יהודה והשומרון,3797,מודיעין עילית,יישוב,349,123,226,21,328,97,347,16,3.34%
2011-11,אזור יהודה והשומרון,3616,מעלה אדומים,יישוב,631,269,362,99,532,211,622,46,3.53%
2011-11,אזור יהודה והשומרון,3660,עמנואל,יישוב,75,37,38,4,71,57,75,0,8.07%
2011-11,אזור יהודה והשומרון,3557,קדומים,יישוב,26,14,12,11,15,7,26,2,1.63%
2011-11,אזור יהודה והשומרון,3611,קריית ארבע,יישוב,122,54,68,20,102,77,121,10,4.34%
2011-11,אזור יהודה והשומרון,3640,קרני שומרון,יישוב,86,46,40,21,65,21,84,3,2.58%
2011-11,הדרום,31,אופקים,יישוב,1399,579,820,98,1301,982,1391,38,12.37%
2011-11,הדרום,2600,אילת,יישוב,1380,620,760,70,1310,621,1364,77,4.47%
2011-11,הדרום,70,אשדוד,יישוב,6931,2780,4151,784,6147,4012,6892,392,6.91%
2011-11,הדרום,7100,אשקלון,יישוב,4345,1716,2629,650,3695,2664,4230,216,7.30%
2011-11,הדרום,9000,באר שבע,יישוב,7264,3082,4182,1002,6262,4762,7204,547,7.69%
2011-11,הדרום,2200,דימונה,יישוב,2176,953,1223,134,2042,1515,2143,105,12.20%
2011-11,הדרום,1303,חורה,יישוב,717,302,415,1,716,669,717,14,23.62%
2011-11,הדרום,831,ירוחם,יישוב,456,230,226,21,435,287,450,46,10.86%
2011-11,הדרום,1059,כסיפה,יישוב,984,416,568,5,979,908,982,26,26.31%
2011-11,הדרום,1271,להבים,יישוב,45,20,25,25,20,4,45,5,1.47%
2011-11,הדרום,1060,לקיה,יישוב,923,404,519,3,920,866,921,15,28.66%
2011-11,הדרום,1268,מיתר,יישוב,59,21,38,25,34,8,58,4,1.58%
2011-11,הדרום,99,מצפה רמון,יישוב,235,83,152,18,217,127,219,26,9.87%
2011-11,הדרום,246,נתיבות,יישוב,1022,416,606,64,958,540,1014,90,8.68%
2011-11,הדרום,666,עומר,יישוב,57,16,41,23,34,9,57,11,1.54%
2011-11,הדרום,2560,ערד,יישוב,899,400,499,186,713,518,881,115,7.18%
2011-11,הדרום,1192,ערערה-בנגב,יישוב,928,390,538,2,926,863,927,9,29.35%
2011-11,הדרום,2630,קריית גת,יישוב,2335,957,1378,191,2144,1537,2326,109,9.37%
2011-11,הדרום,1034,קריית מלאכי,יישוב,1238,556,682,25,1213,830,1221,130,11.38%
2011-11,הדרום,1161,רהט,יישוב,2859,1125,1734,10,2849,2598,2859,80,20.52%
2011-11,הדרום,1286,שגב-שלום,יישוב,462,166,296,0,462,429,461,17,23.27%
2011-11,הדרום,1031,שדרות,יישוב,1085,458,627,61,1024,668,1080,61,9.77%
2011-11,הדרום,1054,תל שבע,יישוב,1117,511,606,1,1116,1047,1117,29,29.45%
2011-11,המרכז,182,אבן יהודה,יישוב,139,75,64,44,95,19,139,10,2.34%
2011-11,המרכז,41,אליכין,יישוב,49,23,26,4,45,16,49,6,3.12%
2011-11,המרכז,1309,אלעד,יישוב,371,151,220,18,353,105,371,21,3.53%
2011-11,המרכז,2530,באר יעקב,יישוב,243,104,139,44,199,76,237,25,3.40%
2011-11,המרכז,466,בית דגן,יישוב,93,45,48,16,77,32,92,7,2.83%
2011-11,המרכז,1066,"בני עי""ש",יישוב,186,90,96,27,159,71,186,2,4.83%
2011-11,המרכז,681,גבעת שמואל,יישוב,242,125,117,97,145,57,242,10,2.33%
2011-11,המרכז,2550,גדרה,יישוב,381,149,232,80,301,102,376,4,3.75%
2011-11,המרכז,627,ג'לג'וליה,יישוב,56,29,27,2,54,33,56,3,1.99%
2011-11,המרכז,166,גן יבנה,יישוב,320,136,184,46,274,98,317,23,3.30%
2011-11,המרכז,229,גני תקווה,יישוב,182,74,108,54,128,26,181,7,2.60%
2011-11,המרכז,9700,הוד השרון,יישוב,577,254,323,218,359,61,576,34,2.31%
2011-11,המרכז,1290,זמר,יישוב,156,55,101,7,149,123,156,3,6.46%
2011-11,המרכז,2730,טייבה,יישוב,2150,885,1265,4,2146,1863,2139,32,14.53%
2011-11,המרכז,2720,טירה,יישוב,295,148,147,13,282,180,294,17,3.31%
2011-11,המרכז,2660,יבנה,יישוב,872,438,434,73,799,434,870,85,4.88%
2011-11,המרכז,9400,יהוד,יישוב,510,195,315,81,429,84,489,40,3.35%
2011-11,המרכז,1224,כוכב יאיר,יישוב,92,47,45,47,45,4,92,4,1.76%
2011-11,המרכז,633,כפר ברא,יישוב,22,15,7,0,22,7,22,1,2.17%
2011-11,המרכז,168,כפר יונה,יישוב,327,148,179,72,255,81,326,42,3.48%
2011-11,המרכז,6900,כפר סבא,יישוב,1162,485,677,358,804,192,1150,71,2.51%
2011-11,המרכז,634,כפר קאסם,יישוב,207,105,102,1,206,115,207,8,3.18%
2011-11,המרכז,7000,לוד,יישוב,2217,1004,1213,174,2043,1260,2207,181,6.74%
2011-11,המרכז,1200,מודיעין-מכבים-רעות*,יישוב,941,413,528,398,543,70,930,71,2.54%
2011-11,המרכז,28,מזכרת בתיה,יישוב,147,65,82,43,104,39,146,0,2.66%
2011-11,המרכז,7200,נס ציונה,יישוב,635,276,359,123,512,197,629,5,3.18%
2011-11,המרכז,7400,נתניה,יישוב,4287,1974,2313,642,3645,1757,4253,448,4.57%
2011-11,המרכז,587,סביון*,יישוב,12,3,9,8,4,1,12,0,0.74%
2011-11,המרכז,171,פרדסייה,יישוב,78,37,41,15,63,7,78,5,2.31%
2011-11,המרכז,7900,פתח תקווה,יישוב,3887,1703,2184,772,3115,1125,3854,279,3.57%
2011-11,המרכז,195,קדימה-צורן,יישוב,215,95,120,56,159,39,215,18,2.52%
2011-11,המרכז,638,קלנסווה,יישוב,871,309,562,1,870,763,869,21,12.30%
2011-11,המרכז,469,קריית עקרון,יישוב,263,134,129,13,250,113,263,5,4.94%
2011-11,המרכז,2640,ראש העין,יישוב,700,349,351,82,618,167,690,61,3.45%
2011-11,המרכז,8300,ראשון לציון,יישוב,4243,1870,2373,864,3379,1631,4226,316,3.37%
2011-11,המרכז,8400,רחובות,יישוב,2489,1084,1405,497,1992,1066,2448,32,4.31%
2011-11,המרכז,8500,רמלה,יישוב,1736,823,913,104,1632,828,1705,142,5.36%
2011-11,המרכז,8700,רעננה,יישוב,739,349,390,301,438,85,738,40,2.13%
2011-11,המרכז,1304,שוהם,יישוב,169,73,96,82,87,3,168,13,1.76%
2011-11,המרכז,154,תל מונד,יישוב,138,70,68,52,86,24,138,6,2.59%
2011-11,הצפון,473,אבו סנאן,יישוב,719,263,456,7,712,620,715,18,14.96%
2011-11,הצפון,478,אכסאל,יישוב,521,216,305,14,507,458,521,10,11.52%
2011-11,הצפון,529,אעבלין,יישוב,607,238,369,9,598,520,607,28,13.08%
2011-11,הצפון,482,בועיינה-נוג'ידאת,יישוב,443,185,258,4,439,399,437,6,14.11%
2011-11,הצפון,4001,בוקעאתא,יישוב,366,132,234,7,359,329,357,4,15.46%
2011-11,הצפון,998,ביר אל-מכסור,יישוב,412,155,257,5,407,322,412,2,13.85%
2011-11,הצפון,480,בית ג'ן,יישוב,328,110,218,4,324,231,326,2,7.96%
2011-11,הצפון,9200,בית שאן,יישוב,789,329,460,20,769,456,787,83,8.53%
2011-11,הצפון,944,בסמת טבעון,יישוב,244,98,146,2,242,188,244,9,9.20%
2011-11,הצפון,483,בענה,יישוב,410,158,252,1,409,375,410,10,14.89%
2011-11,הצפון,1292,ג'דיידה-מכר,יישוב,1481,613,868,8,1473,1305,1478,40,19.22%
2011-11,הצפון,485,ג'ולס,יישוב,209,55,154,2,207,149,208,14,8.84%
2011-11,הצפון,487,ג'ש (גוש חלב),יישוב,50,24,26,1,49,24,49,0,3.46%
2011-11,הצפון,489,דבורייה,יישוב,386,166,220,9,377,304,385,8,10.81%
2011-11,הצפון,490,דייר אל-אסד,יישוב,378,162,216,10,368,321,378,10,9.30%
2011-11,הצפון,492,דייר חנא,יישוב,632,260,372,9,623,519,632,22,16.24%
2011-11,הצפון,975,זרזיר,יישוב,293,119,174,3,290,201,288,14,11.96%
2011-11,הצפון,496,חורפיש,יישוב,115,48,67,6,109,78,114,4,5.57%
2011-11,הצפון,2034,חצור הגלילית,יישוב,268,99,169,10,258,132,263,13,6.10%
2011-11,הצפון,6700,טבריה,יישוב,1835,765,1070,107,1728,1226,1715,152,8.57%
2011-11,הצפון,962,טובא-זנגרייה,יישוב,333,153,180,4,329,251,329,4,12.57%
2011-11,הצפון,498,טורעאן,יישוב,520,183,337,12,508,438,518,13,11.42%
2011-11,הצפון,8900,טמרה,יישוב,1927,779,1148,12,1915,1723,1923,66,16.70%
2011-11,הצפון,1295,יאנוח-ג'ת,יישוב,142,44,98,1,141,105,142,2,6.79%
2011-11,הצפון,46,יבנאל,יישוב,129,89,40,6,123,104,120,2,9.11%
2011-11,הצפון,499,יפיע,יישוב,593,245,348,13,580,475,590,23,9.23%
2011-11,הצפון,240,יקנעם עילית,יישוב,504,220,284,94,410,184,503,62,4.95%
2011-11,הצפון,502,ירכא,יישוב,479,185,294,2,477,404,479,16,10.67%
2011-11,הצפון,504,כאבול,יישוב,657,250,407,10,647,596,654,18,16.20%
2011-11,הצפון,505,כאוכב אבו אל-היג'א,יישוב,210,87,123,5,205,180,210,8,14.91%
2011-11,הצפון,1296,כסרא-סמיע,יישוב,210,90,120,1,209,158,209,9,7.93%
2011-11,הצפון,978,כעביה-טבאש-חג'אג'רה,יישוב,189,77,112,2,187,139,188,2,10.21%
2011-11,הצפון,1263,כפר ורדים,יישוב,64,36,28,30,34,6,64,5,2.21%
2011-11,הצפון,507,כפר יאסיף,יישוב,478,188,290,6,472,408,477,18,11.25%
2011-11,הצפון,508,כפר כמא,יישוב,67,29,38,1,66,40,65,3,4.91%
2011-11,הצפון,509,כפר כנא,יישוב,1112,415,697,21,1091,986,1101,51,15.37%
2011-11,הצפון,510,כפר מנדא,יישוב,925,419,506,10,915,721,920,38,15.54%
2011-11,הצפון,47,כפר תבור,יישוב,50,21,29,16,34,6,50,1,2.99%
2011-11,הצפון,1139,כרמיאל,יישוב,1783,707,1076,380,1403,910,1731,127,7.04%
2011-11,הצפון,481,מגאר,יישוב,1339,506,833,21,1318,1235,1335,79,18.37%
2011-11,הצפון,516,מג'ד אל-כרום,יישוב,583,256,327,9,574,470,583,24,11.23%
2011-11,הצפון,874,מגדל העמק,יישוב,1030,437,593,83,947,478,982,140,7.88%
2011-11,הצפון,4201,מג'דל שמס,יישוב,481,183,298,13,468,400,477,15,12.19%
2011-11,הצפון,517,מזרעה,יישוב,158,55,103,1,157,140,157,6,9.93%
2011-11,הצפון,4203,מסעדה,יישוב,189,66,123,4,185,165,188,2,13.05%
2011-11,הצפון,518,מעיליא,יישוב,42,22,20,3,39,24,42,0,3.07%
2011-11,הצפון,1063,מעלות-תרשיחא,יישוב,874,396,478,109,765,565,873,63,7.79%
2011-11,הצפון,520,משהד,יישוב,281,101,180,2,279,250,279,7,10.92%
2011-11,הצפון,9100,נהרייה,יישוב,2036,920,1116,212,1824,1305,2022,103,7.29%
2011-11,הצפון,522,נחף,יישוב,394,172,222,8,386,336,394,11,9.89%
2011-11,הצפון,7300,נצרת,יישוב,2844,1187,1657,74,2770,2266,2830,109,9.82%
2011-11,הצפון,1061,נצרת עילית,יישוב,1900,829,1071,279,1621,1083,1808,236,8.00%
2011-11,הצפון,525,סאג'ור,יישוב,115,43,72,0,115,96,114,2,8.14%
2011-11,הצפון,7500,סח'נין,יישוב,1955,847,1108,34,1921,1717,1954,50,17.14%
2011-11,הצפון,4501,ע'ג'ר,יישוב,82,31,51,3,79,70,82,2,9.87%
2011-11,הצפון,530,עיילבון,יישוב,180,71,109,4,176,142,179,11,8.48%
2011-11,הצפון,511,עילוט,יישוב,311,125,186,5,306,250,310,11,13.51%
2011-11,הצפון,532,עין מאהל,יישוב,578,253,325,12,566,499,571,6,13.54%
2011-11,הצפון,7600,עכו,יישוב,3201,1414,1787,159,3042,2508,3172,173,13.18%
2011-11,הצפון,7700,עפולה,יישוב,1793,749,1044,192,1601,936,1744,164,8.02%
2011-11,הצפון,531,עראבה,יישוב,1352,533,819,34,1318,1225,1351,38,16.76%
2011-11,הצפון,535,פסוטה,יישוב,111,47,64,2,109,84,111,3,7.57%
2011-11,הצפון,536,פקיעין (בוקייעה),יישוב,115,55,60,3,112,86,113,4,4.90%
2011-11,הצפון,8000,צפת,יישוב,1073,516,557,74,999,761,1063,29,9.33%
2011-11,הצפון,4100,קצרין,יישוב,191,81,110,34,157,91,189,17,5.12%
2011-11,הצפון,2800,קריית שמונה,יישוב,721,332,389,70,651,287,701,79,5.77%
2011-11,הצפון,543,ראמה,יישוב,313,125,188,7,306,250,312,5,9.75%
2011-11,הצפון,26,ראש פינה,יישוב,46,13,33,10,36,19,46,3,3.37%
2011-11,הצפון,542,ריינה,יישוב,595,228,367,10,585,504,592,27,10.75%
2011-11,הצפון,122,רמת ישי,יישוב,82,29,53,33,49,7,81,2,2.23%
2011-11,הצפון,913,שבלי - אום אל-גנם,יישוב,235,106,129,5,230,177,234,7,10.98%
2011-11,הצפון,812,שלומי,יישוב,251,97,154,17,234,149,248,17,7.61%
2011-11,הצפון,538,שעב,יישוב,446,176,270,4,442,410,446,9,17.98%
2011-11,הצפון,8800,שפרעם,יישוב,1957,751,1206,29,1928,1640,1951,69,13.33%
2011-11,חיפה,2710,אום אל-פחם,יישוב,3608,1464,2144,15,3593,3136,3605,39,21.21%
2011-11,חיפה,1020,אור עקיבא,יישוב,605,270,335,47,558,228,595,76,6.57%
2011-11,חיפה,6000,באקה אל-גרביה,יישוב,642,303,339,11,631,436,642,28,NULL
2011-11,חיפה,9800,בנימינה-גבעת עדה*,יישוב,183,75,108,59,124,49,183,18,3.00%
2011-11,חיפה,1326,"בסמ""ה",יישוב,402,174,228,1,401,336,402,10,12.61%
2011-11,חיפה,541,ג'סר א-זרקא,יישוב,422,262,160,0,422,291,420,22,8.33%
2011-11,חיפה,628,ג'ת,יישוב,185,78,107,8,177,122,184,7,NULL
2011-11,חיפה,494,דאלית אל-כרמל,יישוב,487,200,287,10,477,296,480,13,7.12%
2011-11,חיפה,9300,זכרון יעקב,יישוב,212,98,114,85,127,44,211,24,2.35%
2011-11,חיפה,6500,חדרה,יישוב,2318,995,1323,282,2036,971,2279,207,5.20%
2011-11,חיפה,4000,חיפה,יישוב,7339,3302,4037,1383,5956,4626,7301,615,5.62%
2011-11,חיפה,1247,חריש-קציר,יישוב,11,6,5,3,8,5,11,0,0.68%
2011-11,חיפה,2100,טירת כרמל,יישוב,742,333,409,38,704,484,737,61,7.75%
2011-11,חיפה,654,כפר קרע,יישוב,354,160,194,3,351,228,352,11,5.17%
2011-11,חיפה,1327,מעלה עירון,יישוב,888,345,543,4,884,738,888,8,18.62%
2011-11,חיפה,2500,נשר,יישוב,523,241,282,89,434,274,519,61,4.29%
2011-11,חיפה,534,עספיא,יישוב,327,147,180,5,322,204,325,9,6.86%
2011-11,חיפה,637,ערערה,יישוב,531,195,336,2,529,387,530,27,8.02%
2011-11,חיפה,537,פוריידיס,יישוב,381,194,187,1,380,264,380,19,8.10%
2011-11,חיפה,7800,פרדס חנה-כרכור,יישוב,792,354,438,135,657,289,789,108,4.71%
2011-11,חיפה,6800,קריית אתא,יישוב,1779,752,1027,145,1634,1127,1771,136,6.67%
2011-11,חיפה,9500,קריית ביאליק,יישוב,1168,482,686,117,1051,654,1163,90,5.86%
2011-11,חיפה,2300,קריית טבעון,יישוב,177,80,97,65,112,45,172,16,2.29%
2011-11,חיפה,9600,קריית ים,יישוב,1647,711,936,166,1481,1116,1639,124,8.27%
2011-11,חיפה,8200,קריית מוצקין,יישוב,1104,435,669,169,935,579,1096,82,5.31%
2011-11,חיפה,922,רכסים,יישוב,149,65,84,11,138,95,148,8,5.49%
2011-11,ירושלים,472,אבו גוש,יישוב,236,109,127,5,231,179,236,7,9.85%
2011-11,ירושלים,2610,בית שמש,יישוב,1162,493,669,110,1052,550,1152,112,4.68%
2011-11,ירושלים,3000,ירושלים,יישוב,10217,4428,5789,1277,8940,6177,10142,611,4.08%
2011-11,ירושלים,1015,מבשרת ציון,יישוב,332,147,185,58,274,157,329,26,2.82%
2011-11,ירושלים,1137,קריית יערים,יישוב,29,10,19,4,25,11,29,1,2.91%
2011-11,תל אביב,2400,אור יהודה,יישוב,803,377,426,30,773,301,789,79,4.55%
2011-11,תל אביב,565,אזור,יישוב,148,66,82,20,128,41,146,23,2.50%
2011-11,תל אביב,6100,בני ברק,יישוב,2298,1115,1183,111,2187,1385,2289,93,4.96%
2011-11,תל אביב,6200,בת ים,יישוב,3385,1526,1859,450,2935,1437,3329,336,4.78%
2011-11,תל אביב,6300,גבעתיים,יישוב,667,278,389,295,372,115,660,59,2.42%
2011-11,תל אביב,6400,הרצלייה,יישוב,1038,483,555,322,716,80,1015,156,2.24%
2011-11,תל אביב,6600,חולון,יישוב,2984,1367,1617,460,2524,927,2935,302,3.18%
2011-11,תל אביב,2620,קריית אונו,יישוב,387,163,224,123,264,51,383,24,2.37%
2011-11,תל אביב,8600,רמת גן,יישוב,2058,941,1117,654,1404,499,2040,140,2.87%
2011-11,תל אביב,2650,רמת השרון,יישוב,364,156,208,160,204,20,363,33,1.79%
2011-11,תל אביב,5000,תל אביב -יפו,יישוב,7699,3803,3896,2373,5326,2724,7633,560,3.32%
2011-12,אזור יהודה והשומרון,3760,אורנית,יישוב,92,40,52,38,54,4,91,7,2.43%
2011-12,אזור יהודה והשומרון,3750,אלפי מנשה,יישוב,82,28,54,22,60,1,82,3,2.04%
2011-12,אזור יהודה והשומרון,3560,אלקנה,יישוב,23,13,10,11,12,1,23,1,1.36%
2011-12,אזור יהודה והשומרון,3650,אפרתה,יישוב,47,31,16,22,25,7,47,5,1.34%
2011-12,אזור יהודה והשומרון,3570,אריאל,יישוב,397,190,207,88,309,104,396,32,3.99%
2011-12,אזור יהודה והשומרון,3574,בית אל,יישוב,47,24,23,8,39,20,47,2,2.21%
2011-12,אזור יהודה והשומרון,3652,בית אריה,יישוב,71,28,43,17,54,5,71,5,3.33%
2011-12,אזור יהודה והשומרון,3780,ביתר עילית,יישוב,394,188,206,16,378,190,390,40,4.66%
2011-12,אזור יהודה והשומרון,3730,גבעת זאב,יישוב,161,76,85,21,140,43,160,13,2.67%
2011-12,אזור יהודה והשומרון,3769,הר אדר,יישוב,27,13,14,11,16,0,26,0,1.52%
2011-12,אזור יהודה והשומרון,3797,מודיעין עילית,יישוב,355,124,231,21,334,97,352,11,3.38%
2011-12,אזור יהודה והשומרון,3616,מעלה אדומים,יישוב,627,259,368,91,536,224,618,50,3.50%
2011-12,אזור יהודה והשומרון,3660,עמנואל,יישוב,79,41,38,3,76,63,79,1,8.47%
2011-12,אזור יהודה והשומרון,3557,קדומים,יישוב,27,16,11,10,17,6,27,3,1.69%
2011-12,אזור יהודה והשומרון,3611,קריית ארבע,יישוב,101,45,56,17,84,67,101,12,3.65%
2011-12,אזור יהודה והשומרון,3640,קרני שומרון,יישוב,87,42,45,21,66,19,86,6,2.64%
2011-12,הדרום,31,אופקים,יישוב,1356,571,785,95,1261,979,1344,43,12.00%
2011-12,הדרום,2600,אילת,יישוב,1442,673,769,66,1376,608,1429,64,4.67%
2011-12,הדרום,70,אשדוד,יישוב,6770,2727,4043,772,5998,3968,6719,332,6.75%
2011-12,הדרום,7100,אשקלון,יישוב,4172,1668,2504,618,3554,2664,4061,182,7.03%
2011-12,הדרום,9000,באר שבע,יישוב,7175,3093,4082,980,6195,4735,7122,439,7.61%
2011-12,הדרום,2200,דימונה,יישוב,2148,946,1202,136,2012,1503,2112,133,12.05%
2011-12,הדרום,1303,חורה,יישוב,724,308,416,3,721,673,724,8,23.79%
2011-12,הדרום,831,ירוחם,יישוב,436,209,227,23,413,282,429,44,10.41%
2011-12,הדרום,1059,כסיפה,יישוב,971,417,554,4,967,897,969,18,26.06%
2011-12,הדרום,1271,להבים,יישוב,39,19,20,21,18,3,39,2,1.28%
2011-12,הדרום,1060,לקיה,יישוב,923,404,519,1,922,868,920,11,28.64%
2011-12,הדרום,1268,מיתר,יישוב,58,26,32,24,34,7,57,3,1.55%
2011-12,הדרום,99,מצפה רמון,יישוב,220,87,133,18,202,128,211,21,9.55%
2011-12,הדרום,246,נתיבות,יישוב,936,391,545,54,882,524,930,78,8.02%
2011-12,הדרום,666,עומר,יישוב,57,18,39,24,33,9,55,3,1.48%
2011-12,הדרום,2560,ערד,יישוב,874,397,477,182,692,513,855,78,6.99%
2011-12,הדרום,1192,ערערה-בנגב,יישוב,947,397,550,2,945,885,947,15,29.80%
2011-12,הדרום,2630,קריית גת,יישוב,2278,910,1368,192,2086,1519,2270,64,9.16%
2011-12,הדרום,1034,קריית מלאכי,יישוב,1236,556,680,28,1208,819,1212,114,11.30%
2011-12,הדרום,1161,רהט,יישוב,2889,1145,1744,8,2881,2622,2888,117,20.69%
2011-12,הדרום,1286,שגב-שלום,יישוב,453,156,297,0,453,427,452,5,22.92%
2011-12,הדרום,1031,שדרות,יישוב,1017,429,588,60,957,652,1013,56,9.22%
2011-12,הדרום,1054,תל שבע,יישוב,1118,514,604,2,1116,1046,1118,20,29.47%
2011-12,המרכז,182,אבן יהודה,יישוב,116,65,51,39,77,19,116,14,1.96%
2011-12,המרכז,41,אליכין,יישוב,45,22,23,3,42,14,45,1,2.87%
2011-12,המרכז,1309,אלעד,יישוב,372,153,219,18,354,100,372,27,3.54%
2011-12,המרכז,2530,באר יעקב,יישוב,245,110,135,45,200,79,242,10,3.47%
2011-12,המרכז,466,בית דגן,יישוב,92,42,50,14,78,34,92,6,2.83%
2011-12,המרכז,1066,"בני עי""ש",יישוב,175,83,92,28,147,72,175,0,4.56%
2011-12,המרכז,681,גבעת שמואל,יישוב,246,129,117,108,138,57,244,13,2.35%
2011-12,המרכז,2550,גדרה,יישוב,364,153,211,80,284,106,358,1,3.58%
2011-12,המרכז,627,ג'לג'וליה,יישוב,59,30,29,2,57,33,59,3,2.10%
2011-12,המרכז,166,גן יבנה,יישוב,326,139,187,48,278,98,323,13,3.36%
2011-12,המרכז,229,גני תקווה,יישוב,171,73,98,48,123,23,169,7,2.43%
2011-12,המרכז,9700,הוד השרון,יישוב,567,254,313,206,361,62,564,29,2.27%
2011-12,המרכז,1290,זמר,יישוב,159,56,103,8,151,124,159,3,6.58%
2011-12,המרכז,2730,טייבה,יישוב,2185,902,1283,4,2181,1880,2175,41,14.73%
2011-12,המרכז,2720,טירה,יישוב,307,153,154,7,300,183,306,16,3.44%
2011-12,המרכז,2660,יבנה,יישוב,840,425,415,76,764,420,837,66,4.71%
2011-12,המרכז,9400,יהוד,יישוב,499,190,309,77,422,87,479,45,3.29%
2011-12,המרכז,1224,כוכב יאיר,יישוב,81,43,38,40,41,4,81,7,1.55%
2011-12,המרכז,633,כפר ברא,יישוב,27,18,9,2,25,8,27,1,2.64%
2011-12,המרכז,168,כפר יונה,יישוב,324,154,170,71,253,75,324,28,3.46%
2011-12,המרכז,6900,כפר סבא,יישוב,1133,484,649,364,769,184,1121,64,2.45%
2011-12,המרכז,634,כפר קאסם,יישוב,230,124,106,1,229,123,228,11,3.49%
2011-12,המרכז,7000,לוד,יישוב,2215,990,1225,164,2051,1284,2206,143,6.74%
2011-12,המרכז,1200,מודיעין-מכבים-רעות*,יישוב,905,403,502,370,535,70,894,45,2.44%
2011-12,המרכז,28,מזכרת בתיה,יישוב,143,65,78,44,99,35,142,1,2.59%
2011-12,המרכז,7200,נס ציונה,יישוב,610,270,340,120,490,197,603,9,3.05%
2011-12,המרכז,7400,נתניה,יישוב,4142,1932,2210,622,3520,1758,4102,405,4.42%
2011-12,המרכז,587,סביון*,יישוב,11,2,9,7,4,1,11,0,0.68%
2011-12,המרכז,171,פרדסייה,יישוב,78,42,36,18,60,6,78,7,2.31%
2011-12,המרכז,7900,פתח תקווה,יישוב,3775,1696,2079,772,3003,1106,3745,247,3.47%
2011-12,המרכז,195,קדימה-צורן,יישוב,232,100,132,58,174,41,232,10,2.71%
2011-12,המרכז,638,קלנסווה,יישוב,888,316,572,3,885,769,885,20,12.50%
2011-12,המרכז,469,קריית עקרון,יישוב,272,133,139,15,257,124,271,3,5.08%
2011-12,המרכז,2640,ראש העין,יישוב,683,337,346,90,593,168,673,43,3.37%
2011-12,המרכז,8300,ראשון לציון,יישוב,4264,1865,2399,858,3406,1641,4251,297,3.39%
2011-12,המרכז,8400,רחובות,יישוב,2447,1082,1365,513,1934,1040,2405,23,4.24%
2011-12,המרכז,8500,רמלה,יישוב,1696,800,896,100,1596,829,1659,138,5.23%
2011-12,המרכז,8700,רעננה,יישוב,728,358,370,294,434,83,725,37,2.09%
2011-12,המרכז,1304,שוהם,יישוב,176,85,91,76,100,5,175,9,1.83%
2011-12,המרכז,154,תל מונד,יישוב,138,64,74,55,83,24,138,8,2.59%
2011-12,הצפון,473,אבו סנאן,יישוב,724,271,453,7,717,624,720,17,15.04%
2011-12,הצפון,478,אכסאל,יישוב,529,220,309,11,518,461,529,9,11.68%
2011-12,הצפון,529,אעבלין,יישוב,609,242,367,10,599,524,609,26,13.12%
2011-12,הצפון,482,בועיינה-נוג'ידאת,יישוב,444,195,249,4,440,397,438,5,14.14%
2011-12,הצפון,4001,בוקעאתא,יישוב,366,131,235,7,359,332,358,17,15.50%
2011-12,הצפון,998,ביר אל-מכסור,יישוב,418,160,258,4,414,324,418,14,14.03%
2011-12,הצפון,480,בית ג'ן,יישוב,332,115,217,5,327,239,330,10,8.05%
2011-12,הצפון,9200,בית שאן,יישוב,762,319,443,20,742,441,759,71,8.26%
2011-12,הצפון,944,בסמת טבעון,יישוב,245,105,140,2,243,185,245,18,9.24%
2011-12,הצפון,483,בענה,יישוב,414,159,255,2,412,374,414,8,15.02%
2011-12,הצפון,1292,ג'דיידה-מכר,יישוב,1505,620,885,8,1497,1320,1501,34,19.46%
2011-12,הצפון,485,ג'ולס,יישוב,207,52,155,2,205,147,207,16,8.80%
2011-12,הצפון,487,ג'ש (גוש חלב),יישוב,46,23,23,0,46,23,45,0,3.19%
2011-12,הצפון,489,דבורייה,יישוב,403,183,220,9,394,308,402,7,11.24%
2011-12,הצפון,490,דייר אל-אסד,יישוב,385,164,221,11,374,325,385,10,9.45%
2011-12,הצפון,492,דייר חנא,יישוב,655,275,380,10,645,529,655,19,16.73%
2011-12,הצפון,975,זרזיר,יישוב,299,128,171,2,297,207,295,21,12.21%
2011-12,הצפון,496,חורפיש,יישוב,117,54,63,6,111,73,116,1,5.67%
2011-12,הצפון,2034,חצור הגלילית,יישוב,266,102,164,10,256,132,261,10,6.06%
2011-12,הצפון,6700,טבריה,יישוב,1833,796,1037,110,1723,1257,1710,119,8.55%
2011-12,הצפון,962,טובא-זנגרייה,יישוב,349,168,181,3,346,252,345,1,13.10%
2011-12,הצפון,498,טורעאן,יישוב,507,184,323,12,495,446,504,22,11.15%
2011-12,הצפון,8900,טמרה,יישוב,1945,778,1167,13,1932,1735,1940,68,16.82%
2011-12,הצפון,1295,יאנוח-ג'ת,יישוב,145,45,100,2,143,105,145,3,6.92%
2011-12,הצפון,46,יבנאל,יישוב,141,94,47,7,134,109,131,3,9.86%
2011-12,הצפון,499,יפיע,יישוב,602,250,352,12,590,481,597,23,9.33%
2011-12,הצפון,240,יקנעם עילית,יישוב,489,217,272,86,403,176,488,51,4.81%
2011-12,הצפון,502,ירכא,יישוב,493,195,298,2,491,409,493,17,10.95%
2011-12,הצפון,504,כאבול,יישוב,681,263,418,11,670,615,679,14,16.72%
2011-12,הצפון,505,כאוכב אבו אל-היג'א,יישוב,218,91,127,6,212,185,218,3,15.40%
2011-12,הצפון,1296,כסרא-סמיע,יישוב,219,100,119,1,218,161,218,8,8.24%
2011-12,הצפון,978,כעביה-טבאש-חג'אג'רה,יישוב,218,94,124,3,215,142,218,2,11.65%
2011-12,הצפון,1263,כפר ורדים,יישוב,71,38,33,31,40,7,71,1,2.44%
2011-12,הצפון,507,כפר יאסיף,יישוב,492,199,293,5,487,415,492,15,11.56%
2011-12,הצפון,508,כפר כמא,יישוב,68,26,42,2,66,43,66,1,4.98%
2011-12,הצפון,509,כפר כנא,יישוב,1145,439,706,14,1131,1013,1131,43,15.73%
2011-12,הצפון,510,כפר מנדא,יישוב,944,428,516,9,935,743,937,47,15.78%
2011-12,הצפון,47,כפר תבור,יישוב,54,23,31,16,38,7,54,3,3.22%
2011-12,הצפון,1139,כרמיאל,יישוב,1721,670,1051,357,1364,913,1672,99,6.81%
2011-12,הצפון,481,מגאר,יישוב,1358,516,842,24,1334,1254,1353,72,18.57%
2011-12,הצפון,516,מג'ד אל-כרום,יישוב,573,248,325,6,567,469,573,19,11.06%
2011-12,הצפון,874,מגדל העמק,יישוב,968,417,551,85,883,467,932,127,7.50%
2011-12,הצפון,4201,מג'דל שמס,יישוב,500,186,314,12,488,416,494,12,12.57%
2011-12,הצפון,517,מזרעה,יישוב,169,66,103,2,167,142,168,6,10.55%
2011-12,הצפון,4203,מסעדה,יישוב,193,70,123,5,188,166,192,4,13.29%
2011-12,הצפון,518,מעיליא,יישוב,44,24,20,4,40,25,44,3,3.21%
2011-12,הצפון,1063,מעלות-תרשיחא,יישוב,829,381,448,107,722,545,827,56,7.41%
2011-12,הצפון,520,משהד,יישוב,278,101,177,2,276,247,276,11,10.82%
2011-12,הצפון,9100,נהרייה,יישוב,2051,921,1130,214,1837,1323,2040,94,7.35%
2011-12,הצפון,522,נחף,יישוב,401,175,226,6,395,341,401,14,10.05%
2011-12,הצפון,7300,נצרת,יישוב,2861,1198,1663,65,2796,2279,2843,95,9.86%
2011-12,הצפון,1061,נצרת עילית,יישוב,1831,794,1037,268,1563,1082,1743,176,7.73%
2011-12,הצפון,525,סאג'ור,יישוב,121,43,78,0,121,99,118,4,8.40%
2011-12,הצפון,7500,סח'נין,יישוב,1979,854,1125,31,1948,1725,1979,39,17.32%
2011-12,הצפון,4501,ע'ג'ר,יישוב,88,37,51,3,85,72,88,5,10.51%
2011-12,הצפון,530,עיילבון,יישוב,181,72,109,4,177,140,180,10,8.53%
2011-12,הצפון,511,עילוט,יישוב,325,137,188,8,317,255,324,14,14.03%
2011-12,הצפון,532,עין מאהל,יישוב,593,271,322,11,582,502,585,7,13.83%
2011-12,הצפון,7600,עכו,יישוב,3189,1422,1767,160,3029,2523,3163,147,13.15%
2011-12,הצפון,7700,עפולה,יישוב,1728,726,1002,195,1533,903,1675,164,7.73%
2011-12,הצפון,531,עראבה,יישוב,1371,547,824,30,1341,1238,1370,37,16.95%
2011-12,הצפון,535,פסוטה,יישוב,110,49,61,3,107,85,110,8,7.50%
2011-12,הצפון,536,פקיעין (בוקייעה),יישוב,123,63,60,3,120,85,121,6,5.23%
2011-12,הצפון,8000,צפת,יישוב,1047,531,516,73,974,763,1040,28,9.15%
2011-12,הצפון,4100,קצרין,יישוב,182,72,110,33,149,94,181,8,4.92%
2011-12,הצפון,2800,קריית שמונה,יישוב,715,335,380,70,645,306,693,85,5.70%
2011-12,הצפון,543,ראמה,יישוב,306,123,183,4,302,248,304,1,9.52%
2011-12,הצפון,26,ראש פינה,יישוב,54,19,35,11,43,24,54,3,3.93%
2011-12,הצפון,542,ריינה,יישוב,596,232,364,9,587,505,592,18,10.75%
2011-12,הצפון,122,רמת ישי,יישוב,89,33,56,38,51,11,88,4,2.42%
2011-12,הצפון,913,שבלי - אום אל-גנם,יישוב,249,116,133,3,246,179,246,5,11.48%
2011-12,הצפון,812,שלומי,יישוב,243,97,146,20,223,154,240,13,7.38%
2011-12,הצפון,538,שעב,יישוב,455,177,278,5,450,411,454,6,18.25%
2011-12,הצפון,8800,שפרעם,יישוב,1985,766,1219,27,1958,1689,1978,95,13.49%
2011-12,חיפה,2710,אום אל-פחם,יישוב,3663,1481,2182,12,3651,3169,3660,48,21.46%
2011-12,חיפה,1020,אור עקיבא,יישוב,600,241,359,39,561,238,590,60,6.52%
2011-12,חיפה,6000,באקה אל-גרביה,יישוב,657,316,341,10,647,434,657,37,NULL
2011-12,חיפה,9800,בנימינה-גבעת עדה*,יישוב,179,80,99,56,123,49,179,14,2.94%
2011-12,חיפה,1326,"בסמ""ה",יישוב,412,182,230,1,411,340,412,6,12.88%
2011-12,חיפה,541,ג'סר א-זרקא,יישוב,429,263,166,0,429,289,427,23,8.46%
2011-12,חיפה,628,ג'ת,יישוב,208,90,118,11,197,129,207,13,NULL
2011-12,חיפה,494,דאלית אל-כרמל,יישוב,464,178,286,9,455,297,462,25,6.87%
2011-12,חיפה,9300,זכרון יעקב,יישוב,225,99,126,87,138,45,225,12,2.50%
2011-12,חיפה,6500,חדרה,יישוב,2319,1014,1305,273,2046,982,2282,180,5.20%
2011-12,חיפה,4000,חיפה,יישוב,7270,3322,3948,1390,5880,4540,7222,576,5.56%
2011-12,חיפה,1247,חריש-קציר,יישוב,14,8,6,4,10,5,13,1,0.80%
2011-12,חיפה,2100,טירת כרמל,יישוב,734,327,407,37,697,477,730,64,7.68%
2011-12,חיפה,654,כפר קרע,יישוב,366,171,195,3,363,232,364,12,5.34%
2011-12,חיפה,1327,מעלה עירון,יישוב,906,356,550,4,902,754,906,11,18.93%
2011-12,חיפה,2500,נשר,יישוב,506,239,267,94,412,259,503,50,4.16%
2011-12,חיפה,534,עספיא,יישוב,323,148,175,6,317,197,322,18,6.80%
2011-12,חיפה,637,ערערה,יישוב,561,210,351,1,560,391,560,22,8.44%
2011-12,חיפה,537,פוריידיס,יישוב,390,198,192,2,388,269,388,14,8.26%
2011-12,חיפה,7800,פרדס חנה-כרכור,יישוב,777,349,428,126,651,285,774,79,4.63%
2011-12,חיפה,6800,קריית אתא,יישוב,1742,743,999,147,1595,1101,1736,108,6.55%
2011-12,חיפה,9500,קריית ביאליק,יישוב,1129,464,665,113,1016,641,1126,72,5.69%
2011-12,חיפה,2300,קריית טבעון,יישוב,176,86,90,63,113,43,174,12,2.31%
2011-12,חיפה,9600,קריית ים,יישוב,1639,708,931,164,1475,1114,1635,97,8.25%
2011-12,חיפה,8200,קריית מוצקין,יישוב,1077,428,649,170,907,571,1068,69,5.18%
2011-12,חיפה,922,רכסים,יישוב,141,62,79,8,133,94,139,7,5.17%
2011-12,ירושלים,472,אבו גוש,יישוב,232,109,123,7,225,176,231,12,9.67%
2011-12,ירושלים,2610,בית שמש,יישוב,1143,516,627,115,1028,548,1134,89,4.61%
2011-12,ירושלים,3000,ירושלים,יישוב,10119,4438,5681,1227,8892,6286,10049,387,4.05%
2011-12,ירושלים,1015,מבשרת ציון,יישוב,324,152,172,51,273,148,322,19,2.77%
2011-12,ירושלים,1137,קריית יערים,יישוב,31,11,20,3,28,14,31,0,3.10%
2011-12,תל אביב,2400,אור יהודה,יישוב,766,371,395,28,738,301,751,65,4.34%
2011-12,תל אביב,565,אזור,יישוב,152,69,83,29,123,39,151,7,2.58%
2011-12,תל אביב,6100,בני ברק,יישוב,2252,1104,1148,105,2147,1369,2241,71,4.86%
2011-12,תל אביב,6200,בת ים,יישוב,3289,1497,1792,448,2841,1439,3235,278,4.66%
2011-12,תל אביב,6300,גבעתיים,יישוב,678,294,384,308,370,109,672,39,2.47%
2011-12,תל אביב,6400,הרצלייה,יישוב,1024,472,552,313,711,89,1006,176,2.22%
2011-12,תל אביב,6600,חולון,יישוב,2917,1379,1538,469,2448,943,2869,262,3.11%
2011-12,תל אביב,2620,קריית אונו,יישוב,363,150,213,126,237,48,360,14,2.23%
2011-12,תל אביב,8600,רמת גן,יישוב,2021,932,1089,655,1366,492,2006,126,2.82%
2011-12,תל אביב,2650,רמת השרון,יישוב,385,168,217,170,215,19,382,25,1.88%
2011-12,תל אביב,5000,תל אביב -יפו,יישוב,7616,3783,3833,2330,5286,2699,7551,437,3.29%
2012-01,אזור יהודה והשומרון,3760,אורנית,יישוב,97,45,52,40,57,5,96,6,2.31%
2012-01,אזור יהודה והשומרון,3750,אלפי מנשה,יישוב,98,42,56,26,72,0,98,6,2.36%
2012-01,אזור יהודה והשומרון,3560,אלקנה,יישוב,23,10,13,14,9,1,22,0,1.24%
2012-01,אזור יהודה והשומרון,3650,אפרת,יישוב,41,24,17,20,21,6,41,0,1.09%
2012-01,אזור יהודה והשומרון,3570,אריאל,יישוב,430,219,211,100,330,104,428,38,4.18%
2012-01,אזור יהודה והשומרון,3574,בית אל,יישוב,45,26,19,8,37,17,45,3,1.98%
2012-01,אזור יהודה והשומרון,3652,בית אריה,יישוב,77,27,50,20,57,4,77,4,3.37%
2012-01,אזור יהודה והשומרון,3780,ביתר עילית,יישוב,405,196,209,16,389,205,398,20,3.93%
2012-01,אזור יהודה והשומרון,3730,גבעת זאב,יישוב,171,78,93,24,147,42,171,8,2.54%
2012-01,אזור יהודה והשומרון,3769,הר אדר,יישוב,28,14,14,11,17,2,28,2,1.48%
2012-01,אזור יהודה והשומרון,3797,מודיעין עילית,יישוב,353,137,216,19,334,101,351,11,2.89%
2012-01,אזור יהודה והשומרון,3616,מעלה אדומים,יישוב,651,272,379,99,552,219,643,53,3.35%
2012-01,אזור יהודה והשומרון,3660,עמנואל,יישוב,82,41,41,3,79,62,82,1,7.81%
2012-01,אזור יהודה והשומרון,3557,קדומים,יישוב,32,18,14,12,20,6,32,4,1.86%
2012-01,אזור יהודה והשומרון,3611,קריית ארבע,יישוב,107,46,61,17,90,71,107,6,3.64%
2012-01,אזור יהודה והשומרון,3640,קרני שומרון,יישוב,81,40,41,17,64,18,79,7,2.28%
2012-01,הדרום,31,אופקים,יישוב,1409,605,804,104,1305,990,1393,54,11.36%
2012-01,הדרום,2600,אילת,יישוב,1727,813,914,71,1656,631,1708,90,5.25%
2012-01,הדרום,70,אשדוד,יישוב,7013,2873,4140,811,6202,4039,6955,414,6.69%
2012-01,הדרום,7100,אשקלון,יישוב,4290,1712,2578,624,3666,2675,4188,225,6.59%
2012-01,הדרום,9000,באר שבע,יישוב,7534,3251,4283,1015,6519,4827,7472,547,7.56%
2012-01,הדרום,2200,דימונה,יישוב,2195,979,1216,135,2060,1549,2159,151,12.23%
2012-01,הדרום,1303,חורה,יישוב,742,322,420,3,739,686,742,11,20.80%
2012-01,הדרום,831,ירוחם,יישוב,457,228,229,24,433,296,446,51,10.57%
2012-01,הדרום,1059,כסיפה,יישוב,985,429,556,5,980,897,984,18,23.71%
2012-01,הדרום,1271,להבים,יישוב,35,18,17,20,15,3,35,5,1.08%
2012-01,הדרום,1060,לקיה,יישוב,949,417,532,3,946,896,946,10,26.40%
2012-01,הדרום,1268,מיתר,יישוב,59,27,32,28,31,6,58,4,1.49%
2012-01,הדרום,99,מצפה רמון,יישוב,238,97,141,23,215,123,226,34,9.44%
2012-01,הדרום,246,נתיבות,יישוב,917,392,525,53,864,544,908,63,7.17%
2012-01,הדרום,666,עומר,יישוב,68,22,46,23,45,12,68,4,1.79%
2012-01,הדרום,2560,ערד,יישוב,903,395,508,183,720,518,886,93,7.25%
2012-01,הדרום,1192,ערערה-בנגב,יישוב,939,388,551,2,937,886,939,5,25.19%
2012-01,הדרום,2630,קריית גת,יישוב,2401,971,1430,202,2199,1572,2391,101,9.01%
2012-01,הדרום,1034,קריית מלאכי,יישוב,1283,597,686,28,1255,822,1260,102,11.03%
2012-01,הדרום,1161,רהט,יישוב,2930,1168,1762,10,2920,2647,2928,46,17.78%
2012-01,הדרום,1286,שגב-שלום,יישוב,474,169,305,0,474,446,473,5,19.69%
2012-01,הדרום,1031,שדרות,יישוב,1048,457,591,64,984,680,1044,68,8.74%
2012-01,הדרום,1054,תל שבע,יישוב,1140,538,602,1,1139,1072,1139,14,26.05%
2012-01,המרכז,182,אבן יהודה,יישוב,105,56,49,40,65,19,104,9,1.66%
2012-01,המרכז,41,אליכין,יישוב,50,24,26,3,47,15,50,2,2.89%
2012-01,המרכז,1309,אלעד,יישוב,391,163,228,23,368,113,390,18,3.46%
2012-01,המרכז,2530,באר יעקב,יישוב,236,105,131,44,192,81,233,21,2.86%
2012-01,המרכז,466,בית דגן,יישוב,96,46,50,15,81,34,96,7,2.81%
2012-01,המרכז,1066,"בני עי""ש",יישוב,189,83,106,28,161,70,188,1,4.78%
2012-01,המרכז,681,גבעת שמואל,יישוב,259,140,119,106,153,58,259,10,2.35%
2012-01,המרכז,2550,גדרה,יישוב,381,170,211,82,299,102,372,5,3.47%
2012-01,המרכז,627,ג'לג'וליה,יישוב,59,32,27,2,57,34,59,3,1.96%
2012-01,המרכז,166,גן יבנה,יישוב,324,132,192,48,276,97,322,15,3.12%
2012-01,המרכז,229,גני תקווה,יישוב,184,79,105,52,132,26,183,9,2.43%
2012-01,המרכז,9700,הוד השרון,יישוב,583,251,332,237,346,62,582,33,2.21%
2012-01,המרכז,1290,זמר,יישוב,168,62,106,8,160,125,168,13,6.24%
2012-01,המרכז,2730,טייבה,יישוב,2244,955,1289,4,2240,1903,2232,45,13.98%
2012-01,המרכז,2720,טירה,יישוב,331,177,154,9,322,184,330,15,3.27%
2012-01,המרכז,2660,יבנה,יישוב,878,445,433,75,803,401,872,65,4.41%
2012-01,המרכז,9400,יהוד,יישוב,510,203,307,72,438,82,488,39,3.25%
2012-01,המרכז,1224,כוכב יאיר,יישוב,81,42,39,40,41,5,81,2,1.50%
2012-01,המרכז,633,כפר ברא,יישוב,31,21,10,1,30,9,31,2,2.58%
2012-01,המרכז,168,כפר יונה,יישוב,345,164,181,73,272,74,341,28,3.44%
2012-01,המרכז,6900,כפר סבא,יישוב,1206,509,697,381,825,186,1197,66,2.47%
2012-01,המרכז,634,כפר קאסם,יישוב,221,111,110,2,219,120,219,9,2.80%
2012-01,המרכז,7000,לוד,יישוב,2353,1051,1302,161,2192,1371,2334,160,6.82%
2012-01,המרכז,1200,מודיעין-מכבים-רעות*,יישוב,931,434,497,391,540,68,925,83,2.32%
2012-01,המרכז,28,מזכרת בתיה,יישוב,153,73,80,42,111,34,151,3,2.48%
2012-01,המרכז,7200,נס ציונה,יישוב,614,283,331,123,491,202,604,3,2.84%
2012-01,המרכז,7400,נתניה,יישוב,4328,1970,2358,642,3686,1866,4281,405,4.37%
2012-01,המרכז,587,סביון*,יישוב,14,4,10,9,5,1,14,2,0.79%
2012-01,המרכז,171,פרדסייה,יישוב,74,39,35,19,55,8,74,6,2.15%
2012-01,המרכז,7900,פתח תקווה,יישוב,3899,1793,2106,793,3106,1086,3864,221,3.40%
2012-01,המרכז,195,קדימה-צורן,יישוב,228,93,135,62,166,41,226,25,2.46%
2012-01,המרכז,638,קלנסווה,יישוב,910,336,574,1,909,787,908,25,11.59%
2012-01,המרכז,469,קריית עקרון,יישוב,296,149,147,15,281,128,291,2,5.03%
2012-01,המרכז,2640,ראש העין,יישוב,723,368,355,83,640,173,715,69,3.36%
2012-01,המרכז,8300,ראשון לציון,יישוב,4405,1948,2457,898,3507,1642,4387,280,3.36%
2012-01,המרכז,8400,רחובות,יישוב,2553,1148,1405,545,2008,1032,2522,29,4.11%
2012-01,המרכז,8500,רמלה,יישוב,1804,835,969,100,1704,854,1773,142,5.18%
2012-01,המרכז,8700,רעננה,יישוב,748,364,384,297,451,82,748,38,2.08%
2012-01,המרכז,1304,שוהם,יישוב,185,84,101,83,102,8,184,17,1.82%
2012-01,המרכז,154,תל מונד,יישוב,147,71,76,59,88,28,147,9,2.61%
2012-01,הצפון,473,אבו סנאן,יישוב,747,290,457,6,741,632,743,21,14.02%
2012-01,הצפון,478,אכסאל,יישוב,540,228,312,12,528,460,539,11,10.63%
2012-01,הצפון,529,אעבלין,יישוב,624,253,371,8,616,530,624,20,12.07%
2012-01,הצפון,482,בועיינה-נוג'ידאת,יישוב,450,194,256,5,445,400,446,7,12.81%
2012-01,הצפון,4001,בוקעאתא,יישוב,379,142,237,6,373,335,370,7,14.42%
2012-01,הצפון,998,ביר אל-מכסור,יישוב,425,165,260,3,422,335,425,14,13.15%
2012-01,הצפון,480,בית ג'ן,יישוב,348,118,230,3,345,253,344,5,7.14%
2012-01,הצפון,9200,בית שאן,יישוב,790,345,445,19,771,461,786,76,8.29%
2012-01,הצפון,944,בסמת טבעון,יישוב,231,106,125,0,231,172,231,17,8.10%
2012-01,הצפון,483,בענה,יישוב,403,157,246,3,400,369,403,6,13.17%
2012-01,הצפון,1292,ג'דיידה-מכר,יישוב,1529,640,889,8,1521,1341,1526,46,18.17%
2012-01,הצפון,485,ג'ולס,יישוב,203,50,153,2,201,148,203,20,7.79%
2012-01,הצפון,487,ג'ש (גוש חלב),יישוב,52,26,26,2,50,24,51,2,3.42%
2012-01,הצפון,489,דבורייה,יישוב,419,186,233,11,408,314,418,7,10.70%
2012-01,הצפון,490,דייר אל-אסד,יישוב,404,169,235,10,394,340,404,6,8.77%
2012-01,הצפון,492,דייר חנא,יישוב,663,280,383,9,654,534,663,24,15.12%
2012-01,הצפון,975,זרזיר,יישוב,314,147,167,2,312,200,311,12,11.57%
2012-01,הצפון,496,חורפיש,יישוב,123,50,73,7,116,84,122,3,4.99%
2012-01,הצפון,2034,חצור הגלילית,יישוב,264,101,163,11,253,138,260,24,5.73%
2012-01,הצפון,6700,טבריה,יישוב,1943,847,1096,116,1827,1293,1814,119,8.67%
2012-01,הצפון,962,טובא-זנגרייה,יישוב,370,178,192,5,365,265,364,6,12.75%
2012-01,הצפון,498,טורעאן,יישוב,532,200,332,13,519,465,530,22,10.55%
2012-01,הצפון,8900,טמרה,יישוב,1981,798,1183,12,1969,1761,1978,64,15.37%
2012-01,הצפון,1295,יאנוח-ג'ת,יישוב,169,60,109,3,166,122,169,7,6.84%
2012-01,הצפון,46,יבנאל,יישוב,142,95,47,7,135,111,132,6,8.78%
2012-01,הצפון,499,יפיע,יישוב,638,280,358,13,625,492,634,22,8.98%
2012-01,הצפון,240,יקנעם עילית,יישוב,504,222,282,86,418,178,502,46,4.55%
2012-01,הצפון,502,ירכא,יישוב,510,202,308,2,508,421,510,15,9.49%
2012-01,הצפון,504,כאבול,יישוב,686,272,414,13,673,615,683,16,15.09%
2012-01,הצפון,505,כאוכב אבו אל-היג'א,יישוב,230,96,134,6,224,195,230,9,14.53%
2012-01,הצפון,1296,כסרא-סמיע,יישוב,258,100,158,1,257,212,257,15,8.40%
2012-01,הצפון,978,כעביה-טבאש-חג'אג'רה,יישוב,220,92,128,5,215,145,218,9,10.93%
2012-01,הצפון,1263,כפר ורדים,יישוב,82,40,42,34,48,9,82,2,2.71%
2012-01,הצפון,507,כפר יאסיף,יישוב,509,211,298,6,503,422,509,23,10.70%
2012-01,הצפון,508,כפר כמא,יישוב,72,27,45,2,70,42,70,3,4.64%
2012-01,הצפון,509,כפר כנא,יישוב,1162,458,704,16,1146,1027,1151,69,14.45%
2012-01,הצפון,510,כפר מנדא,יישוב,985,469,516,7,978,770,976,27,14.51%
2012-01,הצפון,47,כפר תבור,יישוב,52,25,27,13,39,6,51,2,2.75%
2012-01,הצפון,1139,כרמיאל,יישוב,1818,719,1099,367,1451,953,1761,86,6.95%
2012-01,הצפון,481,מגאר,יישוב,1407,535,872,24,1383,1289,1403,61,16.76%
2012-01,הצפון,516,מג'ד אל-כרום,יישוב,597,261,336,5,592,472,597,11,10.11%
2012-01,הצפון,874,מגדל העמק,יישוב,1042,431,611,84,958,496,985,126,7.60%
2012-01,הצפון,4201,מג'דל שמס,יישוב,503,191,312,13,490,408,498,18,11.11%
2012-01,הצפון,517,מזרעה,יישוב,162,63,99,3,159,134,160,1,8.77%
2012-01,הצפון,4203,מסעדה,יישוב,186,67,119,5,181,164,185,4,11.78%
2012-01,הצפון,518,מעיליא,יישוב,50,26,24,5,45,27,50,2,3.37%
2012-01,הצפון,1063,מעלות-תרשיחא,יישוב,899,405,494,113,786,598,897,41,7.67%
2012-01,הצפון,520,משהד,יישוב,292,107,185,2,290,251,289,8,9.78%
2012-01,הצפון,9100,נהרייה,יישוב,2124,949,1175,226,1898,1316,2109,100,7.25%
2012-01,הצפון,522,נחף,יישוב,400,177,223,8,392,340,400,9,8.80%
2012-01,הצפון,7300,נצרת,יישוב,2945,1255,1690,75,2870,2324,2929,100,9.50%
2012-01,הצפון,1061,נצרת עילית,יישוב,2018,859,1159,286,1732,1171,1920,195,8.32%
2012-01,הצפון,525,סאג'ור,יישוב,116,38,78,1,115,92,115,3,6.87%
2012-01,הצפון,7500,סח'נין,יישוב,2018,881,1137,35,1983,1745,2017,54,15.92%
2012-01,הצפון,4501,ע'ג'ר,יישוב,87,37,50,1,86,71,86,3,9.06%
2012-01,הצפון,530,עיילבון,יישוב,195,83,112,5,190,140,194,9,7.84%
2012-01,הצפון,511,עילוט,יישוב,326,140,186,6,320,253,325,15,12.57%
2012-01,הצפון,532,עין מאהל,יישוב,607,281,326,10,597,520,599,7,13.46%
2012-01,הצפון,7600,עכו,יישוב,3281,1469,1812,162,3119,2568,3257,143,12.74%
2012-01,הצפון,7700,עפולה,יישוב,1834,769,1065,196,1638,946,1765,165,7.54%
2012-01,הצפון,531,עראבה,יישוב,1397,564,833,31,1366,1253,1396,29,15.36%
2012-01,הצפון,535,פסוטה,יישוב,112,49,63,5,107,86,112,8,7.09%
2012-01,הצפון,536,פקיעין (בוקייעה),יישוב,141,67,74,3,138,97,139,5,5.38%
2012-01,הצפון,8000,צפת,יישוב,1122,584,538,76,1046,824,1112,30,8.97%
2012-01,הצפון,4100,קצרין,יישוב,204,82,122,31,173,100,202,17,5.29%
2012-01,הצפון,2800,קריית שמונה,יישוב,731,349,382,70,661,301,713,80,5.65%
2012-01,הצפון,543,ראמה,יישוב,312,128,184,3,309,254,312,3,8.76%
2012-01,הצפון,26,ראש פינה,יישוב,58,21,37,13,45,23,58,2,3.85%
2012-01,הצפון,542,ריינה,יישוב,617,244,373,9,608,523,612,24,9.98%
2012-01,הצפון,122,רמת ישי,יישוב,101,41,60,37,64,12,100,3,2.56%
2012-01,הצפון,913,שבלי - אום אל-גנם,יישוב,268,132,136,2,266,189,267,6,11.05%
2012-01,הצפון,812,שלומי,יישוב,246,100,146,14,232,151,244,13,7.02%
2012-01,הצפון,538,שעב,יישוב,472,191,281,5,467,421,471,16,16.92%
2012-01,הצפון,8800,שפרעם,יישוב,2000,769,1231,28,1972,1701,1993,87,12.23%
2012-01,חיפה,2710,אום אל-פחם,יישוב,3758,1528,2230,11,3747,3229,3754,46,20.01%
2012-01,חיפה,1020,אור עקיבא,יישוב,631,271,360,43,588,245,617,70,6.46%
2012-01,חיפה,6000,באקה אל-גרביה,יישוב,690,334,356,12,678,450,690,27,6.75%
2012-01,חיפה,9800,בנימינה-גבעת עדה*,יישוב,195,84,111,61,134,51,192,19,2.98%
2012-01,חיפה,1326,"בסמ""ה",יישוב,436,199,237,1,435,347,436,6,12.35%
2012-01,חיפה,541,ג'סר א-זרקא,יישוב,424,259,165,1,423,294,422,12,7.66%
2012-01,חיפה,628,ג'ת,יישוב,218,100,118,11,207,132,217,19,4.78%
2012-01,חיפה,494,דאלית אל-כרמל,יישוב,497,200,297,12,485,317,494,22,6.78%
2012-01,חיפה,9300,זכרון יעקב,יישוב,247,109,138,88,159,49,247,27,2.53%
2012-01,חיפה,6500,חדרה,יישוב,2378,1080,1298,278,2100,960,2335,208,5.13%
2012-01,חיפה,4000,חיפה,יישוב,7340,3406,3934,1412,5928,4503,7293,551,5.35%
2012-01,חיפה,1247,חריש,יישוב,17,10,7,4,13,9,17,0,0.96%
2012-01,חיפה,2100,טירת כרמל,יישוב,768,349,419,36,732,477,761,50,7.54%
2012-01,חיפה,654,כפר קרע,יישוב,371,170,201,6,365,235,369,15,4.89%
2012-01,חיפה,1327,מעלה עירון,יישוב,936,375,561,3,933,772,936,10,17.89%
2012-01,חיפה,2500,נשר,יישוב,526,252,274,95,431,266,521,48,4.17%
2012-01,חיפה,534,עספיא,יישוב,341,149,192,9,332,196,341,9,6.77%
2012-01,חיפה,637,ערערה,יישוב,559,224,335,0,559,399,558,25,7.70%
2012-01,חיפה,537,פוריידיס,יישוב,384,195,189,2,382,261,383,16,7.59%
2012-01,חיפה,7800,פרדס חנה-כרכור,יישוב,852,400,452,145,707,294,846,116,4.70%
2012-01,חיפה,6800,קריית אתא,יישוב,1791,770,1021,152,1639,1100,1784,117,6.29%
2012-01,חיפה,9500,קריית ביאליק,יישוב,1153,488,665,124,1029,628,1148,72,5.55%
2012-01,חיפה,2300,קריית טבעון,יישוב,190,97,93,71,119,45,187,12,2.36%
2012-01,חיפה,9600,קריית ים,יישוב,1662,750,912,163,1499,1101,1656,111,7.91%
2012-01,חיפה,8200,קריית מוצקין,יישוב,1126,469,657,178,948,589,1117,75,5.13%
2012-01,חיפה,922,רכסים,יישוב,144,65,79,10,134,97,144,16,4.70%
2012-01,ירושלים,472,אבו גוש,יישוב,243,114,129,6,237,174,243,6,8.95%
2012-01,ירושלים,2610,בית שמש,יישוב,1180,514,666,125,1055,561,1173,87,4.21%
2012-01,ירושלים,3000,ירושלים,יישוב,10465,4702,5763,1254,9211,6353,10404,408,3.84%
2012-01,ירושלים,1015,מבשרת ציון,יישוב,329,143,186,47,282,150,327,14,2.65%
2012-01,ירושלים,1137,קריית יערים,יישוב,36,11,25,3,33,15,36,0,3.16%
2012-01,תל אביב,2400,אור יהודה,יישוב,777,367,410,35,742,305,763,56,4.24%
2012-01,תל אביב,565,אזור,יישוב,167,82,85,32,135,38,163,17,2.69%
2012-01,תל אביב,6100,בני ברק,יישוב,2265,1115,1150,107,2158,1385,2253,82,4.45%
2012-01,תל אביב,6200,בת ים,יישוב,3417,1565,1852,476,2941,1457,3357,308,4.75%
2012-01,תל אביב,6300,גבעתיים,יישוב,725,311,414,320,405,113,718,49,2.55%
2012-01,תל אביב,6400,הרצלייה,יישוב,1040,484,556,331,709,83,1027,168,2.23%
2012-01,תל אביב,6600,חולון,יישוב,3031,1423,1608,487,2544,982,2969,249,3.12%
2012-01,תל אביב,2620,קריית אונו,יישוב,380,168,212,140,240,44,375,13,2.18%
2012-01,תל אביב,8600,רמת גן,יישוב,2094,958,1136,680,1414,484,2075,137,2.82%
2012-01,תל אביב,2650,רמת השרון,יישוב,415,182,233,188,227,17,410,51,1.94%
2012-01,תל אביב,5000,תל אביב -יפו,יישוב,8001,3959,4042,2477,5524,2766,7924,498,3.31%
2012-02,אזור יהודה והשומרון,3760,אורנית,יישוב,84,40,44,32,52,3,83,3,2.01%
2012-02,אזור יהודה והשומרון,3750,אלפי מנשה,יישוב,90,37,53,21,69,1,89,5,2.15%
2012-02,אזור יהודה והשומרון,3560,אלקנה,יישוב,27,12,15,14,13,3,27,0,1.52%
2012-02,אזור יהודה והשומרון,3650,אפרת,יישוב,41,30,11,23,18,6,40,4,1.06%
2012-02,אזור יהודה והשומרון,3570,אריאל,יישוב,420,219,201,99,321,103,420,51,4.11%
2012-02,אזור יהודה והשומרון,3574,בית אל,יישוב,47,27,20,8,39,18,47,1,2.06%
2012-02,אזור יהודה והשומרון,3652,בית אריה,יישוב,76,29,47,21,55,4,75,1,3.28%
2012-02,אזור יהודה והשומרון,3780,ביתר עילית,יישוב,364,190,174,17,347,190,358,14,3.55%
2012-02,אזור יהודה והשומרון,3730,גבעת זאב,יישוב,160,70,90,22,138,43,160,4,2.38%
2012-02,אזור יהודה והשומרון,3769,הר אדר,יישוב,29,14,15,12,17,1,28,2,1.48%
2012-02,אזור יהודה והשומרון,3797,מודיעין עילית,יישוב,335,132,203,13,322,100,334,17,2.75%
2012-02,אזור יהודה והשומרון,3616,מעלה אדומים,יישוב,631,268,363,97,534,209,623,53,3.25%
2012-02,אזור יהודה והשומרון,3660,עמנואל,יישוב,78,40,38,2,76,60,78,0,7.46%
2012-02,אזור יהודה והשומרון,3557,קדומים,יישוב,30,13,17,11,19,7,30,2,1.75%
2012-02,אזור יהודה והשומרון,3611,קריית ארבע,יישוב,107,48,59,15,92,68,107,3,3.64%
2012-02,אזור יהודה והשומרון,3640,קרני שומרון,יישוב,91,46,45,20,71,20,90,2,2.59%
2012-02,הדרום,31,אופקים,יישוב,1342,587,755,98,1244,970,1329,37,10.90%
2012-02,הדרום,2600,אילת,יישוב,1698,775,923,67,1631,630,1684,104,5.18%
2012-02,הדרום,70,אשדוד,יישוב,6789,2754,4035,764,6025,3970,6735,295,6.49%
2012-02,הדרום,7100,אשקלון,יישוב,4206,1668,2538,608,3598,2671,4101,148,6.46%
2012-02,הדרום,9000,באר שבע,יישוב,7195,3098,4097,978,6217,4682,7145,474,7.25%
2012-02,הדרום,2200,דימונה,יישוב,2130,950,1180,126,2004,1555,2105,84,11.96%
2012-02,הדרום,1303,חורה,יישוב,725,300,425,3,722,672,725,8,20.42%
2012-02,הדרום,831,ירוחם,יישוב,435,204,231,23,412,295,426,30,10.15%
2012-02,הדרום,1059,כסיפה,יישוב,983,420,563,6,977,903,981,20,23.66%
2012-02,הדרום,1271,להבים,יישוב,34,17,17,21,13,3,34,6,1.05%
2012-02,הדרום,1060,לקיה,יישוב,932,400,532,4,928,879,929,6,26.05%
2012-02,הדרום,1268,מיתר,יישוב,67,27,40,26,41,6,64,10,1.64%
2012-02,הדרום,99,מצפה רמון,יישוב,232,96,136,24,208,128,221,33,9.25%
2012-02,הדרום,246,נתיבות,יישוב,849,365,484,48,801,501,840,50,6.67%
2012-02,הדרום,666,עומר,יישוב,67,23,44,22,45,11,67,8,1.76%
2012-02,הדרום,2560,ערד,יישוב,858,366,492,178,680,502,844,84,6.93%
2012-02,הדרום,1192,ערערה-בנגב,יישוב,959,387,572,4,955,909,957,7,25.55%
2012-02,הדרום,2630,קריית גת,יישוב,2352,945,1407,192,2160,1559,2346,88,8.85%
2012-02,הדרום,1034,קריית מלאכי,יישוב,1208,556,652,28,1180,815,1193,91,10.50%
2012-02,הדרום,1161,רהט,יישוב,2955,1180,1775,8,2947,2666,2955,55,17.92%
2012-02,הדרום,1286,שגב-שלום,יישוב,473,170,303,0,473,447,472,4,19.66%
2012-02,הדרום,1031,שדרות,יישוב,1047,450,597,63,984,682,1042,62,8.72%
2012-02,הדרום,1054,תל שבע,יישוב,1124,523,601,2,1122,1064,1124,16,25.79%
2012-02,המרכז,182,אבן יהודה,יישוב,119,68,51,37,82,22,118,8,1.88%
2012-02,המרכז,41,אליכין,יישוב,48,23,25,3,45,15,48,4,2.78%
2012-02,המרכז,1309,אלעד,יישוב,358,155,203,18,340,112,358,11,3.18%
2012-02,המרכז,2530,באר יעקב,יישוב,240,101,139,42,198,67,236,15,2.90%
2012-02,המרכז,466,בית דגן,יישוב,98,47,51,20,78,34,98,7,2.86%
2012-02,המרכז,1066,"בני עי""ש",יישוב,192,86,106,27,165,80,190,1,4.83%
2012-02,המרכז,681,גבעת שמואל,יישוב,257,139,118,101,156,57,256,13,2.32%
2012-02,המרכז,2550,גדרה,יישוב,359,161,198,72,287,104,350,3,3.27%
2012-02,המרכז,627,ג'לג'וליה,יישוב,67,35,32,2,65,37,67,3,2.22%
2012-02,המרכז,166,גן יבנה,יישוב,318,122,196,39,279,96,317,10,3.07%
2012-02,המרכז,229,גני תקווה,יישוב,185,84,101,60,125,27,184,8,2.44%
2012-02,המרכז,9700,הוד השרון,יישוב,599,271,328,235,364,64,596,23,2.26%
2012-02,המרכז,1290,זמר,יישוב,165,62,103,7,158,124,165,5,6.13%
2012-02,המרכז,2730,טייבה,יישוב,2229,947,1282,4,2225,1891,2213,36,13.87%
2012-02,המרכז,2720,טירה,יישוב,337,164,173,10,327,181,336,8,3.33%
2012-02,המרכז,2660,יבנה,יישוב,802,392,410,65,737,397,799,29,4.05%
2012-02,המרכז,9400,יהוד,יישוב,491,208,283,66,425,83,474,38,3.16%
2012-02,המרכז,1224,כוכב יאיר,יישוב,92,56,36,44,48,4,91,1,1.68%
2012-02,המרכז,633,כפר ברא,יישוב,26,15,11,2,24,10,25,2,2.09%
2012-02,המרכז,168,כפר יונה,יישוב,324,152,172,70,254,78,322,28,3.25%
2012-02,המרכז,6900,כפר סבא,יישוב,1178,493,685,378,800,190,1164,58,2.41%
2012-02,המרכז,634,כפר קאסם,יישוב,214,108,106,2,212,118,214,9,2.74%
2012-02,המרכז,7000,לוד,יישוב,2227,1008,1219,163,2064,1279,2218,143,6.50%
2012-02,המרכז,1200,מודיעין-מכבים-רעות*,יישוב,885,397,488,369,516,69,878,56,2.21%
2012-02,המרכז,28,מזכרת בתיה,יישוב,148,75,73,39,109,35,148,0,2.43%
2012-02,המרכז,7200,נס ציונה,יישוב,610,282,328,118,492,206,604,4,2.84%
2012-02,המרכז,7400,נתניה,יישוב,4072,1880,2192,621,3451,1737,4028,329,4.12%
2012-02,המרכז,587,סביון*,יישוב,13,2,11,10,3,1,13,2,0.74%
2012-02,המרכז,171,פרדסייה,יישוב,68,32,36,18,50,8,68,7,1.98%
2012-02,המרכז,7900,פתח תקווה,יישוב,3827,1739,2088,752,3075,1088,3791,222,3.34%
2012-02,המרכז,195,קדימה-צורן,יישוב,206,87,119,59,147,35,206,9,2.25%
2012-02,המרכז,638,קלנסווה,יישוב,876,324,552,1,875,766,874,16,11.21%
2012-02,המרכז,469,קריית עקרון,יישוב,291,136,155,19,272,128,288,3,4.98%
2012-02,המרכז,2640,ראש העין,יישוב,679,337,342,80,599,167,673,49,3.17%
2012-02,המרכז,8300,ראשון לציון,יישוב,4354,1963,2391,900,3454,1649,4344,229,3.33%
2012-02,המרכז,8400,רחובות,יישוב,2467,1097,1370,498,1969,1027,2434,15,3.97%
2012-02,המרכז,8500,רמלה,יישוב,1694,824,870,101,1593,819,1668,128,4.89%
2012-02,המרכז,8700,רעננה,יישוב,733,347,386,295,438,71,731,40,2.04%
2012-02,המרכז,1304,שוהם,יישוב,175,83,92,78,97,5,173,18,1.71%
2012-02,המרכז,154,תל מונד,יישוב,151,69,82,55,96,30,151,5,2.68%
2012-02,הצפון,473,אבו סנאן,יישוב,740,285,455,5,735,633,736,22,13.90%
2012-02,הצפון,478,אכסאל,יישוב,545,233,312,15,530,460,543,16,10.70%
2012-02,הצפון,529,אעבלין,יישוב,625,257,368,11,614,534,625,9,12.08%
2012-02,הצפון,482,בועיינה-נוג'ידאת,יישוב,455,194,261,5,450,404,449,13,12.88%
2012-02,הצפון,4001,בוקעאתא,יישוב,385,145,240,8,377,337,376,5,14.62%
2012-02,הצפון,998,ביר אל-מכסור,יישוב,424,159,265,4,420,342,424,9,13.12%
2012-02,הצפון,480,בית ג'ן,יישוב,355,117,238,2,353,254,352,9,7.29%
2012-02,הצפון,9200,בית שאן,יישוב,775,346,429,19,756,445,772,87,8.15%
2012-02,הצפון,944,בסמת טבעון,יישוב,210,91,119,0,210,168,210,9,7.42%
2012-02,הצפון,483,בענה,יישוב,409,158,251,4,405,373,409,9,13.34%
2012-02,הצפון,1292,ג'דיידה-מכר,יישוב,1507,618,889,7,1500,1316,1505,29,17.96%
2012-02,הצפון,485,ג'ולס,יישוב,192,52,140,3,189,151,192,10,7.40%
2012-02,הצפון,487,ג'ש (גוש חלב),יישוב,53,26,27,2,51,26,52,1,3.48%
2012-02,הצפון,489,דבורייה,יישוב,407,184,223,14,393,305,407,4,10.45%
2012-02,הצפון,490,דייר אל-אסד,יישוב,388,154,234,8,380,331,388,20,8.46%
2012-02,הצפון,492,דייר חנא,יישוב,661,281,380,10,651,530,661,29,15.08%
2012-02,הצפון,975,זרזיר,יישוב,307,138,169,3,304,200,303,5,11.31%
2012-02,הצפון,496,חורפיש,יישוב,118,55,63,6,112,79,116,6,4.75%
2012-02,הצפון,2034,חצור הגלילית,יישוב,269,102,167,13,256,131,263,16,5.79%
2012-02,הצפון,6700,טבריה,יישוב,1914,844,1070,104,1810,1281,1785,106,8.54%
2012-02,הצפון,962,טובא-זנגרייה,יישוב,368,174,194,6,362,274,364,2,12.75%
2012-02,הצפון,498,טורעאן,יישוב,529,200,329,11,518,459,527,24,10.49%
2012-02,הצפון,8900,טמרה,יישוב,1949,790,1159,10,1939,1739,1941,23,15.13%
2012-02,הצפון,1295,יאנוח-ג'ת,יישוב,153,53,100,3,150,110,153,12,6.24%
2012-02,הצפון,46,יבנאל,יישוב,145,90,55,9,136,112,136,2,9.02%
2012-02,הצפון,499,יפיע,יישוב,643,287,356,14,629,498,640,21,9.06%
2012-02,הצפון,240,יקנעם עילית,יישוב,510,220,290,86,424,181,509,54,4.61%
2012-02,הצפון,502,ירכא,יישוב,538,209,329,2,536,425,538,20,9.96%
2012-02,הצפון,504,כאבול,יישוב,692,273,419,10,682,613,688,10,15.18%
2012-02,הצפון,505,כאוכב אבו אל-היג'א,יישוב,225,96,129,5,220,189,225,11,14.26%
2012-02,הצפון,1296,כסרא-סמיע,יישוב,220,97,123,1,219,167,220,14,7.28%
2012-02,הצפון,978,כעביה-טבאש-חג'אג'רה,יישוב,214,80,134,6,208,149,213,4,10.70%
2012-02,הצפון,1263,כפר ורדים,יישוב,71,38,33,30,41,7,71,2,2.35%
2012-02,הצפון,507,כפר יאסיף,יישוב,503,203,300,5,498,422,503,15,10.59%
2012-02,הצפון,508,כפר כמא,יישוב,74,29,45,2,72,40,72,0,4.77%
2012-02,הצפון,509,כפר כנא,יישוב,1156,441,715,18,1138,1026,1148,55,14.41%
2012-02,הצפון,510,כפר מנדא,יישוב,1011,470,541,9,1002,765,1004,24,14.87%
2012-02,הצפון,47,כפר תבור,יישוב,48,19,29,11,37,5,48,0,2.59%
2012-02,הצפון,1139,כרמיאל,יישוב,1771,696,1075,354,1417,935,1720,102,6.80%
2012-02,הצפון,481,מגאר,יישוב,1422,544,878,19,1403,1293,1420,73,16.93%
2012-02,הצפון,516,מג'ד אל-כרום,יישוב,586,258,328,6,580,469,586,26,9.95%
2012-02,הצפון,874,מגדל העמק,יישוב,965,415,550,87,878,495,917,82,7.11%
2012-02,הצפון,4201,מג'דל שמס,יישוב,495,187,308,13,482,403,489,12,10.93%
2012-02,הצפון,517,מזרעה,יישוב,186,76,110,3,183,147,185,5,10.01%
2012-02,הצפון,4203,מסעדה,יישוב,192,70,122,9,183,164,191,4,12.11%
2012-02,הצפון,518,מעיליא,יישוב,55,31,24,4,51,27,54,3,3.63%
2012-02,הצפון,1063,מעלות-תרשיחא,יישוב,898,428,470,117,781,567,894,36,7.65%
2012-02,הצפון,520,משהד,יישוב,284,108,176,4,280,246,281,9,9.54%
2012-02,הצפון,9100,נהרייה,יישוב,2071,956,1115,232,1839,1281,2060,101,7.09%
2012-02,הצפון,522,נחף,יישוב,406,180,226,6,400,343,406,11,8.93%
2012-02,הצפון,7300,נצרת,יישוב,2953,1264,1689,82,2871,2323,2938,77,9.52%
2012-02,הצפון,1061,נצרת עילית,יישוב,1938,830,1108,253,1685,1132,1843,175,8.02%
2012-02,הצפון,525,סאג'ור,יישוב,120,42,78,2,118,88,120,4,7.15%
2012-02,הצפון,7500,סח'נין,יישוב,2035,910,1125,36,1999,1749,2035,47,16.04%
2012-02,הצפון,4501,ע'ג'ר,יישוב,78,30,48,2,76,64,78,1,8.29%
2012-02,הצפון,530,עיילבון,יישוב,189,81,108,6,183,137,188,4,7.62%
2012-02,הצפון,511,עילוט,יישוב,321,134,187,5,316,247,320,12,12.40%
2012-02,הצפון,532,עין מאהל,יישוב,580,263,317,12,568,489,573,9,12.95%
2012-02,הצפון,7600,עכו,יישוב,3310,1496,1814,165,3145,2602,3285,147,12.83%
2012-02,הצפון,7700,עפולה,יישוב,1733,731,1002,194,1539,900,1674,144,7.18%
2012-02,הצפון,531,עראבה,יישוב,1419,595,824,29,1390,1253,1418,28,15.56%
2012-02,הצפון,535,פסוטה,יישוב,103,47,56,3,100,78,103,3,6.56%
2012-02,הצפון,536,פקיעין (בוקייעה),יישוב,134,68,66,3,131,95,133,5,5.16%
2012-02,הצפון,8000,צפת,יישוב,1094,571,523,70,1024,817,1082,22,8.75%
2012-02,הצפון,4100,קצרין,יישוב,191,88,103,34,157,100,189,12,4.97%
2012-02,הצפון,2800,קריית שמונה,יישוב,683,323,360,59,624,283,662,104,5.27%
2012-02,הצפון,543,ראמה,יישוב,314,129,185,5,309,258,313,6,8.78%
2012-02,הצפון,26,ראש פינה,יישוב,56,18,38,11,45,22,55,6,3.66%
2012-02,הצפון,542,ריינה,יישוב,632,250,382,8,624,533,626,28,10.18%
2012-02,הצפון,122,רמת ישי,יישוב,110,44,66,41,69,9,110,3,2.81%
2012-02,הצפון,913,שבלי - אום אל-גנם,יישוב,259,118,141,2,257,183,258,8,10.72%
2012-02,הצפון,812,שלומי,יישוב,256,103,153,13,243,159,254,15,7.29%
2012-02,הצפון,538,שעב,יישוב,463,181,282,6,457,417,463,9,16.68%
2012-02,הצפון,8800,שפרעם,יישוב,2012,779,1233,30,1982,1723,2007,37,12.31%
2012-02,חיפה,2710,אום אל-פחם,יישוב,3766,1530,2236,12,3754,3257,3760,50,20.03%
2012-02,חיפה,1020,אור עקיבא,יישוב,635,273,362,44,591,242,623,72,6.51%
2012-02,חיפה,6000,באקה אל-גרביה,יישוב,703,348,355,14,689,441,703,32,6.87%
2012-02,חיפה,9800,בנימינה-גבעת עדה*,יישוב,179,81,98,53,126,56,178,15,2.77%
2012-02,חיפה,1326,"בסמ""ה",יישוב,436,198,238,1,435,347,436,6,12.35%
2012-02,חיפה,541,ג'סר א-זרקא,יישוב,429,260,169,2,427,292,426,14,7.73%
2012-02,חיפה,628,ג'ת,יישוב,218,101,117,14,204,134,217,5,4.78%
2012-02,חיפה,494,דאלית אל-כרמל,יישוב,479,198,281,12,467,307,475,18,6.53%
2012-02,חיפה,9300,זכרון יעקב,יישוב,240,104,136,86,154,48,240,10,2.46%
2012-02,חיפה,6500,חדרה,יישוב,2309,1037,1272,262,2047,961,2272,147,5.00%
2012-02,חיפה,4000,חיפה,יישוב,7122,3313,3809,1361,5761,4379,7074,535,5.20%
2012-02,חיפה,1247,חריש,יישוב,18,9,9,3,15,9,18,1,1.02%
2012-02,חיפה,2100,טירת כרמל,יישוב,750,358,392,36,714,458,746,51,7.40%
2012-02,חיפה,654,כפר קרע,יישוב,378,173,205,10,368,235,376,14,4.98%
2012-02,חיפה,1327,מעלה עירון,יישוב,942,380,562,4,938,775,942,18,17.98%
2012-02,חיפה,2500,נשר,יישוב,500,243,257,81,419,269,496,49,3.98%
2012-02,חיפה,534,עספיא,יישוב,324,142,182,7,317,189,322,12,6.42%
2012-02,חיפה,637,ערערה,יישוב,557,227,330,2,555,395,556,24,7.68%
2012-02,חיפה,537,פוריידיס,יישוב,374,180,194,3,371,258,373,18,7.41%
2012-02,חיפה,7800,פרדס חנה-כרכור,יישוב,795,366,429,137,658,277,778,106,4.33%
2012-02,חיפה,6800,קריית אתא,יישוב,1761,766,995,140,1621,1081,1755,118,6.19%
2012-02,חיפה,9500,קריית ביאליק,יישוב,1197,502,695,133,1064,636,1190,95,5.74%
2012-02,חיפה,2300,קריית טבעון,יישוב,184,92,92,70,114,39,181,24,2.29%
2012-02,חיפה,9600,קריית ים,יישוב,1643,725,918,172,1471,1097,1640,99,7.84%
2012-02,חיפה,8200,קריית מוצקין,יישוב,1095,445,650,161,934,577,1089,83,5.01%
2012-02,חיפה,922,רכסים,יישוב,131,63,68,8,123,85,131,8,4.29%
2012-02,ירושלים,472,אבו גוש,יישוב,243,114,129,8,235,180,243,4,8.95%
2012-02,ירושלים,2610,בית שמש,יישוב,1129,484,645,116,1013,531,1121,79,4.03%
2012-02,ירושלים,3000,ירושלים,יישוב,9975,4464,5511,1193,8782,6244,9933,305,3.67%
2012-02,ירושלים,1015,מבשרת ציון,יישוב,343,157,186,51,292,172,343,11,2.78%
2012-02,ירושלים,1137,קריית יערים,יישוב,30,11,19,6,24,14,28,0,2.48%
2012-02,תל אביב,2400,אור יהודה,יישוב,764,353,411,32,732,296,757,63,4.21%
2012-02,תל אביב,565,אזור,יישוב,156,73,83,27,129,36,152,11,2.51%
2012-02,תל אביב,6100,בני ברק,יישוב,2196,1093,1103,99,2097,1337,2183,63,4.32%
2012-02,תל אביב,6200,בת ים,יישוב,3295,1528,1767,472,2823,1354,3240,254,4.59%
2012-02,תל אביב,6300,גבעתיים,יישוב,715,331,384,314,401,104,710,42,2.52%
2012-02,תל אביב,6400,הרצלייה,יישוב,1004,472,532,313,691,86,983,137,2.13%
2012-02,תל אביב,6600,חולון,יישוב,2982,1408,1574,488,2494,946,2923,215,3.07%
2012-02,תל אביב,2620,קריית אונו,יישוב,360,163,197,130,230,44,355,14,2.07%
2012-02,תל אביב,8600,רמת גן,יישוב,2063,935,1128,639,1424,457,2043,153,2.78%
2012-02,תל אביב,2650,רמת השרון,יישוב,425,195,230,188,237,19,423,44,2.00%
2012-02,תל אביב,5000,תל אביב -יפו,יישוב,7715,3936,3779,2391,5324,2669,7664,465,3.21%
2012-03,אזור יהודה והשומרון,3760,אורנית,יישוב,93,36,57,31,62,2,92,8,2.22%
2012-03,אזור יהודה והשומרון,3750,אלפי מנשה,יישוב,89,34,55,25,64,2,89,3,2.15%
2012-03,אזור יהודה והשומרון,3560,אלקנה,יישוב,24,11,13,14,10,2,24,2,1.35%
2012-03,אזור יהודה והשומרון,3650,אפרת,יישוב,46,28,18,21,25,6,46,1,1.22%
2012-03,אזור יהודה והשומרון,3570,אריאל,יישוב,424,220,204,107,317,103,422,21,4.13%
2012-03,אזור יהודה והשומרון,3574,בית אל,יישוב,43,23,20,9,34,17,43,4,1.89%
2012-03,אזור יהודה והשומרון,3652,בית אריה,יישוב,73,26,47,17,56,4,73,7,3.20%
2012-03,אזור יהודה והשומרון,3780,ביתר עילית,יישוב,374,196,178,16,358,195,370,8,3.66%
2012-03,אזור יהודה והשומרון,3730,גבעת זאב,יישוב,171,71,100,27,144,41,170,13,2.53%
2012-03,אזור יהודה והשומרון,3769,הר אדר,יישוב,26,15,11,12,14,2,26,3,1.38%
2012-03,אזור יהודה והשומרון,3797,מודיעין עילית,יישוב,352,131,221,16,336,99,350,24,2.88%
2012-03,אזור יהודה והשומרון,3616,מעלה אדומים,יישוב,638,279,359,98,540,208,632,52,3.29%
2012-03,אזור יהודה והשומרון,3660,עמנואל,יישוב,77,38,39,2,75,58,77,3,7.37%
2012-03,אזור יהודה והשומרון,3557,קדומים,יישוב,28,14,14,11,17,6,28,1,1.64%
2012-03,אזור יהודה והשומרון,3611,קריית ארבע,יישוב,99,46,53,14,85,63,99,4,3.37%
2012-03,אזור יהודה והשומרון,3640,קרני שומרון,יישוב,93,44,49,21,72,23,92,7,2.65%
2012-03,הדרום,31,אופקים,יישוב,1311,576,735,96,1215,972,1303,41,10.70%
2012-03,הדרום,2600,אילת,יישוב,1610,744,866,65,1545,628,1593,117,4.91%
2012-03,הדרום,70,אשדוד,יישוב,6703,2773,3930,767,5936,3932,6657,243,6.42%
2012-03,הדרום,7100,אשקלון,יישוב,4354,1758,2596,618,3736,2689,4246,288,6.68%
2012-03,הדרום,9000,באר שבע,יישוב,7171,3129,4042,987,6184,4667,7119,429,7.23%
2012-03,הדרום,2200,דימונה,יישוב,2117,937,1180,136,1981,1538,2086,86,11.86%
2012-03,הדרום,1303,חורה,יישוב,729,302,427,3,726,679,729,14,20.51%
2012-03,הדרום,831,ירוחם,יישוב,461,224,237,23,438,298,453,44,10.72%
2012-03,הדרום,1059,כסיפה,יישוב,976,411,565,7,969,900,974,19,23.53%
2012-03,הדרום,1271,להבים,יישוב,32,17,15,20,12,3,32,5,0.99%
2012-03,הדרום,1060,לקיה,יישוב,964,413,551,4,960,891,960,25,26.69%
2012-03,הדרום,1268,מיתר,יישוב,55,26,29,22,33,6,54,3,1.38%
2012-03,הדרום,99,מצפה רמון,יישוב,230,95,135,20,210,124,218,31,9.14%
2012-03,הדרום,246,נתיבות,יישוב,856,381,475,48,808,506,849,50,6.74%
2012-03,הדרום,666,עומר,יישוב,62,19,43,24,38,10,62,5,1.63%
2012-03,הדרום,2560,ערד,יישוב,860,364,496,178,682,487,834,89,6.85%
2012-03,הדרום,1192,ערערה-בנגב,יישוב,955,387,568,4,951,912,953,7,25.47%
2012-03,הדרום,2630,קריית גת,יישוב,2334,940,1394,190,2144,1540,2327,93,8.79%
2012-03,הדרום,1034,קריית מלאכי,יישוב,1177,526,651,22,1155,793,1164,84,10.27%
2012-03,הדרום,1161,רהט,יישוב,2965,1198,1767,7,2958,2670,2965,50,17.97%
2012-03,הדרום,1286,שגב-שלום,יישוב,491,182,309,0,491,451,490,22,20.26%
2012-03,הדרום,1031,שדרות,יישוב,1009,441,568,55,954,673,1004,53,8.43%
2012-03,הדרום,1054,תל שבע,יישוב,1136,519,617,2,1134,1079,1135,9,25.98%
2012-03,המרכז,182,אבן יהודה,יישוב,119,65,54,39,80,21,118,8,1.88%
2012-03,המרכז,41,אליכין,יישוב,41,20,21,3,38,19,41,2,2.38%
2012-03,המרכז,1309,אלעד,יישוב,341,147,194,19,322,108,341,12,3.04%
2012-03,המרכז,2530,באר יעקב,יישוב,235,100,135,41,194,74,230,12,2.83%
2012-03,המרכז,466,בית דגן,יישוב,96,51,45,18,78,31,96,3,2.81%
2012-03,המרכז,1066,"בני עי""ש",יישוב,185,82,103,30,155,80,183,2,4.66%
2012-03,המרכז,681,גבעת שמואל,יישוב,243,137,106,103,140,55,243,17,2.20%
2012-03,המרכז,2550,גדרה,יישוב,335,152,183,64,271,96,330,3,3.09%
2012-03,המרכז,627,ג'לג'וליה,יישוב,77,34,43,2,75,42,77,2,2.54%
2012-03,המרכז,166,גן יבנה,יישוב,314,119,195,36,278,97,314,12,3.05%
2012-03,המרכז,229,גני תקווה,יישוב,183,85,98,67,116,28,182,10,2.41%
2012-03,המרכז,9700,הוד השרון,יישוב,615,296,319,246,369,65,615,45,2.33%
2012-03,המרכז,1290,זמר,יישוב,170,64,106,5,165,123,170,13,6.31%
2012-03,המרכז,2730,טייבה,יישוב,2250,944,1306,4,2246,1913,2240,36,14.02%
2012-03,המרכז,2720,טירה,יישוב,381,164,217,10,371,196,380,16,3.74%
2012-03,המרכז,2660,יבנה,יישוב,848,425,423,65,783,396,846,53,4.28%
2012-03,המרכז,9400,יהוד,יישוב,458,187,271,67,391,77,446,37,2.98%
2012-03,המרכז,1224,כוכב יאיר,יישוב,93,59,34,44,49,3,93,7,1.71%
2012-03,המרכז,633,כפר ברא,יישוב,26,18,8,1,25,10,26,2,2.17%
2012-03,המרכז,168,כפר יונה,יישוב,321,148,173,69,252,73,320,19,3.23%
2012-03,המרכז,6900,כפר סבא,יישוב,1206,524,682,376,830,191,1192,67,2.46%
2012-03,המרכז,634,כפר קאסם,יישוב,212,109,103,2,210,117,212,10,2.71%
2012-03,המרכז,7000,לוד,יישוב,2210,1007,1203,180,2030,1264,2203,114,6.46%
2012-03,המרכז,1200,מודיעין-מכבים-רעות*,יישוב,899,407,492,375,524,66,892,51,2.24%
2012-03,המרכז,28,מזכרת בתיה,יישוב,149,76,73,41,108,37,148,1,2.43%
2012-03,המרכז,7200,נס ציונה,יישוב,613,270,343,126,487,198,607,3,2.85%
2012-03,המרכז,7400,נתניה,יישוב,4024,1896,2128,604,3420,1688,3989,295,4.08%
2012-03,המרכז,587,סביון*,יישוב,12,1,11,8,4,1,12,0,0.68%
2012-03,המרכז,171,פרדסייה,יישוב,68,31,37,19,49,8,68,2,1.98%
2012-03,המרכז,7900,פתח תקווה,יישוב,3888,1758,2130,752,3136,1094,3866,247,3.40%
2012-03,המרכז,195,קדימה-צורן,יישוב,204,86,118,55,149,31,203,11,2.22%
2012-03,המרכז,638,קלנסווה,יישוב,890,327,563,2,888,774,885,19,11.33%
2012-03,המרכז,469,קריית עקרון,יישוב,274,129,145,20,254,130,273,4,4.73%
2012-03,המרכז,2640,ראש העין,יישוב,700,357,343,89,611,169,691,44,3.25%
2012-03,המרכז,8300,ראשון לציון,יישוב,4407,1970,2437,916,3491,1630,4394,271,3.37%
2012-03,המרכז,8400,רחובות,יישוב,2448,1091,1357,486,1962,1022,2412,16,3.93%
2012-03,המרכז,8500,רמלה,יישוב,1640,798,842,101,1539,800,1611,110,4.73%
2012-03,המרכז,8700,רעננה,יישוב,750,379,371,301,449,79,748,40,2.08%
2012-03,המרכז,1304,שוהם,יישוב,178,85,93,83,95,5,178,19,1.76%
2012-03,המרכז,154,תל מונד,יישוב,163,78,85,69,94,30,163,5,2.88%
2012-03,הצפון,473,אבו סנאן,יישוב,754,295,459,5,749,640,749,22,14.11%
2012-03,הצפון,478,אכסאל,יישוב,540,227,313,13,527,458,540,16,10.65%
2012-03,הצפון,529,אעבלין,יישוב,629,259,370,12,617,530,629,22,12.15%
2012-03,הצפון,482,בועיינה-נוג'ידאת,יישוב,469,188,281,3,466,401,464,9,13.25%
2012-03,הצפון,4001,בוקעאתא,יישוב,387,145,242,7,380,339,380,9,14.75%
2012-03,הצפון,998,ביר אל-מכסור,יישוב,419,158,261,3,416,336,419,4,12.99%
2012-03,הצפון,480,בית ג'ן,יישוב,362,120,242,3,359,259,359,12,7.43%
2012-03,הצפון,9200,בית שאן,יישוב,785,369,416,24,761,459,784,78,8.27%
2012-03,הצפון,944,בסמת טבעון,יישוב,214,95,119,0,214,176,213,10,7.52%
2012-03,הצפון,483,בענה,יישוב,407,160,247,3,404,372,407,8,13.28%
2012-03,הצפון,1292,ג'דיידה-מכר,יישוב,1523,635,888,9,1514,1332,1521,45,18.12%
2012-03,הצפון,485,ג'ולס,יישוב,198,56,142,3,195,158,198,12,7.62%
2012-03,הצפון,487,ג'ש (גוש חלב),יישוב,53,25,28,3,50,28,52,0,3.48%
2012-03,הצפון,489,דבורייה,יישוב,405,181,224,13,392,305,405,3,10.40%
2012-03,הצפון,490,דייר אל-אסד,יישוב,396,157,239,6,390,335,396,8,8.61%
2012-03,הצפון,492,דייר חנא,יישוב,672,286,386,17,655,539,672,34,15.29%
2012-03,הצפון,975,זרזיר,יישוב,303,136,167,2,301,205,300,17,11.21%
2012-03,הצפון,496,חורפיש,יישוב,124,54,70,5,119,88,122,6,4.99%
2012-03,הצפון,2034,חצור הגלילית,יישוב,260,99,161,13,247,133,254,8,5.61%
2012-03,הצפון,6700,טבריה,יישוב,1885,847,1038,105,1780,1260,1758,101,8.42%
2012-03,הצפון,962,טובא-זנגרייה,יישוב,374,179,195,5,369,277,369,10,12.90%
2012-03,הצפון,498,טורעאן,יישוב,544,203,341,12,532,472,540,32,10.72%
2012-03,הצפון,8900,טמרה,יישוב,1966,794,1172,10,1956,1753,1963,36,15.27%
2012-03,הצפון,1295,יאנוח-ג'ת,יישוב,157,57,100,3,154,106,157,6,6.39%
2012-03,הצפון,46,יבנאל,יישוב,140,86,54,11,129,104,131,2,8.72%
2012-03,הצפון,499,יפיע,יישוב,631,280,351,9,622,493,628,33,8.91%
2012-03,הצפון,240,יקנעם עילית,יישוב,504,220,284,89,415,175,502,47,4.55%
2012-03,הצפון,502,ירכא,יישוב,546,217,329,2,544,448,546,15,10.09%
2012-03,הצפון,504,כאבול,יישוב,694,270,424,9,685,608,689,14,15.20%
2012-03,הצפון,505,כאוכב אבו אל-היג'א,יישוב,225,98,127,6,219,186,225,7,14.26%
2012-03,הצפון,1296,כסרא-סמיע,יישוב,219,100,119,1,218,161,218,18,7.22%
2012-03,הצפון,978,כעביה-טבאש-חג'אג'רה,יישוב,223,90,133,5,218,149,219,8,10.97%
2012-03,הצפון,1263,כפר ורדים,יישוב,64,31,33,26,38,6,64,3,2.13%
2012-03,הצפון,507,כפר יאסיף,יישוב,511,206,305,5,506,422,510,11,10.72%
2012-03,הצפון,508,כפר כמא,יישוב,72,28,44,0,72,41,70,3,4.64%
2012-03,הצפון,509,כפר כנא,יישוב,1173,441,732,21,1152,1041,1164,48,14.58%
2012-03,הצפון,510,כפר מנדא,יישוב,1015,468,547,11,1004,761,1005,39,14.88%
2012-03,הצפון,47,כפר תבור,יישוב,50,21,29,9,41,7,50,0,2.69%
2012-03,הצפון,1139,כרמיאל,יישוב,1749,687,1062,345,1404,912,1696,105,6.71%
2012-03,הצפון,481,מגאר,יישוב,1427,532,895,20,1407,1305,1424,53,16.97%
2012-03,הצפון,516,מג'ד אל-כרום,יישוב,574,250,324,7,567,463,574,25,9.76%
2012-03,הצפון,874,מגדל העמק,יישוב,938,387,551,86,852,477,902,77,7.00%
2012-03,הצפון,4201,מג'דל שמס,יישוב,481,181,300,13,468,399,474,10,10.63%
2012-03,הצפון,517,מזרעה,יישוב,189,78,111,4,185,151,188,5,10.15%
2012-03,הצפון,4203,מסעדה,יישוב,190,68,122,9,181,164,189,5,12.00%
2012-03,הצפון,518,מעיליא,יישוב,50,31,19,5,45,25,50,1,3.37%
2012-03,הצפון,1063,מעלות-תרשיחא,יישוב,891,423,468,115,776,561,888,47,7.60%
2012-03,הצפון,520,משהד,יישוב,293,113,180,6,287,255,289,7,9.78%
2012-03,הצפון,9100,נהרייה,יישוב,2060,947,1113,232,1828,1293,2051,87,7.06%
2012-03,הצפון,522,נחף,יישוב,406,180,226,7,399,339,406,14,8.93%
2012-03,הצפון,7300,נצרת,יישוב,2959,1267,1692,84,2875,2345,2946,77,9.55%
2012-03,הצפון,1061,נצרת עילית,יישוב,1901,823,1078,259,1642,1105,1804,179,7.86%
2012-03,הצפון,525,סאג'ור,יישוב,121,45,76,3,118,88,121,1,7.20%
2012-03,הצפון,7500,סח'נין,יישוב,2047,906,1141,33,2014,1757,2047,52,16.12%
2012-03,הצפון,4501,ע'ג'ר,יישוב,84,32,52,2,82,69,83,4,8.77%
2012-03,הצפון,530,עיילבון,יישוב,192,85,107,5,187,138,191,16,7.73%
2012-03,הצפון,511,עילוט,יישוב,309,126,183,6,303,242,308,11,11.99%
2012-03,הצפון,532,עין מאהל,יישוב,591,267,324,10,581,498,583,10,13.15%
2012-03,הצפון,7600,עכו,יישוב,3286,1486,1800,159,3127,2600,3255,146,12.73%
2012-03,הצפון,7700,עפולה,יישוב,1694,708,986,180,1514,880,1640,156,7.04%
2012-03,הצפון,531,עראבה,יישוב,1395,581,814,24,1371,1247,1394,27,15.34%
2012-03,הצפון,535,פסוטה,יישוב,110,47,63,4,106,83,110,4,6.98%
2012-03,הצפון,536,פקיעין (בוקייעה),יישוב,129,69,60,2,127,88,128,8,4.98%
2012-03,הצפון,8000,צפת,יישוב,1108,585,523,70,1038,838,1098,24,8.87%
2012-03,הצפון,4100,קצרין,יישוב,183,85,98,37,146,91,182,18,4.79%
2012-03,הצפון,2800,קריית שמונה,יישוב,641,292,349,62,579,285,621,83,4.96%
2012-03,הצפון,543,ראמה,יישוב,316,129,187,4,312,264,313,5,8.78%
2012-03,הצפון,26,ראש פינה,יישוב,60,23,37,11,49,24,60,1,3.98%
2012-03,הצפון,542,ריינה,יישוב,639,248,391,11,628,530,634,20,10.30%
2012-03,הצפון,122,רמת ישי,יישוב,105,39,66,35,70,14,104,3,2.66%
2012-03,הצפון,913,שבלי - אום אל-גנם,יישוב,263,126,137,2,261,184,260,7,10.79%
2012-03,הצפון,812,שלומי,יישוב,263,109,154,15,248,154,260,18,7.45%
2012-03,הצפון,538,שעב,יישוב,470,187,283,6,464,421,470,10,16.89%
2012-03,הצפון,8800,שפרעם,יישוב,2024,769,1255,34,1990,1736,2018,48,12.37%
2012-03,חיפה,2710,אום אל-פחם,יישוב,3778,1544,2234,16,3762,3263,3773,75,20.09%
2012-03,חיפה,1020,אור עקיבא,יישוב,589,256,333,40,549,233,583,70,6.12%
2012-03,חיפה,6000,באקה אל-גרביה,יישוב,697,345,352,16,681,442,697,40,6.81%
2012-03,חיפה,9800,בנימינה-גבעת עדה*,יישוב,180,79,101,54,126,51,178,12,2.77%
2012-03,חיפה,1326,"בסמ""ה",יישוב,422,187,235,1,421,342,422,7,12.01%
2012-03,חיפה,541,ג'סר א-זרקא,יישוב,423,248,175,2,421,293,421,18,7.64%
2012-03,חיפה,628,ג'ת,יישוב,214,99,115,11,203,133,213,10,4.70%
2012-03,חיפה,494,דאלית אל-כרמל,יישוב,490,207,283,13,477,295,486,22,6.68%
2012-03,חיפה,9300,זכרון יעקב,יישוב,232,102,130,81,151,48,230,27,2.36%
2012-03,חיפה,6500,חדרה,יישוב,2388,1048,1340,265,2123,1006,2345,103,5.15%
2012-03,חיפה,4000,חיפה,יישוב,7098,3322,3776,1341,5757,4323,7042,575,5.18%
2012-03,חיפה,1247,חריש,יישוב,17,9,8,3,14,9,16,2,0.91%
2012-03,חיפה,2100,טירת כרמל,יישוב,745,353,392,36,709,474,739,57,7.34%
2012-03,חיפה,654,כפר קרע,יישוב,383,167,216,9,374,237,381,24,5.05%
2012-03,חיפה,1327,מעלה עירון,יישוב,936,373,563,4,932,776,936,13,17.89%
2012-03,חיפה,2500,נשר,יישוב,500,246,254,78,422,261,498,45,3.99%
2012-03,חיפה,534,עספיא,יישוב,325,141,184,6,319,196,321,12,6.40%
2012-03,חיפה,637,ערערה,יישוב,565,235,330,2,563,390,565,29,7.79%
2012-03,חיפה,537,פוריידיס,יישוב,377,179,198,4,373,259,376,16,7.46%
2012-03,חיפה,7800,פרדס חנה-כרכור,יישוב,783,362,421,131,652,270,771,110,4.30%
2012-03,חיפה,6800,קריית אתא,יישוב,1719,757,962,139,1580,1051,1711,108,6.05%
2012-03,חיפה,9500,קריית ביאליק,יישוב,1161,485,676,137,1024,625,1154,75,5.57%
2012-03,חיפה,2300,קריית טבעון,יישוב,183,88,95,61,122,42,181,19,2.29%
2012-03,חיפה,9600,קריית ים,יישוב,1657,740,917,172,1485,1094,1652,100,7.89%
2012-03,חיפה,8200,קריית מוצקין,יישוב,1060,432,628,156,904,568,1054,83,4.85%
2012-03,חיפה,922,רכסים,יישוב,133,68,65,9,124,82,132,4,4.32%
2012-03,ירושלים,472,אבו גוש,יישוב,241,120,121,5,236,179,241,7,8.89%
2012-03,ירושלים,2610,בית שמש,יישוב,1088,474,614,123,965,536,1082,66,3.89%
2012-03,ירושלים,3000,ירושלים,יישוב,10076,4496,5580,1194,8882,6311,10032,371,3.71%
2012-03,ירושלים,1015,מבשרת ציון,יישוב,347,166,181,47,300,166,347,25,2.81%
2012-03,ירושלים,1137,קריית יערים,יישוב,29,12,17,4,25,16,29,1,2.56%
2012-03,תל אביב,2400,אור יהודה,יישוב,748,362,386,35,713,292,738,61,4.11%
2012-03,תל אביב,565,אזור,יישוב,150,69,81,23,127,39,147,17,2.43%
2012-03,תל אביב,6100,בני ברק,יישוב,2204,1116,1088,107,2097,1337,2194,87,4.34%
2012-03,תל אביב,6200,בת ים,יישוב,3271,1508,1763,470,2801,1337,3221,270,4.56%
2012-03,תל אביב,6300,גבעתיים,יישוב,714,344,370,313,401,105,705,45,2.51%
2012-03,תל אביב,6400,הרצלייה,יישוב,1026,479,547,311,715,57,1019,143,2.21%
2012-03,תל אביב,6600,חולון,יישוב,2961,1415,1546,469,2492,941,2915,242,3.06%
2012-03,תל אביב,2620,קריית אונו,יישוב,356,163,193,133,223,41,353,26,2.06%
2012-03,תל אביב,8600,רמת גן,יישוב,1995,892,1103,614,1381,464,1979,128,2.69%
2012-03,תל אביב,2650,רמת השרון,יישוב,392,187,205,185,207,16,388,34,1.84%
2012-03,תל אביב,5000,תל אביב -יפו,יישוב,7699,3886,3813,2371,5328,2660,7649,451,3.20%
2012-04,אזור יהודה והשומרון,3760,אורנית,יישוב,89,32,57,33,56,3,87,4,2.10%
2012-04,אזור יהודה והשומרון,3750,אלפי מנשה,יישוב,93,41,52,25,68,5,93,7,2.25%
2012-04,אזור יהודה והשומרון,3560,אלקנה,יישוב,27,13,14,15,12,2,27,1,1.52%
2012-04,אזור יהודה והשומרון,3650,אפרת,יישוב,44,21,23,22,22,5,44,4,1.16%
2012-04,אזור יהודה והשומרון,3570,אריאל,יישוב,416,221,195,102,314,98,415,16,4.06%
2012-04,אזור יהודה והשומרון,3574,בית אל,יישוב,46,20,26,10,36,17,46,1,2.02%
2012-04,אזור יהודה והשומרון,3652,בית אריה,יישוב,71,23,48,19,52,4,71,4,3.11%
2012-04,אזור יהודה והשומרון,3780,ביתר עילית,יישוב,376,183,193,16,360,191,373,11,3.69%
2012-04,אזור יהודה והשומרון,3730,גבעת זאב,יישוב,155,72,83,20,135,34,154,7,2.29%
2012-04,אזור יהודה והשומרון,3769,הר אדר,יישוב,29,17,12,12,17,2,29,1,1.54%
2012-04,אזור יהודה והשומרון,3797,מודיעין עילית,יישוב,311,127,184,16,295,99,309,3,2.55%
2012-04,אזור יהודה והשומרון,3616,מעלה אדומים,יישוב,602,254,348,96,506,189,597,51,3.12%
2012-04,אזור יהודה והשומרון,3660,עמנואל,יישוב,74,34,40,2,72,59,74,0,7.10%
2012-04,אזור יהודה והשומרון,3557,קדומים,יישוב,26,14,12,11,15,7,25,4,1.46%
2012-04,אזור יהודה והשומרון,3611,קריית ארבע,יישוב,92,36,56,14,78,59,92,4,3.14%
2012-04,אזור יהודה והשומרון,3640,קרני שומרון,יישוב,87,46,41,22,65,21,86,6,2.48%
2012-04,הדרום,31,אופקים,יישוב,1336,593,743,97,1239,961,1330,21,10.90%
2012-04,הדרום,2600,אילת,יישוב,1353,626,727,61,1292,602,1340,128,4.16%
2012-04,הדרום,70,אשדוד,יישוב,6657,2761,3896,767,5890,3882,6608,194,6.37%
2012-04,הדרום,7100,אשקלון,יישוב,4278,1705,2573,622,3656,2648,4173,139,6.57%
2012-04,הדרום,9000,באר שבע,יישוב,7092,3083,4009,949,6143,4638,7052,346,7.16%
2012-04,הדרום,2200,דימונה,יישוב,2095,914,1181,136,1959,1517,2071,72,11.79%
2012-04,הדרום,1303,חורה,יישוב,726,294,432,2,724,687,724,7,20.39%
2012-04,הדרום,831,ירוחם,יישוב,432,209,223,23,409,294,430,30,10.23%
2012-04,הדרום,1059,כסיפה,יישוב,966,400,566,6,960,890,966,20,23.38%
2012-04,הדרום,1271,להבים,יישוב,31,16,15,18,13,3,31,3,0.95%
2012-04,הדרום,1060,לקיה,יישוב,935,403,532,3,932,882,930,14,26.07%
2012-04,הדרום,1268,מיתר,יישוב,66,32,34,24,42,6,65,10,1.66%
2012-04,הדרום,99,מצפה רמון,יישוב,208,84,124,20,188,125,203,12,8.56%
2012-04,הדרום,246,נתיבות,יישוב,873,386,487,51,822,493,868,34,6.88%
2012-04,הדרום,666,עומר,יישוב,62,19,43,24,38,8,62,7,1.63%
2012-04,הדרום,2560,ערד,יישוב,801,347,454,166,635,464,784,87,6.47%
2012-04,הדרום,1192,ערערה-בנגב,יישוב,952,390,562,5,947,905,952,2,25.45%
2012-04,הדרום,2630,קריית גת,יישוב,2292,932,1360,186,2106,1521,2288,66,8.65%
2012-04,הדרום,1034,קריית מלאכי,יישוב,1173,522,651,20,1153,784,1158,70,10.23%
2012-04,הדרום,1161,רהט,יישוב,2937,1158,1779,8,2929,2658,2935,25,17.82%
2012-04,הדרום,1286,שגב-שלום,יישוב,481,173,308,0,481,449,478,9,19.86%
2012-04,הדרום,1031,שדרות,יישוב,1042,439,603,61,981,663,1039,39,8.70%
2012-04,הדרום,1054,תל שבע,יישוב,1125,510,615,2,1123,1071,1124,14,25.79%
2012-04,המרכז,182,אבן יהודה,יישוב,125,67,58,41,84,17,125,8,1.99%
2012-04,המרכז,41,אליכין,יישוב,43,20,23,3,40,18,43,5,2.50%
2012-04,המרכז,1309,אלעד,יישוב,352,149,203,19,333,106,349,15,3.10%
2012-04,המרכז,2530,באר יעקב,יישוב,236,93,143,43,193,70,231,8,2.84%
2012-04,המרכז,466,בית דגן,יישוב,91,48,43,14,77,32,91,5,2.66%
2012-04,המרכז,1066,"בני עי""ש",יישוב,188,89,99,32,156,72,187,1,4.76%
2012-04,המרכז,681,גבעת שמואל,יישוב,229,123,106,98,131,52,229,5,2.08%
2012-04,המרכז,2550,גדרה,יישוב,334,158,176,65,269,93,329,4,3.08%
2012-04,המרכז,627,ג'לג'וליה,יישוב,67,34,33,1,66,41,67,1,2.22%
2012-04,המרכז,166,גן יבנה,יישוב,317,116,201,34,283,89,314,14,3.05%
2012-04,המרכז,229,גני תקווה,יישוב,162,73,89,58,104,25,161,8,2.14%
2012-04,המרכז,9700,הוד השרון,יישוב,579,275,304,229,350,67,577,31,2.19%
2012-04,המרכז,1290,זמר,יישוב,162,56,106,3,159,121,162,12,6.03%
2012-04,המרכז,2730,טייבה,יישוב,2180,901,1279,4,2176,1871,2171,35,13.65%
2012-04,המרכז,2720,טירה,יישוב,336,171,165,13,323,185,336,8,3.33%
2012-04,המרכז,2660,יבנה,יישוב,834,418,416,66,768,393,832,58,4.21%
2012-04,המרכז,9400,יהוד,יישוב,448,176,272,64,384,75,436,27,2.91%
2012-04,המרכז,1224,כוכב יאיר,יישוב,86,50,36,39,47,4,86,7,1.59%
2012-04,המרכז,633,כפר ברא,יישוב,21,12,9,0,21,10,21,0,1.76%
2012-04,המרכז,168,כפר יונה,יישוב,301,130,171,71,230,65,300,23,3.04%
2012-04,המרכז,6900,כפר סבא,יישוב,1163,516,647,365,798,189,1150,70,2.38%
2012-04,המרכז,634,כפר קאסם,יישוב,197,102,95,0,197,112,197,5,2.53%
2012-04,המרכז,7000,לוד,יישוב,2199,977,1222,180,2019,1313,2187,126,6.42%
2012-04,המרכז,1200,מודיעין-מכבים-רעות*,יישוב,880,389,491,371,509,68,871,34,2.19%
2012-04,המרכז,28,מזכרת בתיה,יישוב,150,70,80,42,108,39,148,0,2.43%
2012-04,המרכז,7200,נס ציונה,יישוב,609,261,348,131,478,195,601,4,2.82%
2012-04,המרכז,7400,נתניה,יישוב,3974,1862,2112,560,3414,1655,3945,248,4.04%
2012-04,המרכז,587,סביון*,יישוב,15,1,14,9,6,1,15,0,0.85%
2012-04,המרכז,171,פרדסייה,יישוב,55,25,30,16,39,7,55,6,1.61%
2012-04,המרכז,7900,פתח תקווה,יישוב,3748,1677,2071,751,2997,1059,3733,140,3.29%
2012-04,המרכז,195,קדימה-צורן,יישוב,194,83,111,59,135,29,194,13,2.12%
2012-04,המרכז,638,קלנסווה,יישוב,885,340,545,1,884,767,883,11,11.31%
2012-04,המרכז,469,קריית עקרון,יישוב,266,126,140,19,247,127,264,3,4.58%
2012-04,המרכז,2640,ראש העין,יישוב,673,317,356,90,583,170,661,49,3.12%
2012-04,המרכז,8300,ראשון לציון,יישוב,4248,1903,2345,873,3375,1587,4240,169,3.25%
2012-04,המרכז,8400,רחובות,יישוב,2390,1059,1331,481,1909,1002,2349,11,3.83%
2012-04,המרכז,8500,רמלה,יישוב,1670,770,900,97,1573,815,1638,87,4.81%
2012-04,המרכז,8700,רעננה,יישוב,700,345,355,289,411,76,699,34,1.95%
2012-04,המרכז,1304,שוהם,יישוב,174,79,95,79,95,3,174,11,1.72%
2012-04,המרכז,154,תל מונד,יישוב,165,79,86,68,97,27,165,4,2.92%
2012-04,הצפון,473,אבו סנאן,יישוב,735,283,452,6,729,634,731,18,13.82%
2012-04,הצפון,478,אכסאל,יישוב,525,218,307,14,511,452,524,10,10.37%
2012-04,הצפון,529,אעבלין,יישוב,628,254,374,8,620,527,627,12,12.12%
2012-04,הצפון,482,בועיינה-נוג'ידאת,יישוב,455,180,275,3,452,396,451,20,12.93%
2012-04,הצפון,4001,בוקעאתא,יישוב,397,152,245,6,391,344,390,4,15.08%
2012-04,הצפון,998,ביר אל-מכסור,יישוב,430,164,266,3,427,339,429,5,13.26%
2012-04,הצפון,480,בית ג'ן,יישוב,364,106,258,1,363,254,360,5,7.44%
2012-04,הצפון,9200,בית שאן,יישוב,756,342,414,24,732,456,756,64,8.00%
2012-04,הצפון,944,בסמת טבעון,יישוב,197,82,115,0,197,159,196,7,6.96%
2012-04,הצפון,483,בענה,יישוב,400,152,248,4,396,363,400,10,13.08%
2012-04,הצפון,1292,ג'דיידה-מכר,יישוב,1477,605,872,7,1470,1302,1476,27,17.68%
2012-04,הצפון,485,ג'ולס,יישוב,199,54,145,2,197,161,199,7,7.65%
2012-04,הצפון,487,ג'ש (גוש חלב),יישוב,54,24,30,4,50,27,53,0,3.55%
2012-04,הצפון,489,דבורייה,יישוב,407,166,241,12,395,312,406,8,10.42%
2012-04,הצפון,490,דייר אל-אסד,יישוב,383,153,230,6,377,321,383,6,8.36%
2012-04,הצפון,492,דייר חנא,יישוב,641,263,378,12,629,523,641,13,14.69%
2012-04,הצפון,975,זרזיר,יישוב,293,138,155,3,290,194,288,9,10.81%
2012-04,הצפון,496,חורפיש,יישוב,123,55,68,6,117,85,122,8,4.99%
2012-04,הצפון,2034,חצור הגלילית,יישוב,269,104,165,11,258,140,260,13,5.73%
2012-04,הצפון,6700,טבריה,יישוב,1813,783,1030,108,1705,1252,1685,97,8.10%
2012-04,הצפון,962,טובא-זנגרייה,יישוב,373,178,195,7,366,268,369,8,12.90%
2012-04,הצפון,498,טורעאן,יישוב,513,192,321,8,505,451,506,21,10.12%
2012-04,הצפון,8900,טמרה,יישוב,1950,777,1173,12,1938,1743,1948,41,15.17%
2012-04,הצפון,1295,יאנוח-ג'ת,יישוב,159,49,110,3,156,116,159,3,6.47%
2012-04,הצפון,46,יבנאל,יישוב,143,90,53,9,134,107,135,2,8.96%
2012-04,הצפון,499,יפיע,יישוב,613,257,356,7,606,479,611,22,8.69%
2012-04,הצפון,240,יקנעם עילית,יישוב,474,206,268,84,390,170,473,46,4.30%
2012-04,הצפון,502,ירכא,יישוב,532,210,322,2,530,441,532,19,9.86%
2012-04,הצפון,504,כאבול,יישוב,685,267,418,8,677,602,682,9,15.07%
2012-04,הצפון,505,כאוכב אבו אל-היג'א,יישוב,216,92,124,7,209,181,216,5,13.77%
2012-04,הצפון,1296,כסרא-סמיע,יישוב,254,101,153,1,253,188,253,8,8.28%
2012-04,הצפון,978,כעביה-טבאש-חג'אג'רה,יישוב,199,78,121,3,196,143,198,10,10.03%
2012-04,הצפון,1263,כפר ורדים,יישוב,62,29,33,28,34,7,62,3,2.06%
2012-04,הצפון,507,כפר יאסיף,יישוב,506,212,294,4,502,412,505,17,10.63%
2012-04,הצפון,508,כפר כמא,יישוב,70,26,44,0,70,38,68,4,4.52%
2012-04,הצפון,509,כפר כנא,יישוב,1154,418,736,22,1132,1028,1150,35,14.43%
2012-04,הצפון,510,כפר מנדא,יישוב,991,457,534,8,983,762,985,29,14.63%
2012-04,הצפון,47,כפר תבור,יישוב,44,20,24,11,33,5,44,1,2.38%
2012-04,הצפון,1139,כרמיאל,יישוב,1713,674,1039,347,1366,902,1663,71,6.59%
2012-04,הצפון,481,מגאר,יישוב,1453,539,914,17,1436,1296,1450,51,17.22%
2012-04,הצפון,516,מג'ד אל-כרום,יישוב,565,246,319,6,559,462,565,24,9.62%
2012-04,הצפון,874,מגדל העמק,יישוב,970,396,574,75,895,473,933,82,7.23%
2012-04,הצפון,4201,מג'דל שמס,יישוב,482,180,302,13,469,401,474,5,10.63%
2012-04,הצפון,517,מזרעה,יישוב,183,74,109,3,180,148,182,8,9.86%
2012-04,הצפון,4203,מסעדה,יישוב,188,69,119,8,180,162,187,2,11.89%
2012-04,הצפון,518,מעיליא,יישוב,45,28,17,6,39,22,45,2,3.04%
2012-04,הצפון,1063,מעלות-תרשיחא,יישוב,889,419,470,111,778,561,884,47,7.57%
2012-04,הצפון,520,משהד,יישוב,283,99,184,6,277,242,280,7,9.51%
2012-04,הצפון,9100,נהרייה,יישוב,2019,938,1081,233,1786,1295,2011,74,6.94%
2012-04,הצפון,522,נחף,יישוב,397,175,222,6,391,332,397,15,8.74%
2012-04,הצפון,7300,נצרת,יישוב,2926,1252,1674,78,2848,2334,2911,83,9.44%
2012-04,הצפון,1061,נצרת עילית,יישוב,1879,797,1082,262,1617,1108,1775,119,7.74%
2012-04,הצפון,525,סאג'ור,יישוב,122,40,82,3,119,88,121,3,7.20%
2012-04,הצפון,7500,סח'נין,יישוב,2008,877,1131,32,1976,1739,2008,48,15.86%
2012-04,הצפון,4501,ע'ג'ר,יישוב,74,28,46,2,72,59,74,3,7.90%
2012-04,הצפון,530,עיילבון,יישוב,191,84,107,5,186,140,189,9,7.65%
2012-04,הצפון,511,עילוט,יישוב,311,127,184,6,305,247,310,6,12.06%
2012-04,הצפון,532,עין מאהל,יישוב,585,259,326,9,576,507,576,11,13.01%
2012-04,הצפון,7600,עכו,יישוב,3216,1444,1772,157,3059,2544,3188,126,12.50%
2012-04,הצפון,7700,עפולה,יישוב,1614,659,955,180,1434,846,1559,113,6.72%
2012-04,הצפון,531,עראבה,יישוב,1380,558,822,30,1350,1234,1379,30,15.20%
2012-04,הצפון,535,פסוטה,יישוב,111,50,61,3,108,85,111,2,7.03%
2012-04,הצפון,536,פקיעין (בוקייעה),יישוב,130,71,59,2,128,86,129,8,5.01%
2012-04,הצפון,8000,צפת,יישוב,1100,577,523,69,1031,855,1087,17,8.79%
2012-04,הצפון,4100,קצרין,יישוב,173,80,93,34,139,84,171,13,4.52%
2012-04,הצפון,2800,קריית שמונה,יישוב,624,290,334,49,575,272,600,53,4.80%
2012-04,הצפון,543,ראמה,יישוב,327,138,189,5,322,259,327,3,9.14%
2012-04,הצפון,26,ראש פינה,יישוב,57,22,35,11,46,22,57,2,3.79%
2012-04,הצפון,542,ריינה,יישוב,623,244,379,10,613,524,619,17,10.08%
2012-04,הצפון,122,רמת ישי,יישוב,102,41,61,31,71,12,101,5,2.59%
2012-04,הצפון,913,שבלי - אום אל-גנם,יישוב,225,100,125,2,223,167,223,18,9.40%
2012-04,הצפון,812,שלומי,יישוב,232,91,141,14,218,147,229,10,6.62%
2012-04,הצפון,538,שעב,יישוב,455,175,280,5,450,418,455,8,16.44%
2012-04,הצפון,8800,שפרעם,יישוב,1998,764,1234,33,1965,1710,1992,43,12.23%
2012-04,חיפה,2710,אום אל-פחם,יישוב,3735,1512,2223,16,3719,3231,3730,40,19.91%
2012-04,חיפה,1020,אור עקיבא,יישוב,559,241,318,39,520,223,554,48,5.84%
2012-04,חיפה,6000,באקה אל-גרביה,יישוב,650,312,338,13,637,436,649,38,6.37%
2012-04,חיפה,9800,בנימינה-גבעת עדה*,יישוב,162,70,92,46,116,48,161,7,2.51%
2012-04,חיפה,1326,"בסמ""ה",יישוב,418,185,233,1,417,341,418,5,11.91%
2012-04,חיפה,541,ג'סר א-זרקא,יישוב,401,226,175,1,400,280,399,13,7.27%
2012-04,חיפה,628,ג'ת,יישוב,198,87,111,11,187,133,197,15,4.36%
2012-04,חיפה,494,דאלית אל-כרמל,יישוב,461,190,271,9,452,292,461,26,6.35%
2012-04,חיפה,9300,זכרון יעקב,יישוב,215,99,116,72,143,51,214,17,2.20%
2012-04,חיפה,6500,חדרה,יישוב,2410,997,1413,271,2139,998,2366,125,5.19%
2012-04,חיפה,4000,חיפה,יישוב,6762,3154,3608,1284,5478,4179,6725,412,4.96%
2012-04,חיפה,1247,חריש,יישוב,14,6,8,3,11,7,13,0,0.74%
2012-04,חיפה,2100,טירת כרמל,יישוב,718,340,378,32,686,442,711,25,7.08%
2012-04,חיפה,654,כפר קרע,יישוב,366,158,208,5,361,228,364,9,4.83%
2012-04,חיפה,1327,מעלה עירון,יישוב,937,371,566,3,934,779,937,15,17.91%
2012-04,חיפה,2500,נשר,יישוב,475,224,251,88,387,248,472,27,3.79%
2012-04,חיפה,534,עספיא,יישוב,308,129,179,6,302,192,307,16,6.14%
2012-04,חיפה,637,ערערה,יישוב,552,228,324,2,550,392,552,11,7.63%
2012-04,חיפה,537,פוריידיס,יישוב,365,169,196,3,362,258,364,12,7.24%
2012-04,חיפה,7800,פרדס חנה-כרכור,יישוב,764,342,422,137,627,270,757,52,4.22%
2012-04,חיפה,6800,קריית אתא,יישוב,1661,744,917,134,1527,1038,1658,85,5.87%
2012-04,חיפה,9500,קריית ביאליק,יישוב,1129,448,681,145,984,633,1123,75,5.43%
2012-04,חיפה,2300,קריית טבעון,יישוב,170,82,88,58,112,37,168,10,2.13%
2012-04,חיפה,9600,קריית ים,יישוב,1582,712,870,161,1421,1073,1577,71,7.56%
2012-04,חיפה,8200,קריית מוצקין,יישוב,1069,438,631,160,909,577,1066,43,4.91%
2012-04,חיפה,922,רכסים,יישוב,120,63,57,5,115,78,120,2,3.94%
2012-04,ירושלים,472,אבו גוש,יישוב,236,116,120,6,230,182,236,4,8.72%
2012-04,ירושלים,2610,בית שמש,יישוב,1076,464,612,112,964,539,1069,41,3.85%
2012-04,ירושלים,3000,ירושלים,יישוב,9773,4327,5446,1128,8645,6251,9725,245,3.60%
2012-04,ירושלים,1015,מבשרת ציון,יישוב,345,162,183,54,291,165,345,13,2.79%
2012-04,ירושלים,1137,קריית יערים,יישוב,29,11,18,5,24,14,29,0,2.56%
2012-04,תל אביב,2400,אור יהודה,יישוב,737,356,381,38,699,293,726,41,4.04%
2012-04,תל אביב,565,אזור,יישוב,159,69,90,23,136,42,155,6,2.56%
2012-04,תל אביב,6100,בני ברק,יישוב,2178,1109,1069,104,2074,1327,2167,57,4.29%
2012-04,תל אביב,6200,בת ים,יישוב,3194,1484,1710,469,2725,1308,3146,199,4.46%
2012-04,תל אביב,6300,גבעתיים,יישוב,703,319,384,309,394,100,696,35,2.47%
2012-04,תל אביב,6400,הרצלייה,יישוב,971,463,508,302,669,56,962,109,2.09%
2012-04,תל אביב,6600,חולון,יישוב,2869,1359,1510,455,2414,912,2836,172,2.98%
2012-04,תל אביב,2620,קריית אונו,יישוב,348,153,195,132,216,42,344,16,2.01%
2012-04,תל אביב,8600,רמת גן,יישוב,1948,904,1044,591,1357,448,1936,90,2.64%
2012-04,תל אביב,2650,רמת השרון,יישוב,362,161,201,171,191,12,362,29,1.71%
2012-04,תל אביב,5000,תל אביב -יפו,יישוב,7401,3706,3695,2286,5115,2607,7363,332,3.09%
2012-05,אזור יהודה והשומרון,3760,אורנית,יישוב,84,31,53,29,55,2,84,4,2.03%
2012-05,אזור יהודה והשומרון,3750,אלפי מנשה,יישוב,96,42,54,27,69,2,96,13,2.32%
2012-05,אזור יהודה והשומרון,3560,אלקנה,יישוב,31,17,14,16,15,2,30,2,1.68%
2012-05,אזור יהודה והשומרון,3650,אפרת,יישוב,65,33,32,29,36,8,64,5,1.68%
2012-05,אזור יהודה והשומרון,3570,אריאל,יישוב,433,226,207,103,330,100,433,29,4.23%
2012-05,אזור יהודה והשומרון,3574,בית אל,יישוב,52,21,31,13,39,18,51,2,2.23%
2012-05,אזור יהודה והשומרון,3652,בית אריה,יישוב,66,23,43,13,53,4,65,4,2.86%
2012-05,אזור יהודה והשומרון,3780,ביתר עילית,יישוב,403,205,198,14,389,203,400,16,3.94%
2012-05,אזור יהודה והשומרון,3730,גבעת זאב,יישוב,181,83,98,25,156,34,181,8,2.68%
2012-05,אזור יהודה והשומרון,3769,הר אדר,יישוב,33,22,11,14,19,2,33,2,1.74%
2012-05,אזור יהודה והשומרון,3797,מודיעין עילית,יישוב,344,129,215,18,326,114,342,11,2.82%
2012-05,אזור יהודה והשומרון,3616,מעלה אדומים,יישוב,672,289,383,100,572,206,666,47,3.46%
2012-05,אזור יהודה והשומרון,3660,עמנואל,יישוב,81,43,38,3,78,62,81,2,7.72%
2012-05,אזור יהודה והשומרון,3557,קדומים,יישוב,35,19,16,14,21,7,34,0,1.98%
2012-05,אזור יהודה והשומרון,3611,קריית ארבע,יישוב,82,34,48,13,69,57,82,3,2.81%
2012-05,אזור יהודה והשומרון,3640,קרני שומרון,יישוב,92,50,42,23,69,19,92,6,2.65%
2012-05,הדרום,31,אופקים,יישוב,1415,621,794,97,1318,973,1406,45,11.45%
2012-05,הדרום,2600,אילת,יישוב,1433,670,763,68,1365,615,1412,85,4.38%
2012-05,הדרום,70,אשדוד,יישוב,6917,2852,4065,813,6104,3892,6867,311,6.61%
2012-05,הדרום,7100,אשקלון,יישוב,4489,1795,2694,661,3828,2691,4374,196,6.86%
2012-05,הדרום,9000,באר שבע,יישוב,7363,3216,4147,989,6374,4754,7308,530,7.40%
2012-05,הדרום,2200,דימונה,יישוב,2155,943,1212,137,2018,1541,2129,109,12.08%
2012-05,הדרום,1303,חורה,יישוב,745,310,435,3,742,694,743,9,20.82%
2012-05,הדרום,831,ירוחם,יישוב,449,215,234,27,422,290,446,47,10.57%
2012-05,הדרום,1059,כסיפה,יישוב,984,416,568,5,979,901,983,10,23.69%
2012-05,הדרום,1271,להבים,יישוב,35,17,18,22,13,3,35,4,1.08%
2012-05,הדרום,1060,לקיה,יישוב,955,409,546,2,953,904,953,19,26.55%
2012-05,הדרום,1268,מיתר,יישוב,64,29,35,28,36,7,64,2,1.64%
2012-05,הדרום,99,מצפה רמון,יישוב,240,92,148,21,219,134,232,29,9.67%
2012-05,הדרום,246,נתיבות,יישוב,981,439,542,54,927,518,975,50,7.66%
2012-05,הדרום,666,עומר,יישוב,62,20,42,26,36,6,62,3,1.63%
2012-05,הדרום,2560,ערד,יישוב,851,380,471,159,692,472,832,110,6.84%
2012-05,הדרום,1192,ערערה-בנגב,יישוב,972,393,579,5,967,915,972,27,25.85%
2012-05,הדרום,2630,קריית גת,יישוב,2397,989,1408,184,2213,1546,2390,99,9.00%
2012-05,הדרום,1034,קריית מלאכי,יישוב,1215,548,667,24,1191,795,1192,99,10.49%
2012-05,הדרום,1161,רהט,יישוב,3038,1248,1790,8,3030,2707,3038,66,18.33%
2012-05,הדרום,1286,שגב-שלום,יישוב,492,178,314,0,492,457,490,18,20.26%
2012-05,הדרום,1031,שדרות,יישוב,1098,457,641,60,1038,682,1093,61,9.11%
2012-05,הדרום,1054,תל שבע,יישוב,1149,533,616,3,1146,1092,1148,20,26.20%
2012-05,המרכז,182,אבן יהודה,יישוב,125,66,59,42,83,18,125,10,1.99%
2012-05,המרכז,41,אליכין,יישוב,62,30,32,6,56,16,62,1,3.56%
2012-05,המרכז,1309,אלעד,יישוב,360,170,190,15,345,115,357,17,3.17%
2012-05,המרכז,2530,באר יעקב,יישוב,259,101,158,54,205,66,254,11,3.11%
2012-05,המרכז,466,בית דגן,יישוב,103,55,48,15,88,36,103,2,3.01%
2012-05,המרכז,1066,"בני עי""ש",יישוב,191,88,103,30,161,71,189,1,4.81%
2012-05,המרכז,681,גבעת שמואל,יישוב,319,168,151,110,209,54,317,9,2.86%
2012-05,המרכז,2550,גדרה,יישוב,373,168,205,76,297,102,367,6,3.42%
2012-05,המרכז,627,ג'לג'וליה,יישוב,68,31,37,0,68,43,68,2,2.25%
2012-05,המרכז,166,גן יבנה,יישוב,362,140,222,44,318,96,358,16,3.46%
2012-05,המרכז,229,גני תקווה,יישוב,170,87,83,53,117,26,169,5,2.24%
2012-05,המרכז,9700,הוד השרון,יישוב,740,361,379,253,487,73,738,42,2.79%
2012-05,המרכז,1290,זמר,יישוב,168,66,102,5,163,122,168,11,6.24%
2012-05,המרכז,2730,טייבה,יישוב,2213,923,1290,5,2208,1877,2205,44,13.83%
2012-05,המרכז,2720,טירה,יישוב,345,173,172,13,332,185,345,16,3.41%
2012-05,המרכז,2660,יבנה,יישוב,882,444,438,74,808,405,876,80,4.43%
2012-05,המרכז,9400,יהוד,יישוב,505,204,301,73,432,72,490,43,3.26%
2012-05,המרכז,1224,כוכב יאיר,יישוב,81,41,40,37,44,4,81,4,1.50%
2012-05,המרכז,633,כפר ברא,יישוב,27,16,11,0,27,14,27,0,2.25%
2012-05,המרכז,168,כפר יונה,יישוב,328,146,182,72,256,66,327,24,3.30%
2012-05,המרכז,6900,כפר סבא,יישוב,1205,542,663,388,817,191,1199,82,2.48%
2012-05,המרכז,634,כפר קאסם,יישוב,208,109,99,1,207,111,207,6,2.65%
2012-05,המרכז,7000,לוד,יישוב,2220,1005,1215,177,2043,1282,2206,128,6.47%
2012-05,המרכז,1200,מודיעין-מכבים-רעות*,יישוב,1010,462,548,377,633,67,1001,51,2.51%
2012-05,המרכז,28,מזכרת בתיה,יישוב,169,79,90,42,127,38,168,4,2.75%
2012-05,המרכז,7200,נס ציונה,יישוב,635,270,365,138,497,196,627,4,2.94%
2012-05,המרכז,7400,נתניה,יישוב,4161,1944,2217,620,3541,1677,4133,337,4.22%
2012-05,המרכז,587,סביון*,יישוב,15,3,12,9,6,2,15,1,0.85%
2012-05,המרכז,171,פרדסייה,יישוב,66,27,39,16,50,7,66,2,1.92%
2012-05,המרכז,7900,פתח תקווה,יישוב,4450,1987,2463,794,3656,1096,4417,246,3.87%
2012-05,המרכז,195,קדימה-צורן,יישוב,208,90,118,56,152,34,208,17,2.27%
2012-05,המרכז,638,קלנסווה,יישוב,898,345,553,1,897,766,896,13,11.46%
2012-05,המרכז,469,קריית עקרון,יישוב,281,142,139,21,260,128,279,7,4.83%
2012-05,המרכז,2640,ראש העין,יישוב,751,369,382,95,656,175,740,75,3.48%
2012-05,המרכז,8300,ראשון לציון,יישוב,4937,2182,2755,956,3981,1642,4927,272,3.76%
2012-05,המרכז,8400,רחובות,יישוב,2533,1140,1393,494,2039,1056,2492,15,4.06%
2012-05,המרכז,8500,רמלה,יישוב,1792,847,945,113,1679,823,1751,141,5.12%
2012-05,המרכז,8700,רעננה,יישוב,778,395,383,321,457,85,774,50,2.16%
2012-05,המרכז,1304,שוהם,יישוב,271,130,141,82,189,4,271,10,2.66%
2012-05,המרכז,154,תל מונד,יישוב,171,81,90,72,99,31,171,13,3.02%
2012-05,הצפון,473,אבו סנאן,יישוב,734,283,451,5,729,641,730,17,13.80%
2012-05,הצפון,478,אכסאל,יישוב,527,223,304,17,510,449,525,11,10.38%
2012-05,הצפון,529,אעבלין,יישוב,622,249,373,10,612,525,622,17,12.03%
2012-05,הצפון,482,בועיינה-נוג'ידאת,יישוב,435,170,265,3,432,391,431,17,12.43%
2012-05,הצפון,4001,בוקעאתא,יישוב,401,157,244,6,395,345,393,9,15.18%
2012-05,הצפון,998,ביר אל-מכסור,יישוב,420,157,263,3,417,339,420,5,13.02%
2012-05,הצפון,480,בית ג'ן,יישוב,384,116,268,2,382,276,378,6,7.79%
2012-05,הצפון,9200,בית שאן,יישוב,798,360,438,25,773,464,798,82,8.40%
2012-05,הצפון,944,בסמת טבעון,יישוב,197,82,115,0,197,157,196,9,6.96%
2012-05,הצפון,483,בענה,יישוב,407,158,249,3,404,371,407,12,13.28%
2012-05,הצפון,1292,ג'דיידה-מכר,יישוב,1501,614,887,8,1493,1313,1500,39,17.91%
2012-05,הצפון,485,ג'ולס,יישוב,204,52,152,2,202,161,204,6,7.83%
2012-05,הצפון,487,ג'ש (גוש חלב),יישוב,61,26,35,6,55,27,60,3,3.99%
2012-05,הצפון,489,דבורייה,יישוב,400,164,236,15,385,317,399,5,10.26%
2012-05,הצפון,490,דייר אל-אסד,יישוב,393,160,233,6,387,326,393,11,8.55%
2012-05,הצפון,492,דייר חנא,יישוב,623,256,367,13,610,509,623,26,14.34%
2012-05,הצפון,975,זרזיר,יישוב,299,138,161,4,295,205,297,5,11.11%
2012-05,הצפון,496,חורפיש,יישוב,118,48,70,7,111,82,118,6,4.83%
2012-05,הצפון,2034,חצור הגלילית,יישוב,274,107,167,14,260,138,268,28,5.90%
2012-05,הצפון,6700,טבריה,יישוב,1847,807,1040,99,1748,1260,1711,117,8.21%
2012-05,הצפון,962,טובא-זנגרייה,יישוב,410,183,227,7,403,274,405,21,13.98%
2012-05,הצפון,498,טורעאן,יישוב,540,209,331,6,534,476,534,31,10.62%
2012-05,הצפון,8900,טמרה,יישוב,1995,795,1200,11,1984,1760,1992,49,15.46%
2012-05,הצפון,1295,יאנוח-ג'ת,יישוב,158,52,106,3,155,115,158,4,6.43%
2012-05,הצפון,46,יבנאל,יישוב,149,95,54,8,141,116,139,2,9.21%
2012-05,הצפון,499,יפיע,יישוב,635,273,362,10,625,492,630,27,8.93%
2012-05,הצפון,240,יקנעם עילית,יישוב,498,216,282,90,408,170,497,52,4.51%
2012-05,הצפון,502,ירכא,יישוב,547,218,329,1,546,447,547,20,10.11%
2012-05,הצפון,504,כאבול,יישוב,694,268,426,8,686,612,691,10,15.24%
2012-05,הצפון,505,כאוכב אבו אל-היג'א,יישוב,213,90,123,7,206,184,213,8,13.60%
2012-05,הצפון,1296,כסרא-סמיע,יישוב,217,97,120,1,216,161,215,19,7.12%
2012-05,הצפון,978,כעביה-טבאש-חג'אג'רה,יישוב,200,82,118,3,197,139,198,5,10.03%
2012-05,הצפון,1263,כפר ורדים,יישוב,64,30,34,27,37,8,64,3,2.13%
2012-05,הצפון,507,כפר יאסיף,יישוב,511,210,301,8,503,414,510,23,10.72%
2012-05,הצפון,508,כפר כמא,יישוב,65,24,41,0,65,38,64,0,4.26%
2012-05,הצפון,509,כפר כנא,יישוב,1192,447,745,22,1170,1067,1182,63,14.78%
2012-05,הצפון,510,כפר מנדא,יישוב,983,448,535,8,975,764,976,36,14.51%
2012-05,הצפון,47,כפר תבור,יישוב,42,18,24,12,30,5,42,0,2.27%
2012-05,הצפון,1139,כרמיאל,יישוב,1783,694,1089,366,1417,923,1734,105,6.85%
2012-05,הצפון,481,מגאר,יישוב,1497,556,941,18,1479,1336,1495,70,17.66%
2012-05,הצפון,516,מג'ד אל-כרום,יישוב,573,245,328,4,569,463,573,18,9.75%
2012-05,הצפון,874,מגדל העמק,יישוב,1010,425,585,79,931,492,971,113,7.50%
2012-05,הצפון,4201,מג'דל שמס,יישוב,478,173,305,13,465,410,471,12,10.57%
2012-05,הצפון,517,מזרעה,יישוב,170,64,106,1,169,150,169,7,9.22%
2012-05,הצפון,4203,מסעדה,יישוב,184,67,117,7,177,157,183,6,11.66%
2012-05,הצפון,518,מעיליא,יישוב,45,25,20,5,40,21,45,5,3.04%
2012-05,הצפון,1063,מעלות-תרשיחא,יישוב,899,419,480,110,789,563,896,45,7.66%
2012-05,הצפון,520,משהד,יישוב,296,104,192,4,292,252,294,12,9.94%
2012-05,הצפון,9100,נהרייה,יישוב,2094,977,1117,243,1851,1327,2086,128,7.18%
2012-05,הצפון,522,נחף,יישוב,401,170,231,7,394,338,401,11,8.82%
2012-05,הצפון,7300,נצרת,יישוב,2943,1267,1676,83,2860,2356,2929,88,9.50%
2012-05,הצפון,1061,נצרת עילית,יישוב,1941,842,1099,254,1687,1126,1845,182,8.02%
2012-05,הצפון,525,סאג'ור,יישוב,126,45,81,3,123,87,126,3,7.48%
2012-05,הצפון,7500,סח'נין,יישוב,1996,871,1125,29,1967,1734,1996,53,15.78%
2012-05,הצפון,4501,ע'ג'ר,יישוב,69,27,42,1,68,58,67,4,7.20%
2012-05,הצפון,530,עיילבון,יישוב,197,81,116,6,191,144,196,8,7.92%
2012-05,הצפון,511,עילוט,יישוב,317,128,189,6,311,253,316,11,12.27%
2012-05,הצפון,532,עין מאהל,יישוב,578,259,319,8,570,498,569,14,12.87%
2012-05,הצפון,7600,עכו,יישוב,3290,1476,1814,157,3133,2579,3267,127,12.77%
2012-05,הצפון,7700,עפולה,יישוב,1746,725,1021,182,1564,859,1691,155,7.25%
2012-05,הצפון,531,עראבה,יישוב,1407,592,815,28,1379,1257,1406,39,15.45%
2012-05,הצפון,535,פסוטה,יישוב,110,46,64,2,108,83,110,1,6.98%
2012-05,הצפון,536,פקיעין (בוקייעה),יישוב,121,69,52,5,116,77,119,6,4.64%
2012-05,הצפון,8000,צפת,יישוב,1158,613,545,73,1085,888,1145,31,9.21%
2012-05,הצפון,4100,קצרין,יישוב,173,78,95,31,142,80,172,8,4.54%
2012-05,הצפון,2800,קריית שמונה,יישוב,668,298,370,52,616,274,645,109,5.14%
2012-05,הצפון,543,ראמה,יישוב,323,137,186,4,319,255,320,6,8.96%
2012-05,הצפון,26,ראש פינה,יישוב,52,15,37,10,42,20,52,2,3.47%
2012-05,הצפון,542,ריינה,יישוב,630,238,392,12,618,522,625,17,10.17%
2012-05,הצפון,122,רמת ישי,יישוב,110,47,63,34,76,13,109,5,2.79%
2012-05,הצפון,913,שבלי - אום אל-גנם,יישוב,223,100,123,3,220,171,219,4,9.25%
2012-05,הצפון,812,שלומי,יישוב,256,108,148,14,242,155,253,14,7.26%
2012-05,הצפון,538,שעב,יישוב,473,187,286,6,467,430,473,6,16.98%
2012-05,הצפון,8800,שפרעם,יישוב,2002,764,1238,36,1966,1695,1998,62,12.26%
2012-05,חיפה,2710,אום אל-פחם,יישוב,3760,1540,2220,15,3745,3255,3755,47,20.01%
2012-05,חיפה,1020,אור עקיבא,יישוב,600,256,344,42,558,236,591,74,6.20%
2012-05,חיפה,6000,באקה אל-גרביה,יישוב,656,311,345,14,642,436,656,29,6.44%
2012-05,חיפה,9800,בנימינה-גבעת עדה*,יישוב,189,83,106,50,139,57,187,13,2.90%
2012-05,חיפה,1326,"בסמ""ה",יישוב,419,183,236,1,418,340,419,9,11.93%
2012-05,חיפה,541,ג'סר א-זרקא,יישוב,449,243,206,1,448,284,446,15,8.06%
2012-05,חיפה,628,ג'ת,יישוב,204,96,108,8,196,131,203,10,4.49%
2012-05,חיפה,494,דאלית אל-כרמל,יישוב,476,196,280,8,468,286,473,19,6.51%
2012-05,חיפה,9300,זכרון יעקב,יישוב,228,100,128,73,155,49,228,24,2.34%
2012-05,חיפה,6500,חדרה,יישוב,2542,1046,1496,283,2259,1020,2489,188,5.45%
2012-05,חיפה,4000,חיפה,יישוב,7057,3297,3760,1375,5682,4284,7031,495,5.17%
2012-05,חיפה,1247,חריש,יישוב,21,10,11,3,18,8,20,0,1.13%
2012-05,חיפה,2100,טירת כרמל,יישוב,778,366,412,31,747,472,770,68,7.62%
2012-05,חיפה,654,כפר קרע,יישוב,359,160,199,5,354,225,357,16,4.74%
2012-05,חיפה,1327,מעלה עירון,יישוב,936,371,565,3,933,779,936,13,17.89%
2012-05,חיפה,2500,נשר,יישוב,518,243,275,96,422,253,515,52,4.12%
2012-05,חיפה,534,עספיא,יישוב,316,136,180,3,313,181,315,11,6.29%
2012-05,חיפה,637,ערערה,יישוב,570,237,333,9,561,393,570,14,7.85%
2012-05,חיפה,537,פוריידיס,יישוב,368,169,199,2,366,262,367,13,7.30%
2012-05,חיפה,7800,פרדס חנה-כרכור,יישוב,859,372,487,153,706,292,849,94,4.71%
2012-05,חיפה,6800,קריית אתא,יישוב,1794,792,1002,159,1635,1056,1786,94,6.29%
2012-05,חיפה,9500,קריית ביאליק,יישוב,1196,498,698,147,1049,666,1192,88,5.75%
2012-05,חיפה,2300,קריית טבעון,יישוב,173,82,91,60,113,38,171,7,2.17%
2012-05,חיפה,9600,קריית ים,יישוב,1686,757,929,169,1517,1111,1681,101,8.02%
2012-05,חיפה,8200,קריית מוצקין,יישוב,1148,482,666,169,979,602,1145,73,5.25%
2012-05,חיפה,922,רכסים,יישוב,132,66,66,6,126,80,132,9,4.32%
2012-05,ירושלים,472,אבו גוש,יישוב,244,117,127,6,238,185,244,3,8.99%
2012-05,ירושלים,2610,בית שמש,יישוב,1143,497,646,123,1020,573,1138,128,4.09%
2012-05,ירושלים,3000,ירושלים,יישוב,10425,4642,5783,1227,9198,6412,10363,375,3.82%
2012-05,ירושלים,1015,מבשרת ציון,יישוב,363,181,182,55,308,166,363,8,2.93%
2012-05,ירושלים,1137,קריית יערים,יישוב,34,15,19,6,28,15,34,0,2.99%
2012-05,תל אביב,2400,אור יהודה,יישוב,814,396,418,40,774,305,803,74,4.45%
2012-05,תל אביב,565,אזור,יישוב,162,69,93,19,143,38,159,17,2.62%
2012-05,תל אביב,6100,בני ברק,יישוב,2275,1165,1110,112,2163,1362,2265,61,4.47%
2012-05,תל אביב,6200,בת ים,יישוב,3449,1628,1821,507,2942,1359,3392,278,4.79%
2012-05,תל אביב,6300,גבעתיים,יישוב,740,328,412,304,436,103,734,40,2.61%
2012-05,תל אביב,6400,הרצלייה,יישוב,1015,480,535,314,701,69,1007,130,2.19%
2012-05,תל אביב,6600,חולון,יישוב,2973,1402,1571,456,2517,921,2944,225,3.09%
2012-05,תל אביב,2620,קריית אונו,יישוב,363,168,195,136,227,39,357,29,2.08%
2012-05,תל אביב,8600,רמת גן,יישוב,2149,987,1162,631,1518,460,2134,111,2.90%
2012-05,תל אביב,2650,רמת השרון,יישוב,407,197,210,184,223,13,403,34,1.91%
2012-05,תל אביב,5000,תל אביב -יפו,יישוב,7813,3925,3888,2479,5334,2611,7765,430,3.25%
2012-06,אזור יהודה והשומרון,3760,אורנית,יישוב,218,92,126,31,187,4,215,8,5.03%
2012-06,אזור יהודה והשומרון,3750,אלפי מנשה,יישוב,141,70,71,18,123,3,141,3,3.37%
2012-06,אזור יהודה והשומרון,3560,אלקנה,יישוב,47,26,21,17,30,2,46,2,2.56%
2012-06,אזור יהודה והשומרון,3650,אפרת,יישוב,69,36,33,29,40,8,69,9,1.81%
2012-06,אזור יהודה והשומרון,3570,אריאל,יישוב,457,251,206,97,360,94,457,33,4.45%
2012-06,אזור יהודה והשומרון,3574,בית אל,יישוב,54,27,27,10,44,18,53,3,2.32%
2012-06,אזור יהודה והשומרון,3652,בית אריה,יישוב,106,48,58,11,95,5,106,2,4.58%
2012-06,אזור יהודה והשומרון,3780,ביתר עילית,יישוב,420,207,213,18,402,208,417,15,4.11%
2012-06,אזור יהודה והשומרון,3730,גבעת זאב,יישוב,210,108,102,27,183,35,210,9,3.10%
2012-06,אזור יהודה והשומרון,3769,הר אדר,יישוב,39,24,15,15,24,1,39,3,2.05%
2012-06,אזור יהודה והשומרון,3797,מודיעין עילית,יישוב,369,134,235,19,350,116,366,2,3.01%
2012-06,אזור יהודה והשומרון,3616,מעלה אדומים,יישוב,677,290,387,91,586,202,672,39,3.49%
2012-06,אזור יהודה והשומרון,3660,עמנואל,יישוב,81,43,38,3,78,59,81,2,7.72%
2012-06,אזור יהודה והשומרון,3557,קדומים,יישוב,72,33,39,11,61,8,72,2,4.10%
2012-06,אזור יהודה והשומרון,3611,קריית ארבע,יישוב,90,35,55,15,75,59,90,2,3.08%
2012-06,אזור יהודה והשומרון,3640,קרני שומרון,יישוב,114,62,52,23,91,18,114,7,3.26%
2012-06,הדרום,31,אופקים,יישוב,1498,650,848,94,1404,962,1489,65,12.05%
2012-06,הדרום,2600,אילת,יישוב,1583,691,892,63,1520,597,1567,115,4.83%
2012-06,הדרום,70,אשדוד,יישוב,6954,2865,4089,823,6131,3864,6904,264,6.64%
2012-06,הדרום,7100,אשקלון,יישוב,4820,1985,2835,663,4157,2652,4720,371,7.37%
2012-06,הדרום,9000,באר שבע,יישוב,8273,3659,4614,975,7298,4663,8224,1173,8.26%
2012-06,הדרום,2200,דימונה,יישוב,2261,999,1262,145,2116,1522,2235,118,12.60%
2012-06,הדרום,1303,חורה,יישוב,735,309,426,2,733,686,735,15,20.64%
2012-06,הדרום,831,ירוחם,יישוב,484,229,255,27,457,286,472,41,11.12%
2012-06,הדרום,1059,כסיפה,יישוב,983,415,568,6,977,885,982,33,23.67%
2012-06,הדרום,1271,להבים,יישוב,91,51,40,22,69,3,91,30,2.75%
2012-06,הדרום,1060,לקיה,יישוב,939,414,525,3,936,884,937,10,26.22%
2012-06,הדרום,1268,מיתר,יישוב,115,67,48,26,89,6,115,42,2.90%
2012-06,הדרום,99,מצפה רמון,יישוב,273,114,159,19,254,129,267,53,10.97%
2012-06,הדרום,246,נתיבות,יישוב,1248,579,669,55,1193,532,1245,98,9.58%
2012-06,הדרום,666,עומר,יישוב,102,52,50,23,79,6,102,22,2.65%
2012-06,הדרום,2560,ערד,יישוב,857,375,482,154,703,459,836,110,6.87%
2012-06,הדרום,1192,ערערה-בנגב,יישוב,984,404,580,5,979,924,983,6,26.07%
2012-06,הדרום,2630,קריית גת,יישוב,2451,1029,1422,193,2258,1521,2446,73,9.20%
2012-06,הדרום,1034,קריית מלאכי,יישוב,1267,561,706,29,1238,781,1252,125,10.97%
2012-06,הדרום,1161,רהט,יישוב,3075,1265,1810,10,3065,2692,3075,77,18.51%
2012-06,הדרום,1286,שגב-שלום,יישוב,490,179,311,0,490,448,489,20,20.22%
2012-06,הדרום,1031,שדרות,יישוב,1204,507,697,58,1146,675,1199,54,9.90%
2012-06,הדרום,1054,תל שבע,יישוב,1130,529,601,2,1128,1069,1130,21,25.89%
2012-06,המרכז,182,אבן יהודה,יישוב,166,83,83,41,125,20,166,8,2.62%
2012-06,המרכז,41,אליכין,יישוב,73,35,38,5,68,17,72,1,4.11%
2012-06,המרכז,1309,אלעד,יישוב,418,200,218,15,403,116,414,19,3.66%
2012-06,המרכז,2530,באר יעקב,יישוב,267,110,157,44,223,70,263,15,3.22%
2012-06,המרכז,466,בית דגן,יישוב,149,70,79,17,132,36,149,32,4.29%
2012-06,המרכז,1066,"בני עי""ש",יישוב,198,95,103,30,168,69,198,1,5.03%
2012-06,המרכז,681,גבעת שמואל,יישוב,283,145,138,100,183,54,282,13,2.55%
2012-06,המרכז,2550,גדרה,יישוב,466,204,262,73,393,96,461,3,4.26%
2012-06,המרכז,627,ג'לג'וליה,יישוב,82,39,43,0,82,46,82,2,2.70%
2012-06,המרכז,166,גן יבנה,יישוב,352,128,224,45,307,92,351,22,3.39%
2012-06,המרכז,229,גני תקווה,יישוב,241,113,128,49,192,24,238,8,3.13%
2012-06,המרכז,9700,הוד השרון,יישוב,862,441,421,257,605,65,859,35,3.23%
2012-06,המרכז,1290,זמר,יישוב,178,71,107,4,174,122,178,4,6.59%
2012-06,המרכז,2730,טייבה,יישוב,2259,968,1291,4,2255,1848,2253,41,14.09%
2012-06,המרכז,2720,טירה,יישוב,368,198,170,15,353,180,366,17,3.61%
2012-06,המרכז,2660,יבנה,יישוב,978,498,480,73,905,397,972,56,4.89%
2012-06,המרכז,9400,יהוד,יישוב,642,254,388,76,566,71,619,33,4.09%
2012-06,המרכז,1224,כוכב יאיר,יישוב,276,140,136,36,240,3,276,11,4.92%
2012-06,המרכז,633,כפר ברא,יישוב,38,26,12,1,37,12,38,0,3.14%
2012-06,המרכז,168,כפר יונה,יישוב,395,184,211,75,320,71,395,29,3.96%
2012-06,המרכז,6900,כפר סבא,יישוב,1494,711,783,372,1122,184,1488,86,3.06%
2012-06,המרכז,634,כפר קאסם,יישוב,215,108,107,1,214,110,215,5,2.75%
2012-06,המרכז,7000,לוד,יישוב,2350,1077,1273,165,2185,1287,2338,127,6.83%
2012-06,המרכז,1200,מודיעין-מכבים-רעות*,יישוב,1345,643,702,378,967,64,1334,58,3.32%
2012-06,המרכז,28,מזכרת בתיה,יישוב,209,101,108,43,166,36,209,1,3.40%
2012-06,המרכז,7200,נס ציונה,יישוב,713,330,383,137,576,192,707,7,3.30%
2012-06,המרכז,7400,נתניה,יישוב,4563,2139,2424,604,3959,1610,4535,296,4.61%
2012-06,המרכז,587,סביון*,יישוב,25,12,13,9,16,2,25,2,1.41%
2012-06,המרכז,171,פרדסייה,יישוב,85,47,38,18,67,6,85,1,2.46%
2012-06,המרכז,7900,פתח תקווה,יישוב,5093,2376,2717,855,4238,1086,5067,224,4.42%
2012-06,המרכז,195,קדימה-צורן,יישוב,284,118,166,67,217,32,284,8,3.07%
2012-06,המרכז,638,קלנסווה,יישוב,900,354,546,2,898,756,897,11,11.47%
2012-06,המרכז,469,קריית עקרון,יישוב,321,155,166,16,305,121,316,1,5.44%
2012-06,המרכז,2640,ראש העין,יישוב,1013,500,513,99,914,176,1000,51,4.64%
2012-06,המרכז,8300,ראשון לציון,יישוב,5405,2527,2878,945,4460,1580,5394,202,4.10%
2012-06,המרכז,8400,רחובות,יישוב,2784,1232,1552,494,2290,1029,2739,21,4.44%
2012-06,המרכז,8500,רמלה,יישוב,1930,944,986,99,1831,801,1893,130,5.52%
2012-06,המרכז,8700,רעננה,יישוב,1376,734,642,332,1044,83,1375,47,3.77%
2012-06,המרכז,1304,שוהם,יישוב,399,209,190,79,320,4,399,21,3.87%
2012-06,המרכז,154,תל מונד,יישוב,216,96,120,63,153,24,216,14,3.79%
2012-06,הצפון,473,אבו סנאן,יישוב,764,304,460,5,759,645,760,21,14.29%
2012-06,הצפון,478,אכסאל,יישוב,525,222,303,15,510,446,524,12,10.37%
2012-06,הצפון,529,אעבלין,יישוב,623,250,373,9,614,512,623,16,12.05%
2012-06,הצפון,482,בועיינה-נוג'ידאת,יישוב,459,191,268,3,456,393,454,16,13.00%
2012-06,הצפון,4001,בוקעאתא,יישוב,392,147,245,6,386,340,382,7,14.82%
2012-06,הצפון,998,ביר אל-מכסור,יישוב,416,162,254,3,413,329,416,10,12.91%
2012-06,הצפון,480,בית ג'ן,יישוב,354,106,248,1,353,254,351,6,7.27%
2012-06,הצפון,9200,בית שאן,יישוב,809,341,468,27,782,441,808,64,8.50%
2012-06,הצפון,944,בסמת טבעון,יישוב,198,80,118,0,198,157,197,12,6.99%
2012-06,הצפון,483,בענה,יישוב,415,170,245,2,413,366,415,8,13.51%
2012-06,הצפון,1292,ג'דיידה-מכר,יישוב,1511,628,883,7,1504,1280,1509,47,18.00%
2012-06,הצפון,485,ג'ולס,יישוב,210,57,153,2,208,160,210,12,8.04%
2012-06,הצפון,487,ג'ש (גוש חלב),יישוב,66,28,38,4,62,26,65,3,4.31%
2012-06,הצפון,489,דבורייה,יישוב,405,172,233,18,387,312,405,2,10.40%
2012-06,הצפון,490,דייר אל-אסד,יישוב,403,173,230,7,396,320,403,9,8.75%
2012-06,הצפון,492,דייר חנא,יישוב,619,251,368,14,605,495,619,19,14.26%
2012-06,הצפון,975,זרזיר,יישוב,301,142,159,5,296,205,297,10,11.11%
2012-06,הצפון,496,חורפיש,יישוב,119,50,69,6,113,79,119,2,4.87%
2012-06,הצפון,2034,חצור הגלילית,יישוב,306,137,169,12,294,134,301,23,6.57%
2012-06,הצפון,6700,טבריה,יישוב,1918,849,1069,99,1819,1228,1787,95,8.55%
2012-06,הצפון,962,טובא-זנגרייה,יישוב,384,172,212,7,377,264,379,10,13.20%
2012-06,הצפון,498,טורעאן,יישוב,547,217,330,8,539,480,544,37,10.80%
2012-06,הצפון,8900,טמרה,יישוב,1956,772,1184,11,1945,1718,1951,38,15.19%
2012-06,הצפון,1295,יאנוח-ג'ת,יישוב,168,60,108,2,166,120,167,5,6.77%
2012-06,הצפון,46,יבנאל,יישוב,148,94,54,7,141,113,135,0,8.96%
2012-06,הצפון,499,יפיע,יישוב,644,285,359,15,629,482,641,10,9.07%
2012-06,הצפון,240,יקנעם עילית,יישוב,488,204,284,89,399,170,487,51,4.42%
2012-06,הצפון,502,ירכא,יישוב,549,218,331,2,547,446,549,19,10.14%
2012-06,הצפון,504,כאבול,יישוב,690,268,422,9,681,602,687,8,15.16%
2012-06,הצפון,505,כאוכב אבו אל-היג'א,יישוב,220,98,122,5,215,186,220,9,13.99%
2012-06,הצפון,1296,כסרא-סמיע,יישוב,214,101,113,2,212,158,213,13,7.06%
2012-06,הצפון,978,כעביה-טבאש-חג'אג'רה,יישוב,190,72,118,2,188,140,189,1,9.61%
2012-06,הצפון,1263,כפר ורדים,יישוב,84,44,40,24,60,7,84,2,2.77%
2012-06,הצפון,507,כפר יאסיף,יישוב,528,219,309,3,525,412,527,20,11.04%
2012-06,הצפון,508,כפר כמא,יישוב,68,29,39,1,67,35,67,3,4.45%
2012-06,הצפון,509,כפר כנא,יישוב,1221,481,740,26,1195,1071,1209,64,15.06%
2012-06,הצפון,510,כפר מנדא,יישוב,964,433,531,8,956,743,954,34,14.23%
2012-06,הצפון,47,כפר תבור,יישוב,54,21,33,10,44,4,54,4,2.90%
2012-06,הצפון,1139,כרמיאל,יישוב,1934,793,1141,341,1593,910,1885,94,7.40%
2012-06,הצפון,481,מגאר,יישוב,1523,592,931,19,1504,1319,1520,60,17.91%
2012-06,הצפון,516,מג'ד אל-כרום,יישוב,580,252,328,5,575,463,580,20,9.85%
2012-06,הצפון,874,מגדל העמק,יישוב,1051,443,608,82,969,472,1015,92,7.81%
2012-06,הצפון,4201,מג'דל שמס,יישוב,471,172,299,12,459,408,461,9,10.37%
2012-06,הצפון,517,מזרעה,יישוב,181,73,108,1,180,153,180,8,9.76%
2012-06,הצפון,4203,מסעדה,יישוב,178,64,114,6,172,153,177,4,11.32%
2012-06,הצפון,518,מעיליא,יישוב,55,28,27,4,51,26,55,2,3.69%
2012-06,הצפון,1063,מעלות-תרשיחא,יישוב,941,460,481,109,832,536,937,64,7.98%
2012-06,הצפון,520,משהד,יישוב,293,102,191,3,290,250,292,7,9.87%
2012-06,הצפון,9100,נהרייה,יישוב,2204,1045,1159,244,1960,1283,2190,123,7.51%
2012-06,הצפון,522,נחף,יישוב,410,184,226,7,403,332,410,17,9.01%
2012-06,הצפון,7300,נצרת,יישוב,3012,1331,1681,85,2927,2330,2998,68,9.70%
2012-06,הצפון,1061,נצרת עילית,יישוב,2088,912,1176,253,1835,1089,2002,141,8.65%
2012-06,הצפון,525,סאג'ור,יישוב,134,53,81,1,133,79,134,2,7.91%
2012-06,הצפון,7500,סח'נין,יישוב,2020,896,1124,32,1988,1721,2019,63,15.94%
2012-06,הצפון,4501,ע'ג'ר,יישוב,70,29,41,1,69,56,70,4,7.50%
2012-06,הצפון,530,עיילבון,יישוב,202,84,118,7,195,143,201,11,8.10%
2012-06,הצפון,511,עילוט,יישוב,314,134,180,3,311,248,313,10,12.16%
2012-06,הצפון,532,עין מאהל,יישוב,588,265,323,7,581,501,580,16,13.09%
2012-06,הצפון,7600,עכו,יישוב,3349,1509,1840,160,3189,2550,3320,163,12.95%
2012-06,הצפון,7700,עפולה,יישוב,1866,802,1064,178,1688,832,1820,153,7.76%
2012-06,הצפון,531,עראבה,יישוב,1381,580,801,24,1357,1244,1378,35,15.19%
2012-06,הצפון,535,פסוטה,יישוב,112,50,62,4,108,79,112,5,7.09%
2012-06,הצפון,536,פקיעין (בוקייעה),יישוב,117,66,51,4,113,74,116,2,4.53%
2012-06,הצפון,8000,צפת,יישוב,1218,670,548,76,1142,907,1205,84,9.65%
2012-06,הצפון,4100,קצרין,יישוב,248,114,134,30,218,80,247,61,6.39%
2012-06,הצפון,2800,קריית שמונה,יישוב,704,326,378,50,654,259,686,76,5.45%
2012-06,הצפון,543,ראמה,יישוב,318,134,184,8,310,246,317,4,8.89%
2012-06,הצפון,26,ראש פינה,יישוב,59,22,37,9,50,24,59,2,3.92%
2012-06,הצפון,542,ריינה,יישוב,648,270,378,12,636,528,643,23,10.43%
2012-06,הצפון,122,רמת ישי,יישוב,133,51,82,33,100,12,133,7,3.38%
2012-06,הצפון,913,שבלי - אום אל-גנם,יישוב,226,101,125,6,220,168,225,8,9.48%
2012-06,הצפון,812,שלומי,יישוב,282,120,162,14,268,154,280,40,7.97%
2012-06,הצפון,538,שעב,יישוב,466,181,285,3,463,422,466,6,16.77%
2012-06,הצפון,8800,שפרעם,יישוב,2032,802,1230,33,1999,1672,2028,54,12.42%
2012-06,חיפה,2710,אום אל-פחם,יישוב,3754,1554,2200,13,3741,3225,3750,53,19.99%
2012-06,חיפה,1020,אור עקיבא,יישוב,666,296,370,41,625,225,659,55,6.87%
2012-06,חיפה,6000,באקה אל-גרביה,יישוב,695,341,354,11,684,439,693,26,6.78%
2012-06,חיפה,9800,בנימינה-גבעת עדה*,יישוב,213,94,119,44,169,53,211,9,3.26%
2012-06,חיפה,1326,"בסמ""ה",יישוב,450,213,237,1,449,338,450,6,12.70%
2012-06,חיפה,541,ג'סר א-זרקא,יישוב,462,249,213,1,461,280,459,13,8.28%
2012-06,חיפה,628,ג'ת,יישוב,217,113,104,8,209,124,216,8,4.76%
2012-06,חיפה,494,דאלית אל-כרמל,יישוב,490,197,293,7,483,297,487,28,6.69%
2012-06,חיפה,9300,זכרון יעקב,יישוב,318,146,172,80,238,47,318,18,3.24%
2012-06,חיפה,6500,חדרה,יישוב,2677,1117,1560,278,2399,996,2650,140,5.78%
2012-06,חיפה,4000,חיפה,יישוב,7799,3734,4065,1311,6488,4146,7766,510,5.68%
2012-06,חיפה,1247,חריש,יישוב,26,14,12,3,23,9,26,1,1.47%
2012-06,חיפה,2100,טירת כרמל,יישוב,841,388,453,29,812,459,835,55,8.21%
2012-06,חיפה,654,כפר קרע,יישוב,366,162,204,4,362,227,364,18,4.83%
2012-06,חיפה,1327,מעלה עירון,יישוב,936,368,568,2,934,785,936,15,17.89%
2012-06,חיפה,2500,נשר,יישוב,590,265,325,97,493,232,590,42,4.70%
2012-06,חיפה,534,עספיא,יישוב,329,148,181,4,325,187,328,15,6.53%
2012-06,חיפה,637,ערערה,יישוב,602,261,341,9,593,395,602,19,8.26%
2012-06,חיפה,537,פוריידיס,יישוב,395,187,208,3,392,257,394,8,7.79%
2012-06,חיפה,7800,פרדס חנה-כרכור,יישוב,915,392,523,144,771,284,907,91,5.02%
2012-06,חיפה,6800,קריית אתא,יישוב,1812,803,1009,156,1656,1029,1808,95,6.37%
2012-06,חיפה,9500,קריית ביאליק,יישוב,1251,523,728,141,1110,644,1241,58,5.97%
2012-06,חיפה,2300,קריית טבעון,יישוב,204,98,106,53,151,43,201,14,2.54%
2012-06,חיפה,9600,קריית ים,יישוב,1675,777,898,160,1515,1062,1671,82,7.97%
2012-06,חיפה,8200,קריית מוצקין,יישוב,1204,519,685,168,1036,572,1200,59,5.49%
2012-06,חיפה,922,רכסים,יישוב,110,56,54,5,105,70,110,8,3.63%
2012-06,ירושלים,472,אבו גוש,יישוב,265,125,140,5,260,191,265,1,9.69%
2012-06,ירושלים,2610,בית שמש,יישוב,1254,571,683,116,1138,558,1249,112,4.47%
2012-06,ירושלים,3000,ירושלים,יישוב,11312,5261,6051,1188,10124,6337,11252,381,4.14%
2012-06,ירושלים,1015,מבשרת ציון,יישוב,461,230,231,63,398,159,460,18,3.69%
2012-06,ירושלים,1137,קריית יערים,יישוב,37,15,22,6,31,17,37,0,3.25%
2012-06,תל אביב,2400,אור יהודה,יישוב,908,432,476,43,865,289,898,68,4.96%
2012-06,תל אביב,565,אזור,יישוב,204,101,103,16,188,38,203,10,3.32%
2012-06,תל אביב,6100,בני ברק,יישוב,2363,1188,1175,110,2253,1342,2356,84,4.65%
2012-06,תל אביב,6200,בת ים,יישוב,3906,1857,2049,482,3424,1337,3855,249,5.41%
2012-06,תל אביב,6300,גבעתיים,יישוב,821,377,444,296,525,101,812,46,2.87%
2012-06,תל אביב,6400,הרצלייה,יישוב,1407,689,718,296,1111,59,1400,376,3.01%
2012-06,תל אביב,6600,חולון,יישוב,3937,1905,2032,466,3471,897,3901,186,4.06%
2012-06,תל אביב,2620,קריית אונו,יישוב,505,239,266,130,375,46,500,28,2.89%
2012-06,תל אביב,8600,רמת גן,יישוב,2327,1081,1246,597,1730,447,2312,112,3.13%
2012-06,תל אביב,2650,רמת השרון,יישוב,600,285,315,187,413,7,596,159,2.79%
2012-06,תל אביב,5000,תל אביב -יפו,יישוב,8481,4250,4231,2457,6024,2586,8437,387,3.52%
2012-07,אזור יהודה והשומרון,3760,אורנית,יישוב,116,49,67,28,88,6,115,2,2.76%
2012-07,אזור יהודה והשומרון,3750,אלפי מנשה,יישוב,107,55,52,21,86,3,107,6,2.57%
2012-07,אזור יהודה והשומרון,3560,אלקנה,יישוב,47,23,24,18,29,2,46,3,2.56%
2012-07,אזור יהודה והשומרון,3650,אפרת,יישוב,101,58,43,25,76,10,100,2,2.61%
2012-07,אזור יהודה והשומרון,3570,אריאל,יישוב,499,269,230,115,384,98,498,24,4.83%
2012-07,אזור יהודה והשומרון,3574,בית אל,יישוב,66,39,27,12,54,17,66,5,2.87%
2012-07,אזור יהודה והשומרון,3652,בית אריה,יישוב,81,33,48,10,71,4,80,2,3.49%
2012-07,אזור יהודה והשומרון,3780,ביתר עילית,יישוב,569,236,333,18,551,215,564,11,5.47%
2012-07,אזור יהודה והשומרון,3730,גבעת זאב,יישוב,225,122,103,29,196,34,225,12,3.32%
2012-07,אזור יהודה והשומרון,3769,הר אדר,יישוב,48,30,18,14,34,2,48,1,2.52%
2012-07,אזור יהודה והשומרון,3797,מודיעין עילית,יישוב,665,170,495,24,641,123,663,21,5.32%
2012-07,אזור יהודה והשומרון,3616,מעלה אדומים,יישוב,663,260,403,99,564,186,656,43,3.41%
2012-07,אזור יהודה והשומרון,3660,עמנואל,יישוב,115,58,57,4,111,59,114,1,10.54%
2012-07,אזור יהודה והשומרון,3557,קדומים,יישוב,70,40,30,17,53,8,69,4,3.94%
2012-07,אזור יהודה והשומרון,3611,קריית ארבע,יישוב,132,63,69,17,115,63,132,6,4.45%
2012-07,אזור יהודה והשומרון,3640,קרני שומרון,יישוב,172,84,88,33,139,20,172,9,4.84%
2012-07,הדרום,31,אופקים,יישוב,1642,672,970,112,1530,998,1624,39,13.00%
2012-07,הדרום,2600,אילת,יישוב,1557,680,877,74,1483,596,1539,108,4.75%
2012-07,הדרום,70,אשדוד,יישוב,7764,3094,4670,886,6878,3897,7716,309,7.36%
2012-07,הדרום,7100,אשקלון,יישוב,5018,1982,3036,699,4319,2636,4907,341,7.63%
2012-07,הדרום,9000,באר שבע,יישוב,8499,3739,4760,1030,7469,4765,8438,1275,8.45%
2012-07,הדרום,2200,דימונה,יישוב,2391,999,1392,155,2236,1525,2366,106,13.25%
2012-07,הדרום,1303,חורה,יישוב,749,312,437,1,748,692,749,12,20.95%
2012-07,הדרום,831,ירוחם,יישוב,571,259,312,26,545,295,565,78,13.03%
2012-07,הדרום,1059,כסיפה,יישוב,1014,433,581,6,1008,882,1010,31,24.19%
2012-07,הדרום,1271,להבים,יישוב,78,37,41,24,54,3,78,32,2.37%
2012-07,הדרום,1060,לקיה,יישוב,985,418,567,5,980,896,983,12,27.15%
2012-07,הדרום,1268,מיתר,יישוב,114,64,50,28,86,8,114,52,2.88%
2012-07,הדרום,99,מצפה רמון,יישוב,292,121,171,20,272,137,276,55,11.29%
2012-07,הדרום,246,נתיבות,יישוב,1269,532,737,65,1204,559,1258,72,9.67%
2012-07,הדרום,666,עומר,יישוב,95,40,55,25,70,5,95,31,2.48%
2012-07,הדרום,2560,ערד,יישוב,933,401,532,164,769,461,914,140,7.46%
2012-07,הדרום,1192,ערערה-בנגב,יישוב,996,410,586,4,992,929,994,10,26.28%
2012-07,הדרום,2630,קריית גת,יישוב,2660,1105,1555,209,2451,1547,2656,43,9.91%
2012-07,הדרום,1034,קריית מלאכי,יישוב,1393,636,757,35,1358,798,1378,178,11.94%
2012-07,הדרום,1161,רהט,יישוב,3225,1279,1946,10,3215,2725,3222,52,19.22%
2012-07,הדרום,1286,שגב-שלום,יישוב,511,189,322,1,510,460,509,19,20.88%
2012-07,הדרום,1031,שדרות,יישוב,1266,521,745,72,1194,692,1260,46,10.36%
2012-07,הדרום,1054,תל שבע,יישוב,1159,534,625,3,1156,1087,1159,21,26.38%
2012-07,המרכז,182,אבן יהודה,יישוב,173,78,95,51,122,19,172,4,2.72%
2012-07,המרכז,41,אליכין,יישוב,81,33,48,8,73,18,80,5,4.55%
2012-07,המרכז,1309,אלעד,יישוב,496,206,290,20,476,119,494,24,4.34%
2012-07,המרכז,2530,באר יעקב,יישוב,310,123,187,46,264,75,305,13,3.72%
2012-07,המרכז,466,בית דגן,יישוב,138,65,73,25,113,37,138,10,3.99%
2012-07,המרכז,1066,"בני עי""ש",יישוב,218,99,119,33,185,72,217,0,5.48%
2012-07,המרכז,681,גבעת שמואל,יישוב,320,160,160,120,200,55,319,6,2.87%
2012-07,המרכז,2550,גדרה,יישוב,507,217,290,80,427,102,502,4,4.62%
2012-07,המרכז,627,ג'לג'וליה,יישוב,92,46,46,0,92,46,92,1,3.02%
2012-07,המרכז,166,גן יבנה,יישוב,414,147,267,48,366,89,412,10,3.96%
2012-07,המרכז,229,גני תקווה,יישוב,215,118,97,53,162,26,214,5,2.83%
2012-07,המרכז,9700,הוד השרון,יישוב,829,395,434,261,568,67,826,46,3.11%
2012-07,המרכז,1290,זמר,יישוב,161,52,109,5,156,123,161,5,5.99%
2012-07,המרכז,2730,טייבה,יישוב,2267,957,1310,5,2262,1880,2260,27,14.13%
2012-07,המרכז,2720,טירה,יישוב,372,188,184,17,355,188,372,18,3.67%
2012-07,המרכז,2660,יבנה,יישוב,1018,509,509,87,931,387,1013,70,5.08%
2012-07,המרכז,9400,יהוד,יישוב,658,282,376,88,570,65,634,22,4.18%
2012-07,המרכז,1224,כוכב יאיר,יישוב,139,69,70,24,115,3,139,11,2.54%
2012-07,המרכז,633,כפר ברא,יישוב,31,17,14,1,30,13,31,0,2.58%
2012-07,המרכז,168,כפר יונה,יישוב,410,181,229,70,340,67,410,20,4.10%
2012-07,המרכז,6900,כפר סבא,יישוב,1569,729,840,405,1164,189,1558,84,3.19%
2012-07,המרכז,634,כפר קאסם,יישוב,270,116,154,7,263,119,270,5,3.43%
2012-07,המרכז,7000,לוד,יישוב,2680,1189,1491,187,2493,1372,2668,146,7.72%
2012-07,המרכז,1200,מודיעין-מכבים-רעות*,יישוב,1314,564,750,399,915,65,1307,57,3.25%
2012-07,המרכז,28,מזכרת בתיה,יישוב,258,114,144,44,214,38,256,1,4.13%
2012-07,המרכז,7200,נס ציונה,יישוב,832,373,459,144,688,190,826,3,3.84%
2012-07,המרכז,7400,נתניה,יישוב,5086,2228,2858,674,4412,1683,5052,276,5.11%
2012-07,המרכז,587,סביון*,יישוב,27,14,13,9,18,0,27,0,1.52%
2012-07,המרכז,171,פרדסייה,יישוב,85,41,44,21,64,5,85,0,2.46%
2012-07,המרכז,7900,פתח תקווה,יישוב,4869,2166,2703,898,3971,1124,4838,189,4.22%
2012-07,המרכז,195,קדימה-צורן,יישוב,320,137,183,80,240,30,319,11,3.44%
2012-07,המרכז,638,קלנסווה,יישוב,948,354,594,3,945,775,943,17,11.99%
2012-07,המרכז,469,קריית עקרון,יישוב,368,172,196,21,347,131,359,3,6.13%
2012-07,המרכז,2640,ראש העין,יישוב,945,460,485,105,840,168,930,58,4.33%
2012-07,המרכז,8300,ראשון לציון,יישוב,5358,2412,2946,1036,4322,1547,5346,278,4.07%
2012-07,המרכז,8400,רחובות,יישוב,3165,1358,1807,544,2621,1041,3112,20,5.02%
2012-07,המרכז,8500,רמלה,יישוב,2075,976,1099,112,1963,845,2039,127,5.92%
2012-07,המרכז,8700,רעננה,יישוב,1118,548,570,341,777,90,1113,56,3.07%
2012-07,המרכז,1304,שוהם,יישוב,258,120,138,81,177,6,258,12,2.54%
2012-07,המרכז,154,תל מונד,יישוב,194,83,111,61,133,23,194,7,3.41%
2012-07,הצפון,473,אבו סנאן,יישוב,782,323,459,6,776,638,778,18,14.58%
2012-07,הצפון,478,אכסאל,יישוב,538,223,315,15,523,462,536,7,10.58%
2012-07,הצפון,529,אעבלין,יישוב,637,250,387,10,627,519,637,13,12.29%
2012-07,הצפון,482,בועיינה-נוג'ידאת,יישוב,470,191,279,8,462,381,465,22,13.28%
2012-07,הצפון,4001,בוקעאתא,יישוב,399,153,246,10,389,336,393,7,15.18%
2012-07,הצפון,998,ביר אל-מכסור,יישוב,424,163,261,5,419,329,424,6,13.12%
2012-07,הצפון,480,בית ג'ן,יישוב,362,113,249,5,357,260,358,6,7.41%
2012-07,הצפון,9200,בית שאן,יישוב,874,393,481,30,844,450,872,51,9.11%
2012-07,הצפון,944,בסמת טבעון,יישוב,207,86,121,3,204,165,206,9,7.29%
2012-07,הצפון,483,בענה,יישוב,430,164,266,6,424,359,430,14,13.93%
2012-07,הצפון,1292,ג'דיידה-מכר,יישוב,1553,632,921,7,1546,1304,1550,49,18.40%
2012-07,הצפון,485,ג'ולס,יישוב,235,57,178,2,233,156,235,4,8.91%
2012-07,הצפון,487,ג'ש (גוש חלב),יישוב,71,32,39,5,66,30,70,6,4.63%
2012-07,הצפון,489,דבורייה,יישוב,428,183,245,23,405,317,428,5,10.93%
2012-07,הצפון,490,דייר אל-אסד,יישוב,448,182,266,11,437,320,448,7,9.64%
2012-07,הצפון,492,דייר חנא,יישוב,647,260,387,11,636,502,647,27,14.81%
2012-07,הצפון,975,זרזיר,יישוב,327,151,176,5,322,210,320,12,11.87%
2012-07,הצפון,496,חורפיש,יישוב,144,58,86,5,139,79,144,8,5.83%
2012-07,הצפון,2034,חצור הגלילית,יישוב,335,151,184,15,320,134,331,24,7.18%
2012-07,הצפון,6700,טבריה,יישוב,2093,895,1198,124,1969,1240,1953,107,9.27%
2012-07,הצפון,962,טובא-זנגרייה,יישוב,397,181,216,6,391,267,392,5,13.59%
2012-07,הצפון,498,טורעאן,יישוב,620,221,399,12,608,493,617,30,12.07%
2012-07,הצפון,8900,טמרה,יישוב,2019,778,1241,18,2001,1735,2015,39,15.61%
2012-07,הצפון,1295,יאנוח-ג'ת,יישוב,184,69,115,5,179,118,184,7,7.41%
2012-07,הצפון,46,יבנאל,יישוב,155,96,59,8,147,110,145,2,9.56%
2012-07,הצפון,499,יפיע,יישוב,652,290,362,13,639,492,647,19,9.15%
2012-07,הצפון,240,יקנעם עילית,יישוב,563,234,329,89,474,177,563,41,5.07%
2012-07,הצפון,502,ירכא,יישוב,551,227,324,2,549,431,551,13,10.17%
2012-07,הצפון,504,כאבול,יישוב,709,278,431,12,697,602,707,12,15.54%
2012-07,הצפון,505,כאוכב אבו אל-היג'א,יישוב,220,97,123,7,213,181,220,7,13.99%
2012-07,הצפון,1296,כסרא-סמיע,יישוב,241,88,153,3,238,183,239,18,7.86%
2012-07,הצפון,978,כעביה-טבאש-חג'אג'רה,יישוב,192,77,115,3,189,144,190,1,9.66%
2012-07,הצפון,1263,כפר ורדים,יישוב,121,46,75,30,91,9,121,2,3.95%
2012-07,הצפון,507,כפר יאסיף,יישוב,551,233,318,6,545,411,551,23,11.49%
2012-07,הצפון,508,כפר כמא,יישוב,72,26,46,1,71,36,71,2,4.71%
2012-07,הצפון,509,כפר כנא,יישוב,1291,521,770,35,1256,1096,1280,75,15.81%
2012-07,הצפון,510,כפר מנדא,יישוב,963,428,535,11,952,731,949,21,14.17%
2012-07,הצפון,47,כפר תבור,יישוב,62,19,43,11,51,1,62,0,3.32%
2012-07,הצפון,1139,כרמיאל,יישוב,1897,772,1125,360,1537,897,1837,115,7.23%
2012-07,הצפון,481,מגאר,יישוב,1508,582,926,28,1480,1306,1504,65,17.75%
2012-07,הצפון,516,מג'ד אל-כרום,יישוב,579,252,327,4,575,441,579,10,9.84%
2012-07,הצפון,874,מגדל העמק,יישוב,1142,449,693,102,1040,492,1102,116,8.42%
2012-07,הצפון,4201,מג'דל שמס,יישוב,476,173,303,15,461,415,468,8,10.51%
2012-07,הצפון,517,מזרעה,יישוב,184,72,112,4,180,147,183,7,9.91%
2012-07,הצפון,4203,מסעדה,יישוב,188,65,123,4,184,154,187,14,11.89%
2012-07,הצפון,518,מעיליא,יישוב,57,31,26,5,52,21,57,3,3.82%
2012-07,הצפון,1063,מעלות-תרשיחא,יישוב,1037,465,572,124,913,550,1034,56,8.74%
2012-07,הצפון,520,משהד,יישוב,317,118,199,4,313,263,314,11,10.54%
2012-07,הצפון,9100,נהרייה,יישוב,2236,1020,1216,242,1994,1276,2227,134,7.62%
2012-07,הצפון,522,נחף,יישוב,428,197,231,12,416,328,428,10,9.36%
2012-07,הצפון,7300,נצרת,יישוב,3166,1365,1801,103,3063,2346,3153,63,10.15%
2012-07,הצפון,1061,נצרת עילית,יישוב,2147,921,1226,276,1871,1092,2050,161,8.84%
2012-07,הצפון,525,סאג'ור,יישוב,149,62,87,1,148,85,148,7,8.67%
2012-07,הצפון,7500,סח'נין,יישוב,2047,883,1164,43,2004,1727,2047,70,16.12%
2012-07,הצפון,4501,ע'ג'ר,יישוב,71,28,43,1,70,54,71,2,7.60%
2012-07,הצפון,530,עיילבון,יישוב,211,87,124,6,205,143,210,8,8.43%
2012-07,הצפון,511,עילוט,יישוב,317,127,190,3,314,246,316,6,12.27%
2012-07,הצפון,532,עין מאהל,יישוב,594,265,329,6,588,517,587,2,13.23%
2012-07,הצפון,7600,עכו,יישוב,3437,1514,1923,165,3272,2558,3405,128,13.24%
2012-07,הצפון,7700,עפולה,יישוב,1918,824,1094,197,1721,831,1861,108,7.92%
2012-07,הצפון,531,עראבה,יישוב,1432,589,843,31,1401,1253,1429,31,15.67%
2012-07,הצפון,535,פסוטה,יישוב,131,51,80,9,122,87,131,5,8.20%
2012-07,הצפון,536,פקיעין (בוקייעה),יישוב,128,70,58,5,123,78,127,1,4.94%
2012-07,הצפון,8000,צפת,יישוב,1471,748,723,77,1394,975,1457,132,11.43%
2012-07,הצפון,4100,קצרין,יישוב,212,96,116,29,183,90,211,27,5.51%
2012-07,הצפון,2800,קריית שמונה,יישוב,846,391,455,56,790,280,823,82,6.47%
2012-07,הצפון,543,ראמה,יישוב,318,122,196,7,311,243,317,6,8.89%
2012-07,הצפון,26,ראש פינה,יישוב,78,28,50,10,68,22,76,6,4.99%
2012-07,הצפון,542,ריינה,יישוב,684,280,404,18,666,535,678,21,10.93%
2012-07,הצפון,122,רמת ישי,יישוב,130,50,80,31,99,15,130,3,3.31%
2012-07,הצפון,913,שבלי - אום אל-גנם,יישוב,254,117,137,8,246,168,252,6,10.50%
2012-07,הצפון,812,שלומי,יישוב,286,123,163,17,269,140,285,26,8.10%
2012-07,הצפון,538,שעב,יישוב,478,189,289,3,475,430,478,7,17.13%
2012-07,הצפון,8800,שפרעם,יישוב,2085,816,1269,44,2041,1669,2079,62,12.69%
2012-07,חיפה,2710,אום אל-פחם,יישוב,3848,1565,2283,15,3833,3244,3843,45,20.39%
2012-07,חיפה,1020,אור עקיבא,יישוב,659,302,357,49,610,231,647,78,6.75%
2012-07,חיפה,6000,באקה אל-גרביה,יישוב,691,325,366,13,678,458,690,21,6.75%
2012-07,חיפה,9800,בנימינה-גבעת עדה*,יישוב,227,99,128,42,185,51,225,8,3.47%
2012-07,חיפה,1326,"בסמ""ה",יישוב,445,210,235,2,443,341,445,9,12.58%
2012-07,חיפה,541,ג'סר א-זרקא,יישוב,453,241,212,1,452,274,450,12,8.13%
2012-07,חיפה,628,ג'ת,יישוב,201,93,108,10,191,124,200,6,4.42%
2012-07,חיפה,494,דאלית אל-כרמל,יישוב,526,211,315,8,518,300,521,19,7.12%
2012-07,חיפה,9300,זכרון יעקב,יישוב,320,157,163,88,232,48,318,16,3.24%
2012-07,חיפה,6500,חדרה,יישוב,2778,1153,1625,320,2458,993,2746,122,5.98%
2012-07,חיפה,4000,חיפה,יישוב,7379,3510,3869,1286,6093,4159,7347,515,5.39%
2012-07,חיפה,1247,חריש,יישוב,32,16,16,6,26,9,31,1,1.74%
2012-07,חיפה,2100,טירת כרמל,יישוב,791,367,424,29,762,464,783,57,7.74%
2012-07,חיפה,654,כפר קרע,יישוב,384,162,222,9,375,230,382,20,5.06%
2012-07,חיפה,1327,מעלה עירון,יישוב,962,381,581,2,960,784,962,15,18.30%
2012-07,חיפה,2500,נשר,יישוב,554,250,304,91,463,229,553,55,4.41%
2012-07,חיפה,534,עספיא,יישוב,403,168,235,9,394,187,401,43,7.87%
2012-07,חיפה,637,ערערה,יישוב,611,254,357,11,600,402,611,30,8.37%
2012-07,חיפה,537,פוריידיס,יישוב,421,192,229,3,418,263,420,15,8.26%
2012-07,חיפה,7800,פרדס חנה-כרכור,יישוב,968,403,565,150,818,304,959,80,5.29%
2012-07,חיפה,6800,קריית אתא,יישוב,1997,814,1183,169,1828,1057,1991,112,6.97%
2012-07,חיפה,9500,קריית ביאליק,יישוב,1305,551,754,151,1154,655,1300,75,6.23%
2012-07,חיפה,2300,קריית טבעון,יישוב,211,109,102,58,153,44,209,8,2.63%
2012-07,חיפה,9600,קריית ים,יישוב,1739,806,933,167,1572,1043,1733,96,8.24%
2012-07,חיפה,8200,קריית מוצקין,יישוב,1215,514,701,165,1050,575,1209,80,5.53%
2012-07,חיפה,922,רכסים,יישוב,140,61,79,5,135,72,139,5,4.54%
2012-07,ירושלים,472,אבו גוש,יישוב,289,151,138,10,279,193,289,3,10.47%
2012-07,ירושלים,2610,בית שמש,יישוב,1600,662,938,122,1478,598,1594,85,5.63%
2012-07,ירושלים,3000,ירושלים,יישוב,12336,5395,6941,1261,11075,6456,12274,421,4.50%
2012-07,ירושלים,1015,מבשרת ציון,יישוב,527,242,285,75,452,166,526,13,4.19%
2012-07,ירושלים,1137,קריית יערים,יישוב,46,18,28,5,41,20,45,1,3.92%
2012-07,תל אביב,2400,אור יהודה,יישוב,972,442,530,43,929,287,955,71,5.25%
2012-07,תל אביב,565,אזור,יישוב,198,90,108,20,178,36,197,11,3.23%
2012-07,תל אביב,6100,בני ברק,יישוב,2806,1195,1611,119,2687,1346,2798,68,5.47%
2012-07,תל אביב,6200,בת ים,יישוב,3752,1778,1974,512,3240,1345,3687,327,5.19%
2012-07,תל אביב,6300,גבעתיים,יישוב,796,343,453,297,499,101,785,46,2.78%
2012-07,תל אביב,6400,הרצלייה,יישוב,1326,624,702,326,1000,63,1312,306,2.83%
2012-07,תל אביב,6600,חולון,יישוב,3498,1586,1912,509,2989,928,3457,208,3.61%
2012-07,תל אביב,2620,קריית אונו,יישוב,445,191,254,142,303,45,443,12,2.57%
2012-07,תל אביב,8600,רמת גן,יישוב,2392,1086,1306,669,1723,477,2378,141,3.22%
2012-07,תל אביב,2650,רמת השרון,יישוב,518,230,288,186,332,7,515,90,2.42%
2012-07,תל אביב,5000,תל אביב -יפו,יישוב,8696,4323,4373,2629,6067,2681,8646,420,3.61%
2012-08,אזור יהודה והשומרון,3760,אורנית,יישוב,105,43,62,33,72,6,105,4,2.52%
2012-08,אזור יהודה והשומרון,3750,אלפי מנשה,יישוב,107,60,47,23,84,2,107,8,2.57%
2012-08,אזור יהודה והשומרון,3560,אלקנה,יישוב,38,23,15,17,21,2,37,0,2.07%
2012-08,אזור יהודה והשומרון,3650,אפרת,יישוב,58,25,33,27,31,8,57,5,1.50%
2012-08,אזור יהודה והשומרון,3570,אריאל,יישוב,471,242,229,118,353,102,471,20,4.58%
2012-08,אזור יהודה והשומרון,3574,בית אל,יישוב,71,40,31,16,55,21,70,4,3.04%
2012-08,אזור יהודה והשומרון,3652,בית אריה,יישוב,60,24,36,9,51,4,60,1,2.64%
2012-08,אזור יהודה והשומרון,3780,ביתר עילית,יישוב,590,241,349,18,572,212,587,3,5.68%
2012-08,אזור יהודה והשומרון,3730,גבעת זאב,יישוב,191,88,103,29,162,33,191,11,2.83%
2012-08,אזור יהודה והשומרון,3769,הר אדר,יישוב,30,15,15,14,16,2,30,1,1.59%
2012-08,אזור יהודה והשומרון,3797,מודיעין עילית,יישוב,732,168,564,28,704,124,729,40,5.82%
2012-08,אזור יהודה והשומרון,3616,מעלה אדומים,יישוב,663,246,417,95,568,183,654,65,3.40%
2012-08,אזור יהודה והשומרון,3660,עמנואל,יישוב,104,48,56,3,101,61,104,2,9.70%
2012-08,אזור יהודה והשומרון,3557,קדומים,יישוב,43,19,24,15,28,8,42,3,2.43%
2012-08,אזור יהודה והשומרון,3611,קריית ארבע,יישוב,136,68,68,18,118,59,136,24,4.58%
2012-08,אזור יהודה והשומרון,3640,קרני שומרון,יישוב,108,55,53,32,76,18,108,4,3.09%
2012-08,הדרום,31,אופקים,יישוב,1590,631,959,119,1471,995,1577,38,12.67%
2012-08,הדרום,2600,אילת,יישוב,1405,607,798,70,1335,585,1387,89,4.30%
2012-08,הדרום,70,אשדוד,יישוב,8133,3203,4930,927,7206,3813,8084,422,7.69%
2012-08,הדרום,7100,אשקלון,יישוב,4789,1862,2927,727,4062,2610,4680,188,7.31%
2012-08,הדרום,9000,באר שבע,יישוב,7866,3362,4504,1033,6833,4785,7812,631,7.88%
2012-08,הדרום,2200,דימונה,יישוב,2264,893,1371,153,2111,1520,2240,71,12.63%
2012-08,הדרום,1303,חורה,יישוב,744,310,434,1,743,689,744,11,20.84%
2012-08,הדרום,831,ירוחם,יישוב,510,235,275,24,486,296,508,37,11.87%
2012-08,הדרום,1059,כסיפה,יישוב,1013,429,584,5,1008,875,1012,40,24.22%
2012-08,הדרום,1271,להבים,יישוב,47,20,27,20,27,3,47,8,1.44%
2012-08,הדרום,1060,לקיה,יישוב,986,411,575,7,979,889,984,25,27.17%
2012-08,הדרום,1268,מיתר,יישוב,79,36,43,34,45,9,79,19,2.01%
2012-08,הדרום,99,מצפה רמון,יישוב,255,102,153,17,238,136,239,31,9.93%
2012-08,הדרום,246,נתיבות,יישוב,1208,477,731,67,1141,572,1201,98,9.27%
2012-08,הדרום,666,עומר,יישוב,65,19,46,24,41,5,65,10,1.71%
2012-08,הדרום,2560,ערד,יישוב,888,385,503,166,722,461,863,115,7.07%
2012-08,הדרום,1192,ערערה-בנגב,יישוב,999,424,575,3,996,920,997,5,26.34%
2012-08,הדרום,2630,קריית גת,יישוב,2544,1023,1521,215,2329,1585,2539,57,9.51%
2012-08,הדרום,1034,קריית מלאכי,יישוב,1318,581,737,40,1278,805,1299,123,11.33%
2012-08,הדרום,1161,רהט,יישוב,3167,1279,1888,10,3157,2720,3165,32,18.95%
2012-08,הדרום,1286,שגב-שלום,יישוב,500,180,320,0,500,457,499,15,20.55%
2012-08,הדרום,1031,שדרות,יישוב,1213,477,736,73,1140,704,1208,43,9.97%
2012-08,הדרום,1054,תל שבע,יישוב,1153,534,619,2,1151,1079,1153,27,26.28%
2012-08,המרכז,182,אבן יהודה,יישוב,153,73,80,49,104,17,153,5,2.42%
2012-08,המרכז,41,אליכין,יישוב,79,36,43,10,69,18,79,3,4.49%
2012-08,המרכז,1309,אלעד,יישוב,572,199,373,18,554,119,569,72,4.96%
2012-08,המרכז,2530,באר יעקב,יישוב,256,92,164,50,206,69,251,17,3.08%
2012-08,המרכז,466,בית דגן,יישוב,101,60,41,23,78,36,101,5,2.95%
2012-08,המרכז,1066,"בני עי""ש",יישוב,214,94,120,30,184,68,212,1,5.36%
2012-08,המרכז,681,גבעת שמואל,יישוב,306,157,149,123,183,56,304,11,2.74%
2012-08,המרכז,2550,גדרה,יישוב,420,190,230,82,338,102,413,2,3.83%
2012-08,המרכז,627,ג'לג'וליה,יישוב,93,45,48,2,91,50,93,4,3.05%
2012-08,המרכז,166,גן יבנה,יישוב,477,170,307,47,430,96,474,21,4.53%
2012-08,המרכז,229,גני תקווה,יישוב,191,92,99,55,136,24,191,12,2.53%
2012-08,המרכז,9700,הוד השרון,יישוב,703,333,370,267,436,72,702,33,2.65%
2012-08,המרכז,1290,זמר,יישוב,151,47,104,7,144,116,151,2,5.64%
2012-08,המרכז,2730,טייבה,יישוב,2193,906,1287,4,2189,1867,2188,19,13.74%
2012-08,המרכז,2720,טירה,יישוב,331,161,170,12,319,180,330,5,3.27%
2012-08,המרכז,2660,יבנה,יישוב,959,462,497,88,871,374,957,63,4.82%
2012-08,המרכז,9400,יהוד,יישוב,550,216,334,87,463,65,539,17,3.58%
2012-08,המרכז,1224,כוכב יאיר,יישוב,85,31,54,30,55,3,85,3,1.57%
2012-08,המרכז,633,כפר ברא,יישוב,27,14,13,1,26,13,27,2,2.25%
2012-08,המרכז,168,כפר יונה,יישוב,364,155,209,72,292,60,363,15,3.65%
2012-08,המרכז,6900,כפר סבא,יישוב,1337,553,784,416,921,198,1332,60,2.74%
2012-08,המרכז,634,כפר קאסם,יישוב,256,97,159,6,250,123,256,38,3.26%
2012-08,המרכז,7000,לוד,יישוב,2457,1080,1377,201,2256,1287,2441,182,7.11%
2012-08,המרכז,1200,מודיעין-מכבים-רעות*,יישוב,1087,429,658,378,709,68,1081,99,2.71%
2012-08,המרכז,28,מזכרת בתיה,יישוב,196,87,109,43,153,37,192,1,3.13%
2012-08,המרכז,7200,נס ציונה,יישוב,761,322,439,152,609,196,755,5,3.52%
2012-08,המרכז,7400,נתניה,יישוב,4796,2022,2774,680,4116,1637,4767,185,4.84%
2012-08,המרכז,587,סביון*,יישוב,20,8,12,12,8,0,20,0,1.13%
2012-08,המרכז,171,פרדסייה,יישוב,77,36,41,22,55,6,77,5,2.23%
2012-08,המרכז,7900,פתח תקווה,יישוב,4528,1939,2589,914,3614,1133,4500,256,3.94%
2012-08,המרכז,195,קדימה-צורן,יישוב,252,96,156,83,169,34,252,11,2.74%
2012-08,המרכז,638,קלנסווה,יישוב,903,330,573,3,900,762,899,12,11.49%
2012-08,המרכז,469,קריית עקרון,יישוב,333,160,173,20,313,119,329,3,5.65%
2012-08,המרכז,2640,ראש העין,יישוב,914,398,516,115,799,170,903,38,4.21%
2012-08,המרכז,8300,ראשון לציון,יישוב,4799,2088,2711,1034,3765,1562,4791,244,3.66%
2012-08,המרכז,8400,רחובות,יישוב,2944,1200,1744,555,2389,1051,2887,24,4.67%
2012-08,המרכז,8500,רמלה,יישוב,1970,928,1042,117,1853,844,1935,142,5.63%
2012-08,המרכז,8700,רעננה,יישוב,878,416,462,349,529,86,878,31,2.44%
2012-08,המרכז,1304,שוהם,יישוב,224,93,131,87,137,8,224,17,2.21%
2012-08,המרכז,154,תל מונד,יישוב,151,65,86,60,91,22,151,4,2.68%
2012-08,הצפון,473,אבו סנאן,יישוב,745,295,450,6,739,630,741,16,13.98%
2012-08,הצפון,478,אכסאל,יישוב,543,230,313,18,525,459,542,3,10.68%
2012-08,הצפון,529,אעבלין,יישוב,627,242,385,9,618,520,627,11,12.12%
2012-08,הצפון,482,בועיינה-נוג'ידאת,יישוב,439,173,266,9,430,380,435,9,12.53%
2012-08,הצפון,4001,בוקעאתא,יישוב,387,139,248,8,379,336,380,0,14.75%
2012-08,הצפון,998,ביר אל-מכסור,יישוב,409,150,259,5,404,332,409,12,12.72%
2012-08,הצפון,480,בית ג'ן,יישוב,361,124,237,6,355,259,354,2,7.33%
2012-08,הצפון,9200,בית שאן,יישוב,968,409,559,25,943,470,965,83,9.99%
2012-08,הצפון,944,בסמת טבעון,יישוב,203,76,127,3,200,171,202,10,7.16%
2012-08,הצפון,483,בענה,יישוב,420,153,267,4,416,354,420,4,13.65%
2012-08,הצפון,1292,ג'דיידה-מכר,יישוב,1511,609,902,6,1505,1318,1508,33,17.99%
2012-08,הצפון,485,ג'ולס,יישוב,239,56,183,2,237,155,239,17,9.05%
2012-08,הצפון,487,ג'ש (גוש חלב),יישוב,59,21,38,5,54,27,58,3,3.87%
2012-08,הצפון,489,דבורייה,יישוב,413,176,237,20,393,314,413,4,10.58%
2012-08,הצפון,490,דייר אל-אסד,יישוב,425,170,255,10,415,315,425,9,9.19%
2012-08,הצפון,492,דייר חנא,יישוב,635,258,377,13,622,506,635,16,14.57%
2012-08,הצפון,975,זרזיר,יישוב,302,142,160,6,296,199,299,8,11.17%
2012-08,הצפון,496,חורפיש,יישוב,117,46,71,7,110,70,116,4,4.75%
2012-08,הצפון,2034,חצור הגלילית,יישוב,286,128,158,14,272,131,281,9,6.16%
2012-08,הצפון,6700,טבריה,יישוב,2035,850,1185,124,1911,1258,1892,68,9.00%
2012-08,הצפון,962,טובא-זנגרייה,יישוב,388,179,209,8,380,272,384,1,13.35%
2012-08,הצפון,498,טורעאן,יישוב,597,215,382,9,588,483,588,24,11.57%
2012-08,הצפון,8900,טמרה,יישוב,2006,770,1236,17,1989,1753,2004,42,15.54%
2012-08,הצפון,1295,יאנוח-ג'ת,יישוב,157,57,100,6,151,104,157,6,6.39%
2012-08,הצפון,46,יבנאל,יישוב,163,98,65,7,156,111,152,1,9.98%
2012-08,הצפון,499,יפיע,יישוב,636,263,373,12,624,489,631,9,8.95%
2012-08,הצפון,240,יקנעם עילית,יישוב,578,242,336,95,483,179,577,42,5.19%
2012-08,הצפון,502,ירכא,יישוב,547,211,336,2,545,440,547,11,10.11%
2012-08,הצפון,504,כאבול,יישוב,703,263,440,11,692,611,700,10,15.40%
2012-08,הצפון,505,כאוכב אבו אל-היג'א,יישוב,223,100,123,6,217,183,223,7,14.15%
2012-08,הצפון,1296,כסרא-סמיע,יישוב,205,87,118,1,204,152,204,12,6.78%
2012-08,הצפון,978,כעביה-טבאש-חג'אג'רה,יישוב,192,80,112,1,191,149,192,2,9.75%
2012-08,הצפון,1263,כפר ורדים,יישוב,99,36,63,31,68,9,99,0,3.25%
2012-08,הצפון,507,כפר יאסיף,יישוב,521,205,316,6,515,417,521,17,10.93%
2012-08,הצפון,508,כפר כמא,יישוב,66,26,40,1,65,36,65,2,4.32%
2012-08,הצפון,509,כפר כנא,יישוב,1215,458,757,34,1181,1058,1201,39,14.98%
2012-08,הצפון,510,כפר מנדא,יישוב,939,399,540,12,927,726,931,17,13.94%
2012-08,הצפון,47,כפר תבור,יישוב,50,17,33,16,34,7,50,1,2.69%
2012-08,הצפון,1139,כרמיאל,יישוב,1839,749,1090,376,1463,893,1782,71,7.03%
2012-08,הצפון,481,מגאר,יישוב,1518,602,916,23,1495,1316,1515,23,17.86%
2012-08,הצפון,516,מג'ד אל-כרום,יישוב,565,237,328,5,560,441,565,7,9.62%
2012-08,הצפון,874,מגדל העמק,יישוב,1103,431,672,99,1004,492,1066,79,8.17%
2012-08,הצפון,4201,מג'דל שמס,יישוב,460,167,293,14,446,399,452,1,10.19%
2012-08,הצפון,517,מזרעה,יישוב,176,62,114,4,172,148,175,2,9.52%
2012-08,הצפון,4203,מסעדה,יישוב,176,60,116,5,171,149,175,0,11.21%
2012-08,הצפון,518,מעיליא,יישוב,46,22,24,4,42,19,46,2,3.11%
2012-08,הצפון,1063,מעלות-תרשיחא,יישוב,989,446,543,135,854,546,986,54,8.37%
2012-08,הצפון,520,משהד,יישוב,310,117,193,3,307,257,306,5,10.30%
2012-08,הצפון,9100,נהרייה,יישוב,2084,931,1153,251,1833,1257,2077,79,7.15%
2012-08,הצפון,522,נחף,יישוב,409,181,228,8,401,321,409,8,8.99%
2012-08,הצפון,7300,נצרת,יישוב,3098,1284,1814,111,2987,2360,3081,41,9.94%
2012-08,הצפון,1061,נצרת עילית,יישוב,2054,861,1193,294,1760,1058,1961,109,8.49%
2012-08,הצפון,525,סאג'ור,יישוב,130,49,81,1,129,85,129,1,7.64%
2012-08,הצפון,7500,סח'נין,יישוב,2036,880,1156,39,1997,1737,2032,44,16.02%
2012-08,הצפון,4501,ע'ג'ר,יישוב,65,24,41,1,64,53,65,3,7.00%
2012-08,הצפון,530,עיילבון,יישוב,205,80,125,4,201,139,204,2,8.21%
2012-08,הצפון,511,עילוט,יישוב,317,122,195,3,314,253,316,2,12.27%
2012-08,הצפון,532,עין מאהל,יישוב,584,258,326,4,580,512,577,0,13.03%
2012-08,הצפון,7600,עכו,יישוב,3341,1483,1858,169,3172,2503,3315,125,12.94%
2012-08,הצפון,7700,עפולה,יישוב,1853,775,1078,204,1649,839,1803,88,7.69%
2012-08,הצפון,531,עראבה,יישוב,1404,571,833,26,1378,1249,1403,23,15.42%
2012-08,הצפון,535,פסוטה,יישוב,124,52,72,8,116,79,124,3,7.79%
2012-08,הצפון,536,פקיעין (בוקייעה),יישוב,122,68,54,6,116,72,121,3,4.72%
2012-08,הצפון,8000,צפת,יישוב,1357,679,678,80,1277,988,1344,52,10.64%
2012-08,הצפון,4100,קצרין,יישוב,188,87,101,30,158,80,186,13,4.89%
2012-08,הצפון,2800,קריית שמונה,יישוב,720,311,409,64,656,259,702,57,5.57%
2012-08,הצפון,543,ראמה,יישוב,309,116,193,8,301,237,309,1,8.68%
2012-08,הצפון,26,ראש פינה,יישוב,57,18,39,12,45,19,56,1,3.73%
2012-08,הצפון,542,ריינה,יישוב,648,253,395,16,632,529,645,9,10.46%
2012-08,הצפון,122,רמת ישי,יישוב,105,32,73,35,70,14,105,3,2.69%
2012-08,הצפון,913,שבלי - אום אל-גנם,יישוב,239,108,131,10,229,166,237,2,9.93%
2012-08,הצפון,812,שלומי,יישוב,262,101,161,21,241,147,261,9,7.47%
2012-08,הצפון,538,שעב,יישוב,477,187,290,4,473,432,477,10,17.10%
2012-08,הצפון,8800,שפרעם,יישוב,2019,757,1262,44,1975,1693,2011,62,12.33%
2012-08,חיפה,2710,אום אל-פחם,יישוב,3782,1527,2255,14,3768,3225,3776,45,20.10%
2012-08,חיפה,1020,אור עקיבא,יישוב,639,273,366,56,583,232,632,53,6.60%
2012-08,חיפה,6000,באקה אל-גרביה,יישוב,666,306,360,16,650,455,664,19,6.51%
2012-08,חיפה,9800,בנימינה-גבעת עדה*,יישוב,193,75,118,45,148,56,191,8,2.96%
2012-08,חיפה,1326,"בסמ""ה",יישוב,425,193,232,2,423,340,425,6,12.08%
2012-08,חיפה,541,ג'סר א-זרקא,יישוב,432,226,206,1,431,278,430,7,7.79%
2012-08,חיפה,628,ג'ת,יישוב,200,93,107,10,190,123,199,9,4.40%
2012-08,חיפה,494,דאלית אל-כרמל,יישוב,530,201,329,10,520,307,525,15,7.17%
2012-08,חיפה,9300,זכרון יעקב,יישוב,268,124,144,88,180,52,264,8,2.70%
2012-08,חיפה,6500,חדרה,יישוב,2632,1027,1605,334,2298,1002,2602,78,5.68%
2012-08,חיפה,4000,חיפה,יישוב,6980,3246,3734,1274,5706,4156,6951,421,5.12%
2012-08,חיפה,1247,חריש,יישוב,34,16,18,4,30,6,33,0,1.85%
2012-08,חיפה,2100,טירת כרמל,יישוב,760,344,416,34,726,469,753,55,7.47%
2012-08,חיפה,654,כפר קרע,יישוב,345,143,202,8,337,225,343,8,4.57%
2012-08,חיפה,1327,מעלה עירון,יישוב,958,375,583,2,956,790,958,15,18.23%
2012-08,חיפה,2500,נשר,יישוב,501,220,281,101,400,233,498,34,3.99%
2012-08,חיפה,534,עספיא,יישוב,350,134,216,10,340,188,349,9,6.92%
2012-08,חיפה,637,ערערה,יישוב,588,228,360,10,578,392,588,18,8.08%
2012-08,חיפה,537,פוריידיס,יישוב,374,157,217,4,370,258,373,7,7.41%
2012-08,חיפה,7800,פרדס חנה-כרכור,יישוב,913,390,523,154,759,295,909,61,5.03%
2012-08,חיפה,6800,קריית אתא,יישוב,1838,741,1097,166,1672,1012,1834,52,6.45%
2012-08,חיפה,9500,קריית ביאליק,יישוב,1181,479,702,153,1028,653,1177,40,5.68%
2012-08,חיפה,2300,קריית טבעון,יישוב,189,91,98,61,128,51,187,5,2.36%
2012-08,חיפה,9600,קריית ים,יישוב,1661,737,924,183,1478,1048,1655,56,7.90%
2012-08,חיפה,8200,קריית מוצקין,יישוב,1125,484,641,171,954,559,1116,55,5.12%
2012-08,חיפה,922,רכסים,יישוב,168,67,101,4,164,74,167,5,5.40%
2012-08,ירושלים,472,אבו גוש,יישוב,270,133,137,9,261,188,270,1,9.85%
2012-08,ירושלים,2610,בית שמש,יישוב,1449,573,876,130,1319,613,1442,92,5.12%
2012-08,ירושלים,3000,ירושלים,יישוב,11400,4905,6495,1285,10115,6463,11337,355,4.17%
2012-08,ירושלים,1015,מבשרת ציון,יישוב,420,190,230,70,350,171,419,19,3.37%
2012-08,ירושלים,1137,קריית יערים,יישוב,42,18,24,4,38,20,42,1,3.67%
2012-08,תל אביב,2400,אור יהודה,יישוב,971,386,585,41,930,297,955,42,5.25%
2012-08,תל אביב,565,אזור,יישוב,180,79,101,26,154,33,180,12,2.96%
2012-08,תל אביב,6100,בני ברק,יישוב,2969,1195,1774,118,2851,1374,2956,199,5.76%
2012-08,תל אביב,6200,בת ים,יישוב,3385,1587,1798,500,2885,1340,3338,301,4.72%
2012-08,תל אביב,6300,גבעתיים,יישוב,771,330,441,311,460,103,759,47,2.69%
2012-08,תל אביב,6400,הרצלייה,יישוב,1119,466,653,336,783,59,1105,161,2.39%
2012-08,תל אביב,6600,חולון,יישוב,3220,1454,1766,516,2704,931,3162,232,3.31%
2012-08,תל אביב,2620,קריית אונו,יישוב,415,185,230,147,268,47,411,10,2.39%
2012-08,תל אביב,8600,רמת גן,יישוב,2177,968,1209,670,1507,467,2158,147,2.93%
2012-08,תל אביב,2650,רמת השרון,יישוב,452,193,259,201,251,11,446,44,2.10%
2012-08,תל אביב,5000,תל אביב -יפו,יישוב,8305,4079,4226,2629,5676,2656,8255,446,3.45%
2012-09,אזור יהודה והשומרון,3760,אורנית,יישוב,104,45,59,35,69,4,104,5,2.50%
2012-09,אזור יהודה והשומרון,3750,אלפי מנשה,יישוב,99,47,52,28,71,1,99,1,2.39%
2012-09,אזור יהודה והשומרון,3560,אלקנה,יישוב,30,18,12,14,16,2,29,0,1.63%
2012-09,אזור יהודה והשומרון,3650,אפרת,יישוב,49,25,24,22,27,8,49,2,1.29%
2012-09,אזור יהודה והשומרון,3570,אריאל,יישוב,432,219,213,108,324,100,431,11,4.21%
2012-09,אזור יהודה והשומרון,3574,בית אל,יישוב,56,24,32,14,42,21,55,4,2.41%
2012-09,אזור יהודה והשומרון,3652,בית אריה,יישוב,55,20,35,5,50,4,55,1,2.43%
2012-09,אזור יהודה והשומרון,3780,ביתר עילית,יישוב,458,207,251,18,440,207,456,2,4.47%
2012-09,אזור יהודה והשומרון,3730,גבעת זאב,יישוב,169,76,93,23,146,38,168,13,2.50%
2012-09,אזור יהודה והשומרון,3769,הר אדר,יישוב,36,16,20,15,21,7,35,2,1.85%
2012-09,אזור יהודה והשומרון,3797,מודיעין עילית,יישוב,380,133,247,23,357,118,377,43,3.10%
2012-09,אזור יהודה והשומרון,3616,מעלה אדומים,יישוב,600,231,369,93,507,186,595,32,3.11%
2012-09,אזור יהודה והשומרון,3660,עמנואל,יישוב,74,35,39,5,69,60,74,0,7.10%
2012-09,אזור יהודה והשומרון,3557,קדומים,יישוב,30,11,19,9,21,8,30,1,1.75%
2012-09,אזור יהודה והשומרון,3611,קריית ארבע,יישוב,115,57,58,17,98,59,115,5,3.90%
2012-09,אזור יהודה והשומרון,3640,קרני שומרון,יישוב,101,51,50,33,68,16,100,5,2.87%
2012-09,הדרום,31,אופקים,יישוב,1465,609,856,113,1352,983,1455,20,11.81%
2012-09,הדרום,2600,אילת,יישוב,1266,573,693,63,1203,576,1252,61,3.90%
2012-09,הדרום,70,אשדוד,יישוב,6924,2727,4197,870,6054,3799,6872,210,6.61%
2012-09,הדרום,7100,אשקלון,יישוב,4346,1710,2636,688,3658,2556,4254,87,6.69%
2012-09,הדרום,9000,באר שבע,יישוב,7202,3089,4113,1003,6199,4591,7169,309,7.27%
2012-09,הדרום,2200,דימונה,יישוב,2079,827,1252,139,1940,1476,2060,39,11.73%
2012-09,הדרום,1303,חורה,יישוב,737,313,424,0,737,681,737,3,20.68%
2012-09,הדרום,831,ירוחם,יישוב,461,211,250,20,441,290,459,23,10.85%
2012-09,הדרום,1059,כסיפה,יישוב,984,424,560,5,979,873,981,33,23.66%
2012-09,הדרום,1271,להבים,יישוב,48,23,25,21,27,3,48,5,1.47%
2012-09,הדרום,1060,לקיה,יישוב,955,417,538,5,950,884,953,8,26.55%
2012-09,הדרום,1268,מיתר,יישוב,60,29,31,28,32,6,60,7,1.54%
2012-09,הדרום,99,מצפה רמון,יישוב,249,107,142,15,234,136,238,12,9.89%
2012-09,הדרום,246,נתיבות,יישוב,1051,442,609,62,989,541,1049,48,8.20%
2012-09,הדרום,666,עומר,יישוב,53,18,35,24,29,5,53,3,1.40%
2012-09,הדרום,2560,ערד,יישוב,785,346,439,145,640,434,773,45,6.38%
2012-09,הדרום,1192,ערערה-בנגב,יישוב,949,407,542,5,944,883,948,20,25.37%
2012-09,הדרום,2630,קריית גת,יישוב,2336,933,1403,199,2137,1531,2326,27,8.78%
2012-09,הדרום,1034,קריית מלאכי,יישוב,1242,525,717,39,1203,791,1224,58,10.75%
2012-09,הדרום,1161,רהט,יישוב,3041,1241,1800,9,3032,2717,3038,37,18.33%
2012-09,הדרום,1286,שגב-שלום,יישוב,517,191,326,0,517,463,516,19,21.10%
2012-09,הדרום,1031,שדרות,יישוב,1132,443,689,63,1069,697,1126,27,9.36%
2012-09,הדרום,1054,תל שבע,יישוב,1144,532,612,2,1142,1081,1144,15,26.13%
2012-09,המרכז,182,אבן יהודה,יישוב,153,70,83,51,102,19,153,3,2.42%
2012-09,המרכז,41,אליכין,יישוב,76,33,43,7,69,18,76,2,4.33%
2012-09,המרכז,1309,אלעד,יישוב,415,164,251,19,396,117,414,12,3.66%
2012-09,המרכז,2530,באר יעקב,יישוב,228,92,136,45,183,66,221,12,2.72%
2012-09,המרכז,466,בית דגן,יישוב,106,56,50,23,83,37,106,1,3.09%
2012-09,המרכז,1066,"בני עי""ש",יישוב,210,92,118,31,179,73,208,0,5.27%
2012-09,המרכז,681,גבעת שמואל,יישוב,286,149,137,119,167,55,285,8,2.57%
2012-09,המרכז,2550,גדרה,יישוב,375,169,206,76,299,103,366,1,3.41%
2012-09,המרכז,627,ג'לג'וליה,יישוב,86,36,50,3,83,51,85,3,2.80%
2012-09,המרכז,166,גן יבנה,יישוב,356,129,227,40,316,91,353,10,3.41%
2012-09,המרכז,229,גני תקווה,יישוב,176,80,96,57,119,25,175,4,2.32%
2012-09,המרכז,9700,הוד השרון,יישוב,638,291,347,256,382,64,636,7,2.41%
2012-09,המרכז,1290,זמר,יישוב,152,44,108,7,145,118,152,1,5.68%
2012-09,המרכז,2730,טייבה,יישוב,2146,892,1254,6,2140,1854,2133,6,13.44%
2012-09,המרכז,2720,טירה,יישוב,337,168,169,9,328,176,337,10,3.34%
2012-09,המרכז,2660,יבנה,יישוב,809,396,413,82,727,358,806,44,4.09%
2012-09,המרכז,9400,יהוד,יישוב,515,200,315,87,428,69,508,18,3.38%
2012-09,המרכז,1224,כוכב יאיר,יישוב,73,29,44,36,37,4,72,1,1.33%
2012-09,המרכז,633,כפר ברא,יישוב,22,12,10,1,21,10,22,1,1.84%
2012-09,המרכז,168,כפר יונה,יישוב,323,146,177,67,256,64,322,4,3.25%
2012-09,המרכז,6900,כפר סבא,יישוב,1196,516,680,402,794,184,1191,24,2.46%
2012-09,המרכז,634,כפר קאסם,יישוב,213,95,118,0,213,125,213,5,2.73%
2012-09,המרכז,7000,לוד,יישוב,2213,977,1236,184,2029,1255,2203,175,6.46%
2012-09,המרכז,1200,מודיעין-מכבים-רעות*,יישוב,923,380,543,357,566,66,918,33,2.31%
2012-09,המרכז,28,מזכרת בתיה,יישוב,169,70,99,36,133,32,168,0,2.75%
2012-09,המרכז,7200,נס ציונה,יישוב,667,280,387,158,509,192,660,2,3.09%
2012-09,המרכז,7400,נתניה,יישוב,4232,1879,2353,654,3578,1598,4205,63,4.29%
2012-09,המרכז,587,סביון*,יישוב,19,6,13,13,6,0,19,0,1.07%
2012-09,המרכז,171,פרדסייה,יישוב,74,31,43,18,56,9,74,1,2.15%
2012-09,המרכז,7900,פתח תקווה,יישוב,4017,1784,2233,843,3174,1094,3991,190,3.51%
2012-09,המרכז,195,קדימה-צורן,יישוב,234,86,148,84,150,31,234,4,2.55%
2012-09,המרכז,638,קלנסווה,יישוב,883,323,560,3,880,760,879,3,11.27%
2012-09,המרכז,469,קריית עקרון,יישוב,311,155,156,22,289,126,310,3,5.34%
2012-09,המרכז,2640,ראש העין,יישוב,715,331,384,104,611,156,707,12,3.33%
2012-09,המרכז,8300,ראשון לציון,יישוב,4464,1956,2508,989,3475,1509,4459,172,3.41%
2012-09,המרכז,8400,רחובות,יישוב,2626,1101,1525,551,2075,1043,2568,8,4.18%
2012-09,המרכז,8500,רמלה,יישוב,1684,790,894,97,1587,795,1647,99,4.83%
2012-09,המרכז,8700,רעננה,יישוב,765,384,381,311,454,78,765,6,2.13%
2012-09,המרכז,1304,שוהם,יישוב,193,87,106,86,107,6,193,15,1.91%
2012-09,המרכז,154,תל מונד,יישוב,125,59,66,50,75,23,125,1,2.23%
2012-09,הצפון,473,אבו סנאן,יישוב,737,286,451,3,734,627,733,15,13.85%
2012-09,הצפון,478,אכסאל,יישוב,519,213,306,13,506,452,518,6,10.26%
2012-09,הצפון,529,אעבלין,יישוב,623,240,383,12,611,518,623,14,12.05%
2012-09,הצפון,482,בועיינה-נוג'ידאת,יישוב,421,166,255,6,415,369,416,7,12.05%
2012-09,הצפון,4001,בוקעאתא,יישוב,382,134,248,6,376,339,373,3,14.52%
2012-09,הצפון,998,ביר אל-מכסור,יישוב,391,142,249,2,389,324,390,8,12.20%
2012-09,הצפון,480,בית ג'ן,יישוב,331,107,224,10,321,247,328,2,6.83%
2012-09,הצפון,9200,בית שאן,יישוב,855,357,498,19,836,454,854,45,8.94%
2012-09,הצפון,944,בסמת טבעון,יישוב,207,78,129,3,204,171,206,9,7.29%
2012-09,הצפון,483,בענה,יישוב,403,152,251,4,399,350,403,10,13.17%
2012-09,הצפון,1292,ג'דיידה-מכר,יישוב,1485,599,886,6,1479,1301,1482,35,17.74%
2012-09,הצפון,485,ג'ולס,יישוב,239,59,180,2,237,157,239,5,9.05%
2012-09,הצפון,487,ג'ש (גוש חלב),יישוב,50,16,34,3,47,25,49,0,3.29%
2012-09,הצפון,489,דבורייה,יישוב,388,158,230,20,368,309,388,3,10.01%
2012-09,הצפון,490,דייר אל-אסד,יישוב,402,167,235,10,392,321,402,8,8.73%
2012-09,הצפון,492,דייר חנא,יישוב,632,261,371,10,622,505,632,9,14.51%
2012-09,הצפון,975,זרזיר,יישוב,310,145,165,3,307,213,307,11,11.44%
2012-09,הצפון,496,חורפיש,יישוב,110,38,72,8,102,72,110,9,4.52%
2012-09,הצפון,2034,חצור הגלילית,יישוב,258,110,148,15,243,133,252,4,5.56%
2012-09,הצפון,6700,טבריה,יישוב,1885,777,1108,121,1764,1217,1737,65,8.33%
2012-09,הצפון,962,טובא-זנגרייה,יישוב,396,178,218,7,389,274,392,5,13.59%
2012-09,הצפון,498,טורעאן,יישוב,550,208,342,9,541,482,540,15,10.72%
2012-09,הצפון,8900,טמרה,יישוב,1979,755,1224,16,1963,1730,1973,54,15.34%
2012-09,הצפון,1295,יאנוח-ג'ת,יישוב,161,50,111,4,157,108,161,3,6.54%
2012-09,הצפון,46,יבנאל,יישוב,130,82,48,6,124,98,120,2,8.05%
2012-09,הצפון,499,יפיע,יישוב,643,265,378,9,634,507,638,8,9.04%
2012-09,הצפון,240,יקנעם עילית,יישוב,504,206,298,86,418,175,503,25,4.56%
2012-09,הצפון,502,ירכא,יישוב,535,200,335,1,534,442,535,12,9.91%
2012-09,הצפון,504,כאבול,יישוב,699,262,437,10,689,608,695,15,15.31%
2012-09,הצפון,505,כאוכב אבו אל-היג'א,יישוב,217,97,120,4,213,179,217,4,13.82%
2012-09,הצפון,1296,כסרא-סמיע,יישוב,194,84,110,3,191,145,194,7,6.47%
2012-09,הצפון,978,כעביה-טבאש-חג'אג'רה,יישוב,178,67,111,1,177,140,177,1,9.06%
2012-09,הצפון,1263,כפר ורדים,יישוב,63,25,38,26,37,8,63,3,2.09%
2012-09,הצפון,507,כפר יאסיף,יישוב,512,203,309,5,507,411,512,10,10.76%
2012-09,הצפון,508,כפר כמא,יישוב,61,23,38,0,61,33,60,0,4.01%
2012-09,הצפון,509,כפר כנא,יישוב,1170,448,722,31,1139,1039,1154,29,14.48%
2012-09,הצפון,510,כפר מנדא,יישוב,929,394,535,12,917,738,917,20,13.75%
2012-09,הצפון,47,כפר תבור,יישוב,55,16,39,20,35,8,55,3,2.96%
2012-09,הצפון,1139,כרמיאל,יישוב,1706,681,1025,355,1351,892,1661,40,6.58%
2012-09,הצפון,481,מגאר,יישוב,1455,578,877,22,1433,1298,1451,17,17.23%
2012-09,הצפון,516,מג'ד אל-כרום,יישוב,539,230,309,6,533,441,539,10,9.22%
2012-09,הצפון,874,מגדל העמק,יישוב,975,377,598,88,887,472,947,42,7.33%
2012-09,הצפון,4201,מג'דל שמס,יישוב,461,168,293,13,448,405,451,3,10.17%
2012-09,הצפון,517,מזרעה,יישוב,177,66,111,6,171,150,176,4,9.57%
2012-09,הצפון,4203,מסעדה,יישוב,176,59,117,6,170,146,175,0,11.21%
2012-09,הצפון,518,מעיליא,יישוב,43,23,20,3,40,16,43,5,2.91%
2012-09,הצפון,1063,מעלות-תרשיחא,יישוב,894,409,485,127,767,526,892,35,7.63%
2012-09,הצפון,520,משהד,יישוב,306,111,195,7,299,258,301,4,10.15%
2012-09,הצפון,9100,נהרייה,יישוב,1990,878,1112,253,1737,1212,1980,53,6.84%
2012-09,הצפון,522,נחף,יישוב,405,179,226,8,397,327,404,6,8.88%
2012-09,הצפון,7300,נצרת,יישוב,3001,1242,1759,105,2896,2373,2986,40,9.66%
2012-09,הצפון,1061,נצרת עילית,יישוב,1870,768,1102,261,1609,1068,1778,73,7.75%
2012-09,הצפון,525,סאג'ור,יישוב,113,41,72,2,111,80,113,2,6.76%
2012-09,הצפון,7500,סח'נין,יישוב,2032,877,1155,38,1994,1753,2031,28,16.02%
2012-09,הצפון,4501,ע'ג'ר,יישוב,64,24,40,0,64,53,63,2,6.80%
2012-09,הצפון,530,עיילבון,יישוב,196,72,124,4,192,138,196,2,7.92%
2012-09,הצפון,511,עילוט,יישוב,300,121,179,3,297,250,299,4,11.68%
2012-09,הצפון,532,עין מאהל,יישוב,579,248,331,4,575,511,572,2,12.93%
2012-09,הצפון,7600,עכו,יישוב,3201,1436,1765,165,3036,2497,3165,77,12.42%
2012-09,הצפון,7700,עפולה,יישוב,1591,642,949,183,1408,813,1552,73,6.69%
2012-09,הצפון,531,עראבה,יישוב,1389,571,818,25,1364,1242,1388,14,15.28%
2012-09,הצפון,535,פסוטה,יישוב,122,55,67,6,116,80,122,0,7.68%
2012-09,הצפון,536,פקיעין (בוקייעה),יישוב,122,65,57,9,113,72,121,3,4.72%
2012-09,הצפון,8000,צפת,יישוב,1247,639,608,82,1165,973,1235,14,9.86%
2012-09,הצפון,4100,קצרין,יישוב,187,79,108,36,151,84,187,6,4.92%
2012-09,הצפון,2800,קריית שמונה,יישוב,658,285,373,65,593,251,643,49,5.12%
2012-09,הצפון,543,ראמה,יישוב,288,102,186,9,279,238,285,1,8.06%
2012-09,הצפון,26,ראש פינה,יישוב,43,14,29,7,36,18,43,0,2.89%
2012-09,הצפון,542,ריינה,יישוב,626,244,382,19,607,518,622,10,10.12%
2012-09,הצפון,122,רמת ישי,יישוב,104,36,68,33,71,15,104,1,2.66%
2012-09,הצפון,913,שבלי - אום אל-גנם,יישוב,222,93,129,8,214,161,221,5,9.32%
2012-09,הצפון,812,שלומי,יישוב,250,102,148,20,230,140,249,5,7.15%
2012-09,הצפון,538,שעב,יישוב,485,194,291,7,478,439,485,4,17.33%
2012-09,הצפון,8800,שפרעם,יישוב,1979,741,1238,37,1942,1676,1972,48,12.12%
2012-09,חיפה,2710,אום אל-פחם,יישוב,3741,1517,2224,15,3726,3226,3738,18,19.94%
2012-09,חיפה,1020,אור עקיבא,יישוב,539,242,297,47,492,215,534,16,5.64%
2012-09,חיפה,6000,באקה אל-גרביה,יישוב,655,293,362,19,636,445,653,17,6.41%
2012-09,חיפה,9800,בנימינה-גבעת עדה*,יישוב,191,71,120,54,137,53,190,0,2.95%
2012-09,חיפה,1326,"בסמ""ה",יישוב,421,186,235,3,418,338,421,1,11.98%
2012-09,חיפה,541,ג'סר א-זרקא,יישוב,431,223,208,1,430,273,428,2,7.76%
2012-09,חיפה,628,ג'ת,יישוב,195,83,112,12,183,119,194,6,4.29%
2012-09,חיפה,494,דאלית אל-כרמל,יישוב,509,195,314,12,497,298,505,3,6.92%
2012-09,חיפה,9300,זכרון יעקב,יישוב,246,109,137,93,153,45,243,4,2.49%
2012-09,חיפה,6500,חדרה,יישוב,2393,934,1459,317,2076,984,2366,36,5.19%
2012-09,חיפה,4000,חיפה,יישוב,6613,3052,3561,1208,5405,3987,6586,218,4.86%
2012-09,חיפה,1247,חריש,יישוב,32,13,19,4,28,5,31,1,1.74%
2012-09,חיפה,2100,טירת כרמל,יישוב,721,319,402,35,686,460,716,38,7.12%
2012-09,חיפה,654,כפר קרע,יישוב,350,147,203,5,345,235,348,4,4.63%
2012-09,חיפה,1327,מעלה עירון,יישוב,953,364,589,1,952,793,953,1,18.16%
2012-09,חיפה,2500,נשר,יישוב,492,211,281,89,403,235,490,19,3.93%
2012-09,חיפה,534,עספיא,יישוב,297,123,174,8,289,179,296,3,5.93%
2012-09,חיפה,637,ערערה,יישוב,569,226,343,6,563,395,568,20,7.83%
2012-09,חיפה,537,פוריידיס,יישוב,378,168,210,7,371,264,375,2,7.44%
2012-09,חיפה,7800,פרדס חנה-כרכור,יישוב,822,343,479,147,675,283,821,34,4.56%
2012-09,חיפה,6800,קריית אתא,יישוב,1633,698,935,154,1479,995,1626,39,5.76%
2012-09,חיפה,9500,קריית ביאליק,יישוב,1158,456,702,129,1029,644,1153,24,5.57%
2012-09,חיפה,2300,קריית טבעון,יישוב,172,87,85,56,116,53,170,3,2.15%
2012-09,חיפה,9600,קריית ים,יישוב,1539,710,829,172,1367,998,1535,41,7.37%
2012-09,חיפה,8200,קריית מוצקין,יישוב,1053,434,619,165,888,548,1047,26,4.82%
2012-09,חיפה,922,רכסים,יישוב,136,62,74,8,128,80,136,2,4.45%
2012-09,ירושלים,472,אבו גוש,יישוב,246,119,127,5,241,187,246,11,9.05%
2012-09,ירושלים,2610,בית שמש,יישוב,1222,515,707,117,1105,585,1216,134,4.35%
2012-09,ירושלים,3000,ירושלים,יישוב,10466,4595,5871,1226,9240,6414,10413,640,3.84%
2012-09,ירושלים,1015,מבשרת ציון,יישוב,374,165,209,69,305,169,372,20,3.00%
2012-09,ירושלים,1137,קריית יערים,יישוב,43,16,27,5,38,20,42,6,3.67%
2012-09,תל אביב,2400,אור יהודה,יישוב,797,325,472,40,757,290,785,46,4.36%
2012-09,תל אביב,565,אזור,יישוב,164,83,81,25,139,31,164,10,2.70%
2012-09,תל אביב,6100,בני ברק,יישוב,2441,1145,1296,122,2319,1338,2429,68,4.78%
2012-09,תל אביב,6200,בת ים,יישוב,3131,1453,1678,471,2660,1337,3076,170,4.37%
2012-09,תל אביב,6300,גבעתיים,יישוב,724,309,415,310,414,97,718,30,2.55%
2012-09,תל אביב,6400,הרצלייה,יישוב,969,412,557,305,664,60,962,135,2.09%
2012-09,תל אביב,6600,חולון,יישוב,2943,1353,1590,497,2446,905,2899,157,3.05%
2012-09,תל אביב,2620,קריית אונו,יישוב,382,170,212,142,240,45,378,9,2.20%
2012-09,תל אביב,8600,רמת גן,יישוב,2002,907,1095,641,1361,458,1987,109,2.70%
2012-09,תל אביב,2650,רמת השרון,יישוב,391,172,219,181,210,8,385,37,1.82%
2012-09,תל אביב,5000,תל אביב -יפו,יישוב,7774,3816,3958,2493,5281,2583,7731,268,3.24%
2012-10,אזור יהודה והשומרון,3760,אורנית,יישוב,102,47,55,38,64,3,102,3,2.45%
2012-10,אזור יהודה והשומרון,3750,אלפי מנשה,יישוב,102,50,52,33,69,2,102,2,2.46%
2012-10,אזור יהודה והשומרון,3560,אלקנה,יישוב,29,16,13,15,14,1,28,0,1.57%
2012-10,אזור יהודה והשומרון,3650,אפרת,יישוב,51,27,24,27,24,7,51,1,1.35%
2012-10,אזור יהודה והשומרון,3570,אריאל,יישוב,446,225,221,107,339,97,445,13,4.34%
2012-10,אזור יהודה והשומרון,3574,בית אל,יישוב,59,28,31,15,44,22,59,2,2.58%
2012-10,אזור יהודה והשומרון,3652,בית אריה,יישוב,50,20,30,4,46,4,50,0,2.21%
2012-10,אזור יהודה והשומרון,3780,ביתר עילית,יישוב,453,216,237,15,438,213,451,1,4.43%
2012-10,אזור יהודה והשומרון,3730,גבעת זאב,יישוב,169,82,87,24,145,38,169,9,2.51%
2012-10,אזור יהודה והשומרון,3769,הר אדר,יישוב,30,12,18,15,15,3,30,1,1.59%
2012-10,אזור יהודה והשומרון,3797,מודיעין עילית,יישוב,378,141,237,24,354,121,376,12,3.09%
2012-10,אזור יהודה והשומרון,3616,מעלה אדומים,יישוב,630,245,385,94,536,195,625,34,3.26%
2012-10,אזור יהודה והשומרון,3660,עמנואל,יישוב,81,38,43,5,76,61,81,1,7.72%
2012-10,אזור יהודה והשומרון,3557,קדומים,יישוב,34,15,19,9,25,7,33,0,1.92%
2012-10,אזור יהודה והשומרון,3611,קריית ארבע,יישוב,109,50,59,23,86,56,109,1,3.70%
2012-10,אזור יהודה והשומרון,3640,קרני שומרון,יישוב,91,45,46,29,62,15,91,2,2.62%
2012-10,הדרום,31,אופקים,יישוב,1469,610,859,105,1364,984,1458,26,11.83%
2012-10,הדרום,2600,אילת,יישוב,1300,580,720,64,1236,588,1285,35,4.00%
2012-10,הדרום,70,אשדוד,יישוב,7137,2828,4309,842,6295,3800,7085,239,6.80%
2012-10,הדרום,7100,אשקלון,יישוב,4504,1778,2726,700,3804,2599,4406,74,6.91%
2012-10,הדרום,9000,באר שבע,יישוב,7368,3240,4128,1018,6350,4612,7320,265,7.42%
2012-10,הדרום,2200,דימונה,יישוב,2159,876,1283,142,2017,1501,2135,45,12.11%
2012-10,הדרום,1303,חורה,יישוב,734,306,428,0,734,683,734,5,20.62%
2012-10,הדרום,831,ירוחם,יישוב,459,216,243,21,438,284,455,29,10.76%
2012-10,הדרום,1059,כסיפה,יישוב,957,404,553,5,952,870,956,4,23.19%
2012-10,הדרום,1271,להבים,יישוב,55,31,24,21,34,4,55,10,1.68%
2012-10,הדרום,1060,לקיה,יישוב,935,410,525,4,931,881,934,7,26.16%
2012-10,הדרום,1268,מיתר,יישוב,60,27,33,26,34,6,60,6,1.54%
2012-10,הדרום,99,מצפה רמון,יישוב,261,106,155,18,243,137,246,16,10.19%
2012-10,הדרום,246,נתיבות,יישוב,1099,470,629,61,1038,567,1094,40,8.52%
2012-10,הדרום,666,עומר,יישוב,57,18,39,26,31,4,57,5,1.50%
2012-10,הדרום,2560,ערד,יישוב,842,365,477,157,685,473,823,55,6.77%
2012-10,הדרום,1192,ערערה-בנגב,יישוב,938,404,534,4,934,877,937,4,25.15%
2012-10,הדרום,2630,קריית גת,יישוב,2431,1013,1418,201,2230,1545,2426,44,9.13%
2012-10,הדרום,1034,קריית מלאכי,יישוב,1299,582,717,40,1259,814,1274,113,11.14%
2012-10,הדרום,1161,רהט,יישוב,3056,1275,1781,10,3046,2739,3055,26,18.41%
2012-10,הדרום,1286,שגב-שלום,יישוב,493,175,318,0,493,454,492,2,20.32%
2012-10,הדרום,1031,שדרות,יישוב,1170,465,705,66,1104,708,1164,28,9.64%
2012-10,הדרום,1054,תל שבע,יישוב,1129,509,620,2,1127,1073,1128,6,25.86%
2012-10,המרכז,182,אבן יהודה,יישוב,164,67,97,57,107,26,163,2,2.58%
2012-10,המרכז,41,אליכין,יישוב,63,26,37,7,56,20,63,0,3.62%
2012-10,המרכז,1309,אלעד,יישוב,438,181,257,21,417,113,434,13,3.83%
2012-10,המרכז,2530,באר יעקב,יישוב,248,106,142,50,198,67,243,8,2.98%
2012-10,המרכז,466,בית דגן,יישוב,116,53,63,24,92,38,115,5,3.34%
2012-10,המרכז,1066,"בני עי""ש",יישוב,231,108,123,30,201,75,229,4,5.77%
2012-10,המרכז,681,גבעת שמואל,יישוב,306,158,148,125,181,58,303,9,2.73%
2012-10,המרכז,2550,גדרה,יישוב,377,168,209,73,304,106,369,5,3.44%
2012-10,המרכז,627,ג'לג'וליה,יישוב,87,38,49,2,85,52,86,2,2.83%
2012-10,המרכז,166,גן יבנה,יישוב,369,140,229,47,322,94,367,19,3.54%
2012-10,המרכז,229,גני תקווה,יישוב,181,86,95,58,123,27,180,6,2.39%
2012-10,המרכז,9700,הוד השרון,יישוב,687,326,361,270,417,68,681,4,2.58%
2012-10,המרכז,1290,זמר,יישוב,152,43,109,7,145,119,152,1,5.68%
2012-10,המרכז,2730,טייבה,יישוב,2124,888,1236,9,2115,1838,2117,4,13.35%
2012-10,המרכז,2720,טירה,יישוב,344,177,167,7,337,176,342,11,3.38%
2012-10,המרכז,2660,יבנה,יישוב,889,418,471,78,811,370,887,55,4.48%
2012-10,המרכז,9400,יהוד,יישוב,538,216,322,91,447,72,525,12,3.49%
2012-10,המרכז,1224,כוכב יאיר,יישוב,79,31,48,36,43,3,79,1,1.46%
2012-10,המרכז,633,כפר ברא,יישוב,21,11,10,0,21,11,21,0,1.76%
2012-10,המרכז,168,כפר יונה,יישוב,334,146,188,71,263,61,333,3,3.36%
2012-10,המרכז,6900,כפר סבא,יישוב,1247,538,709,390,857,190,1237,20,2.55%
2012-10,המרכז,634,כפר קאסם,יישוב,218,98,120,0,218,131,218,4,2.79%
2012-10,המרכז,7000,לוד,יישוב,2207,971,1236,171,2036,1253,2191,77,6.43%
2012-10,המרכז,1200,מודיעין-מכבים-רעות*,יישוב,933,385,548,347,586,64,924,44,2.32%
2012-10,המרכז,28,מזכרת בתיה,יישוב,176,67,109,34,142,43,174,1,2.85%
2012-10,המרכז,7200,נס ציונה,יישוב,693,295,398,160,533,196,687,5,3.21%
2012-10,המרכז,7400,נתניה,יישוב,4413,2001,2412,664,3749,1633,4390,78,4.47%
2012-10,המרכז,587,סביון*,יישוב,18,6,12,13,5,0,18,0,1.02%
2012-10,המרכז,171,פרדסייה,יישוב,84,32,52,21,63,6,84,0,2.43%
2012-10,המרכז,7900,פתח תקווה,יישוב,4225,1876,2349,864,3361,1107,4201,221,3.69%
2012-10,המרכז,195,קדימה-צורן,יישוב,248,94,154,75,173,37,248,0,2.70%
2012-10,המרכז,638,קלנסווה,יישוב,869,317,552,4,865,760,866,0,11.12%
2012-10,המרכז,469,קריית עקרון,יישוב,304,146,158,21,283,129,303,1,5.23%
2012-10,המרכז,2640,ראש העין,יישוב,770,366,404,104,666,156,765,31,3.59%
2012-10,המרכז,8300,ראשון לציון,יישוב,4649,2035,2614,1026,3623,1544,4637,200,3.55%
2012-10,המרכז,8400,רחובות,יישוב,2674,1146,1528,540,2134,1062,2616,13,4.25%
2012-10,המרכז,8500,רמלה,יישוב,1794,864,930,115,1679,810,1755,81,5.14%
2012-10,המרכז,8700,רעננה,יישוב,840,401,439,346,494,90,839,6,2.33%
2012-10,המרכז,1304,שוהם,יישוב,207,89,118,88,119,6,207,8,2.05%
2012-10,המרכז,154,תל מונד,יישוב,120,59,61,44,76,24,120,0,2.14%
2012-10,הצפון,473,אבו סנאן,יישוב,737,298,439,3,734,630,733,10,13.85%
2012-10,הצפון,478,אכסאל,יישוב,515,212,303,8,507,449,515,4,10.21%
2012-10,הצפון,529,אעבלין,יישוב,613,236,377,7,606,517,613,4,11.88%
2012-10,הצפון,482,בועיינה-נוג'ידאת,יישוב,404,168,236,3,401,363,396,24,11.54%
2012-10,הצפון,4001,בוקעאתא,יישוב,384,136,248,7,377,340,375,3,14.59%
2012-10,הצפון,998,ביר אל-מכסור,יישוב,386,135,251,1,385,330,386,2,12.09%
2012-10,הצפון,480,בית ג'ן,יישוב,331,105,226,9,322,238,329,6,6.85%
2012-10,הצפון,9200,בית שאן,יישוב,886,387,499,19,867,465,885,62,9.24%
2012-10,הצפון,944,בסמת טבעון,יישוב,202,78,124,0,202,173,201,3,7.12%
2012-10,הצפון,483,בענה,יישוב,398,151,247,2,396,346,398,5,13.03%
2012-10,הצפון,1292,ג'דיידה-מכר,יישוב,1472,599,873,6,1466,1296,1469,21,17.61%
2012-10,הצפון,485,ג'ולס,יישוב,239,59,180,2,237,154,239,6,9.05%
2012-10,הצפון,487,ג'ש (גוש חלב),יישוב,48,17,31,2,46,25,47,0,3.16%
2012-10,הצפון,489,דבורייה,יישוב,372,152,220,21,351,300,372,0,9.63%
2012-10,הצפון,490,דייר אל-אסד,יישוב,404,171,233,9,395,325,404,5,8.77%
2012-10,הצפון,492,דייר חנא,יישוב,611,247,364,8,603,499,611,6,14.10%
2012-10,הצפון,975,זרזיר,יישוב,307,137,170,3,304,216,305,4,11.37%
2012-10,הצפון,496,חורפיש,יישוב,119,41,78,8,111,77,119,4,4.87%
2012-10,הצפון,2034,חצור הגלילית,יישוב,297,130,167,17,280,143,292,2,6.39%
2012-10,הצפון,6700,טבריה,יישוב,1945,823,1122,125,1820,1203,1794,80,8.58%
2012-10,הצפון,962,טובא-זנגרייה,יישוב,369,170,199,7,362,273,365,2,12.78%
2012-10,הצפון,498,טורעאן,יישוב,567,217,350,10,557,484,563,25,11.13%
2012-10,הצפון,8900,טמרה,יישוב,1972,771,1201,15,1957,1738,1967,26,15.30%
2012-10,הצפון,1295,יאנוח-ג'ת,יישוב,155,49,106,2,153,115,155,6,6.31%
2012-10,הצפון,46,יבנאל,יישוב,142,93,49,8,134,99,129,0,8.60%
2012-10,הצפון,499,יפיע,יישוב,636,265,371,7,629,504,633,8,8.97%
2012-10,הצפון,240,יקנעם עילית,יישוב,537,224,313,90,447,184,536,21,4.84%
2012-10,הצפון,502,ירכא,יישוב,522,189,333,0,522,438,522,11,9.69%
2012-10,הצפון,504,כאבול,יישוב,671,256,415,6,665,598,669,3,14.82%
2012-10,הצפון,505,כאוכב אבו אל-היג'א,יישוב,214,92,122,4,210,179,214,2,13.66%
2012-10,הצפון,1296,כסרא-סמיע,יישוב,234,90,144,2,232,180,234,6,7.70%
2012-10,הצפון,978,כעביה-טבאש-חג'אג'רה,יישוב,183,71,112,3,180,144,182,1,9.29%
2012-10,הצפון,1263,כפר ורדים,יישוב,73,28,45,31,42,11,73,1,2.42%
2012-10,הצפון,507,כפר יאסיף,יישוב,515,209,306,7,508,416,515,10,10.82%
2012-10,הצפון,508,כפר כמא,יישוב,63,24,39,1,62,33,62,0,4.13%
2012-10,הצפון,509,כפר כנא,יישוב,1194,463,731,29,1165,1065,1178,40,14.73%
2012-10,הצפון,510,כפר מנדא,יישוב,910,392,518,10,900,734,903,13,13.57%
2012-10,הצפון,47,כפר תבור,יישוב,47,16,31,17,30,7,46,1,2.48%
2012-10,הצפון,1139,כרמיאל,יישוב,1748,691,1057,368,1380,890,1697,37,6.71%
2012-10,הצפון,481,מגאר,יישוב,1426,555,871,19,1407,1278,1423,15,16.96%
2012-10,הצפון,516,מג'ד אל-כרום,יישוב,528,225,303,8,520,431,528,2,9.05%
2012-10,הצפון,874,מגדל העמק,יישוב,1076,417,659,85,991,511,1043,58,8.01%
2012-10,הצפון,4201,מג'דל שמס,יישוב,452,165,287,12,440,394,446,3,10.07%
2012-10,הצפון,517,מזרעה,יישוב,164,58,106,6,158,139,163,2,8.92%
2012-10,הצפון,4203,מסעדה,יישוב,174,59,115,6,168,149,173,0,11.10%
2012-10,הצפון,518,מעיליא,יישוב,38,21,17,1,37,16,38,1,2.58%
2012-10,הצפון,1063,מעלות-תרשיחא,יישוב,903,414,489,128,775,534,896,32,7.66%
2012-10,הצפון,520,משהד,יישוב,304,117,187,8,296,264,303,3,10.21%
2012-10,הצפון,9100,נהרייה,יישוב,2097,919,1178,261,1836,1268,2084,67,7.17%
2012-10,הצפון,522,נחף,יישוב,395,176,219,5,390,327,395,11,8.70%
2012-10,הצפון,7300,נצרת,יישוב,2948,1217,1731,96,2852,2369,2938,34,9.52%
2012-10,הצפון,1061,נצרת עילית,יישוב,1991,858,1133,262,1729,1085,1893,85,8.22%
2012-10,הצפון,525,סאג'ור,יישוב,107,38,69,1,106,73,107,0,6.42%
2012-10,הצפון,7500,סח'נין,יישוב,1991,850,1141,28,1963,1732,1991,17,15.75%
2012-10,הצפון,4501,ע'ג'ר,יישוב,75,32,43,0,75,55,75,2,8.00%
2012-10,הצפון,530,עיילבון,יישוב,193,72,121,2,191,137,193,2,7.80%
2012-10,הצפון,511,עילוט,יישוב,299,116,183,2,297,249,299,3,11.68%
2012-10,הצפון,532,עין מאהל,יישוב,588,254,334,9,579,520,582,3,13.13%
2012-10,הצפון,7600,עכו,יישוב,3232,1474,1758,157,3075,2495,3205,83,12.56%
2012-10,הצפון,7700,עפולה,יישוב,1767,700,1067,206,1561,859,1722,66,7.37%
2012-10,הצפון,531,עראבה,יישוב,1363,555,808,28,1335,1236,1362,13,15.04%
2012-10,הצפון,535,פסוטה,יישוב,110,47,63,3,107,80,110,8,6.98%
2012-10,הצפון,536,פקיעין (בוקייעה),יישוב,124,62,62,5,119,83,122,2,4.75%
2012-10,הצפון,8000,צפת,יישוב,1313,672,641,89,1224,991,1300,14,10.33%
2012-10,הצפון,4100,קצרין,יישוב,194,86,108,38,156,79,193,5,5.07%
2012-10,הצפון,2800,קריית שמונה,יישוב,683,293,390,62,621,273,652,64,5.19%
2012-10,הצפון,543,ראמה,יישוב,295,110,185,10,285,237,295,0,8.32%
2012-10,הצפון,26,ראש פינה,יישוב,47,17,30,8,39,17,47,0,3.15%
2012-10,הצפון,542,ריינה,יישוב,661,271,390,14,647,548,657,9,10.63%
2012-10,הצפון,122,רמת ישי,יישוב,97,31,66,36,61,14,97,1,2.49%
2012-10,הצפון,913,שבלי - אום אל-גנם,יישוב,217,95,122,8,209,160,216,0,9.13%
2012-10,הצפון,812,שלומי,יישוב,263,109,154,20,243,147,262,8,7.50%
2012-10,הצפון,538,שעב,יישוב,484,195,289,4,480,440,484,2,17.30%
2012-10,הצפון,8800,שפרעם,יישוב,1987,750,1237,30,1957,1687,1981,34,12.17%
2012-10,חיפה,2710,אום אל-פחם,יישוב,3683,1484,2199,12,3671,3215,3679,9,19.69%
2012-10,חיפה,1020,אור עקיבא,יישוב,614,268,346,50,564,226,600,15,6.29%
2012-10,חיפה,6000,באקה אל-גרביה,יישוב,659,299,360,16,643,451,658,16,6.46%
2012-10,חיפה,9800,בנימינה-גבעת עדה*,יישוב,212,79,133,65,147,53,211,3,3.26%
2012-10,חיפה,1326,"בסמ""ה",יישוב,413,182,231,2,411,334,413,4,11.78%
2012-10,חיפה,541,ג'סר א-זרקא,יישוב,426,225,201,1,425,279,424,0,7.69%
2012-10,חיפה,628,ג'ת,יישוב,199,87,112,11,188,119,198,3,4.38%
2012-10,חיפה,494,דאלית אל-כרמל,יישוב,490,190,300,9,481,293,486,9,6.68%
2012-10,חיפה,9300,זכרון יעקב,יישוב,248,103,145,88,160,46,244,0,2.50%
2012-10,חיפה,6500,חדרה,יישוב,2454,977,1477,328,2126,1002,2418,42,5.30%
2012-10,חיפה,4000,חיפה,יישוב,6797,3182,3615,1194,5603,4002,6776,171,4.99%
2012-10,חיפה,1247,חריש,יישוב,33,12,21,6,27,4,33,1,1.85%
2012-10,חיפה,2100,טירת כרמל,יישוב,741,343,398,33,708,459,736,35,7.31%
2012-10,חיפה,654,כפר קרע,יישוב,354,146,208,3,351,233,353,12,4.69%
2012-10,חיפה,1327,מעלה עירון,יישוב,938,359,579,1,937,788,938,1,17.92%
2012-10,חיפה,2500,נשר,יישוב,494,206,288,89,405,241,493,17,3.95%
2012-10,חיפה,534,עספיא,יישוב,286,113,173,8,278,173,285,5,5.73%
2012-10,חיפה,637,ערערה,יישוב,563,229,334,4,559,393,563,13,7.77%
2012-10,חיפה,537,פוריידיס,יישוב,370,168,202,6,364,254,369,1,7.33%
2012-10,חיפה,7800,פרדס חנה-כרכור,יישוב,862,377,485,144,718,290,856,29,4.75%
2012-10,חיפה,6800,קריית אתא,יישוב,1682,721,961,173,1509,996,1676,46,5.93%
2012-10,חיפה,9500,קריית ביאליק,יישוב,1193,482,711,132,1061,639,1184,23,5.71%
2012-10,חיפה,2300,קריית טבעון,יישוב,182,92,90,56,126,52,180,6,2.28%
2012-10,חיפה,9600,קריית ים,יישוב,1550,729,821,162,1388,983,1549,51,7.43%
2012-10,חיפה,8200,קריית מוצקין,יישוב,1076,438,638,170,906,548,1072,31,4.93%
2012-10,חיפה,922,רכסים,יישוב,141,66,75,6,135,81,141,3,4.60%
2012-10,ירושלים,472,אבו גוש,יישוב,255,129,126,6,249,190,255,6,9.35%
2012-10,ירושלים,2610,בית שמש,יישוב,1262,543,719,112,1150,585,1256,43,4.49%
2012-10,ירושלים,3000,ירושלים,יישוב,10719,4698,6021,1264,9455,6534,10641,313,3.92%
2012-10,ירושלים,1015,מבשרת ציון,יישוב,399,183,216,68,331,187,398,6,3.21%
2012-10,ירושלים,1137,קריית יערים,יישוב,49,16,33,4,45,17,49,0,4.25%
2012-10,תל אביב,2400,אור יהודה,יישוב,867,366,501,43,824,288,853,43,4.72%
2012-10,תל אביב,565,אזור,יישוב,165,79,86,22,143,33,165,5,2.72%
2012-10,תל אביב,6100,בני ברק,יישוב,2446,1176,1270,121,2325,1344,2434,61,4.79%
2012-10,תל אביב,6200,בת ים,יישוב,3352,1565,1787,485,2867,1348,3288,171,4.65%
2012-10,תל אביב,6300,גבעתיים,יישוב,781,339,442,325,456,104,773,24,2.74%
2012-10,תל אביב,6400,הרצלייה,יישוב,1033,463,570,324,709,53,1022,105,2.22%
2012-10,תל אביב,6600,חולון,יישוב,3186,1464,1722,505,2681,906,3145,91,3.30%
2012-10,תל אביב,2620,קריית אונו,יישוב,400,176,224,136,264,49,394,4,2.29%
2012-10,תל אביב,8600,רמת גן,יישוב,2067,928,1139,647,1420,439,2048,91,2.78%
2012-10,תל אביב,2650,רמת השרון,יישוב,405,177,228,178,227,8,399,27,1.89%
2012-10,תל אביב,5000,תל אביב -יפו,יישוב,8007,3927,4080,2519,5488,2634,7965,274,3.33%
2012-11,אזור יהודה והשומרון,3760,אורנית,יישוב,102,48,54,37,65,3,102,3,2.45%
2012-11,אזור יהודה והשומרון,3750,אלפי מנשה,יישוב,104,50,54,35,69,2,104,1,2.50%
2012-11,אזור יהודה והשומרון,3560,אלקנה,יישוב,29,13,16,16,13,1,28,0,1.57%
2012-11,אזור יהודה והשומרון,3650,אפרת,יישוב,50,25,25,25,25,8,50,2,1.32%
2012-11,אזור יהודה והשומרון,3570,אריאל,יישוב,411,207,204,92,319,103,410,11,4.01%
2012-11,אזור יהודה והשומרון,3574,בית אל,יישוב,58,27,31,14,44,22,57,4,2.49%
2012-11,אזור יהודה והשומרון,3652,בית אריה,יישוב,61,24,37,5,56,4,60,0,2.64%
2012-11,אזור יהודה והשומרון,3780,ביתר עילית,יישוב,452,219,233,14,438,205,449,18,4.41%
2012-11,אזור יהודה והשומרון,3730,גבעת זאב,יישוב,159,78,81,20,139,37,159,6,2.37%
2012-11,אזור יהודה והשומרון,3769,הר אדר,יישוב,29,14,15,14,15,4,29,1,1.54%
2012-11,אזור יהודה והשומרון,3797,מודיעין עילית,יישוב,373,141,232,24,349,124,371,13,3.05%
2012-11,אזור יהודה והשומרון,3616,מעלה אדומים,יישוב,625,250,375,100,525,202,617,43,3.22%
2012-11,אזור יהודה והשומרון,3660,עמנואל,יישוב,79,40,39,4,75,56,79,0,7.55%
2012-11,אזור יהודה והשומרון,3557,קדומים,יישוב,39,15,24,12,27,7,38,1,2.21%
2012-11,אזור יהודה והשומרון,3611,קריית ארבע,יישוב,108,51,57,27,81,58,108,6,3.67%
2012-11,אזור יהודה והשומרון,3640,קרני שומרון,יישוב,93,47,46,27,66,16,92,2,2.65%
2012-11,הדרום,31,אופקים,יישוב,1385,570,815,100,1285,974,1380,9,11.27%
2012-11,הדרום,2600,אילת,יישוב,1354,604,750,64,1290,605,1339,57,4.16%
2012-11,הדרום,70,אשדוד,יישוב,6943,2813,4130,803,6140,3789,6891,160,6.63%
2012-11,הדרום,7100,אשקלון,יישוב,4338,1747,2591,662,3676,2594,4245,103,6.67%
2012-11,הדרום,9000,באר שבע,יישוב,7230,3140,4090,981,6249,4594,7186,155,7.29%
2012-11,הדרום,2200,דימונה,יישוב,2148,897,1251,130,2018,1513,2126,46,12.06%
2012-11,הדרום,1303,חורה,יישוב,748,317,431,1,747,696,748,2,20.93%
2012-11,הדרום,831,ירוחם,יישוב,467,221,246,20,447,283,461,31,10.89%
2012-11,הדרום,1059,כסיפה,יישוב,968,414,554,5,963,884,967,16,23.40%
2012-11,הדרום,1271,להבים,יישוב,45,21,24,22,23,5,45,2,1.38%
2012-11,הדרום,1060,לקיה,יישוב,969,433,536,3,966,909,967,9,26.83%
2012-11,הדרום,1268,מיתר,יישוב,51,26,25,21,30,6,51,2,1.31%
2012-11,הדרום,99,מצפה רמון,יישוב,242,93,149,13,229,144,230,9,9.59%
2012-11,הדרום,246,נתיבות,יישוב,1060,461,599,55,1005,560,1050,38,8.20%
2012-11,הדרום,666,עומר,יישוב,52,16,36,25,27,4,52,3,1.37%
2012-11,הדרום,2560,ערד,יישוב,831,369,462,150,681,458,809,60,6.66%
2012-11,הדרום,1192,ערערה-בנגב,יישוב,975,417,558,4,971,900,974,4,25.89%
2012-11,הדרום,2630,קריית גת,יישוב,2410,1003,1407,187,2223,1541,2406,28,9.06%
2012-11,הדרום,1034,קריית מלאכי,יישוב,1211,538,673,41,1170,815,1196,43,10.53%
2012-11,הדרום,1161,רהט,יישוב,3117,1303,1814,9,3108,2762,3116,29,18.71%
2012-11,הדרום,1286,שגב-שלום,יישוב,498,180,318,0,498,458,497,4,20.49%
2012-11,הדרום,1031,שדרות,יישוב,1145,470,675,65,1080,708,1139,18,9.46%
2012-11,הדרום,1054,תל שבע,יישוב,1146,528,618,2,1144,1077,1145,2,26.15%
2012-11,המרכז,182,אבן יהודה,יישוב,157,67,90,55,102,26,156,2,2.47%
2012-11,המרכז,41,אליכין,יישוב,55,24,31,4,51,19,55,1,3.17%
2012-11,המרכז,1309,אלעד,יישוב,425,184,241,20,405,109,424,19,3.75%
2012-11,המרכז,2530,באר יעקב,יישוב,236,98,138,44,192,72,230,13,2.83%
2012-11,המרכז,466,בית דגן,יישוב,115,56,59,19,96,42,115,2,3.34%
2012-11,המרכז,1066,"בני עי""ש",יישוב,201,88,113,26,175,72,201,0,5.10%
2012-11,המרכז,681,גבעת שמואל,יישוב,297,151,146,118,179,56,294,6,2.65%
2012-11,המרכז,2550,גדרה,יישוב,382,167,215,74,308,107,376,1,3.50%
2012-11,המרכז,627,ג'לג'וליה,יישוב,89,35,54,5,84,55,88,0,2.89%
2012-11,המרכז,166,גן יבנה,יישוב,360,141,219,47,313,91,358,7,3.46%
2012-11,המרכז,229,גני תקווה,יישוב,186,88,98,59,127,27,184,8,2.44%
2012-11,המרכז,9700,הוד השרון,יישוב,692,323,369,247,445,83,689,12,2.61%
2012-11,המרכז,1290,זמר,יישוב,162,47,115,6,156,119,162,1,6.03%
2012-11,המרכז,2730,טייבה,יישוב,2188,921,1267,13,2175,1880,2182,9,13.71%
2012-11,המרכז,2720,טירה,יישוב,348,179,169,6,342,180,348,11,3.44%
2012-11,המרכז,2660,יבנה,יישוב,876,409,467,87,789,378,872,51,4.41%
2012-11,המרכז,9400,יהוד,יישוב,561,238,323,95,466,79,545,14,3.62%
2012-11,המרכז,1224,כוכב יאיר,יישוב,88,38,50,45,43,2,88,0,1.62%
2012-11,המרכז,633,כפר ברא,יישוב,29,16,13,0,29,16,29,0,2.41%
2012-11,המרכז,168,כפר יונה,יישוב,333,148,185,66,267,65,332,8,3.35%
2012-11,המרכז,6900,כפר סבא,יישוב,1265,556,709,397,868,202,1258,25,2.60%
2012-11,המרכז,634,כפר קאסם,יישוב,251,127,124,1,250,139,251,8,3.20%
2012-11,המרכז,7000,לוד,יישוב,2273,1009,1264,167,2106,1265,2254,123,6.60%
2012-11,המרכז,1200,מודיעין-מכבים-רעות*,יישוב,946,403,543,363,583,70,940,48,2.36%
2012-11,המרכז,28,מזכרת בתיה,יישוב,181,76,105,35,146,34,179,0,2.93%
2012-11,המרכז,7200,נס ציונה,יישוב,679,295,384,147,532,205,672,1,3.14%
2012-11,המרכז,7400,נתניה,יישוב,4416,2026,2390,680,3736,1616,4374,95,4.46%
2012-11,המרכז,587,סביון*,יישוב,13,3,10,12,1,0,13,0,0.74%
2012-11,המרכז,171,פרדסייה,יישוב,72,30,42,21,51,5,72,0,2.09%
2012-11,המרכז,7900,פתח תקווה,יישוב,4271,1903,2368,880,3391,1131,4236,230,3.72%
2012-11,המרכז,195,קדימה-צורן,יישוב,245,99,146,82,163,35,244,2,2.65%
2012-11,המרכז,638,קלנסווה,יישוב,895,336,559,4,891,776,891,2,11.40%
2012-11,המרכז,469,קריית עקרון,יישוב,323,148,175,19,304,133,320,3,5.50%
2012-11,המרכז,2640,ראש העין,יישוב,759,372,387,99,660,157,749,26,3.52%
2012-11,המרכז,8300,ראשון לציון,יישוב,4672,2057,2615,1034,3638,1557,4666,206,3.57%
2012-11,המרכז,8400,רחובות,יישוב,2619,1122,1497,529,2090,1070,2564,13,4.17%
2012-11,המרכז,8500,רמלה,יישוב,1862,883,979,116,1746,829,1826,65,5.33%
2012-11,המרכז,8700,רעננה,יישוב,816,389,427,324,492,91,813,11,2.26%
2012-11,המרכז,1304,שוהם,יישוב,205,86,119,80,125,6,205,15,2.03%
2012-11,המרכז,154,תל מונד,יישוב,131,63,68,41,90,26,131,1,2.33%
2012-11,הצפון,473,אבו סנאן,יישוב,760,310,450,4,756,648,756,15,14.23%
2012-11,הצפון,478,אכסאל,יישוב,519,221,298,11,508,451,518,4,10.26%
2012-11,הצפון,529,אעבלין,יישוב,629,250,379,8,621,530,629,9,12.15%
2012-11,הצפון,482,בועיינה-נוג'ידאת,יישוב,385,159,226,3,382,345,381,12,11.15%
2012-11,הצפון,4001,בוקעאתא,יישוב,402,145,257,6,396,353,393,5,15.18%
2012-11,הצפון,998,ביר אל-מכסור,יישוב,400,139,261,1,399,342,400,3,12.47%
2012-11,הצפון,480,בית ג'ן,יישוב,363,116,247,10,353,256,359,1,7.43%
2012-11,הצפון,9200,בית שאן,יישוב,885,388,497,19,866,476,883,45,9.22%
2012-11,הצפון,944,בסמת טבעון,יישוב,221,99,122,1,220,176,220,5,7.74%
2012-11,הצפון,483,בענה,יישוב,416,169,247,2,414,348,416,8,13.54%
2012-11,הצפון,1292,ג'דיידה-מכר,יישוב,1512,619,893,5,1507,1338,1511,17,18.02%
2012-11,הצפון,485,ג'ולס,יישוב,259,70,189,2,257,167,259,13,9.73%
2012-11,הצפון,487,ג'ש (גוש חלב),יישוב,52,20,32,1,51,26,51,1,3.42%
2012-11,הצפון,489,דבורייה,יישוב,385,161,224,19,366,307,385,1,9.94%
2012-11,הצפון,490,דייר אל-אסד,יישוב,416,173,243,7,409,334,416,5,9.01%
2012-11,הצפון,492,דייר חנא,יישוב,639,274,365,8,631,512,639,9,14.65%
2012-11,הצפון,975,זרזיר,יישוב,335,153,182,3,332,233,332,4,12.26%
2012-11,הצפון,496,חורפיש,יישוב,121,37,84,7,114,71,121,1,4.95%
2012-11,הצפון,2034,חצור הגלילית,יישוב,297,122,175,16,281,151,291,7,6.37%
2012-11,הצפון,6700,טבריה,יישוב,1952,865,1087,120,1832,1203,1811,64,8.65%
2012-11,הצפון,962,טובא-זנגרייה,יישוב,367,167,200,5,362,275,362,2,12.68%
2012-11,הצפון,498,טורעאן,יישוב,577,222,355,11,566,479,573,32,11.31%
2012-11,הצפון,8900,טמרה,יישוב,2023,793,1230,14,2009,1761,2018,19,15.63%
2012-11,הצפון,1295,יאנוח-ג'ת,יישוב,143,51,92,3,140,106,143,3,5.85%
2012-11,הצפון,46,יבנאל,יישוב,144,93,51,10,134,102,130,1,8.66%
2012-11,הצפון,499,יפיע,יישוב,646,274,372,6,640,509,643,5,9.10%
2012-11,הצפון,240,יקנעם עילית,יישוב,539,229,310,85,454,183,539,42,4.87%
2012-11,הצפון,502,ירכא,יישוב,527,195,332,0,527,434,527,15,9.77%
2012-11,הצפון,504,כאבול,יישוב,700,271,429,5,695,611,698,8,15.37%
2012-11,הצפון,505,כאוכב אבו אל-היג'א,יישוב,227,102,125,4,223,189,227,9,14.37%
2012-11,הצפון,1296,כסרא-סמיע,יישוב,210,91,119,3,207,157,208,5,6.91%
2012-11,הצפון,978,כעביה-טבאש-חג'אג'רה,יישוב,205,82,123,2,203,148,205,1,10.34%
2012-11,הצפון,1263,כפר ורדים,יישוב,67,24,43,28,39,12,67,0,2.22%
2012-11,הצפון,507,כפר יאסיף,יישוב,529,217,312,7,522,429,529,9,11.08%
2012-11,הצפון,508,כפר כמא,יישוב,69,30,39,2,67,34,67,1,4.45%
2012-11,הצפון,509,כפר כנא,יישוב,1214,481,733,26,1188,1080,1207,34,15.04%
2012-11,הצפון,510,כפר מנדא,יישוב,900,396,504,9,891,723,894,16,13.46%
2012-11,הצפון,47,כפר תבור,יישוב,43,16,27,15,28,6,42,2,2.27%
2012-11,הצפון,1139,כרמיאל,יישוב,1738,712,1026,347,1391,899,1683,43,6.66%
2012-11,הצפון,481,מגאר,יישוב,1443,569,874,16,1427,1289,1439,20,17.11%
2012-11,הצפון,516,מג'ד אל-כרום,יישוב,566,248,318,9,557,450,566,10,9.64%
2012-11,הצפון,874,מגדל העמק,יישוב,1047,420,627,72,975,505,1019,52,7.84%
2012-11,הצפון,4201,מג'דל שמס,יישוב,459,168,291,13,446,406,453,4,10.21%
2012-11,הצפון,517,מזרעה,יישוב,172,63,109,4,168,137,171,4,9.32%
2012-11,הצפון,4203,מסעדה,יישוב,179,62,117,7,172,148,178,0,11.38%
2012-11,הצפון,518,מעיליא,יישוב,39,18,21,2,37,16,38,0,2.58%
2012-11,הצפון,1063,מעלות-תרשיחא,יישוב,869,408,461,122,747,517,866,25,7.42%
2012-11,הצפון,520,משהד,יישוב,320,124,196,7,313,267,318,6,10.66%
2012-11,הצפון,9100,נהרייה,יישוב,2103,943,1160,254,1849,1275,2090,64,7.19%
2012-11,הצפון,522,נחף,יישוב,404,178,226,6,398,327,404,6,8.88%
2012-11,הצפון,7300,נצרת,יישוב,3050,1298,1752,103,2947,2403,3044,18,9.83%
2012-11,הצפון,1061,נצרת עילית,יישוב,1918,833,1085,247,1671,1090,1826,102,7.95%
2012-11,הצפון,525,סאג'ור,יישוב,115,43,72,1,114,77,113,0,6.76%
2012-11,הצפון,7500,סח'נין,יישוב,2021,866,1155,31,1990,1743,2020,28,15.94%
2012-11,הצפון,4501,ע'ג'ר,יישוב,84,37,47,2,82,60,83,3,8.77%
2012-11,הצפון,530,עיילבון,יישוב,195,75,120,6,189,141,194,2,7.84%
2012-11,הצפון,511,עילוט,יישוב,302,121,181,2,300,250,301,7,11.75%
2012-11,הצפון,532,עין מאהל,יישוב,602,257,345,7,595,534,594,5,13.36%
2012-11,הצפון,7600,עכו,יישוב,3259,1479,1780,155,3104,2540,3231,86,12.65%
2012-11,הצפון,7700,עפולה,יישוב,1762,694,1068,209,1553,839,1715,89,7.34%
2012-11,הצפון,531,עראבה,יישוב,1423,578,845,24,1399,1287,1422,24,15.60%
2012-11,הצפון,535,פסוטה,יישוב,101,44,57,3,98,76,101,2,6.44%
2012-11,הצפון,536,פקיעין (בוקייעה),יישוב,132,72,60,4,128,79,131,3,5.09%
2012-11,הצפון,8000,צפת,יישוב,1337,707,630,97,1240,1019,1325,22,10.51%
2012-11,הצפון,4100,קצרין,יישוב,199,85,114,38,161,80,197,7,5.17%
2012-11,הצפון,2800,קריית שמונה,יישוב,689,307,382,57,632,276,661,72,5.26%
2012-11,הצפון,543,ראמה,יישוב,304,119,185,9,295,239,304,0,8.55%
2012-11,הצפון,26,ראש פינה,יישוב,46,17,29,6,40,17,46,0,3.08%
2012-11,הצפון,542,ריינה,יישוב,671,273,398,12,659,551,669,19,10.80%
2012-11,הצפון,122,רמת ישי,יישוב,98,36,62,37,61,11,98,0,2.51%
2012-11,הצפון,913,שבלי - אום אל-גנם,יישוב,238,117,121,11,227,164,237,2,9.93%
2012-11,הצפון,812,שלומי,יישוב,259,109,150,20,239,152,258,10,7.39%
2012-11,הצפון,538,שעב,יישוב,504,212,292,5,499,454,504,9,17.89%
2012-11,הצפון,8800,שפרעם,יישוב,1995,741,1254,29,1966,1685,1990,29,12.22%
2012-11,חיפה,2710,אום אל-פחם,יישוב,3747,1541,2206,15,3732,3235,3743,13,19.96%
2012-11,חיפה,1020,אור עקיבא,יישוב,623,277,346,49,574,228,617,25,6.46%
2012-11,חיפה,6000,באקה אל-גרביה,יישוב,675,317,358,15,660,459,674,11,6.60%
2012-11,חיפה,9800,בנימינה-גבעת עדה*,יישוב,220,82,138,67,153,59,219,4,3.38%
2012-11,חיפה,1326,"בסמ""ה",יישוב,427,185,242,3,424,342,426,4,12.11%
2012-11,חיפה,541,ג'סר א-זרקא,יישוב,424,235,189,2,422,283,421,2,7.64%
2012-11,חיפה,628,ג'ת,יישוב,207,93,114,12,195,121,207,4,4.57%
2012-11,חיפה,494,דאלית אל-כרמל,יישוב,521,205,316,10,511,296,516,4,7.06%
2012-11,חיפה,9300,זכרון יעקב,יישוב,250,102,148,83,167,50,247,2,2.53%
2012-11,חיפה,6500,חדרה,יישוב,2481,985,1496,332,2149,1013,2447,33,5.36%
2012-11,חיפה,4000,חיפה,יישוב,6963,3258,3705,1184,5779,4076,6939,179,5.11%
2012-11,חיפה,1247,חריש,יישוב,29,14,15,9,20,4,29,0,1.63%
2012-11,חיפה,2100,טירת כרמל,יישוב,773,347,426,26,747,476,768,50,7.60%
2012-11,חיפה,654,כפר קרע,יישוב,375,164,211,1,374,240,374,8,4.96%
2012-11,חיפה,1327,מעלה עירון,יישוב,948,366,582,2,946,798,948,4,18.08%
2012-11,חיפה,2500,נשר,יישוב,492,221,271,80,412,230,491,8,3.94%
2012-11,חיפה,534,עספיא,יישוב,294,117,177,6,288,182,294,3,5.90%
2012-11,חיפה,637,ערערה,יישוב,565,224,341,6,559,398,565,13,7.79%
2012-11,חיפה,537,פוריידיס,יישוב,396,191,205,7,389,266,394,1,7.79%
2012-11,חיפה,7800,פרדס חנה-כרכור,יישוב,879,376,503,142,737,290,871,27,4.83%
2012-11,חיפה,6800,קריית אתא,יישוב,1766,774,992,173,1593,1016,1755,57,6.19%
2012-11,חיפה,9500,קריית ביאליק,יישוב,1223,515,708,130,1093,643,1209,43,5.82%
2012-11,חיפה,2300,קריית טבעון,יישוב,192,101,91,60,132,46,189,2,2.39%
2012-11,חיפה,9600,קריית ים,יישוב,1578,733,845,165,1413,989,1572,49,7.54%
2012-11,חיפה,8200,קריית מוצקין,יישוב,1113,464,649,165,948,554,1106,38,5.08%
2012-11,חיפה,922,רכסים,יישוב,138,73,65,9,129,77,137,1,4.48%
2012-11,ירושלים,472,אבו גוש,יישוב,264,133,131,5,259,197,264,4,9.65%
2012-11,ירושלים,2610,בית שמש,יישוב,1303,585,718,111,1192,593,1296,64,4.63%
2012-11,ירושלים,3000,ירושלים,יישוב,11063,4947,6116,1279,9784,6744,10993,347,4.05%
2012-11,ירושלים,1015,מבשרת ציון,יישוב,409,179,230,73,336,191,409,12,3.29%
2012-11,ירושלים,1137,קריית יערים,יישוב,42,12,30,4,38,17,42,1,3.67%
2012-11,תל אביב,2400,אור יהודה,יישוב,894,401,493,34,860,292,878,34,4.85%
2012-11,תל אביב,565,אזור,יישוב,185,92,93,27,158,38,185,8,3.04%
2012-11,תל אביב,6100,בני ברק,יישוב,2380,1160,1220,111,2269,1313,2372,57,4.68%
2012-11,תל אביב,6200,בת ים,יישוב,3422,1668,1754,485,2937,1342,3367,208,4.76%
2012-11,תל אביב,6300,גבעתיים,יישוב,797,346,451,341,456,100,790,26,2.80%
2012-11,תל אביב,6400,הרצלייה,יישוב,1076,471,605,329,747,51,1059,87,2.30%
2012-11,תל אביב,6600,חולון,יישוב,3240,1529,1711,504,2736,916,3203,160,3.35%
2012-11,תל אביב,2620,קריית אונו,יישוב,385,180,205,128,257,44,382,2,2.22%
2012-11,תל אביב,8600,רמת גן,יישוב,2107,965,1142,657,1450,451,2091,71,2.84%
2012-11,תל אביב,2650,רמת השרון,יישוב,413,180,233,178,235,15,410,38,1.94%
2012-11,תל אביב,5000,תל אביב -יפו,יישוב,8335,4124,4211,2694,5641,2647,8271,302,3.45%
2012-12,אזור יהודה והשומרון,3760,אורנית,יישוב,97,43,54,33,64,5,97,1,2.34%
2012-12,אזור יהודה והשומרון,3750,אלפי מנשה,יישוב,121,55,66,39,82,3,119,1,2.86%
2012-12,אזור יהודה והשומרון,3560,אלקנה,יישוב,33,16,17,15,18,2,32,0,1.79%
2012-12,אזור יהודה והשומרון,3650,אפרת,יישוב,55,28,27,27,28,7,55,1,1.45%
2012-12,אזור יהודה והשומרון,3570,אריאל,יישוב,394,183,211,81,313,103,394,7,3.86%
2012-12,אזור יהודה והשומרון,3574,בית אל,יישוב,56,30,26,16,40,19,55,0,2.41%
2012-12,אזור יהודה והשומרון,3652,בית אריה,יישוב,64,29,35,9,55,4,64,1,2.81%
2012-12,אזור יהודה והשומרון,3780,ביתר עילית,יישוב,447,223,224,16,431,208,444,4,4.36%
2012-12,אזור יהודה והשומרון,3730,גבעת זאב,יישוב,165,84,81,18,147,36,165,5,2.45%
2012-12,אזור יהודה והשומרון,3769,הר אדר,יישוב,31,13,18,17,14,4,31,0,1.64%
2012-12,אזור יהודה והשומרון,3797,מודיעין עילית,יישוב,383,141,242,22,361,117,377,7,3.10%
2012-12,אזור יהודה והשומרון,3616,מעלה אדומים,יישוב,626,252,374,95,531,207,617,23,3.22%
2012-12,אזור יהודה והשומרון,3660,עמנואל,יישוב,78,36,42,4,74,56,78,2,7.46%
2012-12,אזור יהודה והשומרון,3557,קדומים,יישוב,38,16,22,12,26,9,37,0,2.15%
2012-12,אזור יהודה והשומרון,3611,קריית ארבע,יישוב,107,52,55,24,83,59,107,3,3.64%
2012-12,אזור יהודה והשומרון,3640,קרני שומרון,יישוב,87,44,43,24,63,18,87,2,2.51%
2012-12,הדרום,31,אופקים,יישוב,1399,601,798,100,1299,990,1392,9,11.35%
2012-12,הדרום,2600,אילת,יישוב,1418,646,772,65,1353,608,1395,31,4.33%
2012-12,הדרום,70,אשדוד,יישוב,7053,2871,4182,804,6249,3812,6998,158,6.72%
2012-12,הדרום,7100,אשקלון,יישוב,4438,1802,2636,673,3765,2638,4339,91,6.81%
2012-12,הדרום,9000,באר שבע,יישוב,7442,3285,4157,981,6461,4637,7390,181,7.48%
2012-12,הדרום,2200,דימונה,יישוב,2193,930,1263,136,2057,1504,2149,62,12.18%
2012-12,הדרום,1303,חורה,יישוב,779,322,457,1,778,713,779,1,21.61%
2012-12,הדרום,831,ירוחם,יישוב,468,227,241,20,448,283,462,20,10.91%
2012-12,הדרום,1059,כסיפה,יישוב,977,423,554,2,975,886,975,2,23.55%
2012-12,הדרום,1271,להבים,יישוב,43,21,22,21,22,4,43,0,1.32%
2012-12,הדרום,1060,לקיה,יישוב,982,434,548,3,979,920,981,1,27.11%
2012-12,הדרום,1268,מיתר,יישוב,59,28,31,19,40,6,58,4,1.49%
2012-12,הדרום,99,מצפה רמון,יישוב,246,95,151,16,230,154,236,8,9.82%
2012-12,הדרום,246,נתיבות,יישוב,1079,469,610,59,1020,569,1077,27,8.40%
2012-12,הדרום,666,עומר,יישוב,57,21,36,26,31,6,57,2,1.50%
2012-12,הדרום,2560,ערד,יישוב,782,364,418,149,633,440,761,58,6.29%
2012-12,הדרום,1192,ערערה-בנגב,יישוב,990,401,589,2,988,907,989,0,26.18%
2012-12,הדרום,2630,קריית גת,יישוב,2480,1020,1460,179,2301,1523,2475,34,9.29%
2012-12,הדרום,1034,קריית מלאכי,יישוב,1276,571,705,37,1239,816,1257,84,11.00%
2012-12,הדרום,1161,רהט,יישוב,3214,1370,1844,9,3205,2838,3213,26,19.18%
2012-12,הדרום,1286,שגב-שלום,יישוב,512,195,317,0,512,463,511,2,20.94%
2012-12,הדרום,1031,שדרות,יישוב,1190,498,692,62,1128,725,1184,25,9.79%
2012-12,הדרום,1054,תל שבע,יישוב,1171,532,639,2,1169,1088,1170,2,26.57%
2012-12,המרכז,182,אבן יהודה,יישוב,170,77,93,61,109,28,169,3,2.67%
2012-12,המרכז,41,אליכין,יישוב,53,25,28,4,49,18,51,1,2.95%
2012-12,המרכז,1309,אלעד,יישוב,433,189,244,19,414,112,431,4,3.81%
2012-12,המרכז,2530,באר יעקב,יישוב,251,112,139,49,202,65,246,5,3.02%
2012-12,המרכז,466,בית דגן,יישוב,112,58,54,19,93,37,112,0,3.26%
2012-12,המרכז,1066,"בני עי""ש",יישוב,197,86,111,26,171,72,195,1,4.95%
2012-12,המרכז,681,גבעת שמואל,יישוב,329,168,161,136,193,61,327,5,2.94%
2012-12,המרכז,2550,גדרה,יישוב,368,159,209,68,300,111,361,4,3.37%
2012-12,המרכז,627,ג'לג'וליה,יישוב,89,38,51,3,86,49,88,3,2.89%
2012-12,המרכז,166,גן יבנה,יישוב,385,140,245,50,335,95,383,8,3.69%
2012-12,המרכז,229,גני תקווה,יישוב,194,88,106,64,130,31,193,1,2.56%
2012-12,המרכז,9700,הוד השרון,יישוב,670,339,331,222,448,68,665,11,2.52%
2012-12,המרכז,1290,זמר,יישוב,175,55,120,8,167,127,175,4,6.48%
2012-12,המרכז,2730,טייבה,יישוב,2214,927,1287,13,2201,1878,2209,10,13.85%
2012-12,המרכז,2720,טירה,יישוב,376,196,180,9,367,185,376,8,3.71%
2012-12,המרכז,2660,יבנה,יישוב,911,435,476,97,814,390,907,29,4.58%
2012-12,המרכז,9400,יהוד,יישוב,570,240,330,91,479,67,557,27,3.69%
2012-12,המרכז,1224,כוכב יאיר,יישוב,91,39,52,45,46,2,91,0,1.68%
2012-12,המרכז,633,כפר ברא,יישוב,31,18,13,0,31,15,31,1,2.58%
2012-12,המרכז,168,כפר יונה,יישוב,360,161,199,72,288,66,359,10,3.61%
2012-12,המרכז,6900,כפר סבא,יישוב,1284,536,748,394,890,206,1279,31,2.64%
2012-12,המרכז,634,כפר קאסם,יישוב,242,119,123,0,242,144,242,1,3.09%
2012-12,המרכז,7000,לוד,יישוב,2273,1037,1236,168,2105,1239,2262,52,6.62%
2012-12,המרכז,1200,מודיעין-מכבים-רעות*,יישוב,943,402,541,364,579,63,934,32,2.35%
2012-12,המרכז,28,מזכרת בתיה,יישוב,175,76,99,32,143,39,173,2,2.83%
2012-12,המרכז,7200,נס ציונה,יישוב,682,315,367,135,547,210,674,7,3.15%
2012-12,המרכז,7400,נתניה,יישוב,4415,2063,2352,663,3752,1638,4379,88,4.46%
2012-12,המרכז,587,סביון*,יישוב,13,4,9,10,3,0,13,0,0.74%
2012-12,המרכז,171,פרדסייה,יישוב,72,31,41,18,54,6,72,0,2.09%
2012-12,המרכז,7900,פתח תקווה,יישוב,4233,1918,2315,839,3394,1104,4199,69,3.69%
2012-12,המרכז,195,קדימה-צורן,יישוב,250,106,144,83,167,35,250,1,2.72%
2012-12,המרכז,638,קלנסווה,יישוב,912,351,561,4,908,786,908,1,11.59%
2012-12,המרכז,469,קריית עקרון,יישוב,309,137,172,20,289,138,305,4,5.26%
2012-12,המרכז,2640,ראש העין,יישוב,793,406,387,106,687,157,782,18,3.67%
2012-12,המרכז,8300,ראשון לציון,יישוב,4707,2096,2611,1040,3667,1570,4699,52,3.59%
2012-12,המרכז,8400,רחובות,יישוב,2569,1136,1433,509,2060,1072,2516,9,4.10%
2012-12,המרכז,8500,רמלה,יישוב,1882,901,981,120,1762,848,1849,56,5.40%
2012-12,המרכז,8700,רעננה,יישוב,777,370,407,290,487,85,776,13,2.16%
2012-12,המרכז,1304,שוהם,יישוב,183,81,102,75,108,4,182,4,1.80%
2012-12,המרכז,154,תל מונד,יישוב,141,70,71,39,102,26,140,2,2.49%
2012-12,הצפון,473,אבו סנאן,יישוב,758,308,450,4,754,645,754,12,14.19%
2012-12,הצפון,478,אכסאל,יישוב,533,227,306,11,522,463,533,3,10.53%
2012-12,הצפון,529,אעבלין,יישוב,641,252,389,8,633,531,641,7,12.36%
2012-12,הצפון,482,בועיינה-נוג'ידאת,יישוב,404,163,241,4,400,344,399,5,11.61%
2012-12,הצפון,4001,בוקעאתא,יישוב,401,152,249,4,397,354,389,7,15.05%
2012-12,הצפון,998,ביר אל-מכסור,יישוב,413,145,268,4,409,345,413,6,12.83%
2012-12,הצפון,480,בית ג'ן,יישוב,347,114,233,5,342,258,342,2,7.10%
2012-12,הצפון,9200,בית שאן,יישוב,847,372,475,19,828,468,845,70,8.86%
2012-12,הצפון,944,בסמת טבעון,יישוב,214,96,118,1,213,173,213,2,7.52%
2012-12,הצפון,483,בענה,יישוב,420,173,247,1,419,353,420,4,13.65%
2012-12,הצפון,1292,ג'דיידה-מכר,יישוב,1538,644,894,5,1533,1352,1536,21,18.26%
2012-12,הצפון,485,ג'ולס,יישוב,252,63,189,2,250,166,252,7,9.50%
2012-12,הצפון,487,ג'ש (גוש חלב),יישוב,61,26,35,2,59,29,60,0,3.99%
2012-12,הצפון,489,דבורייה,יישוב,399,171,228,14,385,311,398,4,10.24%
2012-12,הצפון,490,דייר אל-אסד,יישוב,418,176,242,7,411,337,418,0,9.05%
2012-12,הצפון,492,דייר חנא,יישוב,659,288,371,8,651,515,659,12,15.04%
2012-12,הצפון,975,זרזיר,יישוב,345,162,183,2,343,236,339,13,12.48%
2012-12,הצפון,496,חורפיש,יישוב,131,42,89,8,123,73,130,3,5.30%
2012-12,הצפון,2034,חצור הגלילית,יישוב,294,126,168,19,275,140,290,8,6.35%
2012-12,הצפון,6700,טבריה,יישוב,1980,877,1103,116,1864,1208,1830,74,8.74%
2012-12,הצפון,962,טובא-זנגרייה,יישוב,374,170,204,4,370,265,368,2,12.87%
2012-12,הצפון,498,טורעאן,יישוב,557,228,329,11,546,478,554,14,10.97%
2012-12,הצפון,8900,טמרה,יישוב,2028,802,1226,12,2016,1775,2022,19,15.66%
2012-12,הצפון,1295,יאנוח-ג'ת,יישוב,165,59,106,5,160,117,165,4,6.69%
2012-12,הצפון,46,יבנאל,יישוב,149,98,51,7,142,109,134,2,8.90%
2012-12,הצפון,499,יפיע,יישוב,663,293,370,6,657,515,660,4,9.32%
2012-12,הצפון,240,יקנעם עילית,יישוב,505,215,290,75,430,176,504,26,4.57%
2012-12,הצפון,502,ירכא,יישוב,533,201,332,0,533,440,533,13,9.87%
2012-12,הצפון,504,כאבול,יישוב,693,267,426,5,688,603,691,7,15.24%
2012-12,הצפון,505,כאוכב אבו אל-היג'א,יישוב,217,102,115,3,214,182,217,5,13.82%
2012-12,הצפון,1296,כסרא-סמיע,יישוב,214,95,119,2,212,162,213,15,7.06%
2012-12,הצפון,978,כעביה-טבאש-חג'אג'רה,יישוב,221,90,131,3,218,152,219,2,10.97%
2012-12,הצפון,1263,כפר ורדים,יישוב,65,29,36,29,36,9,65,0,2.16%
2012-12,הצפון,507,כפר יאסיף,יישוב,544,223,321,6,538,430,544,12,11.36%
2012-12,הצפון,508,כפר כמא,יישוב,62,29,33,2,60,33,62,0,4.13%
2012-12,הצפון,509,כפר כנא,יישוב,1199,459,740,25,1174,1071,1193,34,14.89%
2012-12,הצפון,510,כפר מנדא,יישוב,919,413,506,9,910,722,913,2,13.70%
2012-12,הצפון,47,כפר תבור,יישוב,43,15,28,15,28,6,43,0,2.33%
2012-12,הצפון,1139,כרמיאל,יישוב,1780,730,1050,337,1443,919,1728,47,6.83%
2012-12,הצפון,481,מגאר,יישוב,1475,581,894,16,1459,1305,1472,6,17.44%
2012-12,הצפון,516,מג'ד אל-כרום,יישוב,576,249,327,7,569,459,576,10,9.79%
2012-12,הצפון,874,מגדל העמק,יישוב,1079,444,635,84,995,502,1040,68,7.99%
2012-12,הצפון,4201,מג'דל שמס,יישוב,490,189,301,12,478,414,480,1,10.75%
2012-12,הצפון,517,מזרעה,יישוב,190,73,117,4,186,145,189,3,10.20%
2012-12,הצפון,4203,מסעדה,יישוב,191,72,119,7,184,156,190,1,12.06%
2012-12,הצפון,518,מעיליא,יישוב,44,23,21,5,39,17,43,1,2.91%
2012-12,הצפון,1063,מעלות-תרשיחא,יישוב,864,416,448,119,745,519,860,14,7.38%
2012-12,הצפון,520,משהד,יישוב,322,115,207,8,314,263,322,5,10.78%
2012-12,הצפון,9100,נהרייה,יישוב,2106,963,1143,244,1862,1255,2089,47,7.19%
2012-12,הצפון,522,נחף,יישוב,427,184,243,4,423,346,427,8,9.34%
2012-12,הצפון,7300,נצרת,יישוב,3125,1351,1774,112,3013,2447,3122,15,10.06%
2012-12,הצפון,1061,נצרת עילית,יישוב,1999,894,1105,236,1763,1092,1908,107,8.27%
2012-12,הצפון,525,סאג'ור,יישוב,120,39,81,1,119,83,119,1,7.09%
2012-12,הצפון,7500,סח'נין,יישוב,2061,897,1164,32,2029,1776,2060,22,16.21%
2012-12,הצפון,4501,ע'ג'ר,יישוב,80,35,45,2,78,57,79,3,8.39%
2012-12,הצפון,530,עיילבון,יישוב,198,74,124,6,192,147,198,0,7.99%
2012-12,הצפון,511,עילוט,יישוב,307,123,184,3,304,247,307,1,11.96%
2012-12,הצפון,532,עין מאהל,יישוב,623,276,347,11,612,535,613,2,13.73%
2012-12,הצפון,7600,עכו,יישוב,3314,1525,1789,145,3169,2580,3290,61,12.85%
2012-12,הצפון,7700,עפולה,יישוב,1770,732,1038,203,1567,854,1716,98,7.34%
2012-12,הצפון,531,עראבה,יישוב,1487,603,884,39,1448,1310,1481,17,16.14%
2012-12,הצפון,535,פסוטה,יישוב,109,50,59,2,107,78,109,0,6.92%
2012-12,הצפון,536,פקיעין (בוקייעה),יישוב,133,74,59,6,127,79,132,4,5.12%
2012-12,הצפון,8000,צפת,יישוב,1329,710,619,89,1240,1024,1316,26,10.44%
2012-12,הצפון,4100,קצרין,יישוב,200,85,115,40,160,82,200,5,5.24%
2012-12,הצפון,2800,קריית שמונה,יישוב,695,334,361,57,638,271,671,45,5.34%
2012-12,הצפון,543,ראמה,יישוב,296,111,185,8,288,238,294,0,8.30%
2012-12,הצפון,26,ראש פינה,יישוב,53,19,34,5,48,17,53,0,3.53%
2012-12,הצפון,542,ריינה,יישוב,668,267,401,9,659,551,665,6,10.75%
2012-12,הצפון,122,רמת ישי,יישוב,95,34,61,33,62,14,94,1,2.41%
2012-12,הצפון,913,שבלי - אום אל-גנם,יישוב,232,114,118,8,224,159,231,1,9.71%
2012-12,הצפון,812,שלומי,יישוב,264,115,149,21,243,151,263,5,7.53%
2012-12,הצפון,538,שעב,יישוב,512,212,300,6,506,451,512,1,18.12%
2012-12,הצפון,8800,שפרעם,יישוב,2011,757,1254,30,1981,1687,2006,30,12.30%
2012-12,חיפה,2710,אום אל-פחם,יישוב,3834,1581,2253,19,3815,3294,3829,9,20.33%
2012-12,חיפה,1020,אור עקיבא,יישוב,627,279,348,48,579,233,619,29,6.48%
2012-12,חיפה,6000,באקה אל-גרביה,יישוב,699,328,371,15,684,462,697,17,6.81%
2012-12,חיפה,9800,בנימינה-גבעת עדה*,יישוב,216,81,135,59,157,61,214,2,3.31%
2012-12,חיפה,1326,"בסמ""ה",יישוב,450,201,249,2,448,348,450,6,12.70%
2012-12,חיפה,541,ג'סר א-זרקא,יישוב,411,238,173,0,411,290,407,3,7.41%
2012-12,חיפה,628,ג'ת,יישוב,225,106,119,11,214,135,225,1,4.95%
2012-12,חיפה,494,דאלית אל-כרמל,יישוב,564,231,333,10,554,311,560,10,7.61%
2012-12,חיפה,9300,זכרון יעקב,יישוב,249,97,152,84,165,48,246,3,2.52%
2012-12,חיפה,6500,חדרה,יישוב,2552,1027,1525,325,2227,1012,2509,43,5.49%
2012-12,חיפה,4000,חיפה,יישוב,6960,3317,3643,1220,5740,4054,6937,229,5.11%
2012-12,חיפה,1247,חריש,יישוב,23,12,11,6,17,6,22,0,1.24%
2012-12,חיפה,2100,טירת כרמל,יישוב,772,344,428,29,743,467,769,23,7.61%
2012-12,חיפה,654,כפר קרע,יישוב,361,154,207,3,358,238,360,6,4.78%
2012-12,חיפה,1327,מעלה עירון,יישוב,955,373,582,2,953,805,955,3,18.19%
2012-12,חיפה,2500,נשר,יישוב,512,233,279,85,427,230,511,14,4.09%
2012-12,חיפה,534,עספיא,יישוב,314,132,182,4,310,183,314,3,6.27%
2012-12,חיפה,637,ערערה,יישוב,598,237,361,8,590,409,598,15,8.21%
2012-12,חיפה,537,פוריידיס,יישוב,394,194,200,6,388,270,392,1,7.75%
2012-12,חיפה,7800,פרדס חנה-כרכור,יישוב,880,395,485,135,745,295,877,25,4.86%
2012-12,חיפה,6800,קריית אתא,יישוב,1698,755,943,159,1539,994,1686,47,5.96%
2012-12,חיפה,9500,קריית ביאליק,יישוב,1177,487,690,134,1043,625,1169,37,5.64%
2012-12,חיפה,2300,קריית טבעון,יישוב,180,98,82,54,126,46,178,2,2.25%
2012-12,חיפה,9600,קריית ים,יישוב,1570,739,831,157,1413,1002,1566,35,7.51%
2012-12,חיפה,8200,קריית מוצקין,יישוב,1095,462,633,170,925,547,1090,30,5.01%
2012-12,חיפה,922,רכסים,יישוב,143,76,67,10,133,82,142,1,4.63%
2012-12,ירושלים,472,אבו גוש,יישוב,268,139,129,6,262,198,268,7,9.78%
2012-12,ירושלים,2610,בית שמש,יישוב,1334,601,733,102,1232,609,1325,46,4.73%
2012-12,ירושלים,3000,ירושלים,יישוב,11257,5114,6143,1289,9968,6840,11187,180,4.12%
2012-12,ירושלים,1015,מבשרת ציון,יישוב,408,186,222,65,343,189,404,4,3.25%
2012-12,ירושלים,1137,קריית יערים,יישוב,44,13,31,5,39,18,44,1,3.84%
2012-12,תל אביב,2400,אור יהודה,יישוב,902,402,500,40,862,289,891,32,4.92%
2012-12,תל אביב,565,אזור,יישוב,201,99,102,31,170,37,200,5,3.27%
2012-12,תל אביב,6100,בני ברק,יישוב,2430,1180,1250,114,2316,1349,2419,43,4.76%
2012-12,תל אביב,6200,בת ים,יישוב,3510,1725,1785,476,3034,1371,3446,101,4.87%
2012-12,תל אביב,6300,גבעתיים,יישוב,818,367,451,356,462,102,812,8,2.87%
2012-12,תל אביב,6400,הרצלייה,יישוב,1080,482,598,315,765,57,1064,61,2.31%
2012-12,תל אביב,6600,חולון,יישוב,3314,1571,1743,507,2807,914,3275,88,3.43%
2012-12,תל אביב,2620,קריית אונו,יישוב,400,175,225,126,274,49,397,7,2.31%
2012-12,תל אביב,8600,רמת גן,יישוב,2117,979,1138,654,1463,448,2097,29,2.85%
2012-12,תל אביב,2650,רמת השרון,יישוב,402,179,223,174,228,8,400,10,1.89%
2012-12,תל אביב,5000,תל אביב -יפו,יישוב,8296,4124,4172,2645,5651,2623,8236,113,3.44%
2013-01,אזור יהודה והשומרון,3760,אורנית,יישוב,109,49,60,37,72,4,109,2,2.44%
2013-01,אזור יהודה והשומרון,3750,אלפי מנשה,יישוב,114,50,64,35,79,0,113,5,2.66%
2013-01,אזור יהודה והשומרון,3560,אלקנה,יישוב,29,11,18,16,13,1,29,0,1.58%
2013-01,אזור יהודה והשומרון,3650,אפרת,יישוב,52,24,28,27,25,7,52,2,1.32%
2013-01,אזור יהודה והשומרון,3570,אריאל,יישוב,406,189,217,73,333,101,406,10,3.90%
2013-01,אזור יהודה והשומרון,3574,בית אל,יישוב,48,25,23,17,31,19,47,1,1.97%
2013-01,אזור יהודה והשומרון,3652,בית אריה,יישוב,56,22,34,8,48,2,56,2,2.29%
2013-01,אזור יהודה והשומרון,3780,ביתר עילית,יישוב,403,207,196,13,390,196,402,5,3.59%
2013-01,אזור יהודה והשומרון,3730,גבעת זאב,יישוב,157,71,86,25,132,39,157,2,2.17%
2013-01,אזור יהודה והשומרון,3769,הר אדר,יישוב,25,10,15,15,10,3,25,1,1.26%
2013-01,אזור יהודה והשומרון,3797,מודיעין עילית,יישוב,354,137,217,19,335,108,350,9,2.69%
2013-01,אזור יהודה והשומרון,3616,מעלה אדומים,יישוב,555,216,339,95,460,189,553,34,2.76%
2013-01,אזור יהודה והשומרון,3660,עמנואל,יישוב,77,35,42,5,72,54,77,1,6.99%
2013-01,אזור יהודה והשומרון,3557,קדומים,יישוב,41,20,21,11,30,10,41,1,2.28%
2013-01,אזור יהודה והשומרון,3611,קריית ארבע,יישוב,103,49,54,21,82,56,103,1,3.32%
2013-01,אזור יהודה והשומרון,3640,קרני שומרון,יישוב,88,39,49,24,64,17,88,2,2.49%
2013-01,הדרום,31,אופקים,יישוב,1379,616,763,99,1280,990,1371,13,10.84%
2013-01,הדרום,2600,אילת,יישוב,1663,731,932,77,1586,628,1635,46,4.93%
2013-01,הדרום,70,אשדוד,יישוב,7120,2936,4184,783,6337,3871,7073,192,6.56%
2013-01,הדרום,7100,אשקלון,יישוב,4509,1850,2659,673,3836,2665,4404,110,6.55%
2013-01,הדרום,9000,באר שבע,יישוב,7531,3406,4125,987,6544,4632,7475,277,7.24%
2013-01,הדרום,2200,דימונה,יישוב,2242,952,1290,136,2106,1517,2202,65,11.96%
2013-01,הדרום,1303,חורה,יישוב,788,341,447,2,786,721,787,2,20.32%
2013-01,הדרום,831,ירוחם,יישוב,453,214,239,21,432,287,448,33,9.96%
2013-01,הדרום,1059,כסיפה,יישוב,976,421,555,3,973,885,973,18,21.93%
2013-01,הדרום,1271,להבים,יישוב,40,17,23,21,19,4,40,1,1.17%
2013-01,הדרום,1060,לקיה,יישוב,1006,457,549,2,1004,942,1006,6,24.79%
2013-01,הדרום,1268,מיתר,יישוב,54,25,29,18,36,5,54,2,1.29%
2013-01,הדרום,99,מצפה רמון,יישוב,245,97,148,13,232,148,234,7,9.57%
2013-01,הדרום,246,נתיבות,יישוב,1053,465,588,65,988,573,1047,31,7.82%
2013-01,הדרום,666,עומר,יישוב,48,23,25,22,26,5,48,2,1.19%
2013-01,הדרום,2560,ערד,יישוב,818,375,443,143,675,455,796,40,6.37%
2013-01,הדרום,1192,ערערה-בנגב,יישוב,970,399,571,3,967,892,968,0,24.42%
2013-01,הדרום,2630,קריית גת,יישוב,2490,1040,1450,188,2302,1493,2485,65,8.85%
2013-01,הדרום,1034,קריית מלאכי,יישוב,1274,580,694,37,1237,817,1254,85,10.67%
2013-01,הדרום,1161,רהט,יישוב,3179,1362,1817,9,3170,2850,3178,53,17.67%
2013-01,הדרום,1286,שגב-שלום,יישוב,508,195,313,0,508,463,507,2,20.30%
2013-01,הדרום,1031,שדרות,יישוב,1134,498,636,60,1074,731,1128,14,9.02%
2013-01,הדרום,1054,תל שבע,יישוב,1182,556,626,4,1178,1108,1181,3,25.29%
2013-01,המרכז,182,אבן יהודה,יישוב,176,81,95,70,106,22,175,4,2.64%
2013-01,המרכז,41,אליכין,יישוב,54,31,23,4,50,17,54,0,2.98%
2013-01,המרכז,1309,אלעד,יישוב,416,186,230,20,396,114,414,0,3.49%
2013-01,המרכז,2530,באר יעקב,יישוב,221,102,119,43,178,62,218,3,2.53%
2013-01,המרכז,466,בית דגן,יישוב,128,60,68,25,103,40,128,0,3.63%
2013-01,המרכז,1066,"בני עי""ש",יישוב,201,87,114,23,178,70,198,2,5.00%
2013-01,המרכז,681,גבעת שמואל,יישוב,315,167,148,138,177,60,314,0,2.70%
2013-01,המרכז,2550,גדרה,יישוב,402,171,231,67,335,105,398,0,3.49%
2013-01,המרכז,627,ג'לג'וליה,יישוב,97,44,53,2,95,50,95,1,2.79%
2013-01,המרכז,166,גן יבנה,יישוב,376,147,229,45,331,95,374,4,3.40%
2013-01,המרכז,229,גני תקווה,יישוב,194,86,108,62,132,28,193,4,2.40%
2013-01,המרכז,9700,הוד השרון,יישוב,701,343,358,245,456,70,693,18,2.48%
2013-01,המרכז,1290,זמר,יישוב,171,53,118,8,163,123,171,2,6.07%
2013-01,המרכז,2730,טייבה,יישוב,2228,937,1291,13,2215,1891,2222,16,13.00%
2013-01,המרכז,2720,טירה,יישוב,354,172,182,12,342,195,353,17,3.24%
2013-01,המרכז,2660,יבנה,יישוב,889,426,463,91,798,393,881,16,4.04%
2013-01,המרכז,9400,יהוד,יישוב,539,224,315,88,451,73,530,29,3.41%
2013-01,המרכז,1224,כוכב יאיר,יישוב,112,49,63,52,60,2,112,0,2.01%
2013-01,המרכז,633,כפר ברא,יישוב,30,17,13,1,29,15,30,1,2.35%
2013-01,המרכז,168,כפר יונה,יישוב,328,146,182,62,266,65,325,6,3.10%
2013-01,המרכז,6900,כפר סבא,יישוב,1332,589,743,417,915,207,1321,37,2.57%
2013-01,המרכז,634,כפר קאסם,יישוב,240,111,129,0,240,145,240,1,2.82%
2013-01,המרכז,7000,לוד,יישוב,2198,988,1210,163,2035,1239,2186,39,6.24%
2013-01,המרכז,1200,מודיעין-מכבים-רעות*,יישוב,909,388,521,339,570,59,902,77,2.17%
2013-01,המרכז,28,מזכרת בתיה,יישוב,158,68,90,25,133,36,156,0,2.35%
2013-01,המרכז,7200,נס ציונה,יישוב,694,321,373,146,548,211,686,2,3.03%
2013-01,המרכז,7400,נתניה,יישוב,4566,2153,2413,662,3904,1692,4531,119,4.40%
2013-01,המרכז,587,סביון*,יישוב,11,5,6,7,4,0,11,0,0.59%
2013-01,המרכז,171,פרדסייה,יישוב,81,33,48,17,64,8,81,3,2.29%
2013-01,המרכז,7900,פתח תקווה,יישוב,4111,1874,2237,823,3288,1113,4079,46,3.37%
2013-01,המרכז,195,קדימה-צורן,יישוב,285,122,163,83,202,34,285,0,2.85%
2013-01,המרכז,638,קלנסווה,יישוב,927,366,561,4,923,798,923,4,10.99%
2013-01,המרכז,469,קריית עקרון,יישוב,304,137,167,21,283,139,301,3,5.15%
2013-01,המרכז,2640,ראש העין,יישוב,750,394,356,97,653,151,744,31,3.32%
2013-01,המרכז,8300,ראשון לציון,יישוב,4562,2035,2527,987,3575,1531,4536,37,3.34%
2013-01,המרכז,8400,רחובות,יישוב,2640,1148,1492,561,2079,1076,2594,14,3.96%
2013-01,המרכז,8500,רמלה,יישוב,1779,840,939,115,1664,831,1745,56,4.84%
2013-01,המרכז,8700,רעננה,יישוב,807,389,418,302,505,85,807,13,2.19%
2013-01,המרכז,1304,שוהם,יישוב,190,87,103,82,108,7,190,4,1.80%
2013-01,המרכז,154,תל מונד,יישוב,139,69,70,42,97,25,139,0,2.36%
2013-01,הצפון,473,אבו סנאן,יישוב,759,307,452,4,755,651,755,4,13.40%
2013-01,הצפון,478,אכסאל,יישוב,538,235,303,14,524,461,538,8,9.96%
2013-01,הצפון,529,אעבלין,יישוב,638,253,385,9,629,530,638,5,11.66%
2013-01,הצפון,482,בועיינה-נוג'ידאת,יישוב,403,172,231,4,399,345,399,5,10.77%
2013-01,הצפון,4001,בוקעאתא,יישוב,405,153,252,7,398,354,398,1,15.04%
2013-01,הצפון,998,ביר אל-מכסור,יישוב,421,150,271,1,420,352,421,8,11.91%
2013-01,הצפון,480,בית ג'ן,יישוב,367,120,247,9,358,259,366,1,7.22%
2013-01,הצפון,9200,בית שאן,יישוב,880,392,488,20,860,474,878,73,8.80%
2013-01,הצפון,944,בסמת טבעון,יישוב,217,101,116,3,214,167,216,4,7.08%
2013-01,הצפון,483,בענה,יישוב,426,172,254,1,425,360,426,9,13.10%
2013-01,הצפון,1292,ג'דיידה-מכר,יישוב,1557,655,902,6,1551,1375,1556,7,17.56%
2013-01,הצפון,485,ג'ולס,יישוב,261,73,188,2,259,173,261,3,9.31%
2013-01,הצפון,487,ג'ש (גוש חלב),יישוב,64,29,35,5,59,31,63,1,3.97%
2013-01,הצפון,489,דבורייה,יישוב,412,178,234,17,395,306,412,2,10.00%
2013-01,הצפון,490,דייר אל-אסד,יישוב,441,185,256,9,432,350,441,8,8.90%
2013-01,הצפון,492,דייר חנא,יישוב,680,303,377,11,669,519,680,15,14.50%
2013-01,הצפון,975,זרזיר,יישוב,350,164,186,1,349,241,345,13,11.82%
2013-01,הצפון,496,חורפיש,יישוב,135,56,79,4,131,73,134,2,5.19%
2013-01,הצפון,2034,חצור הגלילית,יישוב,273,117,156,19,254,140,268,5,5.75%
2013-01,הצפון,6700,טבריה,יישוב,1990,890,1100,106,1884,1179,1846,65,8.44%
2013-01,הצפון,962,טובא-זנגרייה,יישוב,374,171,203,4,370,267,371,0,12.55%
2013-01,הצפון,498,טורעאן,יישוב,581,240,341,8,573,501,578,21,10.56%
2013-01,הצפון,8900,טמרה,יישוב,2030,816,1214,13,2017,1779,2024,17,14.91%
2013-01,הצפון,1295,יאנוח-ג'ת,יישוב,160,60,100,4,156,111,160,1,6.09%
2013-01,הצפון,46,יבנאל,יישוב,154,107,47,8,146,118,141,1,9.04%
2013-01,הצפון,499,יפיע,יישוב,678,302,376,12,666,527,676,12,8.95%
2013-01,הצפון,240,יקנעם עילית,יישוב,523,229,294,85,438,169,521,41,4.58%
2013-01,הצפון,502,ירכא,יישוב,553,220,333,1,552,437,553,1,10.11%
2013-01,הצפון,504,כאבול,יישוב,705,278,427,6,699,615,702,13,14.61%
2013-01,הצפון,505,כאוכב אבו אל-היג'א,יישוב,227,110,117,3,224,189,227,5,13.72%
2013-01,הצפון,1296,כסרא-סמיע,יישוב,200,85,115,6,194,150,199,7,6.16%
2013-01,הצפון,978,כעביה-טבאש-חג'אג'רה,יישוב,213,83,130,1,212,151,212,1,9.81%
2013-01,הצפון,1263,כפר ורדים,יישוב,66,30,36,22,44,11,66,3,2.12%
2013-01,הצפון,507,כפר יאסיף,יישוב,567,241,326,5,562,446,567,2,11.24%
2013-01,הצפון,508,כפר כמא,יישוב,70,32,38,2,68,35,69,0,4.37%
2013-01,הצפון,509,כפר כנא,יישוב,1230,481,749,29,1201,1094,1224,29,14.25%
2013-01,הצפון,510,כפר מנדא,יישוב,971,446,525,10,961,740,965,15,13.67%
2013-01,הצפון,47,כפר תבור,יישוב,40,17,23,9,31,6,40,0,1.95%
2013-01,הצפון,1139,כרמיאל,יישוב,1826,735,1091,346,1480,914,1770,42,6.82%
2013-01,הצפון,481,מגאר,יישוב,1535,636,899,19,1516,1354,1531,15,17.58%
2013-01,הצפון,516,מג'ד אל-כרום,יישוב,589,257,332,7,582,462,589,13,9.39%
2013-01,הצפון,874,מגדל העמק,יישוב,1067,454,613,82,985,493,1032,86,7.69%
2013-01,הצפון,4201,מג'דל שמס,יישוב,475,177,298,11,464,409,469,6,10.03%
2013-01,הצפון,517,מזרעה,יישוב,180,65,115,3,177,138,179,3,9.27%
2013-01,הצפון,4203,מסעדה,יישוב,202,78,124,8,194,156,201,0,12.23%
2013-01,הצפון,518,מעיליא,יישוב,45,24,21,5,40,16,45,2,2.91%
2013-01,הצפון,1063,מעלות-תרשיחא,יישוב,896,438,458,112,784,542,893,36,7.49%
2013-01,הצפון,520,משהד,יישוב,317,114,203,10,307,259,317,11,10.17%
2013-01,הצפון,9100,נהרייה,יישוב,2107,962,1145,241,1866,1255,2096,58,6.84%
2013-01,הצפון,522,נחף,יישוב,440,194,246,8,432,352,440,9,9.28%
2013-01,הצפון,7300,נצרת,יישוב,3204,1412,1792,108,3096,2470,3200,48,9.56%
2013-01,הצפון,1061,נצרת עילית,יישוב,2057,912,1145,261,1796,1174,1974,105,8.23%
2013-01,הצפון,525,סאג'ור,יישוב,113,40,73,0,113,77,112,2,6.64%
2013-01,הצפון,7500,סח'נין,יישוב,2095,914,1181,39,2056,1780,2094,28,15.56%
2013-01,הצפון,4501,ע'ג'ר,יישוב,85,41,44,4,81,56,85,0,8.67%
2013-01,הצפון,530,עיילבון,יישוב,204,84,120,6,198,149,204,1,7.65%
2013-01,הצפון,511,עילוט,יישוב,321,135,186,3,318,257,320,1,11.78%
2013-01,הצפון,532,עין מאהל,יישוב,636,286,350,11,625,546,626,6,12.80%
2013-01,הצפון,7600,עכו,יישוב,3340,1554,1786,150,3190,2586,3323,61,12.54%
2013-01,הצפון,7700,עפולה,יישוב,1718,712,1006,196,1522,856,1687,107,6.94%
2013-01,הצפון,531,עראבה,יישוב,1516,628,888,43,1473,1324,1510,26,15.51%
2013-01,הצפון,535,פסוטה,יישוב,120,52,68,5,115,83,120,3,7.27%
2013-01,הצפון,536,פקיעין (בוקייעה),יישוב,140,76,64,8,132,88,139,4,5.22%
2013-01,הצפון,8000,צפת,יישוב,1351,720,631,98,1253,1045,1338,8,10.15%
2013-01,הצפון,4100,קצרין,יישוב,202,90,112,39,163,81,200,6,5.09%
2013-01,הצפון,2800,קריית שמונה,יישוב,725,353,372,62,663,304,700,27,5.43%
2013-01,הצפון,543,ראמה,יישוב,310,121,189,9,301,241,310,2,8.21%
2013-01,הצפון,26,ראש פינה,יישוב,51,16,35,5,46,19,50,0,3.20%
2013-01,הצפון,542,ריינה,יישוב,691,291,400,9,682,571,686,17,10.48%
2013-01,הצפון,122,רמת ישי,יישוב,102,37,65,37,65,17,102,2,2.48%
2013-01,הצפון,913,שבלי - אום אל-גנם,יישוב,232,114,118,5,227,155,230,3,9.22%
2013-01,הצפון,812,שלומי,יישוב,261,112,149,22,239,151,259,8,7.18%
2013-01,הצפון,538,שעב,יישוב,522,220,302,7,515,458,522,8,17.80%
2013-01,הצפון,8800,שפרעם,יישוב,2016,765,1251,23,1993,1700,2012,32,11.81%
2013-01,חיפה,2710,אום אל-פחם,יישוב,3905,1613,2292,21,3884,3342,3899,13,19.28%
2013-01,חיפה,1020,אור עקיבא,יישוב,628,284,344,41,587,233,616,41,6.25%
2013-01,חיפה,6000,באקה אל-גרביה,יישוב,716,341,375,16,700,475,715,19,6.45%
2013-01,חיפה,9800,בנימינה-גבעת עדה*,יישוב,205,82,123,58,147,64,204,5,3.00%
2013-01,חיפה,1326,"בסמ""ה",יישוב,445,192,253,2,443,356,445,13,11.69%
2013-01,חיפה,541,ג'סר א-זרקא,יישוב,427,248,179,0,427,303,425,5,7.44%
2013-01,חיפה,628,ג'ת,יישוב,234,107,127,11,223,141,234,12,4.76%
2013-01,חיפה,494,דאלית אל-כרמל,יישוב,553,236,317,9,544,303,549,15,7.20%
2013-01,חיפה,9300,זכרון יעקב,יישוב,258,103,155,85,173,51,255,4,2.45%
2013-01,חיפה,6500,חדרה,יישוב,2493,1011,1482,323,2170,1022,2463,53,5.09%
2013-01,חיפה,4000,חיפה,יישוב,6957,3340,3617,1207,5750,4002,6933,287,4.88%
2013-01,חיפה,1247,חריש,יישוב,24,15,9,6,18,5,24,0,1.57%
2013-01,חיפה,2100,טירת כרמל,יישוב,799,372,427,28,771,465,796,28,7.63%
2013-01,חיפה,654,כפר קרע,יישוב,391,177,214,4,387,239,390,10,4.86%
2013-01,חיפה,1327,מעלה עירון,יישוב,982,393,589,2,980,811,982,3,17.34%
2013-01,חיפה,2500,נשר,יישוב,503,232,271,90,413,218,502,12,3.92%
2013-01,חיפה,534,עספיא,יישוב,307,121,186,3,304,192,306,16,5.75%
2013-01,חיפה,637,ערערה,יישוב,611,243,368,5,606,420,611,17,7.87%
2013-01,חיפה,537,פוריידיס,יישוב,405,205,200,4,401,276,403,7,7.57%
2013-01,חיפה,7800,פרדס חנה-כרכור,יישוב,863,380,483,146,717,296,859,40,4.43%
2013-01,חיפה,6800,קריית אתא,יישוב,1750,786,964,173,1577,1025,1741,73,5.94%
2013-01,חיפה,9500,קריית ביאליק,יישוב,1181,483,698,126,1055,629,1176,48,5.44%
2013-01,חיפה,2300,קריית טבעון,יישוב,199,103,96,67,132,49,197,3,2.35%
2013-01,חיפה,9600,קריית ים,יישוב,1625,766,859,174,1451,1006,1621,88,7.53%
2013-01,חיפה,8200,קריית מוצקין,יישוב,1108,481,627,168,940,561,1103,46,4.86%
2013-01,חיפה,922,רכסים,יישוב,153,79,74,12,141,88,152,3,4.66%
2013-01,ירושלים,472,אבו גוש,יישוב,256,123,133,5,251,196,256,2,8.87%
2013-01,ירושלים,2610,בית שמש,יישוב,1191,529,662,90,1101,574,1185,61,3.99%
2013-01,ירושלים,3000,ירושלים,יישוב,10759,4858,5901,1264,9495,6718,10698,293,3.70%
2013-01,ירושלים,1015,מבשרת ציון,יישוב,379,177,202,64,315,177,378,7,2.89%
2013-01,ירושלים,1137,קריית יערים,יישוב,36,14,22,4,32,16,36,0,2.95%
2013-01,תל אביב,2400,אור יהודה,יישוב,872,411,461,39,833,288,859,25,4.58%
2013-01,תל אביב,565,אזור,יישוב,208,104,104,29,179,36,207,1,3.32%
2013-01,תל אביב,6100,בני ברק,יישוב,2309,1149,1160,107,2202,1337,2291,7,4.27%
2013-01,תל אביב,6200,בת ים,יישוב,3353,1632,1721,458,2895,1332,3283,37,4.59%
2013-01,תל אביב,6300,גבעתיים,יישוב,747,338,409,321,426,94,742,2,2.50%
2013-01,תל אביב,6400,הרצלייה,יישוב,1021,461,560,299,722,54,1004,123,2.12%
2013-01,תל אביב,6600,חולון,יישוב,3342,1562,1780,510,2832,916,3296,29,3.35%
2013-01,תל אביב,2620,קריית אונו,יישוב,386,169,217,124,262,48,383,41,2.10%
2013-01,תל אביב,8600,רמת גן,יישוב,2147,1025,1122,669,1478,461,2123,12,2.76%
2013-01,תל אביב,2650,רמת השרון,יישוב,400,168,232,157,243,8,397,44,1.79%
2013-01,תל אביב,5000,תל אביב -יפו,יישוב,8086,3973,4113,2510,5576,2606,7999,36,3.22%
2013-02,אזור יהודה והשומרון,3760,אורנית,יישוב,111,51,60,40,71,4,111,0,2.48%
2013-02,אזור יהודה והשומרון,3750,אלפי מנשה,יישוב,112,49,63,39,73,0,111,1,2.61%
2013-02,אזור יהודה והשומרון,3560,אלקנה,יישוב,29,13,16,16,13,1,29,1,1.58%
2013-02,אזור יהודה והשומרון,3650,אפרת,יישוב,49,23,26,22,27,7,49,1,1.24%
2013-02,אזור יהודה והשומרון,3570,אריאל,יישוב,382,179,203,71,311,105,381,12,3.66%
2013-02,אזור יהודה והשומרון,3574,בית אל,יישוב,47,23,24,18,29,20,46,0,1.93%
2013-02,אזור יהודה והשומרון,3652,בית אריה,יישוב,52,24,28,6,46,2,52,0,2.13%
2013-02,אזור יהודה והשומרון,3780,ביתר עילית,יישוב,417,207,210,14,403,199,412,1,3.68%
2013-02,אזור יהודה והשומרון,3730,גבעת זאב,יישוב,157,72,85,25,132,40,156,0,2.16%
2013-02,אזור יהודה והשומרון,3769,הר אדר,יישוב,23,10,13,12,11,2,23,0,1.16%
2013-02,אזור יהודה והשומרון,3797,מודיעין עילית,יישוב,327,130,197,18,309,107,320,2,2.46%
2013-02,אזור יהודה והשומרון,3616,מעלה אדומים,יישוב,589,232,357,101,488,182,585,3,2.92%
2013-02,אזור יהודה והשומרון,3660,עמנואל,יישוב,75,30,45,5,70,50,75,2,6.82%
2013-02,אזור יהודה והשומרון,3557,קדומים,יישוב,39,18,21,10,29,9,39,1,2.17%
2013-02,אזור יהודה והשומרון,3611,קריית ארבע,יישוב,103,48,55,23,80,59,103,0,3.32%
2013-02,אזור יהודה והשומרון,3640,קרני שומרון,יישוב,93,44,49,26,67,14,93,1,2.63%
2013-02,הדרום,31,אופקים,יישוב,1334,612,722,101,1233,967,1327,18,10.53%
2013-02,הדרום,2600,אילת,יישוב,1668,737,931,77,1591,627,1655,46,4.99%
2013-02,הדרום,70,אשדוד,יישוב,6879,2834,4045,752,6127,3796,6836,167,6.35%
2013-02,הדרום,7100,אשקלון,יישוב,4369,1766,2603,691,3678,2628,4271,97,6.36%
2013-02,הדרום,9000,באר שבע,יישוב,7317,3296,4021,977,6340,4550,7256,233,7.04%
2013-02,הדרום,2200,דימונה,יישוב,2199,932,1267,140,2059,1521,2176,60,11.83%
2013-02,הדרום,1303,חורה,יישוב,775,329,446,1,774,718,774,0,20.05%
2013-02,הדרום,831,ירוחם,יישוב,432,213,219,22,410,274,427,22,9.54%
2013-02,הדרום,1059,כסיפה,יישוב,1000,438,562,1,999,897,996,10,22.34%
2013-02,הדרום,1271,להבים,יישוב,45,17,28,22,23,4,45,0,1.32%
2013-02,הדרום,1060,לקיה,יישוב,999,445,554,2,997,927,999,4,24.66%
2013-02,הדרום,1268,מיתר,יישוב,49,23,26,18,31,6,49,2,1.18%
2013-02,הדרום,99,מצפה רמון,יישוב,232,87,145,11,221,144,225,8,9.24%
2013-02,הדרום,246,נתיבות,יישוב,1015,462,553,58,957,542,1008,32,7.55%
2013-02,הדרום,666,עומר,יישוב,53,26,27,22,31,4,53,2,1.31%
2013-02,הדרום,2560,ערד,יישוב,800,365,435,137,663,446,781,55,6.26%
2013-02,הדרום,1192,ערערה-בנגב,יישוב,984,404,580,3,981,905,983,0,24.70%
2013-02,הדרום,2630,קריית גת,יישוב,2417,986,1431,180,2237,1504,2410,57,8.61%
2013-02,הדרום,1034,קריית מלאכי,יישוב,1262,575,687,35,1227,805,1248,89,10.63%
2013-02,הדרום,1161,רהט,יישוב,3165,1349,1816,9,3156,2817,3164,18,17.61%
2013-02,הדרום,1286,שגב-שלום,יישוב,516,202,314,0,516,462,515,5,20.56%
2013-02,הדרום,1031,שדרות,יישוב,1117,492,625,53,1064,706,1110,20,8.88%
2013-02,הדרום,1054,תל שבע,יישוב,1177,552,625,1,1176,1097,1175,6,25.20%
2013-02,המרכז,182,אבן יהודה,יישוב,167,78,89,62,105,20,166,2,2.51%
2013-02,המרכז,41,אליכין,יישוב,52,29,23,4,48,20,52,0,2.87%
2013-02,המרכז,1309,אלעד,יישוב,418,189,229,22,396,117,417,0,3.51%
2013-02,המרכז,2530,באר יעקב,יישוב,243,112,131,42,201,59,241,2,2.79%
2013-02,המרכז,466,בית דגן,יישוב,124,59,65,21,103,43,124,1,3.52%
2013-02,המרכז,1066,"בני עי""ש",יישוב,191,92,99,25,166,72,190,2,4.81%
2013-02,המרכז,681,גבעת שמואל,יישוב,332,175,157,138,194,67,331,0,2.84%
2013-02,המרכז,2550,גדרה,יישוב,349,147,202,59,290,102,345,0,3.04%
2013-02,המרכז,627,ג'לג'וליה,יישוב,87,42,45,1,86,47,86,0,2.53%
2013-02,המרכז,166,גן יבנה,יישוב,378,151,227,39,339,102,377,8,3.43%
2013-02,המרכז,229,גני תקווה,יישוב,197,86,111,63,134,27,196,0,2.43%
2013-02,המרכז,9700,הוד השרון,יישוב,648,319,329,215,433,59,643,5,2.30%
2013-02,המרכז,1290,זמר,יישוב,171,58,113,7,164,122,171,0,6.07%
2013-02,המרכז,2730,טייבה,יישוב,2212,942,1270,14,2198,1885,2208,28,12.93%
2013-02,המרכז,2720,טירה,יישוב,352,167,185,12,340,186,351,12,3.22%
2013-02,המרכז,2660,יבנה,יישוב,902,430,472,92,810,386,896,23,4.11%
2013-02,המרכז,9400,יהוד,יישוב,583,250,333,84,499,78,570,13,3.66%
2013-02,המרכז,1224,כוכב יאיר,יישוב,113,48,65,56,57,1,113,0,2.03%
2013-02,המרכז,633,כפר ברא,יישוב,33,20,13,2,31,13,33,0,2.58%
2013-02,המרכז,168,כפר יונה,יישוב,299,133,166,64,235,64,296,6,2.83%
2013-02,המרכז,6900,כפר סבא,יישוב,1254,534,720,394,860,190,1247,20,2.43%
2013-02,המרכז,634,כפר קאסם,יישוב,248,122,126,3,245,152,246,2,2.89%
2013-02,המרכז,7000,לוד,יישוב,2215,989,1226,152,2063,1232,2194,21,6.26%
2013-02,המרכז,1200,מודיעין-מכבים-רעות*,יישוב,940,393,547,327,613,55,932,5,2.24%
2013-02,המרכז,28,מזכרת בתיה,יישוב,155,70,85,27,128,36,154,0,2.32%
2013-02,המרכז,7200,נס ציונה,יישוב,698,323,375,159,539,214,693,1,3.06%
2013-02,המרכז,7400,נתניה,יישוב,4282,2033,2249,627,3655,1573,4256,94,4.14%
2013-02,המרכז,587,סביון*,יישוב,11,6,5,6,5,0,11,0,0.59%
2013-02,המרכז,171,פרדסייה,יישוב,65,30,35,14,51,6,65,0,1.85%
2013-02,המרכז,7900,פתח תקווה,יישוב,4121,1882,2239,836,3285,1116,4092,18,3.38%
2013-02,המרכז,195,קדימה-צורן,יישוב,269,118,151,77,192,36,266,3,2.67%
2013-02,המרכז,638,קלנסווה,יישוב,930,368,562,4,926,798,927,7,11.03%
2013-02,המרכז,469,קריית עקרון,יישוב,305,148,157,17,288,143,303,1,5.18%
2013-02,המרכז,2640,ראש העין,יישוב,711,367,344,99,612,156,706,22,3.16%
2013-02,המרכז,8300,ראשון לציון,יישוב,4680,2101,2579,976,3704,1546,4657,23,3.43%
2013-02,המרכז,8400,רחובות,יישוב,2562,1146,1416,551,2011,1046,2515,9,3.84%
2013-02,המרכז,8500,רמלה,יישוב,1832,870,962,124,1708,839,1790,24,4.96%
2013-02,המרכז,8700,רעננה,יישוב,763,376,387,289,474,78,762,9,2.07%
2013-02,המרכז,1304,שוהם,יישוב,198,92,106,78,120,9,198,1,1.87%
2013-02,המרכז,154,תל מונד,יישוב,126,61,65,36,90,24,126,1,2.14%
2013-02,הצפון,473,אבו סנאן,יישוב,766,300,466,5,761,652,760,2,13.48%
2013-02,הצפון,478,אכסאל,יישוב,533,228,305,18,515,450,533,3,9.88%
2013-02,הצפון,529,אעבלין,יישוב,635,262,373,11,624,525,635,3,11.61%
2013-02,הצפון,482,בועיינה-נוג'ידאת,יישוב,408,174,234,4,404,350,404,2,10.89%
2013-02,הצפון,4001,בוקעאתא,יישוב,416,159,257,6,410,362,409,1,15.39%
2013-02,הצפון,998,ביר אל-מכסור,יישוב,411,146,265,1,410,346,411,6,11.66%
2013-02,הצפון,480,בית ג'ן,יישוב,350,115,235,8,342,250,350,1,6.93%
2013-02,הצפון,9200,בית שאן,יישוב,815,360,455,20,795,466,814,44,8.21%
2013-02,הצפון,944,בסמת טבעון,יישוב,216,102,114,3,213,162,216,2,7.08%
2013-02,הצפון,483,בענה,יישוב,407,164,243,1,406,342,407,5,12.59%
2013-02,הצפון,1292,ג'דיידה-מכר,יישוב,1523,628,895,5,1518,1349,1517,0,17.19%
2013-02,הצפון,485,ג'ולס,יישוב,250,65,185,1,249,165,249,0,8.92%
2013-02,הצפון,487,ג'ש (גוש חלב),יישוב,58,28,30,4,54,30,57,1,3.61%
2013-02,הצפון,489,דבורייה,יישוב,406,182,224,16,390,311,406,1,9.87%
2013-02,הצפון,490,דייר אל-אסד,יישוב,399,171,228,5,394,311,399,4,8.12%
2013-02,הצפון,492,דייר חנא,יישוב,667,295,372,11,656,515,667,4,14.26%
2013-02,הצפון,975,זרזיר,יישוב,341,158,183,1,340,243,334,1,11.48%
2013-02,הצפון,496,חורפיש,יישוב,130,52,78,4,126,72,129,3,5.00%
2013-02,הצפון,2034,חצור הגלילית,יישוב,267,113,154,15,252,138,260,14,5.59%
2013-02,הצפון,6700,טבריה,יישוב,1857,839,1018,93,1764,1143,1716,35,7.89%
2013-02,הצפון,962,טובא-זנגרייה,יישוב,366,161,205,4,362,264,361,1,12.25%
2013-02,הצפון,498,טורעאן,יישוב,548,217,331,5,543,473,542,16,9.97%
2013-02,הצפון,8900,טמרה,יישוב,1996,794,1202,17,1979,1748,1987,8,14.68%
2013-02,הצפון,1295,יאנוח-ג'ת,יישוב,154,49,105,3,151,108,152,4,5.81%
2013-02,הצפון,46,יבנאל,יישוב,159,108,51,8,151,120,148,1,9.45%
2013-02,הצפון,499,יפיע,יישוב,643,293,350,12,631,498,641,4,8.53%
2013-02,הצפון,240,יקנעם עילית,יישוב,503,211,292,78,425,175,501,22,4.41%
2013-02,הצפון,502,ירכא,יישוב,547,221,326,1,546,437,546,0,9.99%
2013-02,הצפון,504,כאבול,יישוב,673,257,416,3,670,592,669,1,14.02%
2013-02,הצפון,505,כאוכב אבו אל-היג'א,יישוב,223,102,121,3,220,189,223,0,13.52%
2013-02,הצפון,1296,כסרא-סמיע,יישוב,215,85,130,5,210,162,215,2,6.62%
2013-02,הצפון,978,כעביה-טבאש-חג'אג'רה,יישוב,214,83,131,1,213,150,213,2,9.85%
2013-02,הצפון,1263,כפר ורדים,יישוב,63,28,35,23,40,9,62,3,2.00%
2013-02,הצפון,507,כפר יאסיף,יישוב,550,230,320,5,545,443,550,1,10.94%
2013-02,הצפון,508,כפר כמא,יישוב,70,29,41,1,69,32,69,1,4.37%
2013-02,הצפון,509,כפר כנא,יישוב,1188,458,730,26,1162,1046,1182,26,13.83%
2013-02,הצפון,510,כפר מנדא,יישוב,957,431,526,11,946,712,950,3,13.49%
2013-02,הצפון,47,כפר תבור,יישוב,41,18,23,10,31,7,41,0,2.00%
2013-02,הצפון,1139,כרמיאל,יישוב,1688,669,1019,337,1351,877,1650,14,6.38%
2013-02,הצפון,481,מגאר,יישוב,1489,598,891,20,1469,1309,1483,4,17.12%
2013-02,הצפון,516,מג'ד אל-כרום,יישוב,569,254,315,2,567,436,569,9,9.10%
2013-02,הצפון,874,מגדל העמק,יישוב,988,413,575,78,910,474,964,54,7.22%
2013-02,הצפון,4201,מג'דל שמס,יישוב,472,175,297,12,460,404,469,8,10.03%
2013-02,הצפון,517,מזרעה,יישוב,180,66,114,3,177,137,179,0,9.27%
2013-02,הצפון,4203,מסעדה,יישוב,206,77,129,8,198,161,205,2,12.45%
2013-02,הצפון,518,מעיליא,יישוב,41,21,20,2,39,16,40,0,2.60%
2013-02,הצפון,1063,מעלות-תרשיחא,יישוב,868,423,445,108,760,528,857,22,7.21%
2013-02,הצפון,520,משהד,יישוב,305,113,192,11,294,255,304,10,9.79%
2013-02,הצפון,9100,נהרייה,יישוב,1988,900,1088,226,1762,1234,1977,21,6.48%
2013-02,הצפון,522,נחף,יישוב,407,177,230,8,399,334,407,1,8.64%
2013-02,הצפון,7300,נצרת,יישוב,3167,1391,1776,104,3063,2485,3161,21,9.45%
2013-02,הצפון,1061,נצרת עילית,יישוב,1913,836,1077,254,1659,1078,1831,92,7.68%
2013-02,הצפון,525,סאג'ור,יישוב,104,38,66,0,104,71,104,0,6.19%
2013-02,הצפון,7500,סח'נין,יישוב,2102,929,1173,32,2070,1781,2100,3,15.60%
2013-02,הצפון,4501,ע'ג'ר,יישוב,77,35,42,4,73,58,76,0,7.83%
2013-02,הצפון,530,עיילבון,יישוב,200,78,122,7,193,147,200,0,7.51%
2013-02,הצפון,511,עילוט,יישוב,312,132,180,3,309,252,312,1,11.52%
2013-02,הצפון,532,עין מאהל,יישוב,609,275,334,10,599,512,601,9,12.35%
2013-02,הצפון,7600,עכו,יישוב,3229,1495,1734,138,3091,2520,3202,33,12.14%
2013-02,הצפון,7700,עפולה,יישוב,1601,665,936,183,1418,821,1569,52,6.49%
2013-02,הצפון,531,עראבה,יישוב,1460,612,848,30,1430,1293,1457,4,15.05%
2013-02,הצפון,535,פסוטה,יישוב,116,51,65,3,113,80,116,3,7.05%
2013-02,הצפון,536,פקיעין (בוקייעה),יישוב,141,75,66,5,136,86,140,1,5.25%
2013-02,הצפון,8000,צפת,יישוב,1336,712,624,90,1246,1058,1319,3,10.02%
2013-02,הצפון,4100,קצרין,יישוב,177,76,101,37,140,74,174,0,4.46%
2013-02,הצפון,2800,קריית שמונה,יישוב,680,330,350,56,624,286,662,12,5.15%
2013-02,הצפון,543,ראמה,יישוב,317,123,194,8,309,246,316,0,8.36%
2013-02,הצפון,26,ראש פינה,יישוב,46,13,33,5,41,16,45,1,2.89%
2013-02,הצפון,542,ריינה,יישוב,665,273,392,8,657,545,661,12,10.13%
2013-02,הצפון,122,רמת ישי,יישוב,97,36,61,28,69,16,97,1,2.37%
2013-02,הצפון,913,שבלי - אום אל-גנם,יישוב,216,97,119,3,213,148,215,0,8.67%
2013-02,הצפון,812,שלומי,יישוב,238,102,136,18,220,153,237,3,6.61%
2013-02,הצפון,538,שעב,יישוב,516,212,304,6,510,457,516,2,17.63%
2013-02,הצפון,8800,שפרעם,יישוב,1951,723,1228,25,1926,1650,1944,10,11.46%
2013-02,חיפה,2710,אום אל-פחם,יישוב,3879,1597,2282,20,3859,3350,3874,6,19.18%
2013-02,חיפה,1020,אור עקיבא,יישוב,587,252,335,39,548,227,578,20,5.88%
2013-02,חיפה,6000,באקה אל-גרביה,יישוב,689,322,367,17,672,460,689,15,6.23%
2013-02,חיפה,9800,בנימינה-גבעת עדה*,יישוב,190,71,119,50,140,60,189,3,2.78%
2013-02,חיפה,1326,"בסמ""ה",יישוב,449,195,254,1,448,358,449,5,11.78%
2013-02,חיפה,541,ג'סר א-זרקא,יישוב,426,246,180,0,426,301,424,4,7.42%
2013-02,חיפה,628,ג'ת,יישוב,218,95,123,10,208,137,218,2,4.45%
2013-02,חיפה,494,דאלית אל-כרמל,יישוב,549,234,315,8,541,312,545,6,7.16%
2013-02,חיפה,9300,זכרון יעקב,יישוב,239,102,137,80,159,48,236,0,2.28%
2013-02,חיפה,6500,חדרה,יישוב,2339,952,1387,297,2042,986,2310,31,4.79%
2013-02,חיפה,4000,חיפה,יישוב,6567,3213,3354,1138,5429,3768,6537,72,4.62%
2013-02,חיפה,1247,חריש,יישוב,22,11,11,6,16,6,22,0,1.44%
2013-02,חיפה,2100,טירת כרמל,יישוב,740,337,403,27,713,432,736,17,7.10%
2013-02,חיפה,654,כפר קרע,יישוב,392,169,223,4,388,241,391,5,4.87%
2013-02,חיפה,1327,מעלה עירון,יישוב,975,388,587,2,973,810,975,3,17.24%
2013-02,חיפה,2500,נשר,יישוב,479,228,251,80,399,207,477,5,3.73%
2013-02,חיפה,534,עספיא,יישוב,303,131,172,4,299,184,303,7,5.70%
2013-02,חיפה,637,ערערה,יישוב,604,240,364,6,598,419,604,11,7.79%
2013-02,חיפה,537,פוריידיס,יישוב,412,215,197,3,409,275,410,5,7.69%
2013-02,חיפה,7800,פרדס חנה-כרכור,יישוב,798,354,444,129,669,291,792,29,4.10%
2013-02,חיפה,6800,קריית אתא,יישוב,1659,747,912,162,1497,962,1652,14,5.66%
2013-02,חיפה,9500,קריית ביאליק,יישוב,1134,468,666,127,1007,620,1128,13,5.23%
2013-02,חיפה,2300,קריית טבעון,יישוב,175,85,90,62,113,40,173,1,2.07%
2013-02,חיפה,9600,קריית ים,יישוב,1534,712,822,167,1367,982,1531,11,7.14%
2013-02,חיפה,8200,קריית מוצקין,יישוב,1072,470,602,163,909,543,1070,10,4.72%
2013-02,חיפה,922,רכסים,יישוב,128,65,63,10,118,73,127,1,3.93%
2013-02,ירושלים,472,אבו גוש,יישוב,269,136,133,6,263,194,267,0,9.22%
2013-02,ירושלים,2610,בית שמש,יישוב,1215,552,663,97,1118,575,1190,25,4.01%
2013-02,ירושלים,3000,ירושלים,יישוב,11024,4955,6069,1275,9749,6853,10912,43,3.78%
2013-02,ירושלים,1015,מבשרת ציון,יישוב,380,180,200,69,311,171,378,0,2.89%
2013-02,ירושלים,1137,קריית יערים,יישוב,37,16,21,6,31,17,37,0,3.03%
2013-02,תל אביב,2400,אור יהודה,יישוב,891,421,470,37,854,277,872,22,4.65%
2013-02,תל אביב,565,אזור,יישוב,183,91,92,26,157,30,177,0,2.85%
2013-02,תל אביב,6100,בני ברק,יישוב,2472,1218,1254,126,2346,1421,2456,1,4.56%
2013-02,תל אביב,6200,בת ים,יישוב,3444,1665,1779,468,2976,1296,3366,41,4.70%
2013-02,תל אביב,6300,גבעתיים,יישוב,780,356,424,335,445,103,775,0,2.61%
2013-02,תל אביב,6400,הרצלייה,יישוב,1045,468,577,308,737,57,1026,9,2.17%
2013-02,תל אביב,6600,חולון,יישוב,3362,1593,1769,497,2865,921,3296,24,3.35%
2013-02,תל אביב,2620,קריית אונו,יישוב,403,181,222,130,273,44,400,1,2.19%
2013-02,תל אביב,8600,רמת גן,יישוב,2171,1011,1160,674,1497,480,2139,10,2.78%
2013-02,תל אביב,2650,רמת השרון,יישוב,410,170,240,154,256,11,407,2,1.84%
2013-02,תל אביב,5000,תל אביב -יפו,יישוב,8184,4068,4116,2449,5735,2630,8066,37,3.25%
2013-03,אזור יהודה והשומרון,3760,אורנית,יישוב,94,47,47,33,61,4,94,0,2.11%
2013-03,אזור יהודה והשומרון,3750,אלפי מנשה,יישוב,125,56,69,39,86,0,124,0,2.91%
2013-03,אזור יהודה והשומרון,3560,אלקנה,יישוב,29,14,15,13,16,1,29,1,1.58%
2013-03,אזור יהודה והשומרון,3650,אפרת,יישוב,51,27,24,19,32,6,50,0,1.27%
2013-03,אזור יהודה והשומרון,3570,אריאל,יישוב,369,170,199,70,299,105,367,4,3.53%
2013-03,אזור יהודה והשומרון,3574,בית אל,יישוב,45,24,21,14,31,20,44,0,1.85%
2013-03,אזור יהודה והשומרון,3652,בית אריה,יישוב,51,24,27,8,43,2,51,0,2.09%
2013-03,אזור יהודה והשומרון,3780,ביתר עילית,יישוב,423,218,205,10,413,202,409,1,3.65%
2013-03,אזור יהודה והשומרון,3730,גבעת זאב,יישוב,144,67,77,23,121,38,144,1,2.00%
2013-03,אזור יהודה והשומרון,3769,הר אדר,יישוב,25,10,15,11,14,2,25,0,1.26%
2013-03,אזור יהודה והשומרון,3797,מודיעין עילית,יישוב,346,133,213,13,333,108,340,5,2.61%
2013-03,אזור יהודה והשומרון,3616,מעלה אדומים,יישוב,604,238,366,91,513,185,597,4,2.97%
2013-03,אזור יהודה והשומרון,3660,עמנואל,יישוב,74,33,41,5,69,53,74,0,6.74%
2013-03,אזור יהודה והשומרון,3557,קדומים,יישוב,37,21,16,8,29,9,36,0,2.01%
2013-03,אזור יהודה והשומרון,3611,קריית ארבע,יישוב,104,48,56,21,83,56,104,0,3.35%
2013-03,אזור יהודה והשומרון,3640,קרני שומרון,יישוב,70,30,40,18,52,12,69,0,1.96%
2013-03,הדרום,31,אופקים,יישוב,1269,598,671,95,1174,934,1264,6,10.08%
2013-03,הדרום,2600,אילת,יישוב,1523,669,854,70,1453,584,1510,16,4.57%
2013-03,הדרום,70,אשדוד,יישוב,6418,2596,3822,691,5727,3659,6380,22,5.95%
2013-03,הדרום,7100,אשקלון,יישוב,4077,1614,2463,605,3472,2531,3977,21,5.95%
2013-03,הדרום,9000,באר שבע,יישוב,6858,3081,3777,915,5943,4392,6805,44,6.63%
2013-03,הדרום,2200,דימונה,יישוב,2066,889,1177,127,1939,1473,2043,21,11.19%
2013-03,הדרום,1303,חורה,יישוב,761,319,442,1,760,711,761,0,19.78%
2013-03,הדרום,831,ירוחם,יישוב,401,189,212,25,376,271,398,15,8.95%
2013-03,הדרום,1059,כסיפה,יישוב,970,416,554,1,969,881,967,0,21.83%
2013-03,הדרום,1271,להבים,יישוב,41,16,25,21,20,4,41,0,1.20%
2013-03,הדרום,1060,לקיה,יישוב,957,420,537,1,956,898,957,0,23.87%
2013-03,הדרום,1268,מיתר,יישוב,46,20,26,17,29,5,46,0,1.11%
2013-03,הדרום,99,מצפה רמון,יישוב,235,93,142,11,224,151,227,3,9.31%
2013-03,הדרום,246,נתיבות,יישוב,906,422,484,47,859,520,903,3,6.82%
2013-03,הדרום,666,עומר,יישוב,53,27,26,21,32,4,53,1,1.31%
2013-03,הדרום,2560,ערד,יישוב,743,347,396,128,615,432,726,16,5.84%
2013-03,הדרום,1192,ערערה-בנגב,יישוב,969,382,587,2,967,896,966,0,24.38%
2013-03,הדרום,2630,קריית גת,יישוב,2197,893,1304,169,2028,1447,2191,25,7.89%
2013-03,הדרום,1034,קריית מלאכי,יישוב,1111,486,625,34,1077,776,1099,17,9.48%
2013-03,הדרום,1161,רהט,יישוב,3071,1283,1788,8,3063,2781,3065,19,17.15%
2013-03,הדרום,1286,שגב-שלום,יישוב,488,188,300,0,488,441,486,0,19.63%
2013-03,הדרום,1031,שדרות,יישוב,1063,466,597,48,1015,690,1056,8,8.49%
2013-03,הדרום,1054,תל שבע,יישוב,1152,533,619,2,1150,1086,1147,1,24.75%
2013-03,המרכז,182,אבן יהודה,יישוב,156,74,82,56,100,19,155,0,2.35%
2013-03,המרכז,41,אליכין,יישוב,50,29,21,4,46,16,49,0,2.71%
2013-03,המרכז,1309,אלעד,יישוב,399,189,210,18,381,118,397,0,3.35%
2013-03,המרכז,2530,באר יעקב,יישוב,242,110,132,42,200,60,239,0,2.76%
2013-03,המרכז,466,בית דגן,יישוב,118,57,61,25,93,41,118,1,3.35%
2013-03,המרכז,1066,"בני עי""ש",יישוב,198,93,105,24,174,72,198,0,5.00%
2013-03,המרכז,681,גבעת שמואל,יישוב,319,169,150,136,183,63,319,0,2.74%
2013-03,המרכז,2550,גדרה,יישוב,343,148,195,53,290,105,336,1,2.97%
2013-03,המרכז,627,ג'לג'וליה,יישוב,94,42,52,1,93,50,93,0,2.73%
2013-03,המרכז,166,גן יבנה,יישוב,355,142,213,33,322,95,353,1,3.22%
2013-03,המרכז,229,גני תקווה,יישוב,176,80,96,62,114,22,175,0,2.18%
2013-03,המרכז,9700,הוד השרון,יישוב,666,320,346,207,459,56,660,0,2.36%
2013-03,המרכז,1290,זמר,יישוב,174,56,118,7,167,128,174,1,6.17%
2013-03,המרכז,2730,טייבה,יישוב,2243,961,1282,13,2230,1905,2214,15,12.96%
2013-03,המרכז,2720,טירה,יישוב,346,160,186,7,339,181,342,3,3.14%
2013-03,המרכז,2660,יבנה,יישוב,864,413,451,86,778,377,858,11,3.94%
2013-03,המרכז,9400,יהוד,יישוב,494,196,298,77,417,75,484,8,3.12%
2013-03,המרכז,1224,כוכב יאיר,יישוב,134,57,77,53,81,1,134,0,2.40%
2013-03,המרכז,633,כפר ברא,יישוב,30,17,13,2,28,15,30,0,2.35%
2013-03,המרכז,168,כפר יונה,יישוב,291,120,171,65,226,65,286,2,2.74%
2013-03,המרכז,6900,כפר סבא,יישוב,1313,569,744,393,920,201,1295,5,2.53%
2013-03,המרכז,634,כפר קאסם,יישוב,258,130,128,3,255,152,256,1,3.01%
2013-03,המרכז,7000,לוד,יישוב,2219,999,1220,140,2079,1244,2195,15,6.27%
2013-03,המרכז,1200,מודיעין-מכבים-רעות*,יישוב,982,433,549,307,675,59,972,10,2.33%
2013-03,המרכז,28,מזכרת בתיה,יישוב,155,68,87,28,127,29,154,0,2.32%
2013-03,המרכז,7200,נס ציונה,יישוב,719,333,386,145,574,213,714,0,3.15%
2013-03,המרכז,7400,נתניה,יישוב,4336,1998,2338,604,3732,1683,4247,12,4.14%
2013-03,המרכז,587,סביון*,יישוב,11,6,5,4,7,1,11,0,0.59%
2013-03,המרכז,171,פרדסייה,יישוב,69,33,36,17,52,9,66,0,1.87%
2013-03,המרכז,7900,פתח תקווה,יישוב,4116,1881,2235,846,3270,1094,4084,15,3.38%
2013-03,המרכז,195,קדימה-צורן,יישוב,261,119,142,70,191,35,260,2,2.61%
2013-03,המרכז,638,קלנסווה,יישוב,957,390,567,4,953,807,942,2,11.19%
2013-03,המרכז,469,קריית עקרון,יישוב,306,149,157,18,288,135,304,2,5.20%
2013-03,המרכז,2640,ראש העין,יישוב,714,361,353,82,632,152,706,3,3.16%
2013-03,המרכז,8300,ראשון לציון,יישוב,4711,2114,2597,913,3798,1506,4691,47,3.45%
2013-03,המרכז,8400,רחובות,יישוב,2536,1173,1363,516,2020,1017,2489,16,3.80%
2013-03,המרכז,8500,רמלה,יישוב,1804,843,961,118,1686,828,1761,39,4.89%
2013-03,המרכז,8700,רעננה,יישוב,795,370,425,281,514,90,790,2,2.15%
2013-03,המרכז,1304,שוהם,יישוב,187,85,102,71,116,7,187,0,1.77%
2013-03,המרכז,154,תל מונד,יישוב,143,71,72,34,109,27,143,0,2.42%
2013-03,הצפון,473,אבו סנאן,יישוב,768,299,469,5,763,655,761,6,13.50%
2013-03,הצפון,478,אכסאל,יישוב,526,225,301,17,509,449,523,0,9.71%
2013-03,הצפון,529,אעבלין,יישוב,647,264,383,15,632,533,645,2,11.77%
2013-03,הצפון,482,בועיינה-נוג'ידאת,יישוב,416,185,231,5,411,359,407,0,10.96%
2013-03,הצפון,4001,בוקעאתא,יישוב,426,168,258,7,419,362,414,4,15.55%
2013-03,הצפון,998,ביר אל-מכסור,יישוב,407,145,262,2,405,341,406,6,11.53%
2013-03,הצפון,480,בית ג'ן,יישוב,358,124,234,8,350,257,356,0,7.04%
2013-03,הצפון,9200,בית שאן,יישוב,792,362,430,19,773,476,788,29,7.97%
2013-03,הצפון,944,בסמת טבעון,יישוב,212,103,109,2,210,159,212,0,6.95%
2013-03,הצפון,483,בענה,יישוב,407,170,237,1,406,342,406,0,12.56%
2013-03,הצפון,1292,ג'דיידה-מכר,יישוב,1533,645,888,7,1526,1347,1523,11,17.25%
2013-03,הצפון,485,ג'ולס,יישוב,241,65,176,1,240,165,241,0,8.66%
2013-03,הצפון,487,ג'ש (גוש חלב),יישוב,58,28,30,5,53,31,57,1,3.61%
2013-03,הצפון,489,דבורייה,יישוב,404,183,221,16,388,303,403,1,9.81%
2013-03,הצפון,490,דייר אל-אסד,יישוב,398,161,237,7,391,312,398,2,8.10%
2013-03,הצפון,492,דייר חנא,יישוב,668,296,372,12,656,524,668,0,14.28%
2013-03,הצפון,975,זרזיר,יישוב,327,145,182,1,326,243,323,3,11.15%
2013-03,הצפון,496,חורפיש,יישוב,124,54,70,3,121,66,122,1,4.75%
2013-03,הצפון,2034,חצור הגלילית,יישוב,261,113,148,14,247,139,255,4,5.49%
2013-03,הצפון,6700,טבריה,יישוב,1841,843,998,96,1745,1158,1691,29,7.78%
2013-03,הצפון,962,טובא-זנגרייה,יישוב,366,158,208,4,362,258,361,2,12.25%
2013-03,הצפון,498,טורעאן,יישוב,534,210,324,6,528,460,514,2,9.51%
2013-03,הצפון,8900,טמרה,יישוב,2042,829,1213,19,2023,1785,2029,1,14.94%
2013-03,הצפון,1295,יאנוח-ג'ת,יישוב,156,50,106,3,153,104,155,2,5.91%
2013-03,הצפון,46,יבנאל,יישוב,153,103,50,7,146,122,137,1,8.81%
2013-03,הצפון,499,יפיע,יישוב,647,291,356,12,635,502,641,0,8.53%
2013-03,הצפון,240,יקנעם עילית,יישוב,530,238,292,78,452,180,526,22,4.62%
2013-03,הצפון,502,ירכא,יישוב,541,218,323,0,541,432,540,2,9.90%
2013-03,הצפון,504,כאבול,יישוב,687,261,426,5,682,600,682,0,14.25%
2013-03,הצפון,505,כאוכב אבו אל-היג'א,יישוב,223,104,119,3,220,187,223,1,13.52%
2013-03,הצפון,1296,כסרא-סמיע,יישוב,234,99,135,5,229,173,231,3,7.08%
2013-03,הצפון,978,כעביה-טבאש-חג'אג'רה,יישוב,206,80,126,2,204,144,206,0,9.55%
2013-03,הצפון,1263,כפר ורדים,יישוב,58,24,34,20,38,8,58,0,1.87%
2013-03,הצפון,507,כפר יאסיף,יישוב,548,227,321,3,545,443,543,5,10.81%
2013-03,הצפון,508,כפר כמא,יישוב,78,34,44,4,74,32,76,0,4.79%
2013-03,הצפון,509,כפר כנא,יישוב,1172,446,726,21,1151,1037,1144,1,13.45%
2013-03,הצפון,510,כפר מנדא,יישוב,972,432,540,13,959,715,961,0,13.63%
2013-03,הצפון,47,כפר תבור,יישוב,46,22,24,14,32,6,46,1,2.24%
2013-03,הצפון,1139,כרמיאל,יישוב,1735,700,1035,340,1395,900,1678,33,6.49%
2013-03,הצפון,481,מגאר,יישוב,1524,613,911,20,1504,1339,1513,3,17.41%
2013-03,הצפון,516,מג'ד אל-כרום,יישוב,572,259,313,3,569,443,571,4,9.13%
2013-03,הצפון,874,מגדל העמק,יישוב,955,393,562,77,878,473,927,33,6.96%
2013-03,הצפון,4201,מג'דל שמס,יישוב,481,172,309,12,469,408,473,1,10.11%
2013-03,הצפון,517,מזרעה,יישוב,188,73,115,4,184,146,187,1,9.64%
2013-03,הצפון,4203,מסעדה,יישוב,202,78,124,8,194,161,201,2,12.23%
2013-03,הצפון,518,מעיליא,יישוב,44,22,22,2,42,13,44,1,2.85%
2013-03,הצפון,1063,מעלות-תרשיחא,יישוב,870,427,443,98,772,534,857,17,7.21%
2013-03,הצפון,520,משהד,יישוב,303,115,188,11,292,254,296,0,9.56%
2013-03,הצפון,9100,נהרייה,יישוב,1998,929,1069,235,1763,1223,1982,19,6.49%
2013-03,הצפון,522,נחף,יישוב,420,187,233,10,410,347,419,3,8.87%
2013-03,הצפון,7300,נצרת,יישוב,3131,1391,1740,95,3036,2442,3107,2,9.31%
2013-03,הצפון,1061,נצרת עילית,יישוב,1854,836,1018,244,1610,1066,1769,35,7.44%
2013-03,הצפון,525,סאג'ור,יישוב,107,41,66,0,107,76,106,2,6.31%
2013-03,הצפון,7500,סח'נין,יישוב,2112,932,1180,31,2081,1796,2106,4,15.64%
2013-03,הצפון,4501,ע'ג'ר,יישוב,77,36,41,4,73,58,76,0,7.83%
2013-03,הצפון,530,עיילבון,יישוב,195,79,116,8,187,149,194,0,7.30%
2013-03,הצפון,511,עילוט,יישוב,307,118,189,4,303,248,305,0,11.29%
2013-03,הצפון,532,עין מאהל,יישוב,596,274,322,9,587,500,587,2,12.10%
2013-03,הצפון,7600,עכו,יישוב,3192,1480,1712,127,3065,2521,3152,35,11.97%
2013-03,הצפון,7700,עפולה,יישוב,1579,640,939,182,1397,828,1539,20,6.37%
2013-03,הצפון,531,עראבה,יישוב,1474,623,851,25,1449,1303,1470,0,15.16%
2013-03,הצפון,535,פסוטה,יישוב,109,50,59,3,106,77,109,0,6.65%
2013-03,הצפון,536,פקיעין (בוקייעה),יישוב,146,74,72,6,140,88,145,1,5.43%
2013-03,הצפון,8000,צפת,יישוב,1337,719,618,84,1253,1071,1317,9,10.01%
2013-03,הצפון,4100,קצרין,יישוב,193,86,107,39,154,80,189,2,4.83%
2013-03,הצפון,2800,קריית שמונה,יישוב,677,318,359,50,627,290,653,15,5.08%
2013-03,הצפון,543,ראמה,יישוב,313,124,189,9,304,252,308,1,8.16%
2013-03,הצפון,26,ראש פינה,יישוב,49,14,35,5,44,17,48,0,3.07%
2013-03,הצפון,542,ריינה,יישוב,671,274,397,6,665,552,658,1,10.09%
2013-03,הצפון,122,רמת ישי,יישוב,84,33,51,25,59,14,84,0,2.06%
2013-03,הצפון,913,שבלי - אום אל-גנם,יישוב,221,96,125,6,215,154,219,2,8.82%
2013-03,הצפון,812,שלומי,יישוב,238,96,142,20,218,150,236,0,6.59%
2013-03,הצפון,538,שעב,יישוב,524,216,308,7,517,456,523,0,17.83%
2013-03,הצפון,8800,שפרעם,יישוב,1997,751,1246,28,1969,1673,1987,6,11.68%
2013-03,חיפה,2710,אום אל-פחם,יישוב,3895,1579,2316,21,3874,3355,3886,1,19.23%
2013-03,חיפה,1020,אור עקיבא,יישוב,547,245,302,37,510,218,537,13,5.49%
2013-03,חיפה,6000,באקה אל-גרביה,יישוב,691,327,364,16,675,461,690,2,6.24%
2013-03,חיפה,9800,בנימינה-גבעת עדה*,יישוב,192,79,113,49,143,61,192,1,2.82%
2013-03,חיפה,1326,"בסמ""ה",יישוב,439,179,260,1,438,350,438,1,11.52%
2013-03,חיפה,541,ג'סר א-זרקא,יישוב,420,236,184,1,419,302,417,0,7.31%
2013-03,חיפה,628,ג'ת,יישוב,217,93,124,11,206,141,217,1,4.43%
2013-03,חיפה,494,דאלית אל-כרמל,יישוב,530,226,304,6,524,299,527,6,6.94%
2013-03,חיפה,9300,זכרון יעקב,יישוב,251,107,144,78,173,54,248,0,2.39%
2013-03,חיפה,6500,חדרה,יישוב,2349,955,1394,282,2067,1007,2314,11,4.80%
2013-03,חיפה,4000,חיפה,יישוב,6778,3315,3463,1200,5578,3833,6701,38,4.73%
2013-03,חיפה,1247,חריש,יישוב,22,9,13,6,16,7,22,0,1.44%
2013-03,חיפה,2100,טירת כרמל,יישוב,734,332,402,25,709,433,727,16,7.02%
2013-03,חיפה,654,כפר קרע,יישוב,402,176,226,5,397,247,400,1,4.98%
2013-03,חיפה,1327,מעלה עירון,יישוב,972,382,590,2,970,803,970,0,17.17%
2013-03,חיפה,2500,נשר,יישוב,502,243,259,89,413,204,499,1,3.90%
2013-03,חיפה,534,עספיא,יישוב,303,129,174,6,297,186,301,3,5.66%
2013-03,חיפה,637,ערערה,יישוב,613,244,369,3,610,422,611,8,7.87%
2013-03,חיפה,537,פוריידיס,יישוב,399,212,187,2,397,269,394,0,7.41%
2013-03,חיפה,7800,פרדס חנה-כרכור,יישוב,803,363,440,128,675,300,796,9,4.12%
2013-03,חיפה,6800,קריית אתא,יישוב,1746,775,971,170,1576,992,1734,16,5.92%
2013-03,חיפה,9500,קריית ביאליק,יישוב,1145,477,668,119,1026,611,1136,7,5.27%
2013-03,חיפה,2300,קריית טבעון,יישוב,186,93,93,63,123,42,183,1,2.19%
2013-03,חיפה,9600,קריית ים,יישוב,1546,712,834,161,1385,984,1536,9,7.17%
2013-03,חיפה,8200,קריית מוצקין,יישוב,1096,489,607,158,938,553,1089,9,4.80%
2013-03,חיפה,922,רכסים,יישוב,132,65,67,14,118,83,131,1,4.04%
2013-03,ירושלים,472,אבו גוש,יישוב,257,119,138,7,250,193,256,1,8.87%
2013-03,ירושלים,2610,בית שמש,יישוב,1239,565,674,87,1152,587,1208,49,4.06%
2013-03,ירושלים,3000,ירושלים,יישוב,10904,4878,6026,1209,9695,6817,10816,34,3.74%
2013-03,ירושלים,1015,מבשרת ציון,יישוב,373,167,206,62,311,171,371,1,2.84%
2013-03,ירושלים,1137,קריית יערים,יישוב,35,17,18,5,30,15,35,0,2.87%
2013-03,תל אביב,2400,אור יהודה,יישוב,829,368,461,42,787,265,812,19,4.34%
2013-03,תל אביב,565,אזור,יישוב,182,89,93,23,159,27,181,3,2.91%
2013-03,תל אביב,6100,בני ברק,יישוב,2375,1179,1196,111,2264,1410,2347,10,4.37%
2013-03,תל אביב,6200,בת ים,יישוב,3399,1641,1758,431,2968,1297,3321,43,4.64%
2013-03,תל אביב,6300,גבעתיים,יישוב,774,348,426,299,475,104,767,0,2.58%
2013-03,תל אביב,6400,הרצלייה,יישוב,1039,474,565,290,749,56,1022,3,2.16%
2013-03,תל אביב,6600,חולון,יישוב,3356,1596,1760,501,2855,876,3297,21,3.35%
2013-03,תל אביב,2620,קריית אונו,יישוב,413,182,231,137,276,48,410,1,2.25%
2013-03,תל אביב,8600,רמת גן,יישוב,2160,1014,1146,643,1517,477,2129,9,2.77%
2013-03,תל אביב,2650,רמת השרון,יישוב,406,160,246,143,263,9,405,0,1.83%
2013-03,תל אביב,5000,תל אביב -יפו,יישוב,7965,3983,3982,2314,5651,2636,7848,49,3.16%
2013-04,אזור יהודה והשומרון,3760,אורנית,יישוב,96,48,48,31,65,4,96,0,2.15%
2013-04,אזור יהודה והשומרון,3750,אלפי מנשה,יישוב,128,53,75,39,89,2,125,3,2.93%
2013-04,אזור יהודה והשומרון,3560,אלקנה,יישוב,33,16,17,12,21,1,32,0,1.75%
2013-04,אזור יהודה והשומרון,3650,אפרת,יישוב,47,24,23,17,30,6,47,1,1.19%
2013-04,אזור יהודה והשומרון,3570,אריאל,יישוב,405,191,214,71,334,106,402,11,3.86%
2013-04,אזור יהודה והשומרון,3574,בית אל,יישוב,56,28,28,15,41,21,55,1,2.30%
2013-04,אזור יהודה והשומרון,3652,בית אריה,יישוב,51,20,31,9,42,2,51,0,2.09%
2013-04,אזור יהודה והשומרון,3780,ביתר עילית,יישוב,441,218,223,14,427,195,435,16,3.88%
2013-04,אזור יהודה והשומרון,3730,גבעת זאב,יישוב,174,85,89,25,149,43,173,6,2.39%
2013-04,אזור יהודה והשומרון,3769,הר אדר,יישוב,22,9,13,13,9,2,22,0,1.11%
2013-04,אזור יהודה והשומרון,3797,מודיעין עילית,יישוב,372,140,232,15,357,115,364,6,2.79%
2013-04,אזור יהודה והשומרון,3616,מעלה אדומים,יישוב,636,258,378,87,549,199,626,7,3.11%
2013-04,אזור יהודה והשומרון,3660,עמנואל,יישוב,74,34,40,4,70,53,74,0,6.74%
2013-04,אזור יהודה והשומרון,3557,קדומים,יישוב,40,22,18,10,30,9,40,0,2.23%
2013-04,אזור יהודה והשומרון,3611,קריית ארבע,יישוב,110,53,57,20,90,66,110,3,3.54%
2013-04,אזור יהודה והשומרון,3640,קרני שומרון,יישוב,76,34,42,16,60,12,75,2,2.13%
2013-04,הדרום,31,אופקים,יישוב,1330,599,731,90,1240,944,1316,5,10.45%
2013-04,הדרום,2600,אילת,יישוב,1428,647,781,65,1363,606,1401,18,4.25%
2013-04,הדרום,70,אשדוד,יישוב,7026,2862,4164,751,6275,3762,6958,84,6.46%
2013-04,הדרום,7100,אשקלון,יישוב,4506,1780,2726,614,3892,2623,4381,52,6.52%
2013-04,הדרום,9000,באר שבע,יישוב,7371,3274,4097,940,6431,4556,7259,108,7.04%
2013-04,הדרום,2200,דימונה,יישוב,2241,962,1279,127,2114,1507,2198,32,11.94%
2013-04,הדרום,1303,חורה,יישוב,774,321,453,1,773,722,773,1,20.03%
2013-04,הדרום,831,ירוחם,יישוב,436,205,231,25,411,273,427,19,9.54%
2013-04,הדרום,1059,כסיפה,יישוב,995,412,583,1,994,902,993,2,22.28%
2013-04,הדרום,1271,להבים,יישוב,47,15,32,26,21,5,47,0,1.37%
2013-04,הדרום,1060,לקיה,יישוב,995,442,553,1,994,932,991,3,24.51%
2013-04,הדרום,1268,מיתר,יישוב,66,30,36,22,44,8,66,2,1.58%
2013-04,הדרום,99,מצפה רמון,יישוב,259,100,159,15,244,157,248,8,10.09%
2013-04,הדרום,246,נתיבות,יישוב,1126,500,626,57,1069,554,1098,26,8.17%
2013-04,הדרום,666,עומר,יישוב,58,32,26,21,37,4,57,0,1.41%
2013-04,הדרום,2560,ערד,יישוב,765,350,415,121,644,459,733,14,5.90%
2013-04,הדרום,1192,ערערה-בנגב,יישוב,1014,398,616,2,1012,926,1011,1,25.23%
2013-04,הדרום,2630,קריית גת,יישוב,2321,961,1360,163,2158,1476,2293,21,8.23%
2013-04,הדרום,1034,קריית מלאכי,יישוב,1295,577,718,29,1266,799,1258,42,10.70%
2013-04,הדרום,1161,רהט,יישוב,3200,1353,1847,7,3193,2828,3185,6,17.71%
2013-04,הדרום,1286,שגב-שלום,יישוב,514,198,316,1,513,451,513,0,20.50%
2013-04,הדרום,1031,שדרות,יישוב,1180,504,676,47,1133,715,1168,13,9.31%
2013-04,הדרום,1054,תל שבע,יישוב,1175,550,625,2,1173,1101,1166,1,25.05%
2013-04,המרכז,182,אבן יהודה,יישוב,171,76,95,59,112,20,170,2,2.57%
2013-04,המרכז,41,אליכין,יישוב,63,34,29,5,58,19,63,1,3.46%
2013-04,המרכז,1309,אלעד,יישוב,455,205,250,23,432,130,452,1,3.79%
2013-04,המרכז,2530,באר יעקב,יישוב,252,111,141,45,207,61,247,1,2.85%
2013-04,המרכז,466,בית דגן,יישוב,129,62,67,24,105,43,128,0,3.63%
2013-04,המרכז,1066,"בני עי""ש",יישוב,197,92,105,25,172,71,196,7,4.95%
2013-04,המרכז,681,גבעת שמואל,יישוב,321,173,148,131,190,68,321,0,2.76%
2013-04,המרכז,2550,גדרה,יישוב,360,158,202,56,304,108,353,5,3.11%
2013-04,המרכז,627,ג'לג'וליה,יישוב,99,47,52,1,98,52,98,2,2.87%
2013-04,המרכז,166,גן יבנה,יישוב,391,152,239,35,356,109,386,2,3.51%
2013-04,המרכז,229,גני תקווה,יישוב,179,84,95,63,116,26,177,0,2.20%
2013-04,המרכז,9700,הוד השרון,יישוב,695,340,355,215,480,68,689,3,2.46%
2013-04,המרכז,1290,זמר,יישוב,178,60,118,5,173,130,177,3,6.27%
2013-04,המרכז,2730,טייבה,יישוב,2238,965,1273,11,2227,1899,2216,9,12.97%
2013-04,המרכז,2720,טירה,יישוב,336,154,182,6,330,172,329,6,3.03%
2013-04,המרכז,2660,יבנה,יישוב,918,435,483,84,834,375,911,36,4.17%
2013-04,המרכז,9400,יהוד,יישוב,523,227,296,74,449,77,509,12,3.28%
2013-04,המרכז,1224,כוכב יאיר,יישוב,123,55,68,56,67,1,123,0,2.20%
2013-04,המרכז,633,כפר ברא,יישוב,36,22,14,2,34,15,36,0,2.81%
2013-04,המרכז,168,כפר יונה,יישוב,309,129,180,66,243,72,306,3,2.92%
2013-04,המרכז,6900,כפר סבא,יישוב,1356,573,783,397,959,207,1342,13,2.61%
2013-04,המרכז,634,כפר קאסם,יישוב,287,146,141,4,283,155,282,3,3.30%
2013-04,המרכז,7000,לוד,יישוב,2331,1066,1265,139,2192,1277,2305,35,6.56%
2013-04,המרכז,1200,מודיעין-מכבים-רעות*,יישוב,1026,444,582,316,710,54,1017,11,2.44%
2013-04,המרכז,28,מזכרת בתיה,יישוב,164,72,92,32,132,31,160,7,2.41%
2013-04,המרכז,7200,נס ציונה,יישוב,691,321,370,150,541,208,680,4,3.00%
2013-04,המרכז,7400,נתניה,יישוב,4593,2125,2468,604,3989,1691,4509,32,4.38%
2013-04,המרכז,587,סביון*,יישוב,12,8,4,4,8,1,12,0,0.65%
2013-04,המרכז,171,פרדסייה,יישוב,74,33,41,21,53,6,74,1,2.10%
2013-04,המרכז,7900,פתח תקווה,יישוב,4244,1919,2325,879,3365,1112,4200,53,3.47%
2013-04,המרכז,195,קדימה-צורן,יישוב,274,120,154,74,200,39,272,0,2.72%
2013-04,המרכז,638,קלנסווה,יישוב,920,368,552,3,917,784,908,11,10.83%
2013-04,המרכז,469,קריית עקרון,יישוב,310,155,155,21,289,136,307,5,5.25%
2013-04,המרכז,2640,ראש העין,יישוב,803,411,392,72,731,162,790,10,3.52%
2013-04,המרכז,8300,ראשון לציון,יישוב,4760,2137,2623,929,3831,1534,4732,95,3.48%
2013-04,המרכז,8400,רחובות,יישוב,2651,1214,1437,540,2111,1041,2603,32,3.97%
2013-04,המרכז,8500,רמלה,יישוב,1905,887,1018,112,1793,841,1863,43,5.15%
2013-04,המרכז,8700,רעננה,יישוב,858,410,448,299,559,96,852,3,2.31%
2013-04,המרכז,1304,שוהם,יישוב,192,87,105,75,117,6,191,0,1.81%
2013-04,המרכז,154,תל מונד,יישוב,137,69,68,36,101,25,137,0,2.32%
2013-04,הצפון,473,אבו סנאן,יישוב,761,298,463,4,757,644,755,10,13.40%
2013-04,הצפון,478,אכסאל,יישוב,534,231,303,15,519,461,530,2,9.83%
2013-04,הצפון,529,אעבלין,יישוב,642,267,375,13,629,535,638,1,11.66%
2013-04,הצפון,482,בועיינה-נוג'ידאת,יישוב,421,181,240,2,419,355,414,8,11.13%
2013-04,הצפון,4001,בוקעאתא,יישוב,424,166,258,7,417,358,407,5,15.32%
2013-04,הצפון,998,ביר אל-מכסור,יישוב,421,148,273,2,419,340,419,10,11.86%
2013-04,הצפון,480,בית ג'ן,יישוב,380,115,265,8,372,274,371,1,7.31%
2013-04,הצפון,9200,בית שאן,יישוב,902,396,506,17,885,483,886,98,8.88%
2013-04,הצפון,944,בסמת טבעון,יישוב,218,99,119,2,216,159,217,1,7.11%
2013-04,הצפון,483,בענה,יישוב,415,171,244,1,414,347,415,4,12.80%
2013-04,הצפון,1292,ג'דיידה-מכר,יישוב,1521,631,890,7,1514,1342,1511,19,17.14%
2013-04,הצפון,485,ג'ולס,יישוב,243,64,179,3,240,166,242,0,8.70%
2013-04,הצפון,487,ג'ש (גוש חלב),יישוב,63,29,34,5,58,30,62,0,3.91%
2013-04,הצפון,489,דבורייה,יישוב,428,194,234,15,413,314,426,3,10.31%
2013-04,הצפון,490,דייר אל-אסד,יישוב,399,163,236,5,394,313,399,4,8.12%
2013-04,הצפון,492,דייר חנא,יישוב,656,283,373,11,645,511,656,3,14.06%
2013-04,הצפון,975,זרזיר,יישוב,331,150,181,5,326,244,327,4,11.27%
2013-04,הצפון,496,חורפיש,יישוב,133,55,78,4,129,65,131,1,5.08%
2013-04,הצפון,2034,חצור הגלילית,יישוב,286,132,154,11,275,144,274,2,5.88%
2013-04,הצפון,6700,טבריה,יישוב,1882,845,1037,88,1794,1164,1708,54,7.86%
2013-04,הצפון,962,טובא-זנגרייה,יישוב,393,154,239,3,390,262,385,2,12.96%
2013-04,הצפון,498,טורעאן,יישוב,539,209,330,7,532,461,523,5,9.66%
2013-04,הצפון,8900,טמרה,יישוב,2064,840,1224,20,2044,1803,2054,6,15.10%
2013-04,הצפון,1295,יאנוח-ג'ת,יישוב,166,54,112,3,163,106,165,3,6.27%
2013-04,הצפון,46,יבנאל,יישוב,155,108,47,7,148,123,138,0,8.87%
2013-04,הצפון,499,יפיע,יישוב,677,303,374,12,665,520,670,5,8.88%
2013-04,הצפון,240,יקנעם עילית,יישוב,522,236,286,75,447,165,518,27,4.55%
2013-04,הצפון,502,ירכא,יישוב,567,231,336,0,567,440,565,0,10.31%
2013-04,הצפון,504,כאבול,יישוב,681,257,424,5,676,600,679,1,14.20%
2013-04,הצפון,505,כאוכב אבו אל-היג'א,יישוב,216,97,119,3,213,183,216,1,13.15%
2013-04,הצפון,1296,כסרא-סמיע,יישוב,214,92,122,2,212,155,212,3,6.54%
2013-04,הצפון,978,כעביה-טבאש-חג'אג'רה,יישוב,208,79,129,2,206,141,207,1,9.60%
2013-04,הצפון,1263,כפר ורדים,יישוב,64,30,34,19,45,9,63,0,2.03%
2013-04,הצפון,507,כפר יאסיף,יישוב,558,223,335,4,554,447,552,6,10.97%
2013-04,הצפון,508,כפר כמא,יישוב,66,28,38,3,63,31,64,0,4.07%
2013-04,הצפון,509,כפר כנא,יישוב,1192,448,744,18,1174,1041,1166,7,13.67%
2013-04,הצפון,510,כפר מנדא,יישוב,997,448,549,13,984,743,976,4,13.81%
2013-04,הצפון,47,כפר תבור,יישוב,46,24,22,11,35,6,46,0,2.24%
2013-04,הצפון,1139,כרמיאל,יישוב,1758,713,1045,315,1443,887,1685,27,6.51%
2013-04,הצפון,481,מגאר,יישוב,1536,607,929,16,1520,1347,1520,11,17.47%
2013-04,הצפון,516,מג'ד אל-כרום,יישוב,591,272,319,5,586,453,589,5,9.39%
2013-04,הצפון,874,מגדל העמק,יישוב,1047,434,613,69,978,483,1000,45,7.47%
2013-04,הצפון,4201,מג'דל שמס,יישוב,473,165,308,14,459,407,465,3,9.96%
2013-04,הצפון,517,מזרעה,יישוב,182,72,110,5,177,142,181,1,9.36%
2013-04,הצפון,4203,מסעדה,יישוב,206,77,129,8,198,166,204,1,12.39%
2013-04,הצפון,518,מעיליא,יישוב,52,30,22,2,50,17,52,0,3.35%
2013-04,הצפון,1063,מעלות-תרשיחא,יישוב,872,425,447,91,781,531,860,25,7.23%
2013-04,הצפון,520,משהד,יישוב,296,107,189,8,288,250,292,4,9.44%
2013-04,הצפון,9100,נהרייה,יישוב,2056,935,1121,232,1824,1240,2037,34,6.66%
2013-04,הצפון,522,נחף,יישוב,420,193,227,11,409,340,419,1,8.87%
2013-04,הצפון,7300,נצרת,יישוב,3241,1424,1817,83,3158,2531,3199,10,9.56%
2013-04,הצפון,1061,נצרת עילית,יישוב,1957,867,1090,238,1719,1102,1838,66,7.71%
2013-04,הצפון,525,סאג'ור,יישוב,115,38,77,0,115,78,114,0,6.75%
2013-04,הצפון,7500,סח'נין,יישוב,2098,924,1174,29,2069,1766,2094,4,15.56%
2013-04,הצפון,4501,ע'ג'ר,יישוב,83,38,45,4,79,56,83,0,8.49%
2013-04,הצפון,530,עיילבון,יישוב,205,84,121,9,196,155,201,1,7.55%
2013-04,הצפון,511,עילוט,יישוב,313,122,191,3,310,252,313,2,11.55%
2013-04,הצפון,532,עין מאהל,יישוב,602,276,326,9,593,502,591,0,12.17%
2013-04,הצפון,7600,עכו,יישוב,3295,1538,1757,121,3174,2525,3257,54,12.32%
2013-04,הצפון,7700,עפולה,יישוב,1794,714,1080,187,1607,881,1716,58,7.05%
2013-04,הצפון,531,עראבה,יישוב,1448,602,846,21,1427,1291,1447,1,14.96%
2013-04,הצפון,535,פסוטה,יישוב,115,49,66,3,112,84,115,1,6.99%
2013-04,הצפון,536,פקיעין (בוקייעה),יישוב,147,76,71,5,142,92,144,1,5.40%
2013-04,הצפון,8000,צפת,יישוב,1383,740,643,77,1306,1104,1362,13,10.31%
2013-04,הצפון,4100,קצרין,יישוב,184,81,103,33,151,80,181,7,4.63%
2013-04,הצפון,2800,קריית שמונה,יישוב,750,349,401,52,698,322,721,12,5.58%
2013-04,הצפון,543,ראמה,יישוב,319,128,191,7,312,251,313,0,8.28%
2013-04,הצפון,26,ראש פינה,יישוב,49,12,37,7,42,19,48,1,3.07%
2013-04,הצפון,542,ריינה,יישוב,667,267,400,6,661,553,660,0,10.12%
2013-04,הצפון,122,רמת ישי,יישוב,100,41,59,24,76,16,98,1,2.39%
2013-04,הצפון,913,שבלי - אום אל-גנם,יישוב,217,91,126,4,213,159,214,2,8.63%
2013-04,הצפון,812,שלומי,יישוב,276,110,166,20,256,160,274,2,7.57%
2013-04,הצפון,538,שעב,יישוב,525,220,305,7,518,451,525,1,17.88%
2013-04,הצפון,8800,שפרעם,יישוב,2042,779,1263,35,2007,1695,2035,12,11.93%
2013-04,חיפה,2710,אום אל-פחם,יישוב,3931,1596,2335,22,3909,3368,3920,0,19.36%
2013-04,חיפה,1020,אור עקיבא,יישוב,578,254,324,39,539,230,563,11,5.74%
2013-04,חיפה,6000,באקה אל-גרביה,יישוב,717,345,372,17,700,460,714,13,6.45%
2013-04,חיפה,9800,בנימינה-גבעת עדה*,יישוב,217,93,124,47,170,62,215,2,3.15%
2013-04,חיפה,1326,"בסמ""ה",יישוב,440,183,257,2,438,346,439,4,11.55%
2013-04,חיפה,541,ג'סר א-זרקא,יישוב,435,243,192,1,434,299,432,1,7.55%
2013-04,חיפה,628,ג'ת,יישוב,222,90,132,10,212,146,221,1,4.51%
2013-04,חיפה,494,דאלית אל-כרמל,יישוב,531,225,306,9,522,299,522,4,6.87%
2013-04,חיפה,9300,זכרון יעקב,יישוב,259,108,151,81,178,53,255,0,2.45%
2013-04,חיפה,6500,חדרה,יישוב,2471,1005,1466,272,2199,1004,2436,25,5.04%
2013-04,חיפה,4000,חיפה,יישוב,7007,3401,3606,1230,5777,3889,6907,81,4.87%
2013-04,חיפה,1247,חריש,יישוב,26,12,14,7,19,8,25,0,1.63%
2013-04,חיפה,2100,טירת כרמל,יישוב,781,357,424,27,754,468,774,20,7.44%
2013-04,חיפה,654,כפר קרע,יישוב,431,195,236,5,426,251,429,7,5.32%
2013-04,חיפה,1327,מעלה עירון,יישוב,982,389,593,2,980,810,977,0,17.27%
2013-04,חיפה,2500,נשר,יישוב,503,251,252,85,418,210,500,3,3.90%
2013-04,חיפה,534,עספיא,יישוב,319,142,177,8,311,183,314,2,5.89%
2013-04,חיפה,637,ערערה,יישוב,601,232,369,3,598,411,599,6,7.73%
2013-04,חיפה,537,פוריידיס,יישוב,402,216,186,2,400,271,397,0,7.46%
2013-04,חיפה,7800,פרדס חנה-כרכור,יישוב,871,404,467,129,742,286,862,19,4.44%
2013-04,חיפה,6800,קריית אתא,יישוב,1786,816,970,157,1629,990,1775,35,6.05%
2013-04,חיפה,9500,קריית ביאליק,יישוב,1186,485,701,119,1067,617,1175,15,5.44%
2013-04,חיפה,2300,קריית טבעון,יישוב,190,93,97,67,123,39,187,1,2.23%
2013-04,חיפה,9600,קריית ים,יישוב,1636,758,878,162,1474,1010,1624,28,7.54%
2013-04,חיפה,8200,קריית מוצקין,יישוב,1106,481,625,150,956,555,1097,18,4.84%
2013-04,חיפה,922,רכסים,יישוב,131,70,61,12,119,74,130,0,4.01%
2013-04,ירושלים,472,אבו גוש,יישוב,244,121,123,7,237,187,243,2,8.46%
2013-04,ירושלים,2610,בית שמש,יישוב,1303,603,700,81,1222,606,1275,37,4.28%
2013-04,ירושלים,3000,ירושלים,יישוב,11487,5199,6288,1217,10270,7003,11339,146,3.92%
2013-04,ירושלים,1015,מבשרת ציון,יישוב,399,187,212,60,339,177,396,1,3.03%
2013-04,ירושלים,1137,קריית יערים,יישוב,35,16,19,6,29,16,34,0,2.79%
2013-04,תל אביב,2400,אור יהודה,יישוב,889,408,481,44,845,282,865,32,4.61%
2013-04,תל אביב,565,אזור,יישוב,183,96,87,20,163,26,182,5,2.93%
2013-04,תל אביב,6100,בני ברק,יישוב,2513,1238,1275,107,2406,1445,2479,12,4.60%
2013-04,תל אביב,6200,בת ים,יישוב,3489,1692,1797,451,3038,1293,3405,71,4.76%
2013-04,תל אביב,6300,גבעתיים,יישוב,809,365,444,303,506,114,800,6,2.69%
2013-04,תל אביב,6400,הרצלייה,יישוב,1088,501,587,267,821,58,1072,14,2.26%
2013-04,תל אביב,6600,חולון,יישוב,3448,1630,1818,509,2939,882,3385,46,3.44%
2013-04,תל אביב,2620,קריית אונו,יישוב,453,203,250,148,305,52,447,4,2.45%
2013-04,תל אביב,8600,רמת גן,יישוב,2214,1036,1178,643,1571,473,2185,11,2.84%
2013-04,תל אביב,2650,רמת השרון,יישוב,431,171,260,139,292,13,429,3,1.94%
2013-04,תל אביב,5000,תל אביב -יפו,יישוב,8239,4142,4097,2412,5827,2654,8118,72,3.27%
2013-05,אזור יהודה והשומרון,3760,אורנית,יישוב,88,38,50,29,59,4,88,0,1.98%
2013-05,אזור יהודה והשומרון,3750,אלפי מנשה,יישוב,121,52,69,30,91,4,119,2,2.79%
2013-05,אזור יהודה והשומרון,3560,אלקנה,יישוב,32,14,18,12,20,1,32,0,1.75%
2013-05,אזור יהודה והשומרון,3650,אפרת,יישוב,39,20,19,11,28,6,39,1,0.99%
2013-05,אזור יהודה והשומרון,3570,אריאל,יישוב,369,173,196,58,311,101,362,5,3.49%
2013-05,אזור יהודה והשומרון,3574,בית אל,יישוב,58,28,30,15,43,20,58,0,2.43%
2013-05,אזור יהודה והשומרון,3652,בית אריה,יישוב,57,24,33,8,49,3,57,0,2.33%
2013-05,אזור יהודה והשומרון,3780,ביתר עילית,יישוב,423,208,215,13,410,192,418,25,3.73%
2013-05,אזור יהודה והשומרון,3730,גבעת זאב,יישוב,191,91,100,21,170,43,191,5,2.63%
2013-05,אזור יהודה והשומרון,3769,הר אדר,יישוב,18,8,10,9,9,2,18,0,0.91%
2013-05,אזור יהודה והשומרון,3797,מודיעין עילית,יישוב,359,130,229,9,350,105,348,7,2.67%
2013-05,אזור יהודה והשומרון,3616,מעלה אדומים,יישוב,670,285,385,79,591,198,661,11,3.28%
2013-05,אזור יהודה והשומרון,3660,עמנואל,יישוב,76,35,41,1,75,52,76,1,6.91%
2013-05,אזור יהודה והשומרון,3557,קדומים,יישוב,41,21,20,10,31,9,41,0,2.28%
2013-05,אזור יהודה והשומרון,3611,קריית ארבע,יישוב,117,59,58,18,99,66,117,3,3.76%
2013-05,אזור יהודה והשומרון,3640,קרני שומרון,יישוב,73,36,37,16,57,9,72,1,2.05%
2013-05,הדרום,31,אופקים,יישוב,1344,597,747,84,1260,935,1332,30,10.56%
2013-05,הדרום,2600,אילת,יישוב,1447,665,782,64,1383,593,1427,33,4.33%
2013-05,הדרום,70,אשדוד,יישוב,7156,2926,4230,774,6382,3763,7080,150,6.56%
2013-05,הדרום,7100,אשקלון,יישוב,4646,1852,2794,571,4075,2610,4496,65,6.68%
2013-05,הדרום,9000,באר שבע,יישוב,7327,3241,4086,906,6421,4548,7198,210,6.99%
2013-05,הדרום,2200,דימונה,יישוב,2150,941,1209,117,2033,1466,2097,68,11.45%
2013-05,הדרום,1303,חורה,יישוב,787,321,466,1,786,732,784,3,20.26%
2013-05,הדרום,831,ירוחם,יישוב,422,202,220,18,404,271,407,31,9.13%
2013-05,הדרום,1059,כסיפה,יישוב,994,420,574,1,993,902,990,13,22.23%
2013-05,הדרום,1271,להבים,יישוב,47,18,29,22,25,5,47,0,1.37%
2013-05,הדרום,1060,לקיה,יישוב,973,432,541,1,972,912,972,1,24.16%
2013-05,הדרום,1268,מיתר,יישוב,74,33,41,25,49,8,74,2,1.77%
2013-05,הדרום,99,מצפה רמון,יישוב,267,108,159,15,252,159,246,13,10.01%
2013-05,הדרום,246,נתיבות,יישוב,1090,479,611,50,1040,546,1063,104,7.93%
2013-05,הדרום,666,עומר,יישוב,65,36,29,25,40,6,63,0,1.55%
2013-05,הדרום,2560,ערד,יישוב,775,354,421,104,671,461,746,48,6.00%
2013-05,הדרום,1192,ערערה-בנגב,יישוב,1015,400,615,2,1013,936,1010,13,25.21%
2013-05,הדרום,2630,קריית גת,יישוב,2293,960,1333,150,2143,1443,2274,56,8.16%
2013-05,הדרום,1034,קריית מלאכי,יישוב,1300,588,712,24,1276,790,1265,42,10.76%
2013-05,הדרום,1161,רהט,יישוב,3216,1349,1867,6,3210,2804,3200,26,17.77%
2013-05,הדרום,1286,שגב-שלום,יישוב,518,189,329,1,517,457,517,0,20.62%
2013-05,הדרום,1031,שדרות,יישוב,1122,475,647,42,1080,712,1105,15,8.85%
2013-05,הדרום,1054,תל שבע,יישוב,1168,552,616,1,1167,1098,1159,6,24.94%
2013-05,המרכז,182,אבן יהודה,יישוב,161,72,89,58,103,19,160,0,2.42%
2013-05,המרכז,41,אליכין,יישוב,63,34,29,5,58,18,62,0,3.41%
2013-05,המרכז,1309,אלעד,יישוב,463,200,263,26,437,129,459,3,3.85%
2013-05,המרכז,2530,באר יעקב,יישוב,266,113,153,49,217,62,265,2,3.05%
2013-05,המרכז,466,בית דגן,יישוב,119,62,57,26,93,42,119,5,3.38%
2013-05,המרכז,1066,"בני עי""ש",יישוב,208,101,107,27,181,67,208,1,5.24%
2013-05,המרכז,681,גבעת שמואל,יישוב,392,196,196,126,266,66,392,2,3.35%
2013-05,המרכז,2550,גדרה,יישוב,381,169,212,59,322,110,374,6,3.29%
2013-05,המרכז,627,ג'לג'וליה,יישוב,103,50,53,2,101,52,100,1,2.93%
2013-05,המרכז,166,גן יבנה,יישוב,406,159,247,36,370,103,404,5,3.66%
2013-05,המרכז,229,גני תקווה,יישוב,203,101,102,64,139,29,202,0,2.51%
2013-05,המרכז,9700,הוד השרון,יישוב,682,323,359,208,474,57,674,3,2.41%
2013-05,המרכז,1290,זמר,יישוב,178,57,121,4,174,132,177,3,6.27%
2013-05,המרכז,2730,טייבה,יישוב,2212,953,1259,8,2204,1858,2191,20,12.84%
2013-05,המרכז,2720,טירה,יישוב,347,162,185,8,339,165,343,8,3.15%
2013-05,המרכז,2660,יבנה,יישוב,923,440,483,93,830,373,913,21,4.18%
2013-05,המרכז,9400,יהוד,יישוב,554,237,317,82,472,78,539,8,3.47%
2013-05,המרכז,1224,כוכב יאיר,יישוב,132,63,69,60,72,2,132,0,2.36%
2013-05,המרכז,633,כפר ברא,יישוב,34,20,14,2,32,13,34,1,2.66%
2013-05,המרכז,168,כפר יונה,יישוב,325,133,192,64,261,81,320,5,3.05%
2013-05,המרכז,6900,כפר סבא,יישוב,1367,623,744,382,985,191,1351,16,2.63%
2013-05,המרכז,634,כפר קאסם,יישוב,262,133,129,6,256,156,258,3,3.03%
2013-05,המרכז,7000,לוד,יישוב,2290,1066,1224,138,2152,1202,2262,45,6.44%
2013-05,המרכז,1200,מודיעין-מכבים-רעות*,יישוב,1467,696,771,285,1182,54,1456,10,3.45%
2013-05,המרכז,28,מזכרת בתיה,יישוב,164,73,91,29,135,35,161,2,2.43%
2013-05,המרכז,7200,נס ציונה,יישוב,726,335,391,162,564,204,722,8,3.18%
2013-05,המרכז,7400,נתניה,יישוב,4630,2135,2495,601,4029,1680,4527,54,4.40%
2013-05,המרכז,587,סביון*,יישוב,17,8,9,7,10,1,17,0,0.91%
2013-05,המרכז,171,פרדסייה,יישוב,77,33,44,20,57,7,77,0,2.18%
2013-05,המרכז,7900,פתח תקווה,יישוב,4311,1976,2335,884,3427,1117,4274,57,3.53%
2013-05,המרכז,195,קדימה-צורן,יישוב,259,109,150,71,188,41,257,0,2.58%
2013-05,המרכז,638,קלנסווה,יישוב,897,354,543,4,893,767,890,10,10.64%
2013-05,המרכז,469,קריית עקרון,יישוב,305,155,150,18,287,135,302,7,5.17%
2013-05,המרכז,2640,ראש העין,יישוב,800,395,405,83,717,162,787,16,3.51%
2013-05,המרכז,8300,ראשון לציון,יישוב,5066,2278,2788,932,4134,1491,5044,118,3.70%
2013-05,המרכז,8400,רחובות,יישוב,2650,1227,1423,535,2115,1048,2598,46,3.96%
2013-05,המרכז,8500,רמלה,יישוב,1908,909,999,105,1803,840,1854,42,5.13%
2013-05,המרכז,8700,רעננה,יישוב,861,402,459,305,556,97,857,5,2.33%
2013-05,המרכז,1304,שוהם,יישוב,199,93,106,74,125,6,197,0,1.86%
2013-05,המרכז,154,תל מונד,יישוב,153,71,82,35,118,25,152,0,2.57%
2013-05,הצפון,473,אבו סנאן,יישוב,765,288,477,3,762,647,757,14,13.43%
2013-05,הצפון,478,אכסאל,יישוב,532,232,300,12,520,455,524,0,9.73%
2013-05,הצפון,529,אעבלין,יישוב,637,259,378,11,626,530,635,4,11.61%
2013-05,הצפון,482,בועיינה-נוג'ידאת,יישוב,412,161,251,2,410,351,408,0,10.99%
2013-05,הצפון,4001,בוקעאתא,יישוב,415,160,255,7,408,349,404,0,15.23%
2013-05,הצפון,998,ביר אל-מכסור,יישוב,416,144,272,2,414,339,415,1,11.76%
2013-05,הצפון,480,בית ג'ן,יישוב,389,118,271,8,381,275,378,2,7.44%
2013-05,הצפון,9200,בית שאן,יישוב,827,355,472,14,813,445,817,95,8.24%
2013-05,הצפון,944,בסמת טבעון,יישוב,232,106,126,1,231,170,228,1,7.44%
2013-05,הצפון,483,בענה,יישוב,410,168,242,1,409,345,408,8,12.61%
2013-05,הצפון,1292,ג'דיידה-מכר,יישוב,1492,622,870,7,1485,1318,1479,43,16.84%
2013-05,הצפון,485,ג'ולס,יישוב,237,63,174,2,235,170,236,6,8.50%
2013-05,הצפון,487,ג'ש (גוש חלב),יישוב,67,33,34,4,63,32,66,0,4.16%
2013-05,הצפון,489,דבורייה,יישוב,432,194,238,14,418,317,430,5,10.40%
2013-05,הצפון,490,דייר אל-אסד,יישוב,396,163,233,5,391,311,396,10,8.07%
2013-05,הצפון,492,דייר חנא,יישוב,654,278,376,9,645,508,654,4,14.03%
2013-05,הצפון,975,זרזיר,יישוב,325,145,180,6,319,241,318,5,10.99%
2013-05,הצפון,496,חורפיש,יישוב,132,56,76,3,129,66,132,2,5.11%
2013-05,הצפון,2034,חצור הגלילית,יישוב,276,121,155,8,268,147,263,2,5.65%
2013-05,הצפון,6700,טבריה,יישוב,1873,832,1041,84,1789,1143,1721,63,7.91%
2013-05,הצפון,962,טובא-זנגרייה,יישוב,396,146,250,2,394,249,388,4,13.05%
2013-05,הצפון,498,טורעאן,יישוב,579,233,346,7,572,472,560,5,10.27%
2013-05,הצפון,8900,טמרה,יישוב,2046,832,1214,16,2030,1799,2032,12,14.96%
2013-05,הצפון,1295,יאנוח-ג'ת,יישוב,157,50,107,3,154,101,157,6,5.99%
2013-05,הצפון,46,יבנאל,יישוב,156,102,54,8,148,123,138,2,8.87%
2013-05,הצפון,499,יפיע,יישוב,650,287,363,9,641,510,640,4,8.52%
2013-05,הצפון,240,יקנעם עילית,יישוב,563,252,311,71,492,177,559,23,4.90%
2013-05,הצפון,502,ירכא,יישוב,565,220,345,0,565,447,563,7,10.27%
2013-05,הצפון,504,כאבול,יישוב,665,249,416,5,660,585,660,2,13.86%
2013-05,הצפון,505,כאוכב אבו אל-היג'א,יישוב,221,98,123,2,219,187,221,0,13.41%
2013-05,הצפון,1296,כסרא-סמיע,יישוב,216,85,131,2,214,153,213,1,6.57%
2013-05,הצפון,978,כעביה-טבאש-חג'אג'רה,יישוב,190,69,121,1,189,136,189,0,8.84%
2013-05,הצפון,1263,כפר ורדים,יישוב,59,28,31,18,41,9,58,1,1.87%
2013-05,הצפון,507,כפר יאסיף,יישוב,544,215,329,3,541,437,536,10,10.69%
2013-05,הצפון,508,כפר כמא,יישוב,67,30,37,3,64,33,66,0,4.19%
2013-05,הצפון,509,כפר כנא,יישוב,1207,467,740,17,1190,1059,1180,11,13.81%
2013-05,הצפון,510,כפר מנדא,יישוב,998,440,558,14,984,736,975,17,13.80%
2013-05,הצפון,47,כפר תבור,יישוב,41,21,20,8,33,4,41,0,2.00%
2013-05,הצפון,1139,כרמיאל,יישוב,1819,761,1058,334,1485,899,1751,51,6.75%
2013-05,הצפון,481,מגאר,יישוב,1500,567,933,14,1486,1324,1483,12,17.12%
2013-05,הצפון,516,מג'ד אל-כרום,יישוב,574,259,315,5,569,446,574,10,9.17%
2013-05,הצפון,874,מגדל העמק,יישוב,1065,447,618,74,991,497,992,54,7.42%
2013-05,הצפון,4201,מג'דל שמס,יישוב,459,159,300,11,448,394,454,3,9.74%
2013-05,הצפון,517,מזרעה,יישוב,179,65,114,4,175,137,178,2,9.22%
2013-05,הצפון,4203,מסעדה,יישוב,206,74,132,7,199,166,205,0,12.45%
2013-05,הצפון,518,מעיליא,יישוב,51,27,24,4,47,16,50,0,3.22%
2013-05,הצפון,1063,מעלות-תרשיחא,יישוב,866,424,442,90,776,538,851,34,7.16%
2013-05,הצפון,520,משהד,יישוב,294,106,188,6,288,250,287,3,9.29%
2013-05,הצפון,9100,נהרייה,יישוב,2060,928,1132,220,1840,1245,2037,57,6.66%
2013-05,הצפון,522,נחף,יישוב,430,193,237,9,421,347,428,9,9.05%
2013-05,הצפון,7300,נצרת,יישוב,3230,1405,1825,88,3142,2521,3178,18,9.50%
2013-05,הצפון,1061,נצרת עילית,יישוב,1936,860,1076,212,1724,1092,1808,81,7.59%
2013-05,הצפון,525,סאג'ור,יישוב,108,41,67,0,108,69,108,0,6.42%
2013-05,הצפון,7500,סח'נין,יישוב,2074,906,1168,29,2045,1774,2068,15,15.40%
2013-05,הצפון,4501,ע'ג'ר,יישוב,84,36,48,1,83,59,81,1,8.30%
2013-05,הצפון,530,עיילבון,יישוב,196,77,119,9,187,150,192,3,7.23%
2013-05,הצפון,511,עילוט,יישוב,319,123,196,4,315,259,314,1,11.59%
2013-05,הצפון,532,עין מאהל,יישוב,590,271,319,11,579,486,578,5,11.93%
2013-05,הצפון,7600,עכו,יישוב,3264,1512,1752,110,3154,2497,3219,47,12.19%
2013-05,הצפון,7700,עפולה,יישוב,1750,695,1055,187,1563,843,1684,64,6.93%
2013-05,הצפון,531,עראבה,יישוב,1456,615,841,21,1435,1300,1453,7,15.01%
2013-05,הצפון,535,פסוטה,יישוב,109,44,65,3,106,82,109,0,6.65%
2013-05,הצפון,536,פקיעין (בוקייעה),יישוב,142,73,69,6,136,86,139,3,5.22%
2013-05,הצפון,8000,צפת,יישוב,1403,754,649,68,1335,1106,1377,12,10.41%
2013-05,הצפון,4100,קצרין,יישוב,183,85,98,32,151,75,182,6,4.66%
2013-05,הצפון,2800,קריית שמונה,יישוב,771,348,423,48,723,324,743,22,5.74%
2013-05,הצפון,543,ראמה,יישוב,317,118,199,4,313,252,315,0,8.33%
2013-05,הצפון,26,ראש פינה,יישוב,56,17,39,9,47,19,54,0,3.45%
2013-05,הצפון,542,ריינה,יישוב,663,263,400,4,659,555,651,3,10.00%
2013-05,הצפון,122,רמת ישי,יישוב,105,40,65,25,80,18,103,1,2.51%
2013-05,הצפון,913,שבלי - אום אל-גנם,יישוב,219,95,124,3,216,161,216,2,8.71%
2013-05,הצפון,812,שלומי,יישוב,259,105,154,17,242,147,255,6,7.08%
2013-05,הצפון,538,שעב,יישוב,518,215,303,7,511,449,518,3,17.69%
2013-05,הצפון,8800,שפרעם,יישוב,2013,762,1251,33,1980,1672,2003,32,11.76%
2013-05,חיפה,2710,אום אל-פחם,יישוב,3879,1572,2307,17,3862,3347,3856,2,19.11%
2013-05,חיפה,1020,אור עקיבא,יישוב,589,260,329,35,554,227,566,12,5.77%
2013-05,חיפה,6000,באקה אל-גרביה,יישוב,708,327,381,11,697,459,706,19,6.38%
2013-05,חיפה,9800,בנימינה-גבעת עדה*,יישוב,230,102,128,39,191,65,228,4,3.34%
2013-05,חיפה,1326,"בסמ""ה",יישוב,428,179,249,3,425,342,426,2,11.24%
2013-05,חיפה,541,ג'סר א-זרקא,יישוב,473,260,213,0,473,302,468,3,8.13%
2013-05,חיפה,628,ג'ת,יישוב,221,97,124,10,211,143,221,4,4.51%
2013-05,חיפה,494,דאלית אל-כרמל,יישוב,533,220,313,10,523,292,524,4,6.90%
2013-05,חיפה,9300,זכרון יעקב,יישוב,262,110,152,72,190,50,259,1,2.49%
2013-05,חיפה,6500,חדרה,יישוב,2484,1035,1449,274,2210,973,2432,27,5.03%
2013-05,חיפה,4000,חיפה,יישוב,6950,3345,3605,1195,5755,3855,6839,127,4.82%
2013-05,חיפה,1247,חריש,יישוב,26,13,13,5,21,7,26,0,1.69%
2013-05,חיפה,2100,טירת כרמל,יישוב,768,352,416,24,744,464,759,25,7.31%
2013-05,חיפה,654,כפר קרע,יישוב,432,199,233,4,428,248,430,8,5.33%
2013-05,חיפה,1327,מעלה עירון,יישוב,983,391,592,4,979,801,977,0,17.27%
2013-05,חיפה,2500,נשר,יישוב,521,269,252,94,427,211,516,14,4.02%
2013-05,חיפה,534,עספיא,יישוב,330,147,183,10,320,179,321,4,6.01%
2013-05,חיפה,637,ערערה,יישוב,615,234,381,4,611,411,609,18,7.85%
2013-05,חיפה,537,פוריידיס,יישוב,388,202,186,1,387,263,385,1,7.25%
2013-05,חיפה,7800,פרדס חנה-כרכור,יישוב,856,382,474,121,735,287,849,35,4.38%
2013-05,חיפה,6800,קריית אתא,יישוב,1862,836,1026,158,1704,1002,1838,52,6.25%
2013-05,חיפה,9500,קריית ביאליק,יישוב,1192,496,696,121,1071,624,1185,32,5.48%
2013-05,חיפה,2300,קריית טבעון,יישוב,193,86,107,61,132,44,190,1,2.27%
2013-05,חיפה,9600,קריית ים,יישוב,1657,776,881,141,1516,1027,1642,50,7.62%
2013-05,חיפה,8200,קריית מוצקין,יישוב,1126,494,632,146,980,545,1122,31,4.94%
2013-05,חיפה,922,רכסים,יישוב,144,74,70,14,130,82,141,2,4.34%
2013-05,ירושלים,472,אבו גוש,יישוב,232,109,123,7,225,184,231,2,8.07%
2013-05,ירושלים,2610,בית שמש,יישוב,1253,584,669,78,1175,581,1230,44,4.14%
2013-05,ירושלים,3000,ירושלים,יישוב,11627,5272,6355,1238,10389,6991,11462,179,3.96%
2013-05,ירושלים,1015,מבשרת ציון,יישוב,409,185,224,59,350,178,405,4,3.09%
2013-05,ירושלים,1137,קריית יערים,יישוב,33,12,21,6,27,16,33,0,2.71%
2013-05,תל אביב,2400,אור יהודה,יישוב,879,403,476,40,839,280,850,38,4.54%
2013-05,תל אביב,565,אזור,יישוב,201,102,99,27,174,28,199,5,3.19%
2013-05,תל אביב,6100,בני ברק,יישוב,2464,1217,1247,102,2362,1451,2427,21,4.51%
2013-05,תל אביב,6200,בת ים,יישוב,3513,1673,1840,455,3058,1305,3400,87,4.75%
2013-05,תל אביב,6300,גבעתיים,יישוב,872,410,462,290,582,109,860,2,2.89%
2013-05,תל אביב,6400,הרצלייה,יישוב,1087,503,584,271,816,55,1074,30,2.27%
2013-05,תל אביב,6600,חולון,יישוב,3513,1702,1811,528,2985,886,3435,53,3.48%
2013-05,תל אביב,2620,קריית אונו,יישוב,464,208,256,148,316,44,461,3,2.52%
2013-05,תל אביב,8600,רמת גן,יישוב,2417,1133,1284,627,1790,468,2386,14,3.09%
2013-05,תל אביב,2650,רמת השרון,יישוב,425,164,261,143,282,9,423,2,1.91%
2013-05,תל אביב,5000,תל אביב -יפו,יישוב,8378,4215,4163,2374,6004,2629,8250,120,3.32%
2013-06,אזור יהודה והשומרון,3760,אורנית,יישוב,212,103,109,32,180,5,212,0,4.64%
2013-06,אזור יהודה והשומרון,3750,אלפי מנשה,יישוב,125,51,74,27,98,1,124,1,2.91%
2013-06,אזור יהודה והשומרון,3560,אלקנה,יישוב,45,19,26,15,30,1,44,0,2.38%
2013-06,אזור יהודה והשומרון,3650,אפרת,יישוב,50,30,20,11,39,4,50,1,1.27%
2013-06,אזור יהודה והשומרון,3570,אריאל,יישוב,458,216,242,58,400,102,455,11,4.35%
2013-06,אזור יהודה והשומרון,3574,בית אל,יישוב,81,45,36,13,68,20,80,0,3.32%
2013-06,אזור יהודה והשומרון,3652,בית אריה,יישוב,99,51,48,7,92,3,99,0,3.98%
2013-06,אזור יהודה והשומרון,3780,ביתר עילית,יישוב,450,209,241,11,439,200,444,14,3.95%
2013-06,אזור יהודה והשומרון,3730,גבעת זאב,יישוב,269,128,141,29,240,39,269,11,3.67%
2013-06,אזור יהודה והשומרון,3769,הר אדר,יישוב,52,22,30,13,39,2,50,4,2.49%
2013-06,אזור יהודה והשומרון,3797,מודיעין עילית,יישוב,458,137,321,10,448,105,449,6,3.42%
2013-06,אזור יהודה והשומרון,3616,מעלה אדומים,יישוב,1253,592,661,72,1181,202,1243,29,6.00%
2013-06,אזור יהודה והשומרון,3660,עמנואל,יישוב,70,31,39,0,70,49,70,0,6.40%
2013-06,אזור יהודה והשומרון,3557,קדומים,יישוב,62,38,24,13,49,8,62,0,3.41%
2013-06,אזור יהודה והשומרון,3611,קריית ארבע,יישוב,132,78,54,13,119,63,132,2,4.22%
2013-06,אזור יהודה והשומרון,3640,קרני שומרון,יישוב,111,65,46,17,94,11,110,2,3.09%
2013-06,הדרום,31,אופקים,יישוב,1476,667,809,83,1393,923,1461,29,11.47%
2013-06,הדרום,2600,אילת,יישוב,1978,925,1053,59,1919,577,1962,31,5.86%
2013-06,הדרום,70,אשדוד,יישוב,8493,3595,4898,764,7729,3749,8403,205,7.69%
2013-06,הדרום,7100,אשקלון,יישוב,5246,2150,3096,530,4716,2580,5091,90,7.49%
2013-06,הדרום,9000,באר שבע,יישוב,8344,3801,4543,891,7453,4542,8205,218,7.89%
2013-06,הדרום,2200,דימונה,יישוב,2315,1080,1235,117,2198,1402,2261,71,12.24%
2013-06,הדרום,1303,חורה,יישוב,797,340,457,2,795,735,795,3,20.48%
2013-06,הדרום,831,ירוחם,יישוב,486,241,245,17,469,259,472,26,10.44%
2013-06,הדרום,1059,כסיפה,יישוב,1035,448,587,1,1034,918,1027,5,22.87%
2013-06,הדרום,1271,להבים,יישוב,92,41,51,25,67,5,92,2,2.65%
2013-06,הדרום,1060,לקיה,יישוב,989,437,552,2,987,926,985,2,24.40%
2013-06,הדרום,1268,מיתר,יישוב,117,58,59,23,94,8,115,1,2.72%
2013-06,הדרום,99,מצפה רמון,יישוב,296,124,172,10,286,151,280,7,11.24%
2013-06,הדרום,246,נתיבות,יישוב,1291,601,690,51,1240,550,1266,44,9.31%
2013-06,הדרום,666,עומר,יישוב,80,35,45,22,58,6,80,0,1.97%
2013-06,הדרום,2560,ערד,יישוב,859,383,476,100,759,453,821,38,6.56%
2013-06,הדרום,1192,ערערה-בנגב,יישוב,1026,411,615,2,1024,948,1022,3,25.44%
2013-06,הדרום,2630,קריית גת,יישוב,2588,1101,1487,140,2448,1447,2557,77,9.09%
2013-06,הדרום,1034,קריית מלאכי,יישוב,1519,709,810,21,1498,786,1482,71,12.37%
2013-06,הדרום,1161,רהט,יישוב,3284,1372,1912,4,3280,2769,3267,59,18.08%
2013-06,הדרום,1286,שגב-שלום,יישוב,537,203,334,1,536,469,533,1,21.13%
2013-06,הדרום,1031,שדרות,יישוב,1239,570,669,38,1201,695,1219,19,9.67%
2013-06,הדרום,1054,תל שבע,יישוב,1202,580,622,1,1201,1115,1190,3,25.44%
2013-06,המרכז,182,אבן יהודה,יישוב,227,96,131,51,176,19,227,1,3.40%
2013-06,המרכז,41,אליכין,יישוב,78,43,35,6,72,16,76,0,4.14%
2013-06,המרכז,1309,אלעד,יישוב,550,250,300,23,527,129,545,6,4.54%
2013-06,המרכז,2530,באר יעקב,יישוב,304,129,175,56,248,59,301,7,3.46%
2013-06,המרכז,466,בית דגן,יישוב,192,95,97,24,168,39,192,0,5.34%
2013-06,המרכז,1066,"בני עי""ש",יישוב,238,120,118,21,217,75,237,3,5.92%
2013-06,המרכז,681,גבעת שמואל,יישוב,458,242,216,127,331,66,458,1,3.89%
2013-06,המרכז,2550,גדרה,יישוב,501,233,268,59,442,106,497,4,4.33%
2013-06,המרכז,627,ג'לג'וליה,יישוב,112,65,47,2,110,46,110,1,3.21%
2013-06,המרכז,166,גן יבנה,יישוב,578,235,343,45,533,104,574,5,5.13%
2013-06,המרכז,229,גני תקווה,יישוב,302,157,145,69,233,27,302,0,3.70%
2013-06,המרכז,9700,הוד השרון,יישוב,828,402,426,217,611,67,819,5,2.92%
2013-06,המרכז,1290,זמר,יישוב,196,75,121,3,193,135,195,1,6.86%
2013-06,המרכז,2730,טייבה,יישוב,2233,983,1250,5,2228,1838,2216,14,12.97%
2013-06,המרכז,2720,טירה,יישוב,354,176,178,8,346,171,349,12,3.20%
2013-06,המרכז,2660,יבנה,יישוב,1180,555,625,84,1096,372,1171,23,5.30%
2013-06,המרכז,9400,יהוד,יישוב,792,349,443,78,714,86,776,18,4.92%
2013-06,המרכז,1224,כוכב יאיר,יישוב,172,89,83,60,112,3,172,0,3.05%
2013-06,המרכז,633,כפר ברא,יישוב,48,33,15,3,45,13,48,1,3.71%
2013-06,המרכז,168,כפר יונה,יישוב,443,195,248,62,381,76,439,7,4.14%
2013-06,המרכז,6900,כפר סבא,יישוב,1588,781,807,384,1204,184,1570,13,3.04%
2013-06,המרכז,634,כפר קאסם,יישוב,287,158,129,4,283,153,281,5,3.29%
2013-06,המרכז,7000,לוד,יישוב,2542,1225,1317,144,2398,1223,2504,41,7.09%
2013-06,המרכז,1200,מודיעין-מכבים-רעות*,יישוב,1680,818,862,283,1397,64,1657,14,3.91%
2013-06,המרכז,28,מזכרת בתיה,יישוב,275,121,154,36,239,35,273,1,4.05%
2013-06,המרכז,7200,נס ציונה,יישוב,926,438,488,154,772,209,920,6,4.02%
2013-06,המרכז,7400,נתניה,יישוב,5482,2582,2900,586,4896,1637,5387,75,5.19%
2013-06,המרכז,587,סביון*,יישוב,26,14,12,9,17,1,26,0,1.39%
2013-06,המרכז,171,פרדסייה,יישוב,106,49,57,21,85,7,106,0,2.98%
2013-06,המרכז,7900,פתח תקווה,יישוב,5890,2764,3126,834,5056,1108,5840,76,4.76%
2013-06,המרכז,195,קדימה-צורן,יישוב,345,147,198,62,283,35,343,2,3.41%
2013-06,המרכז,638,קלנסווה,יישוב,900,369,531,3,897,754,888,22,10.62%
2013-06,המרכז,469,קריית עקרון,יישוב,373,182,191,17,356,135,372,7,6.29%
2013-06,המרכז,2640,ראש העין,יישוב,1151,567,584,92,1059,170,1137,21,4.99%
2013-06,המרכז,8300,ראשון לציון,יישוב,5973,2794,3179,878,5095,1465,5945,106,4.33%
2013-06,המרכז,8400,רחובות,יישוב,3252,1526,1726,527,2725,1026,3204,36,4.84%
2013-06,המרכז,8500,רמלה,יישוב,2233,1065,1168,104,2129,826,2174,52,5.96%
2013-06,המרכז,8700,רעננה,יישוב,1140,560,580,286,854,94,1132,5,3.05%
2013-06,המרכז,1304,שוהם,יישוב,467,258,209,79,388,6,466,0,4.29%
2013-06,המרכז,154,תל מונד,יישוב,235,124,111,36,199,24,235,0,3.92%
2013-06,הצפון,473,אבו סנאן,יישוב,757,287,470,3,754,631,751,21,13.34%
2013-06,הצפון,478,אכסאל,יישוב,550,247,303,13,537,457,544,4,10.06%
2013-06,הצפון,529,אעבלין,יישוב,658,270,388,9,649,529,657,9,11.97%
2013-06,הצפון,482,בועיינה-נוג'ידאת,יישוב,441,186,255,1,440,343,433,4,11.58%
2013-06,הצפון,4001,בוקעאתא,יישוב,414,158,256,7,407,351,400,2,15.10%
2013-06,הצפון,998,ביר אל-מכסור,יישוב,432,150,282,2,430,345,430,1,12.13%
2013-06,הצפון,480,בית ג'ן,יישוב,380,120,260,9,371,272,366,0,7.22%
2013-06,הצפון,9200,בית שאן,יישוב,899,426,473,15,884,428,890,66,8.91%
2013-06,הצפון,944,בסמת טבעון,יישוב,240,108,132,2,238,170,235,1,7.65%
2013-06,הצפון,483,בענה,יישוב,417,177,240,1,416,346,416,11,12.83%
2013-06,הצפון,1292,ג'דיידה-מכר,יישוב,1515,651,864,7,1508,1300,1500,40,17.03%
2013-06,הצפון,485,ג'ולס,יישוב,230,65,165,1,229,167,230,2,8.30%
2013-06,הצפון,487,ג'ש (גוש חלב),יישוב,66,30,36,5,61,29,65,0,4.10%
2013-06,הצפון,489,דבורייה,יישוב,439,211,228,12,427,310,435,6,10.50%
2013-06,הצפון,490,דייר אל-אסד,יישוב,401,171,230,5,396,319,400,3,8.14%
2013-06,הצפון,492,דייר חנא,יישוב,656,289,367,9,647,500,656,4,14.06%
2013-06,הצפון,975,זרזיר,יישוב,330,149,181,3,327,238,325,7,11.21%
2013-06,הצפון,496,חורפיש,יישוב,118,50,68,3,115,64,117,3,4.56%
2013-06,הצפון,2034,חצור הגלילית,יישוב,343,169,174,8,335,158,326,4,6.91%
2013-06,הצפון,6700,טבריה,יישוב,2181,994,1187,81,2100,1132,1998,51,9.07%
2013-06,הצפון,962,טובא-זנגרייה,יישוב,394,151,243,2,392,254,382,2,12.87%
2013-06,הצפון,498,טורעאן,יישוב,548,220,328,7,541,466,521,3,9.62%
2013-06,הצפון,8900,טמרה,יישוב,2076,850,1226,20,2056,1801,2062,13,15.15%
2013-06,הצפון,1295,יאנוח-ג'ת,יישוב,162,56,106,2,160,104,160,4,6.09%
2013-06,הצפון,46,יבנאל,יישוב,170,110,60,8,162,120,152,0,9.68%
2013-06,הצפון,499,יפיע,יישוב,721,339,382,12,709,518,707,5,9.32%
2013-06,הצפון,240,יקנעם עילית,יישוב,644,308,336,60,584,170,640,32,5.57%
2013-06,הצפון,502,ירכא,יישוב,576,236,340,0,576,450,575,5,10.47%
2013-06,הצפון,504,כאבול,יישוב,676,252,424,8,668,594,670,3,14.04%
2013-06,הצפון,505,כאוכב אבו אל-היג'א,יישוב,221,90,131,1,220,186,220,1,13.36%
2013-06,הצפון,1296,כסרא-סמיע,יישוב,206,91,115,3,203,138,203,6,6.28%
2013-06,הצפון,978,כעביה-טבאש-חג'אג'רה,יישוב,197,74,123,1,196,137,195,0,9.09%
2013-06,הצפון,1263,כפר ורדים,יישוב,137,72,65,19,118,8,134,1,4.22%
2013-06,הצפון,507,כפר יאסיף,יישוב,556,242,314,3,553,415,546,14,10.87%
2013-06,הצפון,508,כפר כמא,יישוב,72,32,40,4,68,33,71,0,4.49%
2013-06,הצפון,509,כפר כנא,יישוב,1222,480,742,21,1201,1048,1183,9,13.84%
2013-06,הצפון,510,כפר מנדא,יישוב,995,449,546,13,982,739,975,0,13.80%
2013-06,הצפון,47,כפר תבור,יישוב,71,30,41,8,63,4,71,0,3.41%
2013-06,הצפון,1139,כרמיאל,יישוב,2086,899,1187,316,1770,898,1996,58,7.62%
2013-06,הצפון,481,מגאר,יישוב,1532,600,932,16,1516,1325,1508,12,17.36%
2013-06,הצפון,516,מג'ד אל-כרום,יישוב,606,283,323,4,602,451,605,9,9.62%
2013-06,הצפון,874,מגדל העמק,יישוב,1201,518,683,64,1137,490,1119,95,8.29%
2013-06,הצפון,4201,מג'דל שמס,יישוב,467,158,309,10,457,399,460,1,9.86%
2013-06,הצפון,517,מזרעה,יישוב,199,77,122,3,196,144,198,8,10.15%
2013-06,הצפון,4203,מסעדה,יישוב,204,73,131,7,197,165,203,2,12.34%
2013-06,הצפון,518,מעיליא,יישוב,53,34,19,5,48,16,52,0,3.35%
2013-06,הצפון,1063,מעלות-תרשיחא,יישוב,998,501,497,95,903,522,978,32,8.14%
2013-06,הצפון,520,משהד,יישוב,303,112,191,4,299,256,296,10,9.56%
2013-06,הצפון,9100,נהרייה,יישוב,2281,1043,1238,218,2063,1231,2260,45,7.34%
2013-06,הצפון,522,נחף,יישוב,435,201,234,8,427,340,432,22,9.12%
2013-06,הצפון,7300,נצרת,יישוב,3377,1533,1844,84,3293,2551,3325,25,9.90%
2013-06,הצפון,1061,נצרת עילית,יישוב,2183,982,1201,211,1972,1102,2047,91,8.51%
2013-06,הצפון,525,סאג'ור,יישוב,122,49,73,0,122,75,118,1,6.97%
2013-06,הצפון,7500,סח'נין,יישוב,2075,927,1148,29,2046,1755,2072,20,15.42%
2013-06,הצפון,4501,ע'ג'ר,יישוב,80,34,46,1,79,58,80,0,8.21%
2013-06,הצפון,530,עיילבון,יישוב,212,94,118,7,205,150,209,5,7.82%
2013-06,הצפון,511,עילוט,יישוב,322,128,194,2,320,257,317,0,11.68%
2013-06,הצפון,532,עין מאהל,יישוב,606,287,319,6,600,492,590,6,12.15%
2013-06,הצפון,7600,עכו,יישוב,3423,1596,1827,94,3329,2484,3362,53,12.67%
2013-06,הצפון,7700,עפולה,יישוב,1972,860,1112,189,1783,834,1910,83,7.78%
2013-06,הצפון,531,עראבה,יישוב,1484,625,859,18,1466,1319,1480,14,15.25%
2013-06,הצפון,535,פסוטה,יישוב,118,50,68,5,113,82,118,2,7.16%
2013-06,הצפון,536,פקיעין (בוקייעה),יישוב,124,61,63,3,121,81,123,3,4.65%
2013-06,הצפון,8000,צפת,יישוב,1574,856,718,69,1505,1120,1537,33,11.49%
2013-06,הצפון,4100,קצרין,יישוב,247,113,134,30,217,81,245,10,6.17%
2013-06,הצפון,2800,קריית שמונה,יישוב,931,439,492,48,883,314,906,30,6.92%
2013-06,הצפון,543,ראמה,יישוב,327,125,202,4,323,247,325,0,8.57%
2013-06,הצפון,26,ראש פינה,יישוב,69,25,44,8,61,18,69,2,4.36%
2013-06,הצפון,542,ריינה,יישוב,695,295,400,5,690,559,677,5,10.35%
2013-06,הצפון,122,רמת ישי,יישוב,132,55,77,26,106,19,130,1,3.15%
2013-06,הצפון,913,שבלי - אום אל-גנם,יישוב,233,108,125,2,231,161,231,1,9.25%
2013-06,הצפון,812,שלומי,יישוב,309,119,190,18,291,144,306,6,8.38%
2013-06,הצפון,538,שעב,יישוב,512,214,298,7,505,447,512,7,17.52%
2013-06,הצפון,8800,שפרעם,יישוב,2080,800,1280,29,2051,1660,2074,32,12.13%
2013-06,חיפה,2710,אום אל-פחם,יישוב,3898,1599,2299,15,3883,3346,3860,10,19.12%
2013-06,חיפה,1020,אור עקיבא,יישוב,701,315,386,38,663,238,678,18,6.83%
2013-06,חיפה,6000,באקה אל-גרביה,יישוב,746,362,384,9,737,461,740,24,6.66%
2013-06,חיפה,9800,בנימינה-גבעת עדה*,יישוב,284,134,150,40,244,63,283,4,4.11%
2013-06,חיפה,1326,"בסמ""ה",יישוב,449,195,254,2,447,348,446,4,11.71%
2013-06,חיפה,541,ג'סר א-זרקא,יישוב,489,266,223,0,489,303,486,4,8.42%
2013-06,חיפה,628,ג'ת,יישוב,244,116,128,7,237,144,243,4,4.93%
2013-06,חיפה,494,דאלית אל-כרמל,יישוב,534,221,313,8,526,296,526,6,6.92%
2013-06,חיפה,9300,זכרון יעקב,יישוב,375,170,205,73,302,55,372,0,3.54%
2013-06,חיפה,6500,חדרה,יישוב,2938,1274,1664,260,2678,982,2889,31,5.92%
2013-06,חיפה,4000,חיפה,יישוב,8141,3947,4194,1159,6982,3807,7998,203,5.59%
2013-06,חיפה,1247,חריש,יישוב,25,14,11,5,20,5,24,0,1.57%
2013-06,חיפה,2100,טירת כרמל,יישוב,899,420,479,23,876,467,884,26,8.41%
2013-06,חיפה,654,כפר קרע,יישוב,441,213,228,5,436,255,438,10,5.42%
2013-06,חיפה,1327,מעלה עירון,יישוב,1003,404,599,8,995,809,994,4,17.52%
2013-06,חיפה,2500,נשר,יישוב,689,354,335,91,598,208,683,10,5.26%
2013-06,חיפה,534,עספיא,יישוב,344,159,185,11,333,179,339,2,6.33%
2013-06,חיפה,637,ערערה,יישוב,635,262,373,3,632,402,630,15,8.09%
2013-06,חיפה,537,פוריידיס,יישוב,410,207,203,3,407,265,407,1,7.64%
2013-06,חיפה,7800,פרדס חנה-כרכור,יישוב,1052,490,562,120,932,287,1035,29,5.29%
2013-06,חיפה,6800,קריית אתא,יישוב,2001,927,1074,142,1859,975,1982,45,6.71%
2013-06,חיפה,9500,קריית ביאליק,יישוב,1362,583,779,115,1247,620,1355,31,6.22%
2013-06,חיפה,2300,קריית טבעון,יישוב,253,126,127,62,191,36,253,1,3.00%
2013-06,חיפה,9600,קריית ים,יישוב,1810,834,976,145,1665,1042,1793,41,8.26%
2013-06,חיפה,8200,קריית מוצקין,יישוב,1327,602,725,138,1189,545,1316,34,5.75%
2013-06,חיפה,922,רכסים,יישוב,142,67,75,14,128,82,138,1,4.25%
2013-06,ירושלים,472,אבו גוש,יישוב,264,134,130,8,256,182,264,10,9.12%
2013-06,ירושלים,2610,בית שמש,יישוב,1522,730,792,84,1438,562,1490,51,4.97%
2013-06,ירושלים,3000,ירושלים,יישוב,13650,6411,7239,1230,12420,7077,13480,179,4.62%
2013-06,ירושלים,1015,מבשרת ציון,יישוב,604,292,312,57,547,176,599,29,4.51%
2013-06,ירושלים,1137,קריית יערים,יישוב,37,12,25,5,32,17,36,0,2.95%
2013-06,תל אביב,2400,אור יהודה,יישוב,1149,541,608,42,1107,290,1115,38,5.87%
2013-06,תל אביב,565,אזור,יישוב,244,134,110,23,221,30,243,2,3.87%
2013-06,תל אביב,6100,בני ברק,יישוב,2670,1265,1405,105,2565,1459,2613,26,4.84%
2013-06,תל אביב,6200,בת ים,יישוב,4176,2037,2139,427,3749,1305,4069,98,5.63%
2013-06,תל אביב,6300,גבעתיים,יישוב,926,422,504,282,644,102,919,4,3.08%
2013-06,תל אביב,6400,הרצלייה,יישוב,1596,745,851,284,1312,65,1578,33,3.29%
2013-06,תל אביב,6600,חולון,יישוב,4959,2356,2603,496,4463,901,4887,49,4.89%
2013-06,תל אביב,2620,קריית אונו,יישוב,655,325,330,124,531,47,649,6,3.51%
2013-06,תל אביב,8600,רמת גן,יישוב,2792,1347,1445,576,2216,457,2759,21,3.56%
2013-06,תל אביב,2650,רמת השרון,יישוב,632,266,366,149,483,6,627,2,2.80%
2013-06,תל אביב,5000,תל אביב -יפו,יישוב,9707,4959,4748,2243,7464,2537,9577,112,3.83%
2013-07,אזור יהודה והשומרון,3760,אורנית,יישוב,135,57,78,39,96,5,133,0,2.96%
2013-07,אזור יהודה והשומרון,3750,אלפי מנשה,יישוב,142,54,88,30,112,0,140,0,3.27%
2013-07,אזור יהודה והשומרון,3560,אלקנה,יישוב,50,22,28,15,35,2,49,0,2.65%
2013-07,אזור יהודה והשומרון,3650,אפרת,יישוב,68,42,26,11,57,3,67,4,1.69%
2013-07,אזור יהודה והשומרון,3570,אריאל,יישוב,496,249,247,70,426,106,493,13,4.69%
2013-07,אזור יהודה והשומרון,3574,בית אל,יישוב,95,56,39,13,82,21,95,0,3.91%
2013-07,אזור יהודה והשומרון,3652,בית אריה,יישוב,94,38,56,5,89,2,94,1,3.79%
2013-07,אזור יהודה והשומרון,3780,ביתר עילית,יישוב,647,254,393,9,638,225,640,6,5.60%
2013-07,אזור יהודה והשומרון,3730,גבעת זאב,יישוב,250,122,128,34,216,41,249,6,3.41%
2013-07,אזור יהודה והשומרון,3769,הר אדר,יישוב,45,23,22,12,33,2,45,3,2.25%
2013-07,אזור יהודה והשומרון,3797,מודיעין עילית,יישוב,811,180,631,10,801,101,799,3,5.93%
2013-07,אזור יהודה והשומרון,3616,מעלה אדומים,יישוב,996,436,560,67,929,207,984,36,4.81%
2013-07,אזור יהודה והשומרון,3660,עמנואל,יישוב,103,50,53,0,103,48,103,0,9.14%
2013-07,אזור יהודה והשומרון,3557,קדומים,יישוב,69,38,31,14,55,7,69,0,3.78%
2013-07,אזור יהודה והשומרון,3611,קריית ארבע,יישוב,158,88,70,14,144,64,156,15,4.95%
2013-07,אזור יהודה והשומרון,3640,קרני שומרון,יישוב,93,44,49,18,75,8,93,1,2.63%
2013-07,הדרום,31,אופקים,יישוב,1679,738,941,83,1596,925,1663,26,12.85%
2013-07,הדרום,2600,אילת,יישוב,1748,791,957,52,1696,570,1718,50,5.17%
2013-07,הדרום,70,אשדוד,יישוב,8437,3374,5063,780,7657,3737,8317,200,7.62%
2013-07,הדרום,7100,אשקלון,יישוב,5382,2149,3233,502,4880,2590,5099,85,7.50%
2013-07,הדרום,9000,באר שבע,יישוב,8454,3810,4644,888,7566,4609,8236,186,7.92%
2013-07,הדרום,2200,דימונה,יישוב,2484,1099,1385,122,2362,1420,2438,74,13.07%
2013-07,הדרום,1303,חורה,יישוב,830,356,474,4,826,754,823,1,21.05%
2013-07,הדרום,831,ירוחם,יישוב,547,252,295,17,530,269,523,33,11.44%
2013-07,הדרום,1059,כסיפה,יישוב,1055,441,614,1,1054,916,1045,7,23.18%
2013-07,הדרום,1271,להבים,יישוב,85,40,45,24,61,4,85,0,2.46%
2013-07,הדרום,1060,לקיה,יישוב,1018,440,578,2,1016,934,1011,1,24.88%
2013-07,הדרום,1268,מיתר,יישוב,133,65,68,22,111,9,131,1,3.08%
2013-07,הדרום,99,מצפה רמון,יישוב,303,115,188,10,293,155,287,11,11.49%
2013-07,הדרום,246,נתיבות,יישוב,1341,553,788,55,1286,568,1311,32,9.61%
2013-07,הדרום,666,עומר,יישוב,71,36,35,17,54,5,71,0,1.75%
2013-07,הדרום,2560,ערד,יישוב,903,395,508,89,814,451,873,29,6.95%
2013-07,הדרום,1192,ערערה-בנגב,יישוב,1030,407,623,2,1028,942,1028,3,25.55%
2013-07,הדרום,2630,קריית גת,יישוב,2641,1107,1534,137,2504,1430,2610,50,9.26%
2013-07,הדרום,1034,קריית מלאכי,יישוב,1525,701,824,23,1502,783,1478,85,12.34%
2013-07,הדרום,1161,רהט,יישוב,3465,1424,2041,3,3462,2816,3443,26,18.87%
2013-07,הדרום,1286,שגב-שלום,יישוב,559,218,341,2,557,471,550,4,21.65%
2013-07,הדרום,1031,שדרות,יישוב,1278,550,728,40,1238,694,1250,21,9.89%
2013-07,הדרום,1054,תל שבע,יישוב,1224,586,638,2,1222,1130,1207,1,25.71%
2013-07,המרכז,182,אבן יהודה,יישוב,186,79,107,50,136,20,186,2,2.80%
2013-07,המרכז,41,אליכין,יישוב,93,51,42,5,88,19,92,1,4.97%
2013-07,המרכז,1309,אלעד,יישוב,659,275,384,26,633,124,647,9,5.34%
2013-07,המרכז,2530,באר יעקב,יישוב,363,143,220,47,316,64,362,5,4.13%
2013-07,המרכז,466,בית דגן,יישוב,141,78,63,23,118,39,140,2,3.95%
2013-07,המרכז,1066,"בני עי""ש",יישוב,235,109,126,19,216,80,232,7,5.81%
2013-07,המרכז,681,גבעת שמואל,יישוב,388,202,186,114,274,66,386,1,3.30%
2013-07,המרכז,2550,גדרה,יישוב,536,227,309,65,471,103,531,10,4.61%
2013-07,המרכז,627,ג'לג'וליה,יישוב,94,48,46,2,92,54,92,1,2.70%
2013-07,המרכז,166,גן יבנה,יישוב,557,225,332,46,511,102,553,5,4.95%
2013-07,המרכז,229,גני תקווה,יישוב,260,124,136,55,205,29,260,1,3.20%
2013-07,המרכז,9700,הוד השרון,יישוב,829,399,430,214,615,64,820,3,2.92%
2013-07,המרכז,1290,זמר,יישוב,195,72,123,3,192,136,195,3,6.86%
2013-07,המרכז,2730,טייבה,יישוב,2290,979,1311,9,2281,1870,2241,28,13.10%
2013-07,המרכז,2720,טירה,יישוב,334,156,178,8,326,165,327,10,3.01%
2013-07,המרכז,2660,יבנה,יישוב,1156,526,630,82,1074,373,1147,31,5.20%
2013-07,המרכז,9400,יהוד,יישוב,698,304,394,83,615,90,677,19,4.32%
2013-07,המרכז,1224,כוכב יאיר,יישוב,178,90,88,55,123,0,178,0,3.16%
2013-07,המרכז,633,כפר ברא,יישוב,41,22,19,3,38,15,40,0,3.11%
2013-07,המרכז,168,כפר יונה,יישוב,437,194,243,61,376,70,432,8,4.08%
2013-07,המרכז,6900,כפר סבא,יישוב,1628,742,886,369,1259,185,1613,17,3.13%
2013-07,המרכז,634,כפר קאסם,יישוב,270,133,137,2,268,148,266,3,3.12%
2013-07,המרכז,7000,לוד,יישוב,2660,1208,1452,163,2497,1272,2621,41,7.39%
2013-07,המרכז,1200,מודיעין-מכבים-רעות*,יישוב,1507,669,838,270,1237,65,1492,40,3.53%
2013-07,המרכז,28,מזכרת בתיה,יישוב,249,97,152,42,207,40,245,2,3.65%
2013-07,המרכז,7200,נס ציונה,יישוב,937,425,512,155,782,209,932,3,4.07%
2013-07,המרכז,7400,נתניה,יישוב,5637,2501,3136,597,5040,1605,5550,101,5.34%
2013-07,המרכז,587,סביון*,יישוב,30,15,15,9,21,1,30,1,1.60%
2013-07,המרכז,171,פרדסייה,יישוב,115,55,60,18,97,7,115,0,3.22%
2013-07,המרכז,7900,פתח תקווה,יישוב,5044,2283,2761,825,4219,1118,4989,80,4.09%
2013-07,המרכז,195,קדימה-צורן,יישוב,364,170,194,58,306,35,363,0,3.60%
2013-07,המרכז,638,קלנסווה,יישוב,924,382,542,4,920,757,893,15,10.67%
2013-07,המרכז,469,קריית עקרון,יישוב,394,179,215,19,375,138,390,7,6.57%
2013-07,המרכז,2640,ראש העין,יישוב,1050,501,549,99,951,162,1037,23,4.57%
2013-07,המרכז,8300,ראשון לציון,יישוב,5632,2615,3017,877,4755,1485,5594,118,4.09%
2013-07,המרכז,8400,רחובות,יישוב,3442,1537,1905,575,2867,1029,3391,32,5.11%
2013-07,המרכז,8500,רמלה,יישוב,2257,1041,1216,112,2145,803,2208,45,6.05%
2013-07,המרכז,8700,רעננה,יישוב,1090,519,571,299,791,98,1081,9,2.92%
2013-07,המרכז,1304,שוהם,יישוב,302,142,160,76,226,9,302,1,2.82%
2013-07,המרכז,154,תל מונד,יישוב,183,94,89,31,152,22,183,0,3.08%
2013-07,הצפון,473,אבו סנאן,יישוב,787,322,465,4,783,621,779,24,13.77%
2013-07,הצפון,478,אכסאל,יישוב,551,245,306,14,537,456,545,1,10.08%
2013-07,הצפון,529,אעבלין,יישוב,669,278,391,9,660,527,666,10,12.11%
2013-07,הצפון,482,בועיינה-נוג'ידאת,יישוב,434,173,261,1,433,348,425,4,11.39%
2013-07,הצפון,4001,בוקעאתא,יישוב,400,154,246,8,392,340,380,4,14.45%
2013-07,הצפון,998,ביר אל-מכסור,יישוב,439,156,283,4,435,346,436,0,12.28%
2013-07,הצפון,480,בית ג'ן,יישוב,390,123,267,8,382,275,384,10,7.55%
2013-07,הצפון,9200,בית שאן,יישוב,992,454,538,17,975,429,971,73,9.65%
2013-07,הצפון,944,בסמת טבעון,יישוב,260,113,147,2,258,175,256,2,8.28%
2013-07,הצפון,483,בענה,יישוב,446,181,265,1,445,362,444,10,13.57%
2013-07,הצפון,1292,ג'דיידה-מכר,יישוב,1557,668,889,8,1549,1301,1543,50,17.44%
2013-07,הצפון,485,ג'ולס,יישוב,262,81,181,2,260,164,262,3,9.35%
2013-07,הצפון,487,ג'ש (גוש חלב),יישוב,66,30,36,4,62,28,65,4,4.10%
2013-07,הצפון,489,דבורייה,יישוב,459,208,251,12,447,314,454,2,10.91%
2013-07,הצפון,490,דייר אל-אסד,יישוב,428,179,249,6,422,324,427,11,8.64%
2013-07,הצפון,492,דייר חנא,יישוב,663,279,384,7,656,503,663,9,14.19%
2013-07,הצפון,975,זרזיר,יישוב,356,165,191,3,353,245,346,10,11.85%
2013-07,הצפון,496,חורפיש,יישוב,143,68,75,2,141,66,142,2,5.48%
2013-07,הצפון,2034,חצור הגלילית,יישוב,377,173,204,10,367,157,359,27,7.56%
2013-07,הצפון,6700,טבריה,יישוב,2192,954,1238,85,2107,1168,1973,82,8.97%
2013-07,הצפון,962,טובא-זנגרייה,יישוב,406,151,255,2,404,261,393,4,13.19%
2013-07,הצפון,498,טורעאן,יישוב,600,231,369,9,591,480,567,9,10.38%
2013-07,הצפון,8900,טמרה,יישוב,2127,850,1277,24,2103,1813,2112,20,15.46%
2013-07,הצפון,1295,יאנוח-ג'ת,יישוב,198,71,127,5,193,98,195,1,7.33%
2013-07,הצפון,46,יבנאל,יישוב,197,125,72,7,190,124,176,2,11.04%
2013-07,הצפון,499,יפיע,יישוב,709,318,391,11,698,528,697,4,9.20%
2013-07,הצפון,240,יקנעם עילית,יישוב,687,310,377,55,632,174,679,36,5.89%
2013-07,הצפון,502,ירכא,יישוב,616,252,364,0,616,455,612,11,11.07%
2013-07,הצפון,504,כאבול,יישוב,724,283,441,12,712,603,718,0,14.89%
2013-07,הצפון,505,כאוכב אבו אל-היג'א,יישוב,224,95,129,2,222,186,223,4,13.52%
2013-07,הצפון,1296,כסרא-סמיע,יישוב,218,90,128,3,215,152,214,2,6.59%
2013-07,הצפון,978,כעביה-טבאש-חג'אג'רה,יישוב,208,79,129,3,205,143,202,3,9.39%
2013-07,הצפון,1263,כפר ורדים,יישוב,150,74,76,21,129,11,149,0,4.67%
2013-07,הצפון,507,כפר יאסיף,יישוב,576,249,327,2,574,417,567,13,11.24%
2013-07,הצפון,508,כפר כמא,יישוב,64,26,38,4,60,33,62,0,3.95%
2013-07,הצפון,509,כפר כנא,יישוב,1266,500,766,19,1247,1054,1210,9,14.11%
2013-07,הצפון,510,כפר מנדא,יישוב,1021,451,570,14,1007,734,1004,2,14.15%
2013-07,הצפון,47,כפר תבור,יישוב,88,37,51,9,79,4,88,2,4.20%
2013-07,הצפון,1139,כרמיאל,יישוב,2039,879,1160,310,1729,884,1955,52,7.48%
2013-07,הצפון,481,מגאר,יישוב,1516,607,909,12,1504,1303,1490,22,17.19%
2013-07,הצפון,516,מג'ד אל-כרום,יישוב,643,292,351,3,640,464,643,13,10.16%
2013-07,הצפון,874,מגדל העמק,יישוב,1293,535,758,65,1228,490,1184,82,8.73%
2013-07,הצפון,4201,מג'דל שמס,יישוב,481,162,319,10,471,394,469,20,10.03%
2013-07,הצפון,517,מזרעה,יישוב,190,74,116,3,187,148,189,10,9.73%
2013-07,הצפון,4203,מסעדה,יישוב,202,70,132,6,196,166,199,2,12.13%
2013-07,הצפון,518,מעיליא,יישוב,70,43,27,8,62,20,68,1,4.33%
2013-07,הצפון,1063,מעלות-תרשיחא,יישוב,1073,470,603,100,973,522,1054,35,8.72%
2013-07,הצפון,520,משהד,יישוב,318,120,198,3,315,270,304,3,9.79%
2013-07,הצפון,9100,נהרייה,יישוב,2333,1087,1246,202,2131,1214,2303,74,7.47%
2013-07,הצפון,522,נחף,יישוב,430,203,227,7,423,336,427,10,9.03%
2013-07,הצפון,7300,נצרת,יישוב,3468,1536,1932,90,3378,2533,3421,28,10.15%
2013-07,הצפון,1061,נצרת עילית,יישוב,2244,977,1267,189,2055,1130,2057,91,8.55%
2013-07,הצפון,525,סאג'ור,יישוב,140,55,85,0,140,69,137,4,8.00%
2013-07,הצפון,7500,סח'נין,יישוב,2128,939,1189,25,2103,1759,2124,30,15.75%
2013-07,הצפון,4501,ע'ג'ר,יישוב,81,35,46,2,79,59,81,1,8.30%
2013-07,הצפון,530,עיילבון,יישוב,232,101,131,4,228,153,230,5,8.54%
2013-07,הצפון,511,עילוט,יישוב,338,121,217,2,336,258,334,3,12.23%
2013-07,הצפון,532,עין מאהל,יישוב,626,296,330,6,620,509,608,3,12.47%
2013-07,הצפון,7600,עכו,יישוב,3490,1605,1885,95,3395,2453,3421,58,12.86%
2013-07,הצפון,7700,עפולה,יישוב,2090,870,1220,190,1900,864,2018,69,8.19%
2013-07,הצפון,531,עראבה,יישוב,1538,645,893,23,1515,1308,1530,17,15.69%
2013-07,הצפון,535,פסוטה,יישוב,138,58,80,6,132,79,138,7,8.27%
2013-07,הצפון,536,פקיעין (בוקייעה),יישוב,126,65,61,6,120,78,125,3,4.72%
2013-07,הצפון,8000,צפת,יישוב,1708,876,832,65,1643,1104,1665,26,12.32%
2013-07,הצפון,4100,קצרין,יישוב,278,127,151,25,253,90,278,54,6.94%
2013-07,הצפון,2800,קריית שמונה,יישוב,1044,489,555,48,996,329,1014,47,7.68%
2013-07,הצפון,543,ראמה,יישוב,345,137,208,7,338,249,341,3,8.96%
2013-07,הצפון,26,ראש פינה,יישוב,68,23,45,7,61,17,66,10,4.18%
2013-07,הצפון,542,ריינה,יישוב,730,309,421,7,723,569,696,5,10.61%
2013-07,הצפון,122,רמת ישי,יישוב,137,64,73,27,110,19,133,0,3.22%
2013-07,הצפון,913,שבלי - אום אל-גנם,יישוב,222,99,123,3,219,153,221,0,8.89%
2013-07,הצפון,812,שלומי,יישוב,312,127,185,20,292,139,307,3,8.40%
2013-07,הצפון,538,שעב,יישוב,519,220,299,5,514,455,518,5,17.69%
2013-07,הצפון,8800,שפרעם,יישוב,2106,796,1310,33,2073,1699,2092,36,12.22%
2013-07,חיפה,2710,אום אל-פחם,יישוב,3944,1573,2371,19,3925,3345,3899,12,19.28%
2013-07,חיפה,1020,אור עקיבא,יישוב,732,320,412,45,687,238,706,23,7.09%
2013-07,חיפה,6000,באקה אל-גרביה,יישוב,758,356,402,11,747,470,752,21,6.77%
2013-07,חיפה,9800,בנימינה-גבעת עדה*,יישוב,275,117,158,44,231,65,273,5,3.97%
2013-07,חיפה,1326,"בסמ""ה",יישוב,449,198,251,3,446,350,444,4,11.66%
2013-07,חיפה,541,ג'סר א-זרקא,יישוב,492,265,227,0,492,309,488,9,8.45%
2013-07,חיפה,628,ג'ת,יישוב,258,118,140,10,248,149,257,3,5.20%
2013-07,חיפה,494,דאלית אל-כרמל,יישוב,551,218,333,7,544,298,533,7,7.01%
2013-07,חיפה,9300,זכרון יעקב,יישוב,385,174,211,75,310,57,384,1,3.65%
2013-07,חיפה,6500,חדרה,יישוב,2988,1278,1710,235,2753,1011,2922,27,5.99%
2013-07,חיפה,4000,חיפה,יישוב,7853,3802,4051,1108,6745,3802,7690,214,5.39%
2013-07,חיפה,1247,חריש,יישוב,25,17,8,5,20,6,24,0,1.57%
2013-07,חיפה,2100,טירת כרמל,יישוב,839,379,460,24,815,471,823,28,7.87%
2013-07,חיפה,654,כפר קרע,יישוב,472,228,244,4,468,262,467,10,5.76%
2013-07,חיפה,1327,מעלה עירון,יישוב,1028,412,616,9,1019,820,1019,2,17.88%
2013-07,חיפה,2500,נשר,יישוב,664,316,348,83,581,212,660,20,5.09%
2013-07,חיפה,534,עספיא,יישוב,375,167,208,7,368,181,367,5,6.82%
2013-07,חיפה,637,ערערה,יישוב,637,255,382,4,633,407,626,15,8.05%
2013-07,חיפה,537,פוריידיס,יישוב,430,201,229,4,426,261,426,3,7.97%
2013-07,חיפה,7800,פרדס חנה-כרכור,יישוב,1036,479,557,119,917,284,1018,29,5.21%
2013-07,חיפה,6800,קריית אתא,יישוב,2104,901,1203,150,1954,992,2078,53,7.01%
2013-07,חיפה,9500,קריית ביאליק,יישוב,1351,590,761,112,1239,632,1345,38,6.18%
2013-07,חיפה,2300,קריית טבעון,יישוב,246,124,122,52,194,45,244,1,2.90%
2013-07,חיפה,9600,קריית ים,יישוב,1852,845,1007,154,1698,1041,1835,54,8.44%
2013-07,חיפה,8200,קריית מוצקין,יישוב,1245,565,680,139,1106,519,1232,22,5.40%
2013-07,חיפה,922,רכסים,יישוב,212,74,138,11,201,77,209,1,6.30%
2013-07,ירושלים,472,אבו גוש,יישוב,262,135,127,8,254,180,262,10,9.06%
2013-07,ירושלים,2610,בית שמש,יישוב,1883,836,1047,91,1792,581,1849,64,6.09%
2013-07,ירושלים,3000,ירושלים,יישוב,14285,6253,8032,1279,13006,7261,14074,184,4.82%
2013-07,ירושלים,1015,מבשרת ציון,יישוב,536,246,290,61,475,159,531,20,4.02%
2013-07,ירושלים,1137,קריית יערים,יישוב,50,17,33,4,46,19,49,0,3.97%
2013-07,תל אביב,2400,אור יהודה,יישוב,1106,500,606,36,1070,281,1073,41,5.66%
2013-07,תל אביב,565,אזור,יישוב,237,101,136,24,213,31,235,4,3.75%
2013-07,תל אביב,6100,בני ברק,יישוב,3183,1274,1909,110,3073,1462,3117,23,5.72%
2013-07,תל אביב,6200,בת ים,יישוב,3963,1915,2048,423,3540,1300,3845,108,5.34%
2013-07,תל אביב,6300,גבעתיים,יישוב,957,415,542,276,681,97,949,11,3.18%
2013-07,תל אביב,6400,הרצלייה,יישוב,1546,694,852,304,1242,54,1526,28,3.19%
2013-07,תל אביב,6600,חולון,יישוב,4307,1981,2326,493,3814,920,4216,67,4.24%
2013-07,תל אביב,2620,קריית אונו,יישוב,582,265,317,121,461,48,578,10,3.14%
2013-07,תל אביב,8600,רמת גן,יישוב,2683,1219,1464,553,2130,450,2648,17,3.42%
2013-07,תל אביב,2650,רמת השרון,יישוב,534,228,306,144,390,4,529,5,2.38%
2013-07,תל אביב,5000,תל אביב -יפו,יישוב,9485,4777,4708,2307,7178,2579,9329,130,3.74%
2013-08,אזור יהודה והשומרון,3760,אורנית,יישוב,121,48,73,35,86,4,121,0,2.70%
2013-08,אזור יהודה והשומרון,3750,אלפי מנשה,יישוב,134,55,79,26,108,1,134,2,3.13%
2013-08,אזור יהודה והשומרון,3560,אלקנה,יישוב,42,18,24,12,30,2,42,1,2.28%
2013-08,אזור יהודה והשומרון,3650,אפרת,יישוב,48,26,22,7,41,3,48,0,1.22%
2013-08,אזור יהודה והשומרון,3570,אריאל,יישוב,412,198,214,61,351,95,404,4,3.88%
2013-08,אזור יהודה והשומרון,3574,בית אל,יישוב,73,37,36,11,62,20,73,2,3.03%
2013-08,אזור יהודה והשומרון,3652,בית אריה,יישוב,74,27,47,4,70,2,73,1,2.97%
2013-08,אזור יהודה והשומרון,3780,ביתר עילית,יישוב,656,245,411,10,646,227,648,12,5.67%
2013-08,אזור יהודה והשומרון,3730,גבעת זאב,יישוב,201,85,116,37,164,42,198,2,2.73%
2013-08,אזור יהודה והשומרון,3769,הר אדר,יישוב,36,18,18,12,24,2,35,0,1.76%
2013-08,אזור יהודה והשומרון,3797,מודיעין עילית,יישוב,884,206,678,11,873,101,870,10,6.42%
2013-08,אזור יהודה והשומרון,3616,מעלה אדומים,יישוב,882,372,510,59,823,201,852,14,4.19%
2013-08,אזור יהודה והשומרון,3660,עמנואל,יישוב,96,42,54,0,96,50,95,2,8.49%
2013-08,אזור יהודה והשומרון,3557,קדומים,יישוב,57,27,30,14,43,8,57,0,3.14%
2013-08,אזור יהודה והשומרון,3611,קריית ארבע,יישוב,143,77,66,11,132,61,142,2,4.52%
2013-08,אזור יהודה והשומרון,3640,קרני שומרון,יישוב,89,45,44,17,72,7,87,0,2.46%
2013-08,הדרום,31,אופקים,יישוב,1599,659,940,74,1525,912,1570,40,12.22%
2013-08,הדרום,2600,אילת,יישוב,1467,643,824,51,1416,558,1439,23,4.36%
2013-08,הדרום,70,אשדוד,יישוב,7867,3018,4849,762,7105,3704,7742,207,7.13%
2013-08,הדרום,7100,אשקלון,יישוב,4863,1875,2988,495,4368,2552,4573,112,6.78%
2013-08,הדרום,9000,באר שבע,יישוב,7884,3471,4413,900,6984,4536,7648,169,7.39%
2013-08,הדרום,2200,דימונה,יישוב,2363,1006,1357,123,2240,1432,2303,53,12.44%
2013-08,הדרום,1303,חורה,יישוב,818,347,471,3,815,748,812,4,20.83%
2013-08,הדרום,831,ירוחם,יישוב,539,235,304,18,521,279,516,24,11.30%
2013-08,הדרום,1059,כסיפה,יישוב,1037,432,605,1,1036,897,1026,5,22.86%
2013-08,הדרום,1271,להבים,יישוב,62,26,36,28,34,3,62,1,1.80%
2013-08,הדרום,1060,לקיה,יישוב,994,433,561,2,992,920,988,3,24.46%
2013-08,הדרום,1268,מיתר,יישוב,95,38,57,24,71,9,94,0,2.23%
2013-08,הדרום,99,מצפה רמון,יישוב,289,116,173,9,280,160,271,20,10.92%
2013-08,הדרום,246,נתיבות,יישוב,1277,479,798,57,1220,589,1246,36,9.17%
2013-08,הדרום,666,עומר,יישוב,50,26,24,13,37,5,50,0,1.24%
2013-08,הדרום,2560,ערד,יישוב,830,363,467,89,741,445,803,27,6.42%
2013-08,הדרום,1192,ערערה-בנגב,יישוב,1041,418,623,2,1039,954,1038,1,25.73%
2013-08,הדרום,2630,קריית גת,יישוב,2457,985,1472,135,2322,1412,2413,50,8.62%
2013-08,הדרום,1034,קריית מלאכי,יישוב,1427,649,778,25,1402,771,1383,81,11.64%
2013-08,הדרום,1161,רהט,יישוב,3406,1405,2001,4,3402,2804,3382,82,18.60%
2013-08,הדרום,1286,שגב-שלום,יישוב,545,208,337,1,544,465,538,2,21.28%
2013-08,הדרום,1031,שדרות,יישוב,1221,527,694,44,1177,686,1194,12,9.49%
2013-08,הדרום,1054,תל שבע,יישוב,1230,581,649,2,1228,1141,1218,3,25.88%
2013-08,המרכז,182,אבן יהודה,יישוב,179,86,93,54,125,20,179,1,2.70%
2013-08,המרכז,41,אליכין,יישוב,92,50,42,7,85,18,91,2,4.92%
2013-08,המרכז,1309,אלעד,יישוב,635,252,383,30,605,123,621,0,5.14%
2013-08,המרכז,2530,באר יעקב,יישוב,305,114,191,54,251,62,303,3,3.48%
2013-08,המרכז,466,בית דגן,יישוב,124,70,54,22,102,40,123,0,3.49%
2013-08,המרכז,1066,"בני עי""ש",יישוב,219,97,122,20,199,75,217,9,5.45%
2013-08,המרכז,681,גבעת שמואל,יישוב,341,165,176,106,235,69,338,1,2.90%
2013-08,המרכז,2550,גדרה,יישוב,440,178,262,72,368,106,435,3,3.81%
2013-08,המרכז,627,ג'לג'וליה,יישוב,92,47,45,3,89,53,90,2,2.64%
2013-08,המרכז,166,גן יבנה,יישוב,473,177,296,50,423,106,468,6,4.22%
2013-08,המרכז,229,גני תקווה,יישוב,224,103,121,51,173,28,224,1,2.77%
2013-08,המרכז,9700,הוד השרון,יישוב,784,338,446,208,576,69,773,7,2.76%
2013-08,המרכז,1290,זמר,יישוב,169,54,115,2,167,134,168,1,5.97%
2013-08,המרכז,2730,טייבה,יישוב,2192,938,1254,8,2184,1834,2152,23,12.64%
2013-08,המרכז,2720,טירה,יישוב,343,162,181,9,334,166,332,7,3.05%
2013-08,המרכז,2660,יבנה,יישוב,1058,462,596,75,983,379,1045,31,4.76%
2013-08,המרכז,9400,יהוד,יישוב,619,252,367,82,537,88,607,15,3.89%
2013-08,המרכז,1224,כוכב יאיר,יישוב,136,62,74,47,89,1,136,1,2.43%
2013-08,המרכז,633,כפר ברא,יישוב,34,16,18,3,31,14,34,0,2.66%
2013-08,המרכז,168,כפר יונה,יישוב,356,154,202,59,297,65,353,2,3.36%
2013-08,המרכז,6900,כפר סבא,יישוב,1512,669,843,368,1144,185,1489,26,2.89%
2013-08,המרכז,634,כפר קאסם,יישוב,269,130,139,2,267,150,261,0,3.06%
2013-08,המרכז,7000,לוד,יישוב,2442,1069,1373,163,2279,1262,2414,41,6.85%
2013-08,המרכז,1200,מודיעין-מכבים-רעות*,יישוב,1279,517,762,263,1016,69,1257,21,2.99%
2013-08,המרכז,28,מזכרת בתיה,יישוב,211,72,139,41,170,42,207,1,3.10%
2013-08,המרכז,7200,נס ציונה,יישוב,832,337,495,149,683,211,821,8,3.60%
2013-08,המרכז,7400,נתניה,יישוב,5122,2173,2949,588,4534,1616,5037,101,4.87%
2013-08,המרכז,587,סביון*,יישוב,24,9,15,9,15,1,24,0,1.28%
2013-08,המרכז,171,פרדסייה,יישוב,83,39,44,17,66,10,83,0,2.35%
2013-08,המרכז,7900,פתח תקווה,יישוב,4620,1980,2640,818,3802,1126,4560,50,3.75%
2013-08,המרכז,195,קדימה-צורן,יישוב,289,118,171,55,234,38,286,3,2.86%
2013-08,המרכז,638,קלנסווה,יישוב,879,348,531,4,875,733,855,15,10.26%
2013-08,המרכז,469,קריית עקרון,יישוב,359,157,202,20,339,139,356,7,6.03%
2013-08,המרכז,2640,ראש העין,יישוב,931,414,517,93,838,170,920,16,4.08%
2013-08,המרכז,8300,ראשון לציון,יישוב,4934,2171,2763,814,4120,1481,4903,80,3.60%
2013-08,המרכז,8400,רחובות,יישוב,3092,1277,1815,565,2527,1028,3036,51,4.60%
2013-08,המרכז,8500,רמלה,יישוב,2044,893,1151,104,1940,786,1994,43,5.50%
2013-08,המרכז,8700,רעננה,יישוב,972,442,530,305,667,92,962,6,2.60%
2013-08,המרכז,1304,שוהם,יישוב,230,105,125,63,167,7,230,0,2.17%
2013-08,המרכז,154,תל מונד,יישוב,156,75,81,32,124,23,156,2,2.64%
2013-08,הצפון,473,אבו סנאן,יישוב,724,280,444,4,720,609,720,12,12.86%
2013-08,הצפון,478,אכסאל,יישוב,538,232,306,11,527,459,532,0,9.86%
2013-08,הצפון,529,אעבלין,יישוב,645,255,390,10,635,541,639,6,11.68%
2013-08,הצפון,482,בועיינה-נוג'ידאת,יישוב,414,159,255,1,413,339,408,10,10.99%
2013-08,הצפון,4001,בוקעאתא,יישוב,398,151,247,8,390,341,385,2,14.62%
2013-08,הצפון,998,ביר אל-מכסור,יישוב,420,142,278,3,417,343,418,1,11.83%
2013-08,הצפון,480,בית ג'ן,יישוב,379,121,258,10,369,284,370,1,7.30%
2013-08,הצפון,9200,בית שאן,יישוב,933,413,520,17,916,446,903,72,9.03%
2013-08,הצפון,944,בסמת טבעון,יישוב,258,108,150,1,257,180,254,2,8.22%
2013-08,הצפון,483,בענה,יישוב,423,166,257,2,421,348,422,3,12.99%
2013-08,הצפון,1292,ג'דיידה-מכר,יישוב,1485,617,868,8,1477,1264,1475,26,16.80%
2013-08,הצפון,485,ג'ולס,יישוב,222,58,164,2,220,157,222,0,8.03%
2013-08,הצפון,487,ג'ש (גוש חלב),יישוב,69,32,37,4,65,30,67,2,4.22%
2013-08,הצפון,489,דבורייה,יישוב,456,202,254,16,440,319,451,3,10.85%
2013-08,הצפון,490,דייר אל-אסד,יישוב,395,155,240,6,389,316,395,4,8.05%
2013-08,הצפון,492,דייר חנא,יישוב,635,250,385,7,628,510,635,12,13.67%
2013-08,הצפון,975,זרזיר,יישוב,320,138,182,3,317,235,309,9,10.71%
2013-08,הצפון,496,חורפיש,יישוב,128,62,66,2,126,71,125,3,4.86%
2013-08,הצפון,2034,חצור הגלילית,יישוב,312,128,184,8,304,150,296,8,6.32%
2013-08,הצפון,6700,טבריה,יישוב,1981,833,1148,81,1900,1153,1787,66,8.19%
2013-08,הצפון,962,טובא-זנגרייה,יישוב,370,139,231,2,368,250,359,4,12.19%
2013-08,הצפון,498,טורעאן,יישוב,565,204,361,11,554,455,553,7,10.15%
2013-08,הצפון,8900,טמרה,יישוב,2088,826,1262,20,2068,1784,2075,23,15.23%
2013-08,הצפון,1295,יאנוח-ג'ת,יישוב,181,64,117,5,176,103,178,0,6.73%
2013-08,הצפון,46,יבנאל,יישוב,173,117,56,5,168,122,154,0,9.80%
2013-08,הצפון,499,יפיע,יישוב,661,277,384,12,649,525,652,4,8.66%
2013-08,הצפון,240,יקנעם עילית,יישוב,589,239,350,48,541,169,583,30,5.10%
2013-08,הצפון,502,ירכא,יישוב,568,224,344,0,568,441,565,2,10.31%
2013-08,הצפון,504,כאבול,יישוב,714,272,442,8,706,604,709,4,14.73%
2013-08,הצפון,505,כאוכב אבו אל-היג'א,יישוב,222,89,133,1,221,189,221,2,13.41%
2013-08,הצפון,1296,כסרא-סמיע,יישוב,213,88,125,5,208,150,208,6,6.42%
2013-08,הצפון,978,כעביה-טבאש-חג'אג'רה,יישוב,201,76,125,2,199,145,197,2,9.18%
2013-08,הצפון,1263,כפר ורדים,יישוב,99,47,52,17,82,13,95,1,3.03%
2013-08,הצפון,507,כפר יאסיף,יישוב,510,203,307,2,508,400,501,8,10.06%
2013-08,הצפון,508,כפר כמא,יישוב,65,27,38,3,62,31,63,0,4.01%
2013-08,הצפון,509,כפר כנא,יישוב,1176,440,736,16,1160,1014,1142,9,13.43%
2013-08,הצפון,510,כפר מנדא,יישוב,1004,442,562,13,991,737,990,1,13.98%
2013-08,הצפון,47,כפר תבור,יישוב,57,26,31,8,49,4,56,0,2.71%
2013-08,הצפון,1139,כרמיאל,יישוב,1827,745,1082,302,1525,880,1754,56,6.76%
2013-08,הצפון,481,מגאר,יישוב,1405,531,874,11,1394,1253,1388,14,16.20%
2013-08,הצפון,516,מג'ד אל-כרום,יישוב,587,244,343,3,584,453,586,7,9.35%
2013-08,הצפון,874,מגדל העמק,יישוב,1163,464,699,65,1098,474,1059,73,7.88%
2013-08,הצפון,4201,מג'דל שמס,יישוב,450,149,301,11,439,394,438,3,9.43%
2013-08,הצפון,517,מזרעה,יישוב,179,66,113,4,175,141,178,3,9.22%
2013-08,הצפון,4203,מסעדה,יישוב,187,63,124,5,182,159,185,2,11.37%
2013-08,הצפון,518,מעיליא,יישוב,58,27,31,7,51,22,56,0,3.60%
2013-08,הצפון,1063,מעלות-תרשיחא,יישוב,934,414,520,95,839,503,916,29,7.67%
2013-08,הצפון,520,משהד,יישוב,289,106,183,4,285,249,282,4,9.15%
2013-08,הצפון,9100,נהרייה,יישוב,2109,943,1166,196,1913,1223,2087,73,6.81%
2013-08,הצפון,522,נחף,יישוב,409,182,227,7,402,338,407,4,8.64%
2013-08,הצפון,7300,נצרת,יישוב,3332,1415,1917,96,3236,2533,3278,32,9.77%
2013-08,הצפון,1061,נצרת עילית,יישוב,2072,888,1184,190,1882,1095,1910,101,7.99%
2013-08,הצפון,525,סאג'ור,יישוב,114,43,71,2,112,73,109,1,6.47%
2013-08,הצפון,7500,סח'נין,יישוב,2042,875,1167,18,2024,1747,2037,28,15.20%
2013-08,הצפון,4501,ע'ג'ר,יישוב,81,36,45,2,79,62,80,0,8.21%
2013-08,הצפון,530,עיילבון,יישוב,205,78,127,4,201,146,203,2,7.62%
2013-08,הצפון,511,עילוט,יישוב,339,127,212,0,339,260,337,1,12.33%
2013-08,הצפון,532,עין מאהל,יישוב,625,291,334,6,619,516,603,1,12.38%
2013-08,הצפון,7600,עכו,יישוב,3328,1477,1851,100,3228,2436,3258,47,12.32%
2013-08,הצפון,7700,עפולה,יישוב,1981,817,1164,189,1792,870,1913,85,7.80%
2013-08,הצפון,531,עראבה,יישוב,1492,615,877,21,1471,1296,1483,16,15.28%
2013-08,הצפון,535,פסוטה,יישוב,136,58,78,6,130,79,136,1,8.16%
2013-08,הצפון,536,פקיעין (בוקייעה),יישוב,130,66,64,6,124,79,128,1,4.82%
2013-08,הצפון,8000,צפת,יישוב,1590,799,791,60,1530,1097,1546,24,11.55%
2013-08,הצפון,4100,קצרין,יישוב,189,80,109,20,169,86,188,10,4.80%
2013-08,הצפון,2800,קריית שמונה,יישוב,918,416,502,43,875,329,891,41,6.81%
2013-08,הצפון,543,ראמה,יישוב,322,119,203,7,315,246,321,3,8.48%
2013-08,הצפון,26,ראש פינה,יישוב,56,18,38,6,50,19,55,0,3.51%
2013-08,הצפון,542,ריינה,יישוב,678,262,416,6,672,549,661,3,10.13%
2013-08,הצפון,122,רמת ישי,יישוב,111,42,69,27,84,18,105,0,2.56%
2013-08,הצפון,913,שבלי - אום אל-גנם,יישוב,214,92,122,6,208,157,213,1,8.60%
2013-08,הצפון,812,שלומי,יישוב,279,112,167,14,265,136,276,9,7.62%
2013-08,הצפון,538,שעב,יישוב,506,205,301,3,503,453,504,5,17.29%
2013-08,הצפון,8800,שפרעם,יישוב,2026,743,1283,31,1995,1672,2006,30,11.78%
2013-08,חיפה,2710,אום אל-פחם,יישוב,3890,1538,2352,18,3872,3333,3841,8,19.05%
2013-08,חיפה,1020,אור עקיבא,יישוב,617,259,358,42,575,225,597,19,6.06%
2013-08,חיפה,6000,באקה אל-גרביה,יישוב,739,335,404,10,729,483,732,19,6.60%
2013-08,חיפה,9800,בנימינה-גבעת עדה*,יישוב,235,94,141,43,192,63,234,2,3.42%
2013-08,חיפה,1326,"בסמ""ה",יישוב,438,182,256,3,435,355,434,3,11.43%
2013-08,חיפה,541,ג'סר א-זרקא,יישוב,466,244,222,0,466,306,464,1,8.07%
2013-08,חיפה,628,ג'ת,יישוב,248,116,132,12,236,149,247,5,5.01%
2013-08,חיפה,494,דאלית אל-כרמל,יישוב,534,206,328,9,525,306,519,7,6.84%
2013-08,חיפה,9300,זכרון יעקב,יישוב,315,129,186,81,234,60,312,0,2.99%
2013-08,חיפה,6500,חדרה,יישוב,2727,1092,1635,251,2476,1005,2664,47,5.49%
2013-08,חיפה,4000,חיפה,יישוב,7021,3338,3683,1102,5919,3689,6860,194,4.83%
2013-08,חיפה,1247,חריש,יישוב,33,21,12,6,27,8,31,0,2.01%
2013-08,חיפה,2100,טירת כרמל,יישוב,757,354,403,25,732,450,747,23,7.20%
2013-08,חיפה,654,כפר קרע,יישוב,450,209,241,4,446,264,443,7,5.48%
2013-08,חיפה,1327,מעלה עירון,יישוב,1013,396,617,10,1003,837,1001,2,17.62%
2013-08,חיפה,2500,נשר,יישוב,528,245,283,75,453,207,523,14,4.08%
2013-08,חיפה,534,עספיא,יישוב,346,152,194,8,338,177,339,4,6.33%
2013-08,חיפה,637,ערערה,יישוב,628,253,375,2,626,407,614,14,7.91%
2013-08,חיפה,537,פוריידיס,יישוב,414,195,219,7,407,268,410,2,7.69%
2013-08,חיפה,7800,פרדס חנה-כרכור,יישוב,911,400,511,114,797,276,898,32,4.62%
2013-08,חיפה,6800,קריית אתא,יישוב,1915,802,1113,138,1777,974,1885,49,6.40%
2013-08,חיפה,9500,קריית ביאליק,יישוב,1215,508,707,110,1105,626,1206,26,5.57%
2013-08,חיפה,2300,קריית טבעון,יישוב,195,85,110,57,138,41,194,0,2.32%
2013-08,חיפה,9600,קריית ים,יישוב,1691,758,933,145,1546,1018,1677,57,7.77%
2013-08,חיפה,8200,קריית מוצקין,יישוב,1162,502,660,129,1033,544,1147,35,5.05%
2013-08,חיפה,922,רכסים,יישוב,206,63,143,13,193,71,202,2,6.10%
2013-08,ירושלים,472,אבו גוש,יישוב,238,118,120,5,233,177,238,4,8.30%
2013-08,ירושלים,2610,בית שמש,יישוב,1584,655,929,95,1489,571,1544,48,5.14%
2013-08,ירושלים,3000,ירושלים,יישוב,13288,5734,7554,1307,11981,7241,13066,170,4.49%
2013-08,ירושלים,1015,מבשרת ציון,יישוב,430,196,234,63,367,164,424,6,3.23%
2013-08,ירושלים,1137,קריית יערים,יישוב,45,19,26,5,40,21,44,1,3.58%
2013-08,תל אביב,2400,אור יהודה,יישוב,1046,438,608,33,1013,260,1015,41,5.37%
2013-08,תל אביב,565,אזור,יישוב,210,100,110,25,185,34,204,5,3.27%
2013-08,תל אביב,6100,בני ברק,יישוב,3215,1240,1975,113,3102,1421,3136,24,5.75%
2013-08,תל אביב,6200,בת ים,יישוב,3593,1687,1906,411,3182,1284,3488,97,4.87%
2013-08,תל אביב,6300,גבעתיים,יישוב,869,371,498,267,602,100,858,3,2.88%
2013-08,תל אביב,6400,הרצלייה,יישוב,1281,543,738,294,987,59,1262,37,2.65%
2013-08,תל אביב,6600,חולון,יישוב,3650,1651,1999,475,3175,912,3561,49,3.61%
2013-08,תל אביב,2620,קריית אונו,יישוב,481,212,269,108,373,51,477,1,2.61%
2013-08,תל אביב,8600,רמת גן,יישוב,2402,1060,1342,516,1886,459,2364,16,3.06%
2013-08,תל אביב,2650,רמת השרון,יישוב,449,183,266,141,308,9,444,3,2.00%
2013-08,תל אביב,5000,תל אביב -יפו,יישוב,8733,4317,4416,2227,6506,2512,8580,121,3.45%
2013-09,אזור יהודה והשומרון,3760,אורנית,יישוב,102,41,61,30,72,5,102,0,2.29%
2013-09,אזור יהודה והשומרון,3750,אלפי מנשה,יישוב,112,44,68,20,92,1,112,0,2.63%
2013-09,אזור יהודה והשומרון,3560,אלקנה,יישוב,37,15,22,12,25,2,36,0,1.96%
2013-09,אזור יהודה והשומרון,3650,אפרת,יישוב,47,24,23,6,41,6,46,0,1.17%
2013-09,אזור יהודה והשומרון,3570,אריאל,יישוב,376,182,194,58,318,96,371,11,3.57%
2013-09,אזור יהודה והשומרון,3574,בית אל,יישוב,50,20,30,10,40,18,50,0,2.10%
2013-09,אזור יהודה והשומרון,3652,בית אריה,יישוב,66,23,43,5,61,3,66,0,2.69%
2013-09,אזור יהודה והשומרון,3780,ביתר עילית,יישוב,520,219,301,6,514,210,516,4,4.57%
2013-09,אזור יהודה והשומרון,3730,גבעת זאב,יישוב,174,75,99,39,135,39,173,1,2.39%
2013-09,אזור יהודה והשומרון,3769,הר אדר,יישוב,24,11,13,11,13,3,24,0,1.21%
2013-09,אזור יהודה והשומרון,3797,מודיעין עילית,יישוב,490,145,345,12,478,93,477,1,3.63%
2013-09,אזור יהודה והשומרון,3616,מעלה אדומים,יישוב,708,287,421,51,657,194,696,8,3.45%
2013-09,אזור יהודה והשומרון,3660,עמנואל,יישוב,78,33,45,0,78,48,76,5,6.91%
2013-09,אזור יהודה והשומרון,3557,קדומים,יישוב,44,24,20,11,33,9,43,0,2.39%
2013-09,אזור יהודה והשומרון,3611,קריית ארבע,יישוב,125,61,64,14,111,64,125,1,4.00%
2013-09,אזור יהודה והשומרון,3640,קרני שומרון,יישוב,85,39,46,14,71,11,85,1,2.41%
2013-09,הדרום,31,אופקים,יישוב,1447,602,845,78,1369,897,1426,20,11.22%
2013-09,הדרום,2600,אילת,יישוב,1385,583,802,50,1335,546,1363,17,4.14%
2013-09,הדרום,70,אשדוד,יישוב,7039,2756,4283,707,6332,3562,6927,161,6.43%
2013-09,הדרום,7100,אשקלון,יישוב,4423,1712,2711,457,3966,2413,4163,70,6.21%
2013-09,הדרום,9000,באר שבע,יישוב,7261,3184,4077,856,6405,4399,7070,106,6.87%
2013-09,הדרום,2200,דימונה,יישוב,2166,939,1227,113,2053,1377,2119,36,11.56%
2013-09,הדרום,1303,חורה,יישוב,796,333,463,1,795,726,789,2,20.36%
2013-09,הדרום,831,ירוחם,יישוב,495,223,272,16,479,272,472,13,10.44%
2013-09,הדרום,1059,כסיפה,יישוב,975,415,560,1,974,872,966,2,21.81%
2013-09,הדרום,1271,להבים,יישוב,65,31,34,27,38,5,65,1,1.89%
2013-09,הדרום,1060,לקיה,יישוב,958,425,533,3,955,891,951,1,23.76%
2013-09,הדרום,1268,מיתר,יישוב,78,38,40,23,55,7,77,1,1.84%
2013-09,הדרום,99,מצפה רמון,יישוב,281,115,166,10,271,163,262,10,10.59%
2013-09,הדרום,246,נתיבות,יישוב,1160,469,691,59,1101,566,1120,22,8.32%
2013-09,הדרום,666,עומר,יישוב,53,24,29,18,35,5,53,1,1.31%
2013-09,הדרום,2560,ערד,יישוב,790,354,436,76,714,444,757,27,6.08%
2013-09,הדרום,1192,ערערה-בנגב,יישוב,1034,416,618,2,1032,937,1029,0,25.57%
2013-09,הדרום,2630,קריית גת,יישוב,2230,899,1331,126,2104,1340,2196,20,7.91%
2013-09,הדרום,1034,קריית מלאכי,יישוב,1277,541,736,24,1253,731,1249,40,10.64%
2013-09,הדרום,1161,רהט,יישוב,3228,1298,1930,5,3223,2738,3209,39,17.82%
2013-09,הדרום,1286,שגב-שלום,יישוב,528,194,334,1,527,450,523,0,20.81%
2013-09,הדרום,1031,שדרות,יישוב,1135,483,652,33,1102,665,1112,11,8.90%
2013-09,הדרום,1054,תל שבע,יישוב,1210,581,629,1,1209,1126,1195,2,25.52%
2013-09,המרכז,182,אבן יהודה,יישוב,160,70,90,48,112,19,160,0,2.42%
2013-09,המרכז,41,אליכין,יישוב,70,37,33,7,63,19,69,0,3.78%
2013-09,המרכז,1309,אלעד,יישוב,474,213,261,27,447,122,464,4,3.89%
2013-09,המרכז,2530,באר יעקב,יישוב,266,107,159,58,208,59,263,2,3.03%
2013-09,המרכז,466,בית דגן,יישוב,117,68,49,21,96,42,115,1,3.27%
2013-09,המרכז,1066,"בני עי""ש",יישוב,187,84,103,18,169,73,185,3,4.69%
2013-09,המרכז,681,גבעת שמואל,יישוב,302,142,160,98,204,66,297,2,2.56%
2013-09,המרכז,2550,גדרה,יישוב,376,151,225,72,304,107,369,4,3.25%
2013-09,המרכז,627,ג'לג'וליה,יישוב,75,35,40,3,72,44,75,1,2.21%
2013-09,המרכז,166,גן יבנה,יישוב,407,147,260,49,358,99,404,3,3.66%
2013-09,המרכז,229,גני תקווה,יישוב,180,84,96,40,140,25,180,0,2.24%
2013-09,המרכז,9700,הוד השרון,יישוב,672,282,390,179,493,62,663,4,2.37%
2013-09,המרכז,1290,זמר,יישוב,167,50,117,1,166,129,166,1,5.90%
2013-09,המרכז,2730,טייבה,יישוב,2146,920,1226,14,2132,1810,2104,18,12.40%
2013-09,המרכז,2720,טירה,יישוב,325,144,181,8,317,163,315,4,2.90%
2013-09,המרכז,2660,יבנה,יישוב,914,416,498,67,847,361,905,17,4.15%
2013-09,המרכז,9400,יהוד,יישוב,532,219,313,72,460,84,516,7,3.32%
2013-09,המרכז,1224,כוכב יאיר,יישוב,116,57,59,44,72,1,115,0,2.06%
2013-09,המרכז,633,כפר ברא,יישוב,28,14,14,2,26,12,28,0,2.20%
2013-09,המרכז,168,כפר יונה,יישוב,332,152,180,57,275,62,328,5,3.13%
2013-09,המרכז,6900,כפר סבא,יישוב,1283,573,710,324,959,175,1268,13,2.47%
2013-09,המרכז,634,כפר קאסם,יישוב,249,126,123,2,247,146,242,1,2.85%
2013-09,המרכז,7000,לוד,יישוב,2222,1009,1213,157,2065,1226,2193,28,6.26%
2013-09,המרכז,1200,מודיעין-מכבים-רעות*,יישוב,1036,439,597,256,780,59,1024,9,2.45%
2013-09,המרכז,28,מזכרת בתיה,יישוב,159,58,101,37,122,37,157,0,2.37%
2013-09,המרכז,7200,נס ציונה,יישוב,732,303,429,154,578,209,726,5,3.20%
2013-09,המרכז,7400,נתניה,יישוב,4446,1964,2482,510,3936,1540,4374,40,4.25%
2013-09,המרכז,587,סביון*,יישוב,20,7,13,7,13,0,20,0,1.07%
2013-09,המרכז,171,פרדסייה,יישוב,83,39,44,14,69,9,83,0,2.35%
2013-09,המרכז,7900,פתח תקווה,יישוב,4003,1713,2290,737,3266,1097,3944,30,3.26%
2013-09,המרכז,195,קדימה-צורן,יישוב,252,100,152,56,196,36,251,0,2.52%
2013-09,המרכז,638,קלנסווה,יישוב,851,334,517,5,846,717,828,5,9.97%
2013-09,המרכז,469,קריית עקרון,יישוב,313,140,173,19,294,132,311,10,5.31%
2013-09,המרכז,2640,ראש העין,יישוב,749,343,406,83,666,162,740,7,3.31%
2013-09,המרכז,8300,ראשון לציון,יישוב,4420,1985,2435,719,3701,1408,4398,54,3.24%
2013-09,המרכז,8400,רחובות,יישוב,2671,1185,1486,515,2156,998,2625,26,4.00%
2013-09,המרכז,8500,רמלה,יישוב,1808,791,1017,98,1710,756,1753,27,4.86%
2013-09,המרכז,8700,רעננה,יישוב,847,395,452,282,565,87,838,1,2.27%
2013-09,המרכז,1304,שוהם,יישוב,192,87,105,62,130,7,192,0,1.81%
2013-09,המרכז,154,תל מונד,יישוב,133,57,76,35,98,23,132,1,2.24%
2013-09,הצפון,473,אבו סנאן,יישוב,696,264,432,4,692,593,693,2,12.44%
2013-09,הצפון,478,אכסאל,יישוב,511,213,298,11,500,442,508,0,9.46%
2013-09,הצפון,529,אעבלין,יישוב,612,234,378,4,608,517,609,10,11.19%
2013-09,הצפון,482,בועיינה-נוג'ידאת,יישוב,387,152,235,1,386,338,376,0,10.21%
2013-09,הצפון,4001,בוקעאתא,יישוב,387,149,238,7,380,337,375,0,14.29%
2013-09,הצפון,998,ביר אל-מכסור,יישוב,407,142,265,2,405,335,404,1,11.48%
2013-09,הצפון,480,בית ג'ן,יישוב,345,105,240,7,338,265,339,0,6.73%
2013-09,הצפון,9200,בית שאן,יישוב,832,361,471,20,812,440,816,43,8.23%
2013-09,הצפון,944,בסמת טבעון,יישוב,229,98,131,1,228,168,226,1,7.38%
2013-09,הצפון,483,בענה,יישוב,409,157,252,2,407,340,409,3,12.64%
2013-09,הצפון,1292,ג'דיידה-מכר,יישוב,1427,590,837,6,1421,1243,1415,14,16.23%
2013-09,הצפון,485,ג'ולס,יישוב,199,55,144,2,197,152,198,1,7.23%
2013-09,הצפון,487,ג'ש (גוש חלב),יישוב,65,29,36,4,61,31,65,4,4.10%
2013-09,הצפון,489,דבורייה,יישוב,400,175,225,14,386,299,396,3,9.65%
2013-09,הצפון,490,דייר אל-אסד,יישוב,371,141,230,6,365,308,371,4,7.59%
2013-09,הצפון,492,דייר חנא,יישוב,621,251,370,7,614,505,621,4,13.41%
2013-09,הצפון,975,זרזיר,יישוב,289,120,169,4,285,217,282,2,9.87%
2013-09,הצפון,496,חורפיש,יישוב,118,53,65,2,116,67,117,0,4.56%
2013-09,הצפון,2034,חצור הגלילית,יישוב,284,110,174,8,276,136,268,4,5.75%
2013-09,הצפון,6700,טבריה,יישוב,1778,755,1023,70,1708,1074,1586,27,7.34%
2013-09,הצפון,962,טובא-זנגרייה,יישוב,352,130,222,2,350,240,340,2,11.62%
2013-09,הצפון,498,טורעאן,יישוב,533,195,338,10,523,444,519,4,9.59%
2013-09,הצפון,8900,טמרה,יישוב,2025,802,1223,18,2007,1774,2008,12,14.81%
2013-09,הצפון,1295,יאנוח-ג'ת,יישוב,149,54,95,3,146,96,148,3,5.66%
2013-09,הצפון,46,יבנאל,יישוב,159,103,56,6,153,116,146,2,9.34%
2013-09,הצפון,499,יפיע,יישוב,646,274,372,14,632,515,638,2,8.49%
2013-09,הצפון,240,יקנעם עילית,יישוב,516,197,319,43,473,164,511,15,4.50%
2013-09,הצפון,502,ירכא,יישוב,523,203,320,0,523,421,522,0,9.60%
2013-09,הצפון,504,כאבול,יישוב,693,272,421,8,685,598,686,1,14.32%
2013-09,הצפון,505,כאוכב אבו אל-היג'א,יישוב,224,93,131,2,222,194,223,0,13.52%
2013-09,הצפון,1296,כסרא-סמיע,יישוב,206,87,119,6,200,150,199,1,6.16%
2013-09,הצפון,978,כעביה-טבאש-חג'אג'רה,יישוב,193,68,125,3,190,142,187,0,8.75%
2013-09,הצפון,1263,כפר ורדים,יישוב,63,21,42,16,47,9,62,0,2.00%
2013-09,הצפון,507,כפר יאסיף,יישוב,501,195,306,3,498,402,492,5,9.90%
2013-09,הצפון,508,כפר כמא,יישוב,63,22,41,2,61,31,61,0,3.89%
2013-09,הצפון,509,כפר כנא,יישוב,1126,435,691,15,1111,991,1090,6,12.89%
2013-09,הצפון,510,כפר מנדא,יישוב,963,434,529,12,951,711,950,0,13.49%
2013-09,הצפון,47,כפר תבור,יישוב,51,24,27,10,41,4,49,0,2.38%
2013-09,הצפון,1139,כרמיאל,יישוב,1675,658,1017,290,1385,849,1621,20,6.28%
2013-09,הצפון,481,מגאר,יישוב,1344,507,837,11,1333,1223,1324,1,15.57%
2013-09,הצפון,516,מג'ד אל-כרום,יישוב,558,237,321,3,555,438,557,11,8.92%
2013-09,הצפון,874,מגדל העמק,יישוב,1025,398,627,69,956,460,935,36,7.02%
2013-09,הצפון,4201,מג'דל שמס,יישוב,448,148,300,11,437,392,440,2,9.47%
2013-09,הצפון,517,מזרעה,יישוב,167,57,110,4,163,135,164,0,8.56%
2013-09,הצפון,4203,מסעדה,יישוב,187,65,122,5,182,162,184,3,11.32%
2013-09,הצפון,518,מעיליא,יישוב,52,23,29,5,47,22,51,0,3.29%
2013-09,הצפון,1063,מעלות-תרשיחא,יישוב,881,395,486,88,793,499,865,13,7.27%
2013-09,הצפון,520,משהד,יישוב,272,102,170,4,268,235,266,1,8.67%
2013-09,הצפון,9100,נהרייה,יישוב,1940,867,1073,169,1771,1197,1915,41,6.29%
2013-09,הצפון,522,נחף,יישוב,393,175,218,5,388,329,390,3,8.31%
2013-09,הצפון,7300,נצרת,יישוב,3201,1384,1817,93,3108,2497,3162,13,9.46%
2013-09,הצפון,1061,נצרת עילית,יישוב,1870,797,1073,177,1693,1048,1731,44,7.29%
2013-09,הצפון,525,סאג'ור,יישוב,98,39,59,2,96,67,97,0,5.80%
2013-09,הצפון,7500,סח'נין,יישוב,2001,865,1136,13,1988,1746,1994,5,14.93%
2013-09,הצפון,4501,ע'ג'ר,יישוב,76,30,46,0,76,64,76,0,7.83%
2013-09,הצפון,530,עיילבון,יישוב,204,75,129,3,201,143,203,2,7.62%
2013-09,הצפון,511,עילוט,יישוב,308,123,185,0,308,253,305,1,11.29%
2013-09,הצפון,532,עין מאהל,יישוב,585,263,322,7,578,494,569,2,11.77%
2013-09,הצפון,7600,עכו,יישוב,3222,1438,1784,99,3123,2435,3152,34,11.97%
2013-09,הצפון,7700,עפולה,יישוב,1757,705,1052,197,1560,830,1703,45,7.00%
2013-09,הצפון,531,עראבה,יישוב,1463,599,864,20,1443,1292,1451,13,15.00%
2013-09,הצפון,535,פסוטה,יישוב,111,49,62,6,105,78,111,0,6.76%
2013-09,הצפון,536,פקיעין (בוקייעה),יישוב,117,58,59,4,113,77,115,2,4.36%
2013-09,הצפון,8000,צפת,יישוב,1466,755,711,61,1405,1077,1424,21,10.73%
2013-09,הצפון,4100,קצרין,יישוב,180,74,106,20,160,90,179,1,4.58%
2013-09,הצפון,2800,קריית שמונה,יישוב,856,358,498,46,810,342,830,19,6.37%
2013-09,הצפון,543,ראמה,יישוב,307,117,190,8,299,240,306,1,8.11%
2013-09,הצפון,26,ראש פינה,יישוב,46,15,31,7,39,19,45,0,2.89%
2013-09,הצפון,542,ריינה,יישוב,667,261,406,5,662,552,649,0,9.97%
2013-09,הצפון,122,רמת ישי,יישוב,100,36,64,26,74,13,96,0,2.34%
2013-09,הצפון,913,שבלי - אום אל-גנם,יישוב,216,95,121,6,210,158,214,2,8.63%
2013-09,הצפון,812,שלומי,יישוב,264,109,155,15,249,133,259,3,7.18%
2013-09,הצפון,538,שעב,יישוב,507,209,298,3,504,452,506,1,17.35%
2013-09,הצפון,8800,שפרעם,יישוב,1973,740,1233,33,1940,1659,1954,20,11.51%
2013-09,חיפה,2710,אום אל-פחם,יישוב,3805,1509,2296,19,3786,3306,3758,9,18.71%
2013-09,חיפה,1020,אור עקיבא,יישוב,575,234,341,47,528,215,561,16,5.72%
2013-09,חיפה,6000,באקה אל-גרביה,יישוב,705,313,392,7,698,473,699,13,6.32%
2013-09,חיפה,9800,בנימינה-גבעת עדה*,יישוב,211,75,136,43,168,62,208,1,3.05%
2013-09,חיפה,1326,"בסמ""ה",יישוב,434,178,256,3,431,359,432,1,11.38%
2013-09,חיפה,541,ג'סר א-זרקא,יישוב,454,243,211,0,454,290,452,0,7.88%
2013-09,חיפה,628,ג'ת,יישוב,262,132,130,13,249,149,262,4,5.30%
2013-09,חיפה,494,דאלית אל-כרמל,יישוב,488,190,298,7,481,289,478,0,6.33%
2013-09,חיפה,9300,זכרון יעקב,יישוב,264,108,156,76,188,57,263,0,2.53%
2013-09,חיפה,6500,חדרה,יישוב,2485,981,1504,238,2247,980,2431,27,5.03%
2013-09,חיפה,4000,חיפה,יישוב,6535,3080,3455,987,5548,3506,6374,81,4.51%
2013-09,חיפה,1247,חריש,יישוב,26,16,10,4,22,7,25,0,1.63%
2013-09,חיפה,2100,טירת כרמל,יישוב,724,325,399,20,704,449,710,11,6.87%
2013-09,חיפה,654,כפר קרע,יישוב,426,192,234,6,420,256,419,7,5.20%
2013-09,חיפה,1327,מעלה עירון,יישוב,955,366,589,7,948,804,946,5,16.81%
2013-09,חיפה,2500,נשר,יישוב,493,230,263,79,414,196,489,13,3.82%
2013-09,חיפה,534,עספיא,יישוב,338,139,199,8,330,176,335,0,6.26%
2013-09,חיפה,637,ערערה,יישוב,588,228,360,5,583,393,578,12,7.48%
2013-09,חיפה,537,פוריידיס,יישוב,382,177,205,9,373,262,378,1,7.13%
2013-09,חיפה,7800,פרדס חנה-כרכור,יישוב,837,358,479,110,727,268,824,16,4.26%
2013-09,חיפה,6800,קריית אתא,יישוב,1697,740,957,126,1571,933,1675,29,5.73%
2013-09,חיפה,9500,קריית ביאליק,יישוב,1159,468,691,117,1042,614,1146,9,5.31%
2013-09,חיפה,2300,קריית טבעון,יישוב,168,72,96,43,125,42,167,1,2.00%
2013-09,חיפה,9600,קריית ים,יישוב,1575,726,849,139,1436,975,1557,23,7.26%
2013-09,חיפה,8200,קריית מוצקין,יישוב,1071,449,622,133,938,511,1050,12,4.64%
2013-09,חיפה,922,רכסים,יישוב,153,56,97,12,141,63,150,0,4.60%
2013-09,ירושלים,472,אבו גוש,יישוב,242,116,126,7,235,176,242,2,8.43%
2013-09,ירושלים,2610,בית שמש,יישוב,1377,579,798,84,1293,552,1343,27,4.50%
2013-09,ירושלים,3000,ירושלים,יישוב,11853,5148,6705,1220,10633,7088,11660,90,4.02%
2013-09,ירושלים,1015,מבשרת ציון,יישוב,380,178,202,61,319,156,376,3,2.88%
2013-09,ירושלים,1137,קריית יערים,יישוב,40,17,23,2,38,19,39,0,3.18%
2013-09,תל אביב,2400,אור יהודה,יישוב,800,344,456,30,770,254,779,17,4.17%
2013-09,תל אביב,565,אזור,יישוב,176,90,86,25,151,30,175,2,2.82%
2013-09,תל אביב,6100,בני ברק,יישוב,2583,1144,1439,114,2469,1363,2518,9,4.67%
2013-09,תל אביב,6200,בת ים,יישוב,3206,1455,1751,360,2846,1238,3119,53,4.37%
2013-09,תל אביב,6300,גבעתיים,יישוב,732,317,415,226,506,94,724,4,2.44%
2013-09,תל אביב,6400,הרצלייה,יישוב,1065,450,615,269,796,40,1054,22,2.22%
2013-09,תל אביב,6600,חולון,יישוב,3199,1491,1708,428,2771,860,3137,34,3.19%
2013-09,תל אביב,2620,קריית אונו,יישוב,414,174,240,99,315,41,411,2,2.25%
2013-09,תל אביב,8600,רמת גן,יישוב,2074,953,1121,467,1607,444,2040,13,2.65%
2013-09,תל אביב,2650,רמת השרון,יישוב,403,164,239,135,268,13,395,3,1.78%
2013-09,תל אביב,5000,תל אביב -יפו,יישוב,7998,3943,4055,1961,6037,2394,7880,74,3.18%
2013-10,אזור יהודה והשומרון,3760,אורנית,יישוב,107,45,62,33,74,5,106,1,2.37%
2013-10,אזור יהודה והשומרון,3750,אלפי מנשה,יישוב,116,48,68,21,95,4,116,1,2.72%
2013-10,אזור יהודה והשומרון,3560,אלקנה,יישוב,41,17,24,16,25,2,40,1,2.17%
2013-10,אזור יהודה והשומרון,3650,אפרת,יישוב,54,29,25,10,44,4,53,2,1.34%
2013-10,אזור יהודה והשומרון,3570,אריאל,יישוב,408,197,211,55,353,87,403,12,3.87%
2013-10,אזור יהודה והשומרון,3574,בית אל,יישוב,59,25,34,12,47,17,58,0,2.43%
2013-10,אזור יהודה והשומרון,3652,בית אריה,יישוב,66,26,40,5,61,2,65,1,2.65%
2013-10,אזור יהודה והשומרון,3780,ביתר עילית,יישוב,586,258,328,8,578,233,576,15,5.07%
2013-10,אזור יהודה והשומרון,3730,גבעת זאב,יישוב,185,86,99,42,143,42,183,1,2.53%
2013-10,אזור יהודה והשומרון,3769,הר אדר,יישוב,32,13,19,14,18,3,32,0,1.61%
2013-10,אזור יהודה והשומרון,3797,מודיעין עילית,יישוב,491,162,329,15,476,96,481,6,3.66%
2013-10,אזור יהודה והשומרון,3616,מעלה אדומים,יישוב,780,323,457,52,728,209,763,12,3.77%
2013-10,אזור יהודה והשומרון,3660,עמנואל,יישוב,74,37,37,0,74,51,73,3,6.65%
2013-10,אזור יהודה והשומרון,3557,קדומים,יישוב,42,23,19,14,28,8,42,2,2.34%
2013-10,אזור יהודה והשומרון,3611,קריית ארבע,יישוב,121,61,60,14,107,61,120,4,3.85%
2013-10,אזור יהודה והשומרון,3640,קרני שומרון,יישוב,97,47,50,19,78,14,97,4,2.74%
2013-10,הדרום,31,אופקים,יישוב,1532,663,869,77,1455,893,1507,58,11.78%
2013-10,הדרום,2600,אילת,יישוב,1509,667,842,58,1451,595,1475,53,4.47%
2013-10,הדרום,70,אשדוד,יישוב,7475,2986,4489,697,6778,3624,7330,253,6.78%
2013-10,הדרום,7100,אשקלון,יישוב,4708,1893,2815,439,4269,2483,4425,129,6.58%
2013-10,הדרום,9000,באר שבע,יישוב,7853,3495,4358,883,6970,4500,7628,245,7.37%
2013-10,הדרום,2200,דימונה,יישוב,2349,1015,1334,118,2231,1423,2285,66,12.35%
2013-10,הדרום,1303,חורה,יישוב,812,348,464,1,811,749,802,5,20.63%
2013-10,הדרום,831,ירוחם,יישוב,541,251,290,18,523,286,515,25,11.28%
2013-10,הדרום,1059,כסיפה,יישוב,1013,433,580,1,1012,902,1003,16,22.46%
2013-10,הדרום,1271,להבים,יישוב,71,28,43,29,42,7,71,0,2.06%
2013-10,הדרום,1060,לקיה,יישוב,1012,451,561,2,1010,938,1009,1,24.85%
2013-10,הדרום,1268,מיתר,יישוב,99,47,52,26,73,7,96,0,2.28%
2013-10,הדרום,99,מצפה רמון,יישוב,289,116,173,12,277,179,274,13,11.03%
2013-10,הדרום,246,נתיבות,יישוב,1232,508,724,59,1173,592,1186,22,8.77%
2013-10,הדרום,666,עומר,יישוב,64,28,36,20,44,7,64,1,1.58%
2013-10,הדרום,2560,ערד,יישוב,849,400,449,84,765,456,811,44,6.48%
2013-10,הדרום,1192,ערערה-בנגב,יישוב,1046,421,625,2,1044,956,1038,2,25.73%
2013-10,הדרום,2630,קריית גת,יישוב,2383,976,1407,130,2253,1388,2324,57,8.33%
2013-10,הדרום,1034,קריית מלאכי,יישוב,1473,647,826,28,1445,761,1419,93,11.91%
2013-10,הדרום,1161,רהט,יישוב,3320,1390,1930,5,3315,2821,3297,26,18.22%
2013-10,הדרום,1286,שגב-שלום,יישוב,538,201,337,1,537,461,534,3,21.16%
2013-10,הדרום,1031,שדרות,יישוב,1206,533,673,39,1167,671,1175,30,9.36%
2013-10,הדרום,1054,תל שבע,יישוב,1254,607,647,0,1254,1148,1241,10,26.24%
2013-10,המרכז,182,אבן יהודה,יישוב,177,72,105,50,127,17,177,1,2.67%
2013-10,המרכז,41,אליכין,יישוב,68,34,34,5,63,21,66,0,3.62%
2013-10,המרכז,1309,אלעד,יישוב,485,223,262,32,453,118,469,8,3.93%
2013-10,המרכז,2530,באר יעקב,יישוב,292,112,180,59,233,59,287,4,3.30%
2013-10,המרכז,466,בית דגן,יישוב,122,68,54,22,100,43,120,1,3.41%
2013-10,המרכז,1066,"בני עי""ש",יישוב,202,97,105,20,182,73,201,7,5.07%
2013-10,המרכז,681,גבעת שמואל,יישוב,327,152,175,109,218,74,316,1,2.72%
2013-10,המרכז,2550,גדרה,יישוב,414,167,247,77,337,109,410,4,3.60%
2013-10,המרכז,627,ג'לג'וליה,יישוב,80,42,38,3,77,44,80,0,2.36%
2013-10,המרכז,166,גן יבנה,יישוב,416,163,253,44,372,113,410,8,3.72%
2013-10,המרכז,229,גני תקווה,יישוב,204,92,112,39,165,25,204,1,2.53%
2013-10,המרכז,9700,הוד השרון,יישוב,719,304,415,205,514,76,705,7,2.52%
2013-10,המרכז,1290,זמר,יישוב,183,61,122,0,183,133,182,5,6.44%
2013-10,המרכז,2730,טייבה,יישוב,2155,939,1216,13,2142,1808,2102,23,12.39%
2013-10,המרכז,2720,טירה,יישוב,332,147,185,12,320,174,323,6,2.97%
2013-10,המרכז,2660,יבנה,יישוב,1069,486,583,76,993,382,1051,23,4.78%
2013-10,המרכז,9400,יהוד,יישוב,617,262,355,77,540,89,593,16,3.80%
2013-10,המרכז,1224,כוכב יאיר,יישוב,104,54,50,41,63,2,102,2,1.83%
2013-10,המרכז,633,כפר ברא,יישוב,29,13,16,2,27,14,29,0,2.27%
2013-10,המרכז,168,כפר יונה,יישוב,375,174,201,59,316,64,372,7,3.53%
2013-10,המרכז,6900,כפר סבא,יישוב,1436,661,775,347,1089,184,1413,22,2.75%
2013-10,המרכז,634,כפר קאסם,יישוב,255,134,121,1,254,149,251,5,2.95%
2013-10,המרכז,7000,לוד,יישוב,2357,1094,1263,158,2199,1252,2322,49,6.60%
2013-10,המרכז,1200,מודיעין-מכבים-רעות*,יישוב,1223,541,682,295,928,69,1200,16,2.86%
2013-10,המרכז,28,מזכרת בתיה,יישוב,172,62,110,41,131,40,170,4,2.56%
2013-10,המרכז,7200,נס ציונה,יישוב,790,322,468,174,616,211,784,10,3.45%
2013-10,המרכז,7400,נתניה,יישוב,4854,2236,2618,495,4359,1628,4749,107,4.60%
2013-10,המרכז,587,סביון*,יישוב,23,8,15,8,15,0,23,0,1.23%
2013-10,המרכז,171,פרדסייה,יישוב,85,36,49,14,71,9,85,3,2.40%
2013-10,המרכז,7900,פתח תקווה,יישוב,4462,1944,2518,771,3691,1152,4392,74,3.62%
2013-10,המרכז,195,קדימה-צורן,יישוב,255,100,155,59,196,39,254,0,2.55%
2013-10,המרכז,638,קלנסווה,יישוב,856,338,518,7,849,724,824,4,9.93%
2013-10,המרכז,469,קריית עקרון,יישוב,352,162,190,26,326,142,349,7,5.92%
2013-10,המרכז,2640,ראש העין,יישוב,845,389,456,89,756,170,827,21,3.68%
2013-10,המרכז,8300,ראשון לציון,יישוב,4805,2200,2605,782,4023,1478,4756,104,3.50%
2013-10,המרכז,8400,רחובות,יישוב,2843,1291,1552,515,2328,1043,2781,45,4.23%
2013-10,המרכז,8500,רמלה,יישוב,1966,893,1073,103,1863,803,1909,60,5.27%
2013-10,המרכז,8700,רעננה,יישוב,890,413,477,281,609,86,879,10,2.38%
2013-10,המרכז,1304,שוהם,יישוב,225,93,132,73,152,8,224,0,2.11%
2013-10,המרכז,154,תל מונד,יישוב,146,57,89,33,113,25,144,2,2.44%
2013-10,הצפון,473,אבו סנאן,יישוב,720,281,439,5,715,611,715,12,12.78%
2013-10,הצפון,478,אכסאל,יישוב,532,227,305,12,520,463,526,2,9.76%
2013-10,הצפון,529,אעבלין,יישוב,634,251,383,4,630,529,630,8,11.53%
2013-10,הצפון,482,בועיינה-נוג'ידאת,יישוב,417,170,247,3,414,349,405,7,10.91%
2013-10,הצפון,4001,בוקעאתא,יישוב,395,155,240,4,391,341,381,2,14.49%
2013-10,הצפון,998,ביר אל-מכסור,יישוב,415,148,267,1,414,330,413,6,11.71%
2013-10,הצפון,480,בית ג'ן,יישוב,382,118,264,9,373,292,374,1,7.37%
2013-10,הצפון,9200,בית שאן,יישוב,940,406,534,18,922,457,906,68,9.06%
2013-10,הצפון,944,בסמת טבעון,יישוב,237,104,133,1,236,180,235,1,7.65%
2013-10,הצפון,483,בענה,יישוב,417,164,253,2,415,347,416,8,12.83%
2013-10,הצפון,1292,ג'דיידה-מכר,יישוב,1477,631,846,5,1472,1265,1467,43,16.72%
2013-10,הצפון,485,ג'ולס,יישוב,208,62,146,3,205,153,207,1,7.53%
2013-10,הצפון,487,ג'ש (גוש חלב),יישוב,67,37,30,3,64,31,66,0,4.16%
2013-10,הצפון,489,דבורייה,יישוב,422,183,239,15,407,309,417,4,10.11%
2013-10,הצפון,490,דייר אל-אסד,יישוב,378,141,237,7,371,313,378,5,7.73%
2013-10,הצפון,492,דייר חנא,יישוב,622,256,366,9,613,499,622,0,13.43%
2013-10,הצפון,975,זרזיר,יישוב,316,136,180,2,314,225,304,4,10.56%
2013-10,הצפון,496,חורפיש,יישוב,128,57,71,4,124,66,126,3,4.89%
2013-10,הצפון,2034,חצור הגלילית,יישוב,319,133,186,12,307,146,294,5,6.28%
2013-10,הצפון,6700,טבריה,יישוב,1953,850,1103,67,1886,1125,1741,74,8.00%
2013-10,הצפון,962,טובא-זנגרייה,יישוב,369,143,226,2,367,251,358,4,12.16%
2013-10,הצפון,498,טורעאן,יישוב,531,197,334,8,523,450,515,7,9.52%
2013-10,הצפון,8900,טמרה,יישוב,2025,812,1213,16,2009,1776,2006,9,14.80%
2013-10,הצפון,1295,יאנוח-ג'ת,יישוב,145,55,90,4,141,95,144,2,5.52%
2013-10,הצפון,46,יבנאל,יישוב,168,106,62,6,162,122,146,1,9.34%
2013-10,הצפון,499,יפיע,יישוב,665,291,374,14,651,520,656,6,8.71%
2013-10,הצפון,240,יקנעם עילית,יישוב,598,232,366,48,550,177,592,26,5.17%
2013-10,הצפון,502,ירכא,יישוב,534,207,326,0,534,439,532,7,9.76%
2013-10,הצפון,504,כאבול,יישוב,705,280,425,8,697,612,699,0,14.56%
2013-10,הצפון,505,כאוכב אבו אל-היג'א,יישוב,230,96,134,4,226,194,229,2,13.83%
2013-10,הצפון,1296,כסרא-סמיע,יישוב,203,88,115,3,200,147,199,3,6.16%
2013-10,הצפון,978,כעביה-טבאש-חג'אג'רה,יישוב,209,74,135,3,206,151,202,6,9.39%
2013-10,הצפון,1263,כפר ורדים,יישוב,61,21,40,17,44,9,59,2,1.90%
2013-10,הצפון,507,כפר יאסיף,יישוב,505,203,302,4,501,403,496,5,9.97%
2013-10,הצפון,508,כפר כמא,יישוב,71,30,41,3,68,36,69,1,4.37%
2013-10,הצפון,509,כפר כנא,יישוב,1143,446,697,17,1126,997,1111,8,13.11%
2013-10,הצפון,510,כפר מנדא,יישוב,984,445,539,14,970,741,960,23,13.61%
2013-10,הצפון,47,כפר תבור,יישוב,53,25,28,10,43,4,52,1,2.52%
2013-10,הצפון,1139,כרמיאל,יישוב,1822,728,1094,305,1517,873,1744,73,6.72%
2013-10,הצפון,481,מגאר,יישוב,1399,546,853,12,1387,1254,1381,2,16.13%
2013-10,הצפון,516,מג'ד אל-כרום,יישוב,551,234,317,3,548,449,547,12,8.78%
2013-10,הצפון,874,מגדל העמק,יישוב,1165,463,702,65,1100,473,1057,96,7.86%
2013-10,הצפון,4201,מג'דל שמס,יישוב,468,164,304,13,455,401,458,0,9.82%
2013-10,הצפון,517,מזרעה,יישוב,171,63,108,4,167,134,169,2,8.79%
2013-10,הצפון,4203,מסעדה,יישוב,189,70,119,5,184,162,188,1,11.53%
2013-10,הצפון,518,מעיליא,יישוב,58,26,32,6,52,23,56,0,3.60%
2013-10,הצפון,1063,מעלות-תרשיחא,יישוב,953,441,512,83,870,512,929,33,7.77%
2013-10,הצפון,520,משהד,יישוב,270,93,177,6,264,242,264,5,8.61%
2013-10,הצפון,9100,נהרייה,יישוב,2103,947,1156,176,1927,1218,2064,95,6.74%
2013-10,הצפון,522,נחף,יישוב,415,190,225,6,409,340,410,7,8.70%
2013-10,הצפון,7300,נצרת,יישוב,3299,1414,1885,96,3203,2579,3250,29,9.69%
2013-10,הצפון,1061,נצרת עילית,יישוב,2050,878,1172,176,1874,1080,1885,125,7.89%
2013-10,הצפון,525,סאג'ור,יישוב,95,40,55,3,92,63,94,0,5.63%
2013-10,הצפון,7500,סח'נין,יישוב,2007,866,1141,14,1993,1721,2001,8,14.97%
2013-10,הצפון,4501,ע'ג'ר,יישוב,80,33,47,0,80,64,79,0,8.11%
2013-10,הצפון,530,עיילבון,יישוב,206,81,125,4,202,147,204,0,7.65%
2013-10,הצפון,511,עילוט,יישוב,308,121,187,0,308,256,304,0,11.26%
2013-10,הצפון,532,עין מאהל,יישוב,595,266,329,6,589,499,578,4,11.93%
2013-10,הצפון,7600,עכו,יישוב,3339,1482,1857,103,3236,2480,3271,54,12.36%
2013-10,הצפון,7700,עפולה,יישוב,2022,837,1185,198,1824,876,1938,113,7.89%
2013-10,הצפון,531,עראבה,יישוב,1482,614,868,23,1459,1300,1472,19,15.18%
2013-10,הצפון,535,פסוטה,יישוב,124,56,68,8,116,87,124,3,7.50%
2013-10,הצפון,536,פקיעין (בוקייעה),יישוב,127,68,59,4,123,80,126,2,4.75%
2013-10,הצפון,8000,צפת,יישוב,1659,858,801,66,1593,1150,1603,43,11.92%
2013-10,הצפון,4100,קצרין,יישוב,191,78,113,20,171,93,188,8,4.80%
2013-10,הצפון,2800,קריית שמונה,יישוב,969,416,553,42,927,352,934,39,7.12%
2013-10,הצפון,543,ראמה,יישוב,322,120,202,10,312,247,315,4,8.33%
2013-10,הצפון,26,ראש פינה,יישוב,56,19,37,10,46,20,54,0,3.45%
2013-10,הצפון,542,ריינה,יישוב,674,263,411,7,667,562,659,5,10.11%
2013-10,הצפון,122,רמת ישי,יישוב,120,50,70,27,93,14,116,1,2.82%
2013-10,הצפון,913,שבלי - אום אל-גנם,יישוב,222,101,121,6,216,156,221,1,8.89%
2013-10,הצפון,812,שלומי,יישוב,259,110,149,12,247,138,254,5,7.06%
2013-10,הצפון,538,שעב,יישוב,517,210,307,1,516,457,516,2,17.63%
2013-10,הצפון,8800,שפרעם,יישוב,2030,765,1265,26,2004,1703,2013,58,11.82%
2013-10,חיפה,2710,אום אל-פחם,יישוב,3793,1504,2289,17,3776,3300,3750,17,18.68%
2013-10,חיפה,1020,אור עקיבא,יישוב,658,266,392,52,606,233,632,31,6.40%
2013-10,חיפה,6000,באקה אל-גרביה,יישוב,733,340,393,5,728,473,730,11,6.58%
2013-10,חיפה,9800,בנימינה-גבעת עדה*,יישוב,240,88,152,50,190,62,238,1,3.48%
2013-10,חיפה,1326,"בסמ""ה",יישוב,435,181,254,3,432,357,432,3,11.38%
2013-10,חיפה,541,ג'סר א-זרקא,יישוב,431,227,204,0,431,305,428,3,7.49%
2013-10,חיפה,628,ג'ת,יישוב,284,143,141,15,269,156,283,14,5.70%
2013-10,חיפה,494,דאלית אל-כרמל,יישוב,501,204,297,9,492,297,489,2,6.47%
2013-10,חיפה,9300,זכרון יעקב,יישוב,278,117,161,70,208,57,278,0,2.67%
2013-10,חיפה,6500,חדרה,יישוב,2694,1089,1605,251,2443,985,2635,72,5.43%
2013-10,חיפה,4000,חיפה,יישוב,7058,3285,3773,1054,6004,3698,6848,194,4.83%
2013-10,חיפה,1247,חריש,יישוב,22,8,14,4,18,8,20,0,1.31%
2013-10,חיפה,2100,טירת כרמל,יישוב,748,342,406,20,728,457,736,25,7.10%
2013-10,חיפה,654,כפר קרע,יישוב,412,184,228,5,407,251,405,10,5.04%
2013-10,חיפה,1327,מעלה עירון,יישוב,954,371,583,6,948,820,948,3,16.84%
2013-10,חיפה,2500,נשר,יישוב,544,253,291,86,458,217,534,18,4.16%
2013-10,חיפה,534,עספיא,יישוב,342,142,200,11,331,173,337,9,6.29%
2013-10,חיפה,637,ערערה,יישוב,615,240,375,5,610,414,598,14,7.72%
2013-10,חיפה,537,פוריידיס,יישוב,412,199,213,8,404,271,407,0,7.64%
2013-10,חיפה,7800,פרדס חנה-כרכור,יישוב,902,388,514,116,786,275,887,36,4.57%
2013-10,חיפה,6800,קריית אתא,יישוב,1851,808,1043,127,1724,976,1826,60,6.22%
2013-10,חיפה,9500,קריית ביאליק,יישוב,1277,519,758,134,1143,630,1267,42,5.84%
2013-10,חיפה,2300,קריית טבעון,יישוב,192,88,104,46,146,44,191,0,2.28%
2013-10,חיפה,9600,קריית ים,יישוב,1697,776,921,142,1555,1008,1676,49,7.77%
2013-10,חיפה,8200,קריית מוצקין,יישוב,1158,476,682,129,1029,538,1138,34,5.01%
2013-10,חיפה,922,רכסים,יישוב,158,65,93,7,151,73,151,0,4.63%
2013-10,ירושלים,472,אבו גוש,יישוב,258,131,127,8,250,179,256,4,8.87%
2013-10,ירושלים,2610,בית שמש,יישוב,1522,666,856,90,1432,580,1471,53,4.91%
2013-10,ירושלים,3000,ירושלים,יישוב,12700,5608,7092,1362,11338,7345,12447,161,4.28%
2013-10,ירושלים,1015,מבשרת ציון,יישוב,415,192,223,62,353,165,410,6,3.13%
2013-10,ירושלים,1137,קריית יערים,יישוב,42,21,21,3,39,19,41,0,3.34%
2013-10,תל אביב,2400,אור יהודה,יישוב,903,395,508,34,869,262,872,35,4.65%
2013-10,תל אביב,565,אזור,יישוב,190,91,99,27,163,34,187,3,3.00%
2013-10,תל אביב,6100,בני ברק,יישוב,2638,1241,1397,114,2524,1409,2559,36,4.75%
2013-10,תל אביב,6200,בת ים,יישוב,3645,1707,1938,384,3261,1284,3523,102,4.91%
2013-10,תל אביב,6300,גבעתיים,יישוב,779,336,443,242,537,97,771,5,2.60%
2013-10,תל אביב,6400,הרצלייה,יישוב,1203,515,688,287,916,46,1189,30,2.50%
2013-10,תל אביב,6600,חולון,יישוב,3537,1660,1877,446,3091,889,3458,90,3.51%
2013-10,תל אביב,2620,קריית אונו,יישוב,464,194,270,101,363,43,461,4,2.52%
2013-10,תל אביב,8600,רמת גן,יישוב,2320,1071,1249,518,1802,472,2273,29,2.95%
2013-10,תל אביב,2650,רמת השרון,יישוב,401,160,241,130,271,12,395,5,1.78%
2013-10,תל אביב,5000,תל אביב -יפו,יישוב,8703,4240,4463,2114,6589,2466,8552,147,3.44%
2013-11,אזור יהודה והשומרון,3760,אורנית,יישוב,94,38,56,34,60,3,93,0,2.09%
2013-11,אזור יהודה והשומרון,3750,אלפי מנשה,יישוב,109,47,62,17,92,4,109,1,2.56%
2013-11,אזור יהודה והשומרון,3560,אלקנה,יישוב,41,19,22,18,23,2,40,0,2.17%
2013-11,אזור יהודה והשומרון,3650,אפרת,יישוב,49,22,27,12,37,3,49,0,1.24%
2013-11,אזור יהודה והשומרון,3570,אריאל,יישוב,367,183,184,47,320,82,366,7,3.53%
2013-11,אזור יהודה והשומרון,3574,בית אל,יישוב,59,22,37,13,46,15,59,0,2.47%
2013-11,אזור יהודה והשומרון,3652,בית אריה,יישוב,55,24,31,6,49,3,54,0,2.21%
2013-11,אזור יהודה והשומרון,3780,ביתר עילית,יישוב,536,250,286,8,528,228,533,6,4.71%
2013-11,אזור יהודה והשומרון,3730,גבעת זאב,יישוב,173,79,94,34,139,43,172,3,2.38%
2013-11,אזור יהודה והשומרון,3769,הר אדר,יישוב,29,11,18,14,15,3,29,0,1.46%
2013-11,אזור יהודה והשומרון,3797,מודיעין עילית,יישוב,431,156,275,17,414,88,423,3,3.23%
2013-11,אזור יהודה והשומרון,3616,מעלה אדומים,יישוב,729,306,423,53,676,203,713,17,3.53%
2013-11,אזור יהודה והשומרון,3660,עמנואל,יישוב,71,38,33,0,71,52,70,0,6.40%
2013-11,אזור יהודה והשומרון,3557,קדומים,יישוב,38,24,14,15,23,8,38,0,2.12%
2013-11,אזור יהודה והשומרון,3611,קריית ארבע,יישוב,112,58,54,13,99,60,111,3,3.57%
2013-11,אזור יהודה והשומרון,3640,קרני שומרון,יישוב,86,43,43,14,72,11,85,2,2.41%
2013-11,הדרום,31,אופקים,יישוב,1368,593,775,70,1298,868,1347,39,10.67%
2013-11,הדרום,2600,אילת,יישוב,1398,620,778,46,1352,551,1373,49,4.17%
2013-11,הדרום,70,אשדוד,יישוב,6977,2877,4100,673,6304,3506,6832,206,6.35%
2013-11,הדרום,7100,אשקלון,יישוב,4406,1834,2572,393,4013,2375,4126,119,6.16%
2013-11,הדרום,9000,באר שבע,יישוב,7249,3216,4033,854,6395,4332,7041,178,6.85%
2013-11,הדרום,2200,דימונה,יישוב,2136,942,1194,114,2022,1386,2074,64,11.34%
2013-11,הדרום,1303,חורה,יישוב,791,336,455,2,789,734,783,9,20.24%
2013-11,הדרום,831,ירוחם,יישוב,479,216,263,17,462,270,462,25,10.24%
2013-11,הדרום,1059,כסיפה,יישוב,1002,422,580,1,1001,898,995,9,22.32%
2013-11,הדרום,1271,להבים,יישוב,64,26,38,25,39,5,64,0,1.86%
2013-11,הדרום,1060,לקיה,יישוב,1008,457,551,2,1006,935,1001,23,24.70%
2013-11,הדרום,1268,מיתר,יישוב,68,32,36,24,44,6,67,0,1.60%
2013-11,הדרום,99,מצפה רמון,יישוב,290,126,164,13,277,174,270,14,10.88%
2013-11,הדרום,246,נתיבות,יישוב,1071,463,608,42,1029,548,1041,28,7.78%
2013-11,הדרום,666,עומר,יישוב,52,21,31,16,36,6,51,1,1.26%
2013-11,הדרום,2560,ערד,יישוב,849,383,466,83,766,436,811,39,6.48%
2013-11,הדרום,1192,ערערה-בנגב,יישוב,1036,418,618,2,1034,950,1026,40,25.51%
2013-11,הדרום,2630,קריית גת,יישוב,2235,918,1317,119,2116,1310,2194,36,7.90%
2013-11,הדרום,1034,קריית מלאכי,יישוב,1262,548,714,22,1240,749,1226,55,10.46%
2013-11,הדרום,1161,רהט,יישוב,3184,1322,1862,5,3179,2765,3163,45,17.61%
2013-11,הדרום,1286,שגב-שלום,יישוב,541,216,325,0,541,462,534,5,21.16%
2013-11,הדרום,1031,שדרות,יישוב,1122,500,622,28,1094,650,1092,21,8.75%
2013-11,הדרום,1054,תל שבע,יישוב,1212,591,621,0,1212,1124,1201,12,25.61%
2013-11,המרכז,182,אבן יהודה,יישוב,174,71,103,47,127,21,174,2,2.63%
2013-11,המרכז,41,אליכין,יישוב,62,36,26,7,55,20,60,1,3.30%
2013-11,המרכז,1309,אלעד,יישוב,454,211,243,31,423,117,443,5,3.72%
2013-11,המרכז,2530,באר יעקב,יישוב,269,115,154,58,211,56,268,2,3.09%
2013-11,המרכז,466,בית דגן,יישוב,107,59,48,18,89,45,106,1,3.02%
2013-11,המרכז,1066,"בני עי""ש",יישוב,181,89,92,22,159,73,179,6,4.54%
2013-11,המרכז,681,גבעת שמואל,יישוב,300,143,157,94,206,70,290,3,2.50%
2013-11,המרכז,2550,גדרה,יישוב,371,148,223,64,307,105,365,3,3.21%
2013-11,המרכז,627,ג'לג'וליה,יישוב,86,40,46,1,85,46,86,0,2.53%
2013-11,המרכז,166,גן יבנה,יישוב,374,149,225,38,336,99,369,9,3.36%
2013-11,המרכז,229,גני תקווה,יישוב,201,96,105,41,160,28,201,2,2.49%
2013-11,המרכז,9700,הוד השרון,יישוב,705,307,398,197,508,76,695,7,2.48%
2013-11,המרכז,1290,זמר,יישוב,174,58,116,0,174,125,172,4,6.10%
2013-11,המרכז,2730,טייבה,יישוב,2080,876,1204,14,2066,1766,2024,21,11.98%
2013-11,המרכז,2720,טירה,יישוב,328,149,179,6,322,173,323,9,2.97%
2013-11,המרכז,2660,יבנה,יישוב,969,450,519,66,903,372,952,45,4.35%
2013-11,המרכז,9400,יהוד,יישוב,540,232,308,84,456,77,532,12,3.42%
2013-11,המרכז,1224,כוכב יאיר,יישוב,102,49,53,44,58,2,100,3,1.80%
2013-11,המרכז,633,כפר ברא,יישוב,25,11,14,1,24,13,25,0,1.97%
2013-11,המרכז,168,כפר יונה,יישוב,335,160,175,50,285,62,332,10,3.16%
2013-11,המרכז,6900,כפר סבא,יישוב,1335,589,746,322,1013,180,1317,31,2.57%
2013-11,המרכז,634,כפר קאסם,יישוב,284,154,130,1,283,155,279,3,3.27%
2013-11,המרכז,7000,לוד,יישוב,2226,1012,1214,151,2075,1200,2200,43,6.28%
2013-11,המרכז,1200,מודיעין-מכבים-רעות*,יישוב,1092,491,601,284,808,63,1069,14,2.56%
2013-11,המרכז,28,מזכרת בתיה,יישוב,161,66,95,35,126,39,159,2,2.40%
2013-11,המרכז,7200,נס ציונה,יישוב,718,300,418,157,561,216,713,7,3.14%
2013-11,המרכז,7400,נתניה,יישוב,4467,2093,2374,474,3993,1607,4384,102,4.26%
2013-11,המרכז,587,סביון*,יישוב,23,7,16,9,14,0,23,0,1.23%
2013-11,המרכז,171,פרדסייה,יישוב,81,32,49,12,69,12,81,0,2.29%
2013-11,המרכז,7900,פתח תקווה,יישוב,4203,1857,2346,773,3430,1081,4140,50,3.42%
2013-11,המרכז,195,קדימה-צורן,יישוב,258,106,152,52,206,41,256,1,2.57%
2013-11,המרכז,638,קלנסווה,יישוב,818,316,502,3,815,691,794,11,9.60%
2013-11,המרכז,469,קריית עקרון,יישוב,316,154,162,23,293,138,314,10,5.36%
2013-11,המרכז,2640,ראש העין,יישוב,785,374,411,86,699,162,773,16,3.45%
2013-11,המרכז,8300,ראשון לציון,יישוב,4422,2009,2413,757,3665,1396,4380,68,3.23%
2013-11,המרכז,8400,רחובות,יישוב,2672,1207,1465,473,2199,1003,2619,50,3.99%
2013-11,המרכז,8500,רמלה,יישוב,1795,835,960,88,1707,758,1750,50,4.86%
2013-11,המרכז,8700,רעננה,יישוב,839,396,443,270,569,80,828,6,2.25%
2013-11,המרכז,1304,שוהם,יישוב,206,86,120,80,126,11,204,1,1.93%
2013-11,המרכז,154,תל מונד,יישוב,148,64,84,35,113,19,148,0,2.51%
2013-11,הצפון,473,אבו סנאן,יישוב,718,285,433,4,714,608,715,15,12.78%
2013-11,הצפון,478,אכסאל,יישוב,528,226,302,11,517,451,523,3,9.71%
2013-11,הצפון,529,אעבלין,יישוב,629,247,382,3,626,527,626,7,11.47%
2013-11,הצפון,482,בועיינה-נוג'ידאת,יישוב,402,163,239,2,400,334,395,8,10.67%
2013-11,הצפון,4001,בוקעאתא,יישוב,385,142,243,4,381,337,375,0,14.29%
2013-11,הצפון,998,ביר אל-מכסור,יישוב,415,154,261,1,414,331,413,4,11.71%
2013-11,הצפון,480,בית ג'ן,יישוב,378,120,258,9,369,285,372,0,7.33%
2013-11,הצפון,9200,בית שאן,יישוב,836,373,463,17,819,421,807,57,8.15%
2013-11,הצפון,944,בסמת טבעון,יישוב,230,105,125,1,229,176,228,5,7.44%
2013-11,הצפון,483,בענה,יישוב,408,159,249,2,406,342,406,8,12.56%
2013-11,הצפון,1292,ג'דיידה-מכר,יישוב,1442,610,832,5,1437,1261,1429,44,16.36%
2013-11,הצפון,485,ג'ולס,יישוב,197,58,139,2,195,149,196,0,7.16%
2013-11,הצפון,487,ג'ש (גוש חלב),יישוב,70,37,33,1,69,32,70,2,4.40%
2013-11,הצפון,489,דבורייה,יישוב,397,174,223,13,384,304,393,3,9.59%
2013-11,הצפון,490,דייר אל-אסד,יישוב,390,155,235,8,382,317,390,6,7.95%
2013-11,הצפון,492,דייר חנא,יישוב,623,260,363,10,613,496,623,3,13.45%
2013-11,הצפון,975,זרזיר,יישוב,297,130,167,1,296,212,283,5,9.90%
2013-11,הצפון,496,חורפיש,יישוב,117,47,70,4,113,61,115,2,4.49%
2013-11,הצפון,2034,חצור הגלילית,יישוב,321,131,190,14,307,152,294,10,6.28%
2013-11,הצפון,6700,טבריה,יישוב,1799,807,992,62,1737,1081,1585,53,7.33%
2013-11,הצפון,962,טובא-זנגרייה,יישוב,366,158,208,2,364,252,355,2,12.07%
2013-11,הצפון,498,טורעאן,יישוב,525,197,328,10,515,455,505,15,9.36%
2013-11,הצפון,8900,טמרה,יישוב,1984,794,1190,13,1971,1753,1966,28,14.55%
2013-11,הצפון,1295,יאנוח-ג'ת,יישוב,159,57,102,6,153,103,157,2,5.99%
2013-11,הצפון,46,יבנאל,יישוב,168,107,61,5,163,130,145,0,9.28%
2013-11,הצפון,499,יפיע,יישוב,657,289,368,13,644,519,648,10,8.61%
2013-11,הצפון,240,יקנעם עילית,יישוב,531,205,326,40,491,171,524,29,4.60%
2013-11,הצפון,502,ירכא,יישוב,545,211,333,0,545,442,541,5,9.91%
2013-11,הצפון,504,כאבול,יישוב,714,281,433,7,707,620,709,0,14.73%
2013-11,הצפון,505,כאוכב אבו אל-היג'א,יישוב,227,94,133,4,223,195,226,2,13.67%
2013-11,הצפון,1296,כסרא-סמיע,יישוב,199,86,113,4,195,150,196,2,6.07%
2013-11,הצפון,978,כעביה-טבאש-חג'אג'רה,יישוב,208,75,133,3,205,146,204,9,9.47%
2013-11,הצפון,1263,כפר ורדים,יישוב,45,19,26,20,25,5,45,0,1.46%
2013-11,הצפון,507,כפר יאסיף,יישוב,504,203,301,4,500,403,495,15,9.95%
2013-11,הצפון,508,כפר כמא,יישוב,62,23,39,2,60,36,60,1,3.82%
2013-11,הצפון,509,כפר כנא,יישוב,1113,440,673,19,1094,980,1070,20,12.69%
2013-11,הצפון,510,כפר מנדא,יישוב,973,439,534,13,960,737,952,13,13.52%
2013-11,הצפון,47,כפר תבור,יישוב,47,23,24,5,42,1,45,0,2.19%
2013-11,הצפון,1139,כרמיאל,יישוב,1698,665,1033,296,1402,833,1621,69,6.28%
2013-11,הצפון,481,מגאר,יישוב,1389,540,849,13,1376,1244,1370,2,16.03%
2013-11,הצפון,516,מג'ד אל-כרום,יישוב,564,248,316,4,560,451,557,12,8.92%
2013-11,הצפון,874,מגדל העמק,יישוב,1046,414,632,55,991,458,935,77,7.02%
2013-11,הצפון,4201,מג'דל שמס,יישוב,480,175,305,13,467,405,469,1,10.03%
2013-11,הצפון,517,מזרעה,יישוב,171,64,107,3,168,135,169,5,8.79%
2013-11,הצפון,4203,מסעדה,יישוב,191,71,120,3,188,161,188,0,11.53%
2013-11,הצפון,518,מעיליא,יישוב,56,25,31,3,53,24,55,3,3.53%
2013-11,הצפון,1063,מעלות-תרשיחא,יישוב,894,420,474,82,812,521,879,22,7.38%
2013-11,הצפון,520,משהד,יישוב,269,99,170,4,265,240,262,1,8.55%
2013-11,הצפון,9100,נהרייה,יישוב,2052,918,1134,171,1881,1213,2009,87,6.58%
2013-11,הצפון,522,נחף,יישוב,398,183,215,6,392,322,395,6,8.41%
2013-11,הצפון,7300,נצרת,יישוב,3213,1380,1833,89,3124,2540,3172,40,9.48%
2013-11,הצפון,1061,נצרת עילית,יישוב,1863,782,1081,157,1706,1039,1709,105,7.21%
2013-11,הצפון,525,סאג'ור,יישוב,102,42,60,2,100,63,101,2,6.03%
2013-11,הצפון,7500,סח'נין,יישוב,2014,861,1153,18,1996,1722,2010,16,15.03%
2013-11,הצפון,4501,ע'ג'ר,יישוב,84,35,49,0,84,66,84,1,8.58%
2013-11,הצפון,530,עיילבון,יישוב,214,87,127,4,210,153,210,0,7.86%
2013-11,הצפון,511,עילוט,יישוב,311,121,190,0,311,257,310,2,11.46%
2013-11,הצפון,532,עין מאהל,יישוב,586,261,325,8,578,491,567,1,11.73%
2013-11,הצפון,7600,עכו,יישוב,3259,1484,1775,99,3160,2441,3197,55,12.12%
2013-11,הצפון,7700,עפולה,יישוב,1821,792,1029,180,1641,833,1742,88,7.15%
2013-11,הצפון,531,עראבה,יישוב,1458,590,868,15,1443,1288,1449,8,14.98%
2013-11,הצפון,535,פסוטה,יישוב,125,49,76,5,120,88,125,1,7.55%
2013-11,הצפון,536,פקיעין (בוקייעה),יישוב,123,67,56,5,118,81,122,1,4.61%
2013-11,הצפון,8000,צפת,יישוב,1523,797,726,67,1456,1112,1475,23,11.07%
2013-11,הצפון,4100,קצרין,יישוב,185,71,114,17,168,93,184,7,4.70%
2013-11,הצפון,2800,קריית שמונה,יישוב,874,388,486,45,829,352,843,30,6.47%
2013-11,הצפון,543,ראמה,יישוב,318,120,198,9,309,237,312,0,8.26%
2013-11,הצפון,26,ראש פינה,יישוב,58,18,40,12,46,21,56,1,3.57%
2013-11,הצפון,542,ריינה,יישוב,673,270,403,5,668,568,656,6,10.06%
2013-11,הצפון,122,רמת ישי,יישוב,95,36,59,28,67,11,91,1,2.22%
2013-11,הצפון,913,שבלי - אום אל-גנם,יישוב,227,108,119,6,221,154,225,3,9.04%
2013-11,הצפון,812,שלומי,יישוב,246,106,140,10,236,136,237,6,6.61%
2013-11,הצפון,538,שעב,יישוב,519,208,311,1,518,454,518,2,17.69%
2013-11,הצפון,8800,שפרעם,יישוב,2003,757,1246,23,1980,1683,1986,16,11.68%
2013-11,חיפה,2710,אום אל-פחם,יישוב,3751,1495,2256,17,3734,3274,3697,3,18.46%
2013-11,חיפה,1020,אור עקיבא,יישוב,596,236,360,45,551,217,577,10,5.87%
2013-11,חיפה,6000,באקה אל-גרביה,יישוב,726,337,389,3,723,473,718,16,6.48%
2013-11,חיפה,9800,בנימינה-גבעת עדה*,יישוב,241,90,151,56,185,62,240,1,3.51%
2013-11,חיפה,1326,"בסמ""ה",יישוב,423,174,249,3,420,354,420,1,11.10%
2013-11,חיפה,541,ג'סר א-זרקא,יישוב,424,227,197,0,424,303,421,2,7.38%
2013-11,חיפה,628,ג'ת,יישוב,262,131,131,13,249,151,261,8,5.28%
2013-11,חיפה,494,דאלית אל-כרמל,יישוב,508,212,296,11,497,304,496,8,6.55%
2013-11,חיפה,9300,זכרון יעקב,יישוב,265,116,149,58,207,59,265,0,2.55%
2013-11,חיפה,6500,חדרה,יישוב,2501,1037,1464,252,2249,958,2441,52,5.05%
2013-11,חיפה,4000,חיפה,יישוב,6727,3173,3554,1002,5725,3598,6537,191,4.62%
2013-11,חיפה,1247,חריש,יישוב,24,13,11,4,20,8,20,0,1.31%
2013-11,חיפה,2100,טירת כרמל,יישוב,744,357,387,20,724,444,732,18,7.06%
2013-11,חיפה,654,כפר קרע,יישוב,407,174,233,6,401,242,403,9,5.01%
2013-11,חיפה,1327,מעלה עירון,יישוב,926,357,569,5,921,803,919,4,16.41%
2013-11,חיפה,2500,נשר,יישוב,490,236,254,79,411,192,482,10,3.77%
2013-11,חיפה,534,עספיא,יישוב,340,134,206,10,330,178,336,3,6.28%
2013-11,חיפה,637,ערערה,יישוב,580,221,359,6,574,410,569,11,7.37%
2013-11,חיפה,537,פוריידיס,יישוב,408,196,212,8,400,272,403,0,7.57%
2013-11,חיפה,7800,פרדס חנה-כרכור,יישוב,864,408,456,107,757,278,851,16,4.39%
2013-11,חיפה,6800,קריית אתא,יישוב,1714,771,943,113,1601,930,1693,56,5.79%
2013-11,חיפה,9500,קריית ביאליק,יישוב,1206,507,699,122,1084,609,1198,43,5.54%
2013-11,חיפה,2300,קריית טבעון,יישוב,182,81,101,54,128,46,179,2,2.14%
2013-11,חיפה,9600,קריית ים,יישוב,1609,748,861,127,1482,973,1588,45,7.39%
2013-11,חיפה,8200,קריית מוצקין,יישוב,1111,465,646,123,988,517,1095,26,4.83%
2013-11,חיפה,922,רכסים,יישוב,144,60,84,7,137,72,135,1,4.16%
2013-11,ירושלים,472,אבו גוש,יישוב,255,128,127,6,249,182,254,3,8.81%
2013-11,ירושלים,2610,בית שמש,יישוב,1379,623,756,85,1294,547,1333,35,4.47%
2013-11,ירושלים,3000,ירושלים,יישוב,12160,5393,6767,1293,10867,7259,11911,162,4.11%
2013-11,ירושלים,1015,מבשרת ציון,יישוב,384,172,212,61,323,162,381,4,2.92%
2013-11,ירושלים,1137,קריית יערים,יישוב,35,18,17,4,31,18,34,0,2.79%
2013-11,תל אביב,2400,אור יהודה,יישוב,865,409,456,33,832,268,827,37,4.42%
2013-11,תל אביב,565,אזור,יישוב,185,102,83,24,161,32,182,3,2.93%
2013-11,תל אביב,6100,בני ברק,יישוב,2416,1169,1247,105,2311,1376,2345,34,4.37%
2013-11,תל אביב,6200,בת ים,יישוב,3424,1624,1800,377,3047,1256,3316,97,4.64%
2013-11,תל אביב,6300,גבעתיים,יישוב,754,337,417,252,502,103,747,7,2.52%
2013-11,תל אביב,6400,הרצלייה,יישוב,1092,472,620,257,835,31,1078,31,2.27%
2013-11,תל אביב,6600,חולון,יישוב,3366,1596,1770,431,2935,863,3290,83,3.34%
2013-11,תל אביב,2620,קריית אונו,יישוב,440,187,253,95,345,46,435,2,2.38%
2013-11,תל אביב,8600,רמת גן,יישוב,2203,1017,1186,532,1671,456,2161,27,2.81%
2013-11,תל אביב,2650,רמת השרון,יישוב,385,164,221,120,265,7,381,9,1.72%
2013-11,תל אביב,5000,תל אביב -יפו,יישוב,8258,4064,4194,2096,6162,2416,8109,114,3.27%
2013-12,אזור יהודה והשומרון,3760,אורנית,יישוב,108,45,63,39,69,3,107,0,2.40%
2013-12,אזור יהודה והשומרון,3750,אלפי מנשה,יישוב,120,57,63,18,102,5,119,1,2.79%
2013-12,אזור יהודה והשומרון,3560,אלקנה,יישוב,36,17,19,18,18,2,35,2,1.91%
2013-12,אזור יהודה והשומרון,3650,אפרת,יישוב,44,25,19,10,34,1,44,1,1.12%
2013-12,אזור יהודה והשומרון,3570,אריאל,יישוב,368,174,194,49,319,87,364,1,3.51%
2013-12,אזור יהודה והשומרון,3574,בית אל,יישוב,61,24,37,15,46,18,60,3,2.51%
2013-12,אזור יהודה והשומרון,3652,בית אריה,יישוב,62,23,39,10,52,3,62,0,2.53%
2013-12,אזור יהודה והשומרון,3780,ביתר עילית,יישוב,531,246,285,7,524,229,528,6,4.67%
2013-12,אזור יהודה והשומרון,3730,גבעת זאב,יישוב,186,80,106,40,146,40,185,2,2.55%
2013-12,אזור יהודה והשומרון,3769,הר אדר,יישוב,32,15,17,12,20,3,32,0,1.61%
2013-12,אזור יהודה והשומרון,3797,מודיעין עילית,יישוב,462,164,298,24,438,91,451,9,3.44%
2013-12,אזור יהודה והשומרון,3616,מעלה אדומים,יישוב,715,302,413,48,667,211,706,15,3.50%
2013-12,אזור יהודה והשומרון,3660,עמנואל,יישוב,72,41,31,0,72,49,71,2,6.48%
2013-12,אזור יהודה והשומרון,3557,קדומים,יישוב,38,21,17,11,27,9,38,0,2.12%
2013-12,אזור יהודה והשומרון,3611,קריית ארבע,יישוב,112,56,56,13,99,61,109,4,3.51%
2013-12,אזור יהודה והשומרון,3640,קרני שומרון,יישוב,97,58,39,14,83,13,95,2,2.68%
2013-12,הדרום,31,אופקים,יישוב,1343,586,757,75,1268,852,1319,39,10.47%
2013-12,הדרום,2600,אילת,יישוב,1529,692,837,46,1483,580,1494,53,4.52%
2013-12,הדרום,70,אשדוד,יישוב,7124,2972,4152,716,6408,3540,6970,234,6.47%
2013-12,הדרום,7100,אשקלון,יישוב,4393,1840,2553,380,4013,2371,4086,100,6.10%
2013-12,הדרום,9000,באר שבע,יישוב,7409,3326,4083,858,6551,4394,7183,182,6.97%
2013-12,הדרום,2200,דימונה,יישוב,2204,968,1236,116,2088,1396,2137,59,11.64%
2013-12,הדרום,1303,חורה,יישוב,816,361,455,4,812,750,808,2,20.75%
2013-12,הדרום,831,ירוחם,יישוב,483,224,259,15,468,270,463,19,10.26%
2013-12,הדרום,1059,כסיפה,יישוב,1023,436,587,2,1021,914,1009,3,22.56%
2013-12,הדרום,1271,להבים,יישוב,57,24,33,22,35,5,56,2,1.63%
2013-12,הדרום,1060,לקיה,יישוב,1006,449,557,0,1006,938,1001,4,24.70%
2013-12,הדרום,1268,מיתר,יישוב,67,29,38,21,46,8,64,0,1.53%
2013-12,הדרום,99,מצפה רמון,יישוב,285,119,166,10,275,173,270,13,10.88%
2013-12,הדרום,246,נתיבות,יישוב,1143,506,637,46,1097,574,1105,61,8.22%
2013-12,הדרום,666,עומר,יישוב,58,25,33,19,39,7,57,0,1.41%
2013-12,הדרום,2560,ערד,יישוב,908,428,480,89,819,452,868,41,6.91%
2013-12,הדרום,1192,ערערה-בנגב,יישוב,1021,432,589,2,1019,939,1011,18,25.23%
2013-12,הדרום,2630,קריית גת,יישוב,2272,941,1331,121,2151,1310,2226,42,8.01%
2013-12,הדרום,1034,קריית מלאכי,יישוב,1300,584,716,21,1279,765,1259,53,10.71%
2013-12,הדרום,1161,רהט,יישוב,3280,1372,1908,4,3276,2826,3256,46,18.03%
2013-12,הדרום,1286,שגב-שלום,יישוב,565,223,342,0,565,469,560,5,21.96%
2013-12,הדרום,1031,שדרות,יישוב,1164,528,636,38,1126,653,1125,21,8.99%
2013-12,הדרום,1054,תל שבע,יישוב,1251,616,635,0,1251,1142,1240,11,26.23%
2013-12,המרכז,182,אבן יהודה,יישוב,170,74,96,51,119,20,168,2,2.54%
2013-12,המרכז,41,אליכין,יישוב,70,37,33,7,63,18,67,3,3.67%
2013-12,המרכז,1309,אלעד,יישוב,440,215,225,28,412,109,432,8,3.63%
2013-12,המרכז,2530,באר יעקב,יישוב,278,116,162,60,218,58,277,6,3.19%
2013-12,המרכז,466,בית דגן,יישוב,113,67,46,17,96,46,112,1,3.19%
2013-12,המרכז,1066,"בני עי""ש",יישוב,180,82,98,15,165,71,178,6,4.52%
2013-12,המרכז,681,גבעת שמואל,יישוב,302,146,156,88,214,70,293,2,2.52%
2013-12,המרכז,2550,גדרה,יישוב,391,162,229,59,332,108,381,6,3.35%
2013-12,המרכז,627,ג'לג'וליה,יישוב,92,40,52,1,91,57,86,2,2.53%
2013-12,המרכז,166,גן יבנה,יישוב,380,166,214,38,342,102,372,9,3.38%
2013-12,המרכז,229,גני תקווה,יישוב,209,99,110,47,162,24,208,2,2.58%
2013-12,המרכז,9700,הוד השרון,יישוב,713,306,407,213,500,71,704,8,2.52%
2013-12,המרכז,1290,זמר,יישוב,195,65,130,1,194,129,193,9,6.80%
2013-12,המרכז,2730,טייבה,יישוב,2101,914,1187,15,2086,1761,2042,35,12.07%
2013-12,המרכז,2720,טירה,יישוב,365,172,193,8,357,183,354,9,3.25%
2013-12,המרכז,2660,יבנה,יישוב,1000,464,536,91,909,376,984,32,4.49%
2013-12,המרכז,9400,יהוד,יישוב,561,247,314,83,478,82,546,21,3.51%
2013-12,המרכז,1224,כוכב יאיר,יישוב,100,42,58,41,59,1,98,5,1.76%
2013-12,המרכז,633,כפר ברא,יישוב,38,22,16,2,36,18,37,1,2.88%
2013-12,המרכז,168,כפר יונה,יישוב,332,161,171,58,274,70,327,4,3.12%
2013-12,המרכז,6900,כפר סבא,יישוב,1333,611,722,333,1000,183,1313,19,2.56%
2013-12,המרכז,634,כפר קאסם,יישוב,278,145,133,2,276,152,274,2,3.21%
2013-12,המרכז,7000,לוד,יישוב,2315,1067,1248,153,2162,1222,2273,45,6.47%
2013-12,המרכז,1200,מודיעין-מכבים-רעות*,יישוב,1089,479,610,305,784,64,1057,26,2.53%
2013-12,המרכז,28,מזכרת בתיה,יישוב,153,60,93,31,122,37,151,2,2.28%
2013-12,המרכז,7200,נס ציונה,יישוב,750,326,424,165,585,213,746,8,3.28%
2013-12,המרכז,7400,נתניה,יישוב,4643,2198,2445,596,4047,1649,4532,104,4.40%
2013-12,המרכז,587,סביון*,יישוב,23,7,16,9,14,0,23,0,1.23%
2013-12,המרכז,171,פרדסייה,יישוב,86,36,50,16,70,8,85,0,2.40%
2013-12,המרכז,7900,פתח תקווה,יישוב,4306,1925,2381,812,3494,1102,4237,55,3.50%
2013-12,המרכז,195,קדימה-צורן,יישוב,268,118,150,61,207,46,264,1,2.65%
2013-12,המרכז,638,קלנסווה,יישוב,827,333,494,5,822,684,797,11,9.63%
2013-12,המרכז,469,קריית עקרון,יישוב,337,166,171,25,312,137,336,1,5.71%
2013-12,המרכז,2640,ראש העין,יישוב,792,392,400,88,704,169,777,10,3.47%
2013-12,המרכז,8300,ראשון לציון,יישוב,4472,2051,2421,790,3682,1423,4431,96,3.26%
2013-12,המרכז,8400,רחובות,יישוב,2668,1212,1456,483,2185,1020,2605,46,3.97%
2013-12,המרכז,8500,רמלה,יישוב,1876,891,985,106,1770,793,1806,58,5.00%
2013-12,המרכז,8700,רעננה,יישוב,833,405,428,263,570,68,827,5,2.25%
2013-12,המרכז,1304,שוהם,יישוב,182,76,106,71,111,8,181,0,1.71%
2013-12,המרכז,154,תל מונד,יישוב,156,68,88,51,105,20,156,0,2.64%
2013-12,הצפון,473,אבו סנאן,יישוב,755,309,446,6,749,616,750,14,13.33%
2013-12,הצפון,478,אכסאל,יישוב,545,233,312,13,532,464,536,2,9.93%
2013-12,הצפון,529,אעבלין,יישוב,638,250,388,4,634,528,632,11,11.56%
2013-12,הצפון,482,בועיינה-נוג'ידאת,יישוב,435,189,246,3,432,350,421,0,11.30%
2013-12,הצפון,4001,בוקעאתא,יישוב,406,159,247,4,402,344,391,0,14.81%
2013-12,הצפון,998,ביר אל-מכסור,יישוב,438,177,261,1,437,340,434,5,12.23%
2013-12,הצפון,480,בית ג'ן,יישוב,413,131,282,11,402,308,405,1,7.93%
2013-12,הצפון,9200,בית שאן,יישוב,849,374,475,16,833,420,829,51,8.35%
2013-12,הצפון,944,בסמת טבעון,יישוב,233,115,118,2,231,171,232,3,7.56%
2013-12,הצפון,483,בענה,יישוב,399,155,244,3,396,335,396,7,12.29%
2013-12,הצפון,1292,ג'דיידה-מכר,יישוב,1472,628,844,6,1466,1255,1461,31,16.66%
2013-12,הצפון,485,ג'ולס,יישוב,214,67,147,1,213,157,214,2,7.77%
2013-12,הצפון,487,ג'ש (גוש חלב),יישוב,71,37,34,1,70,34,70,7,4.40%
2013-12,הצפון,489,דבורייה,יישוב,410,181,229,14,396,314,405,3,9.85%
2013-12,הצפון,490,דייר אל-אסד,יישוב,398,160,238,10,388,324,396,11,8.07%
2013-12,הצפון,492,דייר חנא,יישוב,649,278,371,13,636,495,647,5,13.90%
2013-12,הצפון,975,זרזיר,יישוב,323,148,175,3,320,223,307,5,10.65%
2013-12,הצפון,496,חורפיש,יישוב,126,52,74,5,121,66,122,3,4.75%
2013-12,הצפון,2034,חצור הגלילית,יישוב,339,138,201,14,325,156,316,17,6.72%
2013-12,הצפון,6700,טבריה,יישוב,1872,842,1030,65,1807,1109,1627,52,7.51%
2013-12,הצפון,962,טובא-זנגרייה,יישוב,381,165,216,2,379,258,371,5,12.55%
2013-12,הצפון,498,טורעאן,יישוב,547,204,343,8,539,475,523,9,9.66%
2013-12,הצפון,8900,טמרה,יישוב,2039,850,1189,17,2022,1790,2012,20,14.84%
2013-12,הצפון,1295,יאנוח-ג'ת,יישוב,171,66,105,6,165,109,167,7,6.34%
2013-12,הצפון,46,יבנאל,יישוב,167,112,55,7,160,128,146,0,9.34%
2013-12,הצפון,499,יפיע,יישוב,671,297,374,12,659,526,662,14,8.78%
2013-12,הצפון,240,יקנעם עילית,יישוב,560,215,345,45,515,173,551,35,4.83%
2013-12,הצפון,502,ירכא,יישוב,557,226,331,0,557,448,554,5,10.13%
2013-12,הצפון,504,כאבול,יישוב,710,294,416,9,701,614,703,4,14.63%
2013-12,הצפון,505,כאוכב אבו אל-היג'א,יישוב,236,104,132,5,231,196,236,2,14.19%
2013-12,הצפון,1296,כסרא-סמיע,יישוב,228,92,136,6,222,166,222,3,6.82%
2013-12,הצפון,978,כעביה-טבאש-חג'אג'רה,יישוב,220,86,134,2,218,145,216,4,9.97%
2013-12,הצפון,1263,כפר ורדים,יישוב,49,23,26,21,28,5,47,1,1.52%
2013-12,הצפון,507,כפר יאסיף,יישוב,506,208,298,6,500,411,497,7,9.99%
2013-12,הצפון,508,כפר כמא,יישוב,68,26,42,2,66,34,67,0,4.25%
2013-12,הצפון,509,כפר כנא,יישוב,1158,451,707,19,1139,1021,1107,10,13.07%
2013-12,הצפון,510,כפר מנדא,יישוב,993,458,535,11,982,744,964,3,13.66%
2013-12,הצפון,47,כפר תבור,יישוב,44,19,25,6,38,2,41,1,2.00%
2013-12,הצפון,1139,כרמיאל,יישוב,1793,701,1092,305,1488,887,1696,55,6.55%
2013-12,הצפון,481,מגאר,יישוב,1422,566,856,15,1407,1250,1396,11,16.28%
2013-12,הצפון,516,מג'ד אל-כרום,יישוב,564,257,307,3,561,448,558,17,8.94%
2013-12,הצפון,874,מגדל העמק,יישוב,1067,439,628,55,1012,449,957,84,7.17%
2013-12,הצפון,4201,מג'דל שמס,יישוב,497,184,313,11,486,413,483,3,10.30%
2013-12,הצפון,517,מזרעה,יישוב,178,67,111,5,173,141,176,7,9.12%
2013-12,הצפון,4203,מסעדה,יישוב,207,75,132,1,206,168,206,0,12.50%
2013-12,הצפון,518,מעיליא,יישוב,57,27,30,3,54,27,57,1,3.66%
2013-12,הצפון,1063,מעלות-תרשיחא,יישוב,934,451,483,83,851,537,919,36,7.69%
2013-12,הצפון,520,משהד,יישוב,285,108,177,4,281,244,278,6,9.03%
2013-12,הצפון,9100,נהרייה,יישוב,2027,928,1099,173,1854,1207,1985,71,6.50%
2013-12,הצפון,522,נחף,יישוב,411,189,222,7,404,335,406,16,8.62%
2013-12,הצפון,7300,נצרת,יישוב,3309,1440,1869,85,3224,2589,3254,31,9.70%
2013-12,הצפון,1061,נצרת עילית,יישוב,1878,828,1050,157,1721,1071,1711,88,7.21%
2013-12,הצפון,525,סאג'ור,יישוב,114,46,68,1,113,75,112,2,6.64%
2013-12,הצפון,7500,סח'נין,יישוב,2073,897,1176,16,2057,1762,2066,12,15.39%
2013-12,הצפון,4501,ע'ג'ר,יישוב,96,44,52,0,96,69,96,2,9.69%
2013-12,הצפון,530,עיילבון,יישוב,217,87,130,3,214,151,214,1,8.00%
2013-12,הצפון,511,עילוט,יישוב,317,126,191,3,314,258,313,0,11.55%
2013-12,הצפון,532,עין מאהל,יישוב,597,267,330,10,587,491,575,7,11.88%
2013-12,הצפון,7600,עכו,יישוב,3287,1495,1792,97,3190,2462,3205,61,12.15%
2013-12,הצפון,7700,עפולה,יישוב,1805,778,1027,176,1629,848,1713,80,7.04%
2013-12,הצפון,531,עראבה,יישוב,1481,597,884,19,1462,1290,1473,8,15.19%
2013-12,הצפון,535,פסוטה,יישוב,128,55,73,7,121,90,127,3,7.66%
2013-12,הצפון,536,פקיעין (בוקייעה),יישוב,125,65,60,5,120,84,124,2,4.68%
2013-12,הצפון,8000,צפת,יישוב,1540,816,724,68,1472,1130,1484,32,11.13%
2013-12,הצפון,4100,קצרין,יישוב,206,85,121,20,186,96,203,6,5.17%
2013-12,הצפון,2800,קריית שמונה,יישוב,928,422,506,41,887,374,894,49,6.83%
2013-12,הצפון,543,ראמה,יישוב,344,129,215,11,333,256,332,2,8.74%
2013-12,הצפון,26,ראש פינה,יישוב,54,14,40,12,42,21,51,1,3.26%
2013-12,הצפון,542,ריינה,יישוב,709,295,414,8,701,581,687,9,10.49%
2013-12,הצפון,122,רמת ישי,יישוב,110,42,68,28,82,12,107,3,2.60%
2013-12,הצפון,913,שבלי - אום אל-גנם,יישוב,268,134,134,6,262,165,264,4,10.44%
2013-12,הצפון,812,שלומי,יישוב,273,116,157,12,261,151,267,13,7.39%
2013-12,הצפון,538,שעב,יישוב,530,219,311,1,529,465,529,1,17.99%
2013-12,הצפון,8800,שפרעם,יישוב,2071,813,1258,30,2041,1722,2045,46,11.98%
2013-12,חיפה,2710,אום אל-פחם,יישוב,3849,1560,2289,19,3830,3308,3778,21,18.79%
2013-12,חיפה,1020,אור עקיבא,יישוב,634,265,369,40,594,223,611,26,6.20%
2013-12,חיפה,6000,באקה אל-גרביה,יישוב,779,372,407,4,775,484,771,28,6.92%
2013-12,חיפה,9800,בנימינה-גבעת עדה*,יישוב,243,92,151,57,186,69,242,0,3.53%
2013-12,חיפה,1326,"בסמ""ה",יישוב,434,181,253,3,431,360,430,2,11.34%
2013-12,חיפה,541,ג'סר א-זרקא,יישוב,421,230,191,0,421,306,418,3,7.33%
2013-12,חיפה,628,ג'ת,יישוב,284,141,143,13,271,162,281,5,5.66%
2013-12,חיפה,494,דאלית אל-כרמל,יישוב,523,225,298,11,512,297,513,7,6.76%
2013-12,חיפה,9300,זכרון יעקב,יישוב,275,120,155,58,217,56,274,2,2.63%
2013-12,חיפה,6500,חדרה,יישוב,2610,1108,1502,266,2344,999,2521,65,5.21%
2013-12,חיפה,4000,חיפה,יישוב,6882,3299,3583,1115,5767,3669,6676,206,4.71%
2013-12,חיפה,1247,חריש,יישוב,25,13,12,4,21,9,21,1,1.37%
2013-12,חיפה,2100,טירת כרמל,יישוב,757,360,397,19,738,472,742,23,7.15%
2013-12,חיפה,654,כפר קרע,יישוב,441,192,249,7,434,258,437,12,5.41%
2013-12,חיפה,1327,מעלה עירון,יישוב,956,378,578,5,951,818,949,4,16.86%
2013-12,חיפה,2500,נשר,יישוב,499,238,261,87,412,212,488,13,3.81%
2013-12,חיפה,534,עספיא,יישוב,343,148,195,12,331,180,336,4,6.28%
2013-12,חיפה,637,ערערה,יישוב,628,241,387,6,622,425,615,12,7.92%
2013-12,חיפה,537,פוריידיס,יישוב,439,223,216,7,432,280,434,2,8.10%
2013-12,חיפה,7800,פרדס חנה-כרכור,יישוב,885,406,479,110,775,281,872,16,4.49%
2013-12,חיפה,6800,קריית אתא,יישוב,1758,800,958,131,1627,949,1731,55,5.91%
2013-12,חיפה,9500,קריית ביאליק,יישוב,1180,494,686,134,1046,598,1167,38,5.40%
2013-12,חיפה,2300,קריית טבעון,יישוב,193,95,98,60,133,43,190,4,2.27%
2013-12,חיפה,9600,קריית ים,יישוב,1601,752,849,132,1469,965,1575,55,7.33%
2013-12,חיפה,8200,קריית מוצקין,יישוב,1087,469,618,146,941,520,1069,32,4.72%
2013-12,חיפה,922,רכסים,יישוב,145,62,83,7,138,79,139,1,4.28%
2013-12,ירושלים,472,אבו גוש,יישוב,259,130,129,7,252,186,259,3,8.97%
2013-12,ירושלים,2610,בית שמש,יישוב,1387,642,745,82,1305,556,1339,36,4.49%
2013-12,ירושלים,3000,ירושלים,יישוב,12225,5567,6658,1296,10929,7316,12016,170,4.14%
2013-12,ירושלים,1015,מבשרת ציון,יישוב,384,184,200,59,325,168,381,7,2.92%
2013-12,ירושלים,1137,קריית יערים,יישוב,39,20,19,4,35,19,38,0,3.10%
2013-12,תל אביב,2400,אור יהודה,יישוב,864,427,437,31,833,275,823,44,4.40%
2013-12,תל אביב,565,אזור,יישוב,187,104,83,25,162,31,185,4,2.97%
2013-12,תל אביב,6100,בני ברק,יישוב,2372,1205,1167,95,2277,1358,2303,45,4.29%
2013-12,תל אביב,6200,בת ים,יישוב,3492,1690,1802,375,3117,1305,3370,90,4.71%
2013-12,תל אביב,6300,גבעתיים,יישוב,765,349,416,260,505,112,755,2,2.54%
2013-12,תל אביב,6400,הרצלייה,יישוב,1131,488,643,250,881,41,1109,31,2.34%
2013-12,תל אביב,6600,חולון,יישוב,3332,1549,1783,414,2918,854,3252,90,3.30%
2013-12,תל אביב,2620,קריית אונו,יישוב,439,193,246,89,350,47,431,4,2.36%
2013-12,תל אביב,8600,רמת גן,יישוב,2264,1081,1183,550,1714,492,2223,21,2.88%
2013-12,תל אביב,2650,רמת השרון,יישוב,391,170,221,108,283,7,385,3,1.74%
2013-12,תל אביב,5000,תל אביב -יפו,יישוב,8323,4069,4254,2092,6231,2453,8177,149,3.29%
2014-01,אזור יהודה והשומרון,3760,אורנית,יישוב,114,49,65,42,72,3,113,0,2.41%
2014-01,אזור יהודה והשומרון,3750,אלפי מנשה,יישוב,104,49,55,18,86,2,104,0,2.44%
2014-01,אזור יהודה והשומרון,3560,אלקנה,יישוב,33,16,17,14,19,1,33,1,1.74%
2014-01,אזור יהודה והשומרון,3650,אפרת,יישוב,49,25,24,14,35,2,49,0,1.20%
2014-01,אזור יהודה והשומרון,3570,אריאל,יישוב,375,174,201,53,322,85,370,2,3.51%
2014-01,אזור יהודה והשומרון,3574,בית אל,יישוב,54,19,35,12,42,13,54,1,2.20%
2014-01,אזור יהודה והשומרון,3652,בית אריה,יישוב,61,22,39,11,50,4,60,2,2.35%
2014-01,אזור יהודה והשומרון,3780,ביתר עילית,יישוב,530,238,292,7,523,215,524,5,4.30%
2014-01,אזור יהודה והשומרון,3730,גבעת זאב,יישוב,187,84,103,44,143,39,184,3,2.45%
2014-01,אזור יהודה והשומרון,3769,הר אדר,יישוב,33,16,17,12,21,3,33,0,1.60%
2014-01,אזור יהודה והשומרון,76,מ.א. גוש עציון,מועצה איזורית,179,83,96,50,129,13,176,0,1.90%
2014-01,אזור יהודה והשומרון,78,מ.א. הר חברון,מועצה איזורית,66,31,35,10,56,6,65,0,2.01%
2014-01,אזור יהודה והשומרון,74,מ.א. מגילות ים המלח,מועצה איזורית,18,8,10,4,14,1,18,0,2.37%
2014-01,אזור יהודה והשומרון,73,מ.א. מטה בנימין,מועצה איזורית,615,297,318,136,479,148,607,0,2.55%
2014-01,אזור יהודה והשומרון,75,מ.א. ערבות הירדן,מועצה איזורית,44,14,30,11,33,3,44,0,1.89%
2014-01,אזור יהודה והשומרון,72,מ.א. שומרון,מועצה איזורית,405,227,178,79,326,58,400,0,2.53%
2014-01,אזור יהודה והשומרון,3797,מודיעין עילית,יישוב,421,169,252,25,396,92,405,10,3.10%
2014-01,אזור יהודה והשומרון,3616,מעלה אדומים,יישוב,747,318,429,57,690,224,735,14,3.60%
2014-01,אזור יהודה והשומרון,3660,עמנואל,יישוב,77,44,33,0,77,50,74,0,6.54%
2014-01,אזור יהודה והשומרון,3557,קדומים,יישוב,34,17,17,11,23,9,34,0,1.83%
2014-01,אזור יהודה והשומרון,3611,קריית ארבע,יישוב,111,53,58,11,100,61,110,4,3.46%
2014-01,אזור יהודה והשומרון,3640,קרני שומרון,יישוב,93,53,40,12,81,11,91,3,2.49%
2014-01,הדרום,31,אופקים,יישוב,1334,575,759,73,1261,860,1304,53,10.11%
2014-01,הדרום,2600,אילת,יישוב,1642,750,892,44,1598,581,1611,53,4.80%
2014-01,הדרום,70,אשדוד,יישוב,6916,2915,4001,709,6207,3470,6765,198,6.22%
2014-01,הדרום,7100,אשקלון,יישוב,4410,1836,2574,352,4058,2327,4103,118,5.94%
2014-01,הדרום,9000,באר שבע,יישוב,7426,3344,4082,840,6586,4430,7164,213,6.87%
2014-01,הדרום,2200,דימונה,יישוב,2155,994,1161,121,2034,1360,2083,72,11.28%
2014-01,הדרום,1303,חורה,יישוב,820,358,462,3,817,749,810,0,19.95%
2014-01,הדרום,831,ירוחם,יישוב,478,233,245,15,463,268,458,19,9.96%
2014-01,הדרום,1059,כסיפה,יישוב,1035,438,597,2,1033,914,1025,6,21.97%
2014-01,הדרום,1271,להבים,יישוב,61,28,33,27,34,5,61,2,1.75%
2014-01,הדרום,1060,לקיה,יישוב,1015,461,554,0,1015,950,1007,2,23.51%
2014-01,הדרום,69,מ.א. אל קסום,מועצה איזורית,766,334,432,4,762,687,758,0,58.90%
2014-01,הדרום,38,מ.א. אשכול,מועצה איזורית,103,46,57,16,87,18,102,0,1.54%
2014-01,הדרום,33,מ.א. באר טוביה,מועצה איזורית,307,119,188,44,263,57,302,0,2.92%
2014-01,הדרום,41,מ.א. בני שמעון,מועצה איזורית,69,25,44,19,50,17,67,2,1.67%
2014-01,הדרום,54,מ.א. הערבה התיכונה,מועצה איזורית,15,5,10,5,10,1,15,0,0.83%
2014-01,הדרום,53,מ.א. חבל אילות,מועצה איזורית,17,12,5,2,15,0,17,3,0.79%
2014-01,הדרום,36,מ.א. חוף אשקלון,מועצה איזורית,243,109,134,24,219,64,232,0,2.97%
2014-01,הדרום,35,מ.א. יואב,מועצה איזורית,102,44,58,17,85,19,102,0,2.66%
2014-01,הדרום,50,מ.א. לכיש,מועצה איזורית,154,68,86,13,141,55,154,0,3.25%
2014-01,הדרום,42,מ.א. מרחבים,מועצה איזורית,192,76,116,22,170,42,189,0,3.55%
2014-01,הדרום,68,מ.א. נווה מדבר,מועצה איזורית,115,47,68,0,115,95,114,0,18.36%
2014-01,הדרום,48,מ.א. רמת נגב,מועצה איזורית,199,100,99,11,188,161,196,1,6.82%
2014-01,הדרום,39,מ.א. שדות נגב,מועצה איזורית,131,61,70,12,119,34,129,0,3.09%
2014-01,הדרום,37,מ.א. שער הנגב,מועצה איזורית,198,109,89,20,178,124,196,0,5.27%
2014-01,הדרום,34,מ.א. שפיר,מועצה איזורית,208,108,100,12,196,81,207,0,4.56%
2014-01,הדרום,51,מ.א. תמר,מועצה איזורית,7,4,3,1,6,0,7,0,1.13%
2014-01,הדרום,1268,מיתר,יישוב,68,31,37,21,47,5,64,2,1.50%
2014-01,הדרום,99,מצפה רמון,יישוב,262,109,153,10,252,172,249,8,10.13%
2014-01,הדרום,246,נתיבות,יישוב,1051,485,566,45,1006,551,1009,40,7.24%
2014-01,הדרום,666,עומר,יישוב,60,27,33,18,42,7,60,0,1.48%
2014-01,הדרום,2560,ערד,יישוב,949,448,501,90,859,443,902,39,7.27%
2014-01,הדרום,1192,ערערה-בנגב,יישוב,1010,426,584,2,1008,932,1001,11,24.07%
2014-01,הדרום,2630,קריית גת,יישוב,2248,951,1297,120,2128,1299,2186,44,7.67%
2014-01,הדרום,1034,קריית מלאכי,יישוב,1300,607,693,28,1272,743,1259,83,10.67%
2014-01,הדרום,1161,רהט,יישוב,3299,1396,1903,6,3293,2838,3276,60,17.15%
2014-01,הדרום,1286,שגב-שלום,יישוב,559,219,340,1,558,477,552,2,20.60%
2014-01,הדרום,1031,שדרות,יישוב,1121,528,593,44,1077,650,1078,17,8.42%
2014-01,הדרום,1054,תל שבע,יישוב,1258,624,634,0,1258,1144,1241,6,24.87%
2014-01,המרכז,182,אבן יהודה,יישוב,178,76,102,62,116,20,176,2,2.61%
2014-01,המרכז,41,אליכין,יישוב,65,34,31,6,59,19,61,2,3.25%
2014-01,המרכז,1309,אלעד,יישוב,417,201,216,25,392,105,409,5,3.28%
2014-01,המרכז,2530,באר יעקב,יישוב,271,114,157,59,212,62,268,3,2.95%
2014-01,המרכז,466,בית דגן,יישוב,116,68,48,19,97,40,115,1,3.21%
2014-01,המרכז,1066,"בני עי""ש",יישוב,178,76,102,16,162,71,177,2,4.48%
2014-01,המרכז,681,גבעת שמואל,יישוב,292,140,152,84,208,61,283,5,2.37%
2014-01,המרכז,2550,גדרה,יישוב,387,157,230,61,326,110,381,5,3.26%
2014-01,המרכז,627,ג'לג'וליה,יישוב,95,47,48,1,94,49,94,1,2.59%
2014-01,המרכז,166,גן יבנה,יישוב,375,157,218,43,332,96,371,4,3.25%
2014-01,המרכז,229,גני תקווה,יישוב,219,101,118,56,163,25,215,3,2.58%
2014-01,המרכז,9700,הוד השרון,יישוב,715,318,397,213,502,76,705,2,2.38%
2014-01,המרכז,1290,זמר,יישוב,191,63,128,0,191,127,190,15,6.41%
2014-01,המרכז,2730,טייבה,יישוב,2080,914,1166,14,2066,1756,1969,35,11.08%
2014-01,המרכז,2720,טירה,יישוב,355,173,182,8,347,176,345,10,3.03%
2014-01,המרכז,2660,יבנה,יישוב,949,438,511,88,861,355,928,22,3.99%
2014-01,המרכז,9400,יהוד,יישוב,570,242,328,87,483,86,552,17,3.46%
2014-01,המרכז,1224,כוכב יאיר,יישוב,99,41,58,43,56,0,98,1,1.73%
2014-01,המרכז,633,כפר ברא,יישוב,31,18,13,1,30,16,30,0,2.19%
2014-01,המרכז,168,כפר יונה,יישוב,332,164,168,60,272,65,329,5,3.04%
2014-01,המרכז,6900,כפר סבא,יישוב,1297,599,698,347,950,174,1280,22,2.42%
2014-01,המרכז,634,כפר קאסם,יישוב,271,142,129,4,267,147,266,4,3.01%
2014-01,המרכז,7000,לוד,יישוב,2273,1053,1220,148,2125,1217,2245,45,6.35%
2014-01,המרכז,28,מ.א. ברנר,מועצה איזורית,64,24,40,14,50,4,64,1,1.67%
2014-01,המרכז,32,מ.א. גדרות,מועצה איזורית,42,18,24,18,24,3,42,0,1.85%
2014-01,המרכז,30,מ.א. גזר,מועצה איזורית,296,134,162,76,220,33,292,0,2.30%
2014-01,המרכז,27,מ.א. גן רווה,מועצה איזורית,56,21,35,13,43,2,56,0,2.05%
2014-01,המרכז,20,מ.א. דרום השרון,מועצה איזורית,336,147,189,110,226,15,332,0,2.18%
2014-01,המרכז,29,מ.א. חבל יבנה,מועצה איזורית,42,21,21,14,28,2,42,1,1.75%
2014-01,המרכז,25,מ.א. חבל מודיעין,מועצה איזורית,278,123,155,55,223,21,274,0,2.62%
2014-01,המרכז,19,מ.א. חוף השרון,מועצה איזורית,114,47,67,52,62,3,114,0,2.09%
2014-01,המרכז,18,מ.א. לב השרון,מועצה איזורית,252,125,127,79,173,33,251,0,2.32%
2014-01,המרכז,31,מ.א. נחל שורק,מועצה איזורית,49,21,28,11,38,6,49,53,1.11%
2014-01,המרכז,16,מ.א. עמק חפר,מועצה איזורית,439,204,235,163,276,30,430,0,2.20%
2014-01,המרכז,40,מ.א. עמק לוד,מועצה איזורית,133,62,71,22,111,14,132,0,2.17%
2014-01,המרכז,1200,מודיעין-מכבים-רעות*,יישוב,1079,478,601,319,760,66,1048,20,2.42%
2014-01,המרכז,28,מזכרת בתיה,יישוב,159,73,86,32,127,34,157,1,2.24%
2014-01,המרכז,7200,נס ציונה,יישוב,753,332,421,168,585,213,743,8,3.17%
2014-01,המרכז,7400,נתניה,יישוב,4633,2204,2429,583,4050,1641,4528,98,4.32%
2014-01,המרכז,587,סביון*,יישוב,25,6,19,9,16,0,25,0,1.29%
2014-01,המרכז,171,פרדסייה,יישוב,91,43,48,16,75,8,91,0,2.51%
2014-01,המרכז,7900,פתח תקווה,יישוב,4236,1893,2343,811,3425,1091,4166,36,3.35%
2014-01,המרכז,195,קדימה-צורן,יישוב,248,106,142,69,179,43,246,1,2.33%
2014-01,המרכז,638,קלנסווה,יישוב,851,349,502,4,847,691,802,14,9.09%
2014-01,המרכז,469,קריית עקרון,יישוב,327,157,170,22,305,147,321,7,5.42%
2014-01,המרכז,2640,ראש העין,יישוב,798,405,393,91,707,176,783,16,3.38%
2014-01,המרכז,8300,ראשון לציון,יישוב,4498,2076,2422,781,3717,1384,4461,102,3.24%
2014-01,המרכז,8400,רחובות,יישוב,2684,1204,1480,496,2188,1019,2613,46,3.86%
2014-01,המרכז,8500,רמלה,יישוב,1884,910,974,104,1780,767,1822,53,4.93%
2014-01,המרכז,8700,רעננה,יישוב,840,414,426,276,564,69,833,7,2.24%
2014-01,המרכז,1304,שוהם,יישוב,189,82,107,81,108,8,188,0,1.71%
2014-01,המרכז,154,תל מונד,יישוב,154,65,89,57,97,20,153,2,2.48%
2014-01,הצפון,473,אבו סנאן,יישוב,732,298,434,5,727,593,728,11,12.47%
2014-01,הצפון,478,אכסאל,יישוב,535,235,300,14,521,456,529,1,9.36%
2014-01,הצפון,529,אעבלין,יישוב,640,254,386,5,635,523,637,5,11.25%
2014-01,הצפון,482,בועיינה-נוג'ידאת,יישוב,422,177,245,4,418,344,410,7,10.65%
2014-01,הצפון,4001,בוקעאתא,יישוב,416,164,252,3,413,348,399,0,14.56%
2014-01,הצפון,998,ביר אל-מכסור,יישוב,443,181,262,2,441,333,440,6,11.92%
2014-01,הצפון,480,בית ג'ן,יישוב,414,131,283,8,406,315,401,2,7.60%
2014-01,הצפון,9200,בית שאן,יישוב,869,379,490,10,859,427,839,53,8.35%
2014-01,הצפון,944,בסמת טבעון,יישוב,228,109,119,3,225,167,225,1,7.00%
2014-01,הצפון,483,בענה,יישוב,394,157,237,4,390,335,391,8,11.73%
2014-01,הצפון,1292,ג'דיידה-מכר,יישוב,1484,642,842,8,1476,1249,1472,41,15.94%
2014-01,הצפון,485,ג'ולס,יישוב,216,68,148,1,215,154,216,1,7.47%
2014-01,הצפון,487,ג'ש (גוש חלב),יישוב,75,38,37,1,74,35,75,4,4.56%
2014-01,הצפון,489,דבורייה,יישוב,415,179,236,14,401,322,412,3,9.63%
2014-01,הצפון,490,דייר אל-אסד,יישוב,404,166,238,10,394,329,401,6,7.85%
2014-01,הצפון,492,דייר חנא,יישוב,678,308,370,15,663,491,676,4,13.89%
2014-01,הצפון,975,זרזיר,יישוב,308,149,159,2,306,204,298,9,9.65%
2014-01,הצפון,496,חורפיש,יישוב,111,44,67,7,104,59,108,1,4.08%
2014-01,הצפון,2034,חצור הגלילית,יישוב,340,148,192,13,327,148,311,16,6.54%
2014-01,הצפון,6700,טבריה,יישוב,1886,852,1034,69,1817,1102,1629,63,7.50%
2014-01,הצפון,962,טובא-זנגרייה,יישוב,379,173,206,2,377,250,366,3,12.05%
2014-01,הצפון,498,טורעאן,יישוב,560,224,336,12,548,479,528,7,9.29%
2014-01,הצפון,8900,טמרה,יישוב,2038,881,1157,19,2019,1774,2013,11,14.26%
2014-01,הצפון,1295,יאנוח-ג'ת,יישוב,167,62,105,5,162,108,165,3,5.89%
2014-01,הצפון,46,יבנאל,יישוב,171,117,54,8,163,130,146,1,9.18%
2014-01,הצפון,499,יפיע,יישוב,652,298,354,13,639,506,645,6,8.27%
2014-01,הצפון,240,יקנעם עילית,יישוב,552,226,326,42,510,164,540,30,4.65%
2014-01,הצפון,502,ירכא,יישוב,545,221,324,1,544,431,543,3,9.33%
2014-01,הצפון,504,כאבול,יישוב,701,296,405,9,692,607,693,5,14.14%
2014-01,הצפון,505,כאוכב אבו אל-היג'א,יישוב,226,104,122,4,222,191,226,6,13.10%
2014-01,הצפון,1296,כסרא-סמיע,יישוב,232,91,141,5,227,169,224,5,6.53%
2014-01,הצפון,978,כעביה-טבאש-חג'אג'רה,יישוב,226,94,132,2,224,152,222,2,9.66%
2014-01,הצפון,1263,כפר ורדים,יישוב,57,21,36,25,32,7,56,1,1.80%
2014-01,הצפון,507,כפר יאסיף,יישוב,518,216,302,6,512,416,508,16,9.75%
2014-01,הצפון,508,כפר כמא,יישוב,72,32,40,3,69,30,70,0,4.30%
2014-01,הצפון,509,כפר כנא,יישוב,1176,472,704,21,1155,1027,1119,26,12.65%
2014-01,הצפון,510,כפר מנדא,יישוב,961,441,520,12,949,706,946,2,12.91%
2014-01,הצפון,47,כפר תבור,יישוב,41,18,23,5,36,3,38,0,1.76%
2014-01,הצפון,1139,כרמיאל,יישוב,1736,697,1039,278,1458,847,1663,49,6.42%
2014-01,הצפון,65,מ.א. אל-בטוף,מועצה איזורית,414,158,256,3,411,337,401,1,15.05%
2014-01,הצפון,66,מ.א. בוסתן אל-מרג,מועצה איזורית,46,16,30,3,43,38,46,0,1.50%
2014-01,הצפון,71,מ.א. גולן,מועצה איזורית,200,89,111,11,189,22,196,0,2.39%
2014-01,הצפון,8,מ.א. הגלבוע,מועצה איזורית,826,337,489,48,778,532,810,0,5.80%
2014-01,הצפון,1,מ.א. הגליל העליון,מועצה איזורית,266,127,139,39,227,69,263,0,2.96%
2014-01,הצפון,3,מ.א. הגליל התחתון,מועצה איזורית,152,72,80,26,126,14,146,0,2.56%
2014-01,הצפון,55,מ.א. מבואות החרמון,מועצה איזורית,121,44,77,16,105,10,120,0,3.12%
2014-01,הצפון,13,מ.א. מגידו,מועצה איזורית,109,47,62,14,95,12,106,0,1.87%
2014-01,הצפון,4,מ.א. מטה אשר,מועצה איזורית,448,203,245,50,398,201,441,0,3.34%
2014-01,הצפון,52,מ.א. מעלה יוסף,מועצה איזורית,215,100,115,27,188,67,212,1,4.04%
2014-01,הצפון,2,מ.א. מרום הגליל,מועצה איזורית,342,167,175,11,331,142,331,0,5.11%
2014-01,הצפון,56,מ.א. משגב,מועצה איזורית,591,250,341,100,491,273,580,0,4.72%
2014-01,הצפון,6,מ.א. עמק הירדן,מועצה איזורית,184,79,105,16,168,43,165,0,2.48%
2014-01,הצפון,7,מ.א. עמק המעיינות,מועצה איזורית,184,92,92,17,167,51,177,0,2.86%
2014-01,הצפון,9,מ.א. עמק יזרעאל,מועצה איזורית,367,160,207,121,246,35,360,0,1.95%
2014-01,הצפון,481,מגאר,יישוב,1467,612,855,10,1457,1279,1431,11,15.34%
2014-01,הצפון,516,מג'ד אל-כרום,יישוב,572,263,309,3,569,446,566,21,8.73%
2014-01,הצפון,874,מגדל העמק,יישוב,1046,437,609,57,989,432,932,83,6.96%
2014-01,הצפון,4201,מג'דל שמס,יישוב,510,187,323,13,497,405,501,1,10.45%
2014-01,הצפון,517,מזרעה,יישוב,182,70,112,6,176,137,181,12,9.21%
2014-01,הצפון,4203,מסעדה,יישוב,217,80,137,1,216,172,216,0,12.83%
2014-01,הצפון,518,מעיליא,יישוב,60,28,32,3,57,34,58,1,3.53%
2014-01,הצפון,1063,מעלות-תרשיחא,יישוב,939,447,492,81,858,548,916,37,7.61%
2014-01,הצפון,520,משהד,יישוב,280,104,176,5,275,246,274,6,8.59%
2014-01,הצפון,9100,נהרייה,יישוב,2072,958,1114,188,1884,1197,2028,73,6.53%
2014-01,הצפון,522,נחף,יישוב,406,190,216,6,400,325,404,9,8.16%
2014-01,הצפון,7300,נצרת,יישוב,3273,1403,1870,83,3190,2573,3216,20,9.28%
2014-01,הצפון,1061,נצרת עילית,יישוב,1918,841,1077,159,1759,1086,1719,107,7.25%
2014-01,הצפון,525,סאג'ור,יישוב,123,46,77,2,121,75,121,0,6.79%
2014-01,הצפון,7500,סח'נין,יישוב,2067,906,1161,17,2050,1762,2062,17,14.85%
2014-01,הצפון,4501,ע'ג'ר,יישוב,94,44,50,0,94,67,94,1,9.12%
2014-01,הצפון,530,עיילבון,יישוב,222,95,127,4,218,157,219,1,7.94%
2014-01,הצפון,511,עילוט,יישוב,314,127,187,3,311,253,311,1,11.10%
2014-01,הצפון,532,עין מאהל,יישוב,605,282,323,12,593,488,584,5,11.04%
2014-01,הצפון,7600,עכו,יישוב,3202,1465,1737,105,3097,2414,3135,64,11.76%
2014-01,הצפון,7700,עפולה,יישוב,1766,769,997,156,1610,838,1681,101,6.75%
2014-01,הצפון,531,עראבה,יישוב,1508,634,874,22,1486,1297,1499,15,14.93%
2014-01,הצפון,535,פסוטה,יישוב,119,54,65,5,114,86,119,2,6.95%
2014-01,הצפון,536,פקיעין (בוקייעה),יישוב,133,71,62,6,127,87,130,3,4.75%
2014-01,הצפון,8000,צפת,יישוב,1515,819,696,58,1457,1137,1457,32,10.79%
2014-01,הצפון,4100,קצרין,יישוב,209,86,123,17,192,100,204,6,5.17%
2014-01,הצפון,2800,קריית שמונה,יישוב,902,402,500,41,861,374,871,34,6.65%
2014-01,הצפון,543,ראמה,יישוב,335,128,207,9,326,249,325,1,8.32%
2014-01,הצפון,26,ראש פינה,יישוב,61,20,41,12,49,21,58,2,3.65%
2014-01,הצפון,542,ריינה,יישוב,701,291,410,10,691,566,680,10,9.96%
2014-01,הצפון,122,רמת ישי,יישוב,109,43,66,30,79,12,104,2,2.51%
2014-01,הצפון,913,שבלי - אום אל-גנם,יישוב,266,126,140,7,259,161,263,4,10.04%
2014-01,הצפון,812,שלומי,יישוב,261,116,145,11,250,148,256,14,7.08%
2014-01,הצפון,538,שעב,יישוב,549,232,317,2,547,473,547,8,17.75%
2014-01,הצפון,8800,שפרעם,יישוב,2069,811,1258,40,2029,1713,2047,38,11.56%
2014-01,חיפה,2710,אום אל-פחם,יישוב,3829,1549,2280,18,3811,3301,3758,32,17.81%
2014-01,חיפה,1020,אור עקיבא,יישוב,637,263,374,38,599,231,609,30,6.05%
2014-01,חיפה,6000,באקה אל-גרביה,יישוב,752,361,391,3,749,482,745,34,6.40%
2014-01,חיפה,9800,בנימינה-גבעת עדה*,יישוב,247,97,150,58,189,70,246,0,3.47%
2014-01,חיפה,1326,"בסמ""ה",יישוב,438,189,249,3,435,356,433,6,10.85%
2014-01,חיפה,541,ג'סר א-זרקא,יישוב,420,231,189,1,419,301,418,2,7.19%
2014-01,חיפה,628,ג'ת,יישוב,285,143,142,12,273,166,284,10,5.41%
2014-01,חיפה,494,דאלית אל-כרמל,יישוב,548,232,316,12,536,314,532,2,6.76%
2014-01,חיפה,9300,זכרון יעקב,יישוב,273,125,148,59,214,57,273,1,2.52%
2014-01,חיפה,6500,חדרה,יישוב,2542,1096,1446,261,2281,982,2446,69,4.95%
2014-01,חיפה,4000,חיפה,יישוב,6838,3286,3552,1117,5721,3619,6626,160,4.66%
2014-01,חיפה,1247,חריש,יישוב,21,10,11,3,18,7,19,0,1.30%
2014-01,חיפה,2100,טירת כרמל,יישוב,759,364,395,19,740,449,750,23,6.99%
2014-01,חיפה,654,כפר קרע,יישוב,446,192,254,6,440,264,434,13,5.21%
2014-01,חיפה,45,מ.א. אלונה,מועצה איזורית,46,17,29,15,31,4,46,0,4.47%
2014-01,חיפה,12,מ.א. זבולון,מועצה איזורית,284,140,144,30,254,195,282,0,5.18%
2014-01,חיפה,15,מ.א. חוף הכרמל,מועצה איזורית,337,148,189,67,270,64,332,0,2.45%
2014-01,חיפה,14,מ.א. מנשה,מועצה איזורית,251,112,139,44,207,76,248,0,3.18%
2014-01,חיפה,1327,מעלה עירון,יישוב,947,373,574,6,941,805,939,11,15.95%
2014-01,חיפה,2500,נשר,יישוב,483,227,256,95,388,192,475,7,3.73%
2014-01,חיפה,534,עספיא,יישוב,339,146,193,8,331,183,321,4,5.87%
2014-01,חיפה,637,ערערה,יישוב,628,246,382,5,623,422,611,28,7.55%
2014-01,חיפה,537,פוריידיס,יישוב,431,217,214,8,423,280,425,2,7.64%
2014-01,חיפה,7800,פרדס חנה-כרכור,יישוב,895,411,484,103,792,291,882,34,4.41%
2014-01,חיפה,6800,קריית אתא,יישוב,1734,789,945,142,1592,952,1708,53,5.71%
2014-01,חיפה,9500,קריית ביאליק,יישוב,1181,482,699,144,1037,573,1171,27,5.44%
2014-01,חיפה,2300,קריית טבעון,יישוב,200,101,99,68,132,42,197,2,2.31%
2014-01,חיפה,9600,קריית ים,יישוב,1585,735,850,124,1461,934,1552,61,7.25%
2014-01,חיפה,8200,קריית מוצקין,יישוב,1096,467,629,151,945,525,1076,31,4.71%
2014-01,חיפה,922,רכסים,יישוב,154,69,85,6,148,82,148,0,4.32%
2014-01,ירושלים,472,אבו גוש,יישוב,279,141,138,8,271,189,279,3,9.07%
2014-01,ירושלים,2610,בית שמש,יישוב,1365,634,731,85,1280,538,1323,38,4.17%
2014-01,ירושלים,3000,ירושלים,יישוב,12323,5697,6626,1298,11025,7349,12097,182,4.07%
2014-01,ירושלים,26,מ.א. מטה יהודה,מועצה איזורית,588,294,294,90,498,143,580,2,2.53%
2014-01,ירושלים,1015,מבשרת ציון,יישוב,386,190,196,63,323,158,380,9,2.85%
2014-01,ירושלים,1137,קריית יערים,יישוב,38,19,19,5,33,17,38,0,2.90%
2014-01,תל אביב,2400,אור יהודה,יישוב,852,403,449,33,819,265,819,42,4.34%
2014-01,תל אביב,565,אזור,יישוב,193,102,91,22,171,34,191,3,2.98%
2014-01,תל אביב,6100,בני ברק,יישוב,2337,1183,1154,93,2244,1341,2260,32,4.05%
2014-01,תל אביב,6200,בת ים,יישוב,3372,1619,1753,386,2986,1268,3247,95,4.56%
2014-01,תל אביב,6300,גבעתיים,יישוב,780,350,430,265,515,114,773,10,2.55%
2014-01,תל אביב,6400,הרצלייה,יישוב,1115,493,622,220,895,44,1095,40,2.26%
2014-01,תל אביב,6600,חולון,יישוב,3299,1523,1776,410,2889,867,3213,83,3.23%
2014-01,תל אביב,2620,קריית אונו,יישוב,418,196,222,93,325,40,415,4,2.20%
2014-01,תל אביב,8600,רמת גן,יישוב,2263,1064,1199,579,1684,468,2222,28,2.84%
2014-01,תל אביב,2650,רמת השרון,יישוב,414,191,223,113,301,5,409,5,1.82%
2014-01,תל אביב,5000,תל אביב -יפו,יישוב,8168,3952,4216,2101,6067,2428,8008,130,3.17%
2014-02,אזור יהודה והשומרון,3760,אורנית,יישוב,112,43,69,40,72,3,111,0,2.37%
2014-02,אזור יהודה והשומרון,3750,אלפי מנשה,יישוב,97,48,49,18,79,1,97,1,2.28%
2014-02,אזור יהודה והשומרון,3560,אלקנה,יישוב,33,15,18,13,20,1,33,0,1.74%
2014-02,אזור יהודה והשומרון,3650,אפרת,יישוב,49,25,24,15,34,3,49,0,1.20%
2014-02,אזור יהודה והשומרון,3570,אריאל,יישוב,378,170,208,57,321,84,373,4,3.54%
2014-02,אזור יהודה והשומרון,3574,בית אל,יישוב,58,22,36,12,46,14,58,2,2.36%
2014-02,אזור יהודה והשומרון,3652,בית אריה,יישוב,63,26,37,13,50,2,63,0,2.46%
2014-02,אזור יהודה והשומרון,3780,ביתר עילית,יישוב,533,240,293,6,527,215,529,2,4.34%
2014-02,אזור יהודה והשומרון,3730,גבעת זאב,יישוב,177,84,93,39,138,38,176,2,2.34%
2014-02,אזור יהודה והשומרון,3769,הר אדר,יישוב,35,19,16,11,24,4,34,0,1.65%
2014-02,אזור יהודה והשומרון,76,מ.א. גוש עציון,מועצה איזורית,161,72,89,44,117,15,160,0,1.73%
2014-02,אזור יהודה והשומרון,78,מ.א. הר חברון,מועצה איזורית,62,33,29,12,50,7,61,0,1.89%
2014-02,אזור יהודה והשומרון,74,מ.א. מגילות ים המלח,מועצה איזורית,13,4,9,3,10,1,13,0,1.71%
2014-02,אזור יהודה והשומרון,73,מ.א. מטה בנימין,מועצה איזורית,608,287,321,125,483,140,599,0,2.51%
2014-02,אזור יהודה והשומרון,75,מ.א. ערבות הירדן,מועצה איזורית,40,16,24,11,29,3,39,0,1.67%
2014-02,אזור יהודה והשומרון,72,מ.א. שומרון,מועצה איזורית,393,219,174,74,319,60,388,0,2.46%
2014-02,אזור יהודה והשומרון,3797,מודיעין עילית,יישוב,401,156,245,27,374,78,393,17,3.01%
2014-02,אזור יהודה והשומרון,3616,מעלה אדומים,יישוב,667,287,380,46,621,219,659,21,3.24%
2014-02,אזור יהודה והשומרון,3660,עמנואל,יישוב,80,47,33,1,79,52,78,0,6.87%
2014-02,אזור יהודה והשומרון,3557,קדומים,יישוב,28,14,14,9,19,8,28,0,1.51%
2014-02,אזור יהודה והשומרון,3611,קריית ארבע,יישוב,112,62,50,12,100,62,110,4,3.46%
2014-02,אזור יהודה והשומרון,3640,קרני שומרון,יישוב,89,50,39,14,75,11,87,2,2.39%
2014-02,הדרום,31,אופקים,יישוב,1272,557,715,77,1195,838,1235,45,9.63%
2014-02,הדרום,2600,אילת,יישוב,1611,731,880,42,1569,567,1585,50,4.72%
2014-02,הדרום,70,אשדוד,יישוב,6790,2884,3906,691,6099,3436,6647,184,6.12%
2014-02,הדרום,7100,אשקלון,יישוב,4244,1823,2421,326,3918,2263,3944,114,5.73%
2014-02,הדרום,9000,באר שבע,יישוב,7274,3286,3988,802,6472,4328,7032,162,6.75%
2014-02,הדרום,2200,דימונה,יישוב,2066,933,1133,118,1948,1363,1999,42,10.88%
2014-02,הדרום,1303,חורה,יישוב,826,360,466,2,824,754,816,0,20.07%
2014-02,הדרום,831,ירוחם,יישוב,467,229,238,14,453,271,446,29,9.73%
2014-02,הדרום,1059,כסיפה,יישוב,1033,429,604,3,1030,917,1019,5,21.87%
2014-02,הדרום,1271,להבים,יישוב,53,23,30,25,28,5,53,1,1.52%
2014-02,הדרום,1060,לקיה,יישוב,1002,442,560,1,1001,937,997,0,23.33%
2014-02,הדרום,69,מ.א. אל קסום,מועצה איזורית,769,327,442,5,764,697,761,0,59.08%
2014-02,הדרום,38,מ.א. אשכול,מועצה איזורית,103,48,55,15,88,15,101,0,1.53%
2014-02,הדרום,33,מ.א. באר טוביה,מועצה איזורית,288,110,178,44,244,56,284,0,2.75%
2014-02,הדרום,41,מ.א. בני שמעון,מועצה איזורית,67,24,43,20,47,16,65,2,1.61%
2014-02,הדרום,54,מ.א. הערבה התיכונה,מועצה איזורית,20,7,13,4,16,2,19,0,1.05%
2014-02,הדרום,53,מ.א. חבל אילות,מועצה איזורית,20,14,6,1,19,0,19,1,0.89%
2014-02,הדרום,36,מ.א. חוף אשקלון,מועצה איזורית,244,110,134,21,223,68,228,1,2.92%
2014-02,הדרום,35,מ.א. יואב,מועצה איזורית,109,50,59,21,88,19,108,0,2.82%
2014-02,הדרום,50,מ.א. לכיש,מועצה איזורית,167,74,93,12,155,63,165,0,3.48%
2014-02,הדרום,42,מ.א. מרחבים,מועצה איזורית,205,81,124,24,181,43,203,0,3.81%
2014-02,הדרום,68,מ.א. נווה מדבר,מועצה איזורית,111,46,65,0,111,93,109,0,17.55%
2014-02,הדרום,48,מ.א. רמת נגב,מועצה איזורית,201,100,101,10,191,164,197,1,6.85%
2014-02,הדרום,39,מ.א. שדות נגב,מועצה איזורית,130,60,70,14,116,30,127,0,3.04%
2014-02,הדרום,37,מ.א. שער הנגב,מועצה איזורית,179,104,75,24,155,105,176,0,4.73%
2014-02,הדרום,34,מ.א. שפיר,מועצה איזורית,201,106,95,11,190,78,198,0,4.36%
2014-02,הדרום,51,מ.א. תמר,מועצה איזורית,6,2,4,1,5,1,6,0,0.97%
2014-02,הדרום,1268,מיתר,יישוב,67,28,39,19,48,5,64,3,1.50%
2014-02,הדרום,99,מצפה רמון,יישוב,285,124,161,10,275,176,270,12,10.89%
2014-02,הדרום,246,נתיבות,יישוב,1038,484,554,43,995,527,998,25,7.16%
2014-02,הדרום,666,עומר,יישוב,62,25,37,17,45,7,62,1,1.53%
2014-02,הדרום,2560,ערד,יישוב,905,402,503,91,814,434,863,53,6.97%
2014-02,הדרום,1192,ערערה-בנגב,יישוב,1013,434,579,3,1010,926,1005,3,24.15%
2014-02,הדרום,2630,קריית גת,יישוב,2198,905,1293,117,2081,1292,2139,43,7.51%
2014-02,הדרום,1034,קריית מלאכי,יישוב,1299,585,714,25,1274,758,1249,55,10.60%
2014-02,הדרום,1161,רהט,יישוב,3320,1431,1889,7,3313,2802,3286,75,17.20%
2014-02,הדרום,1286,שגב-שלום,יישוב,564,222,342,3,561,485,558,1,20.78%
2014-02,הדרום,1031,שדרות,יישוב,1101,523,578,41,1060,647,1061,16,8.29%
2014-02,הדרום,1054,תל שבע,יישוב,1243,611,632,1,1242,1138,1229,4,24.69%
2014-02,המרכז,182,אבן יהודה,יישוב,182,81,101,63,119,19,179,0,2.66%
2014-02,המרכז,41,אליכין,יישוב,67,36,31,7,60,18,63,2,3.36%
2014-02,המרכז,1309,אלעד,יישוב,384,189,195,16,368,96,376,5,3.02%
2014-02,המרכז,2530,באר יעקב,יישוב,268,114,154,56,212,54,265,2,2.92%
2014-02,המרכז,466,בית דגן,יישוב,109,66,43,15,94,38,108,4,3.03%
2014-02,המרכז,1066,"בני עי""ש",יישוב,193,89,104,20,173,67,191,5,4.81%
2014-02,המרכז,681,גבעת שמואל,יישוב,306,148,158,83,223,68,302,3,2.52%
2014-02,המרכז,2550,גדרה,יישוב,369,144,225,61,308,108,361,1,3.10%
2014-02,המרכז,627,ג'לג'וליה,יישוב,99,49,50,2,97,49,99,2,2.73%
2014-02,המרכז,166,גן יבנה,יישוב,367,147,220,41,326,92,363,8,3.18%
2014-02,המרכז,229,גני תקווה,יישוב,196,85,111,57,139,18,195,2,2.34%
2014-02,המרכז,9700,הוד השרון,יישוב,687,302,385,202,485,64,675,10,2.28%
2014-02,המרכז,1290,זמר,יישוב,180,60,120,1,179,129,176,3,5.97%
2014-02,המרכז,2730,טייבה,יישוב,1999,877,1122,12,1987,1701,1888,31,10.67%
2014-02,המרכז,2720,טירה,יישוב,361,178,183,6,355,177,351,10,3.08%
2014-02,המרכז,2660,יבנה,יישוב,936,446,490,93,843,351,920,21,3.96%
2014-02,המרכז,9400,יהוד,יישוב,532,222,310,71,461,79,519,13,3.26%
2014-02,המרכז,1224,כוכב יאיר,יישוב,87,30,57,37,50,0,87,1,1.54%
2014-02,המרכז,633,כפר ברא,יישוב,33,21,12,1,32,17,32,1,2.33%
2014-02,המרכז,168,כפר יונה,יישוב,332,157,175,57,275,62,328,6,3.03%
2014-02,המרכז,6900,כפר סבא,יישוב,1285,593,692,338,947,177,1263,15,2.38%
2014-02,המרכז,634,כפר קאסם,יישוב,264,137,127,3,261,142,259,2,2.93%
2014-02,המרכז,7000,לוד,יישוב,2180,1019,1161,153,2027,1181,2155,47,6.11%
2014-02,המרכז,28,מ.א. ברנר,מועצה איזורית,70,27,43,20,50,3,70,2,1.84%
2014-02,המרכז,32,מ.א. גדרות,מועצה איזורית,39,14,25,18,21,3,39,0,1.72%
2014-02,המרכז,30,מ.א. גזר,מועצה איזורית,282,120,162,79,203,30,275,0,2.16%
2014-02,המרכז,27,מ.א. גן רווה,מועצה איזורית,54,27,27,17,37,1,54,0,1.98%
2014-02,המרכז,20,מ.א. דרום השרון,מועצה איזורית,317,153,164,102,215,12,314,0,2.06%
2014-02,המרכז,29,מ.א. חבל יבנה,מועצה איזורית,46,23,23,17,29,2,46,0,1.91%
2014-02,המרכז,25,מ.א. חבל מודיעין,מועצה איזורית,270,123,147,50,220,22,265,0,2.54%
2014-02,המרכז,19,מ.א. חוף השרון,מועצה איזורית,105,45,60,45,60,3,105,0,1.92%
2014-02,המרכז,18,מ.א. לב השרון,מועצה איזורית,245,123,122,75,170,29,245,0,2.26%
2014-02,המרכז,31,מ.א. נחל שורק,מועצה איזורית,48,23,25,12,36,6,48,45,1.10%
2014-02,המרכז,16,מ.א. עמק חפר,מועצה איזורית,408,188,220,149,259,30,398,0,2.03%
2014-02,המרכז,40,מ.א. עמק לוד,מועצה איזורית,136,64,72,18,118,13,135,0,2.22%
2014-02,המרכז,1200,מודיעין-מכבים-רעות*,יישוב,1018,463,555,311,707,62,994,14,2.30%
2014-02,המרכז,28,מזכרת בתיה,יישוב,141,65,76,29,112,32,139,2,1.99%
2014-02,המרכז,7200,נס ציונה,יישוב,725,327,398,152,573,206,718,11,3.07%
2014-02,המרכז,7400,נתניה,יישוב,4459,2082,2377,580,3879,1599,4363,107,4.17%
2014-02,המרכז,587,סביון*,יישוב,25,6,19,9,16,0,25,0,1.29%
2014-02,המרכז,171,פרדסייה,יישוב,86,40,46,10,76,10,85,0,2.35%
2014-02,המרכז,7900,פתח תקווה,יישוב,4163,1843,2320,798,3365,1092,4088,41,3.29%
2014-02,המרכז,195,קדימה-צורן,יישוב,246,105,141,63,183,41,243,2,2.30%
2014-02,המרכז,638,קלנסווה,יישוב,778,312,466,3,775,653,734,15,8.39%
2014-02,המרכז,469,קריית עקרון,יישוב,331,166,165,21,310,143,326,7,5.50%
2014-02,המרכז,2640,ראש העין,יישוב,769,391,378,80,689,169,757,16,3.27%
2014-02,המרכז,8300,ראשון לציון,יישוב,4346,1991,2355,714,3632,1365,4317,84,3.14%
2014-02,המרכז,8400,רחובות,יישוב,2630,1169,1461,497,2133,1002,2560,45,3.79%
2014-02,המרכז,8500,רמלה,יישוב,1823,864,959,103,1720,749,1761,48,4.78%
2014-02,המרכז,8700,רעננה,יישוב,828,414,414,268,560,72,823,6,2.22%
2014-02,המרכז,1304,שוהם,יישוב,188,90,98,77,111,8,187,0,1.70%
2014-02,המרכז,154,תל מונד,יישוב,149,59,90,54,95,17,149,0,2.41%
2014-02,הצפון,473,אבו סנאן,יישוב,714,293,421,5,709,584,710,14,12.20%
2014-02,הצפון,478,אכסאל,יישוב,536,240,296,15,521,457,528,3,9.35%
2014-02,הצפון,529,אעבלין,יישוב,639,264,375,8,631,525,633,6,11.19%
2014-02,הצפון,482,בועיינה-נוג'ידאת,יישוב,449,183,266,4,445,352,431,1,11.13%
2014-02,הצפון,4001,בוקעאתא,יישוב,429,176,253,3,426,353,410,0,14.90%
2014-02,הצפון,998,ביר אל-מכסור,יישוב,432,168,264,2,430,333,429,3,11.65%
2014-02,הצפון,480,בית ג'ן,יישוב,397,120,277,10,387,304,385,2,7.32%
2014-02,הצפון,9200,בית שאן,יישוב,864,375,489,10,854,420,836,66,8.32%
2014-02,הצפון,944,בסמת טבעון,יישוב,221,111,110,5,216,159,216,3,6.74%
2014-02,הצפון,483,בענה,יישוב,391,156,235,5,386,326,390,6,11.71%
2014-02,הצפון,1292,ג'דיידה-מכר,יישוב,1466,641,825,8,1458,1237,1450,34,15.74%
2014-02,הצפון,485,ג'ולס,יישוב,226,70,156,1,225,157,226,5,7.79%
2014-02,הצפון,487,ג'ש (גוש חלב),יישוב,71,35,36,3,68,38,71,4,4.32%
2014-02,הצפון,489,דבורייה,יישוב,403,181,222,11,392,321,402,2,9.42%
2014-02,הצפון,490,דייר אל-אסד,יישוב,406,171,235,7,399,323,399,10,7.81%
2014-02,הצפון,492,דייר חנא,יישוב,664,302,362,11,653,491,663,4,13.66%
2014-02,הצפון,975,זרזיר,יישוב,308,151,157,2,306,214,293,5,9.50%
2014-02,הצפון,496,חורפיש,יישוב,104,41,63,6,98,61,101,2,3.83%
2014-02,הצפון,2034,חצור הגלילית,יישוב,321,139,182,14,307,148,296,17,6.25%
2014-02,הצפון,6700,טבריה,יישוב,1864,843,1021,67,1797,1110,1617,48,7.44%
2014-02,הצפון,962,טובא-זנגרייה,יישוב,375,168,207,3,372,255,364,6,11.99%
2014-02,הצפון,498,טורעאן,יישוב,537,197,340,10,527,463,513,5,9.05%
2014-02,הצפון,8900,טמרה,יישוב,2021,874,1147,20,2001,1764,1999,18,14.17%
2014-02,הצפון,1295,יאנוח-ג'ת,יישוב,162,60,102,4,158,102,159,1,5.69%
2014-02,הצפון,46,יבנאל,יישוב,171,117,54,6,165,129,147,2,9.23%
2014-02,הצפון,499,יפיע,יישוב,668,312,356,12,656,519,649,2,8.31%
2014-02,הצפון,240,יקנעם עילית,יישוב,531,225,306,49,482,164,520,28,4.49%
2014-02,הצפון,502,ירכא,יישוב,560,231,329,1,559,447,557,11,9.55%
2014-02,הצפון,504,כאבול,יישוב,692,290,402,11,681,597,690,9,14.08%
2014-02,הצפון,505,כאוכב אבו אל-היג'א,יישוב,221,97,124,5,216,192,219,1,12.75%
2014-02,הצפון,1296,כסרא-סמיע,יישוב,236,97,139,5,231,166,232,2,6.75%
2014-02,הצפון,978,כעביה-טבאש-חג'אג'רה,יישוב,240,103,137,2,238,154,235,1,10.17%
2014-02,הצפון,1263,כפר ורדים,יישוב,68,31,37,28,40,5,68,0,2.18%
2014-02,הצפון,507,כפר יאסיף,יישוב,502,204,298,6,496,398,494,13,9.51%
2014-02,הצפון,508,כפר כמא,יישוב,72,31,41,6,66,31,71,0,4.36%
2014-02,הצפון,509,כפר כנא,יישוב,1148,470,678,22,1126,1007,1098,14,12.45%
2014-02,הצפון,510,כפר מנדא,יישוב,1016,474,542,12,1004,720,989,0,13.42%
2014-02,הצפון,47,כפר תבור,יישוב,37,21,16,4,33,2,37,0,1.71%
2014-02,הצפון,1139,כרמיאל,יישוב,1719,702,1017,285,1434,842,1650,66,6.37%
2014-02,הצפון,65,מ.א. אל-בטוף,מועצה איזורית,411,144,267,4,407,330,398,1,14.93%
2014-02,הצפון,66,מ.א. בוסתן אל-מרג,מועצה איזורית,50,19,31,3,47,40,50,0,1.63%
2014-02,הצפון,71,מ.א. גולן,מועצה איזורית,191,82,109,11,180,21,189,0,2.31%
2014-02,הצפון,8,מ.א. הגלבוע,מועצה איזורית,812,326,486,45,767,541,791,0,5.66%
2014-02,הצפון,1,מ.א. הגליל העליון,מועצה איזורית,271,129,142,35,236,77,267,0,3.01%
2014-02,הצפון,3,מ.א. הגליל התחתון,מועצה איזורית,147,65,82,25,122,16,140,0,2.45%
2014-02,הצפון,55,מ.א. מבואות החרמון,מועצה איזורית,105,39,66,15,90,9,104,0,2.70%
2014-02,הצפון,13,מ.א. מגידו,מועצה איזורית,108,48,60,18,90,9,108,0,1.91%
2014-02,הצפון,4,מ.א. מטה אשר,מועצה איזורית,438,199,239,47,391,194,430,0,3.26%
2014-02,הצפון,52,מ.א. מעלה יוסף,מועצה איזורית,204,94,110,23,181,64,203,0,3.87%
2014-02,הצפון,2,מ.א. מרום הגליל,מועצה איזורית,338,168,170,10,328,139,329,0,5.08%
2014-02,הצפון,56,מ.א. משגב,מועצה איזורית,589,252,337,98,491,277,576,0,4.68%
2014-02,הצפון,6,מ.א. עמק הירדן,מועצה איזורית,165,69,96,14,151,39,150,0,2.26%
2014-02,הצפון,7,מ.א. עמק המעיינות,מועצה איזורית,176,80,96,14,162,51,171,1,2.76%
2014-02,הצפון,9,מ.א. עמק יזרעאל,מועצה איזורית,340,154,186,111,229,35,335,0,1.81%
2014-02,הצפון,481,מגאר,יישוב,1457,608,849,9,1448,1263,1426,5,15.30%
2014-02,הצפון,516,מג'ד אל-כרום,יישוב,554,249,305,4,550,436,548,12,8.47%
2014-02,הצפון,874,מגדל העמק,יישוב,1014,420,594,68,946,424,900,97,6.74%
2014-02,הצפון,4201,מג'דל שמס,יישוב,508,186,322,11,497,401,500,0,10.43%
2014-02,הצפון,517,מזרעה,יישוב,172,67,105,4,168,137,171,5,8.75%
2014-02,הצפון,4203,מסעדה,יישוב,216,80,136,3,213,175,213,0,12.67%
2014-02,הצפון,518,מעיליא,יישוב,58,26,32,6,52,31,55,0,3.36%
2014-02,הצפון,1063,מעלות-תרשיחא,יישוב,927,449,478,79,848,523,909,36,7.56%
2014-02,הצפון,520,משהד,יישוב,285,108,177,6,279,250,275,2,8.62%
2014-02,הצפון,9100,נהרייה,יישוב,2043,942,1101,181,1862,1214,1997,86,6.44%
2014-02,הצפון,522,נחף,יישוב,415,192,223,7,408,334,411,12,8.29%
2014-02,הצפון,7300,נצרת,יישוב,3291,1432,1859,81,3210,2580,3226,10,9.31%
2014-02,הצפון,1061,נצרת עילית,יישוב,1841,837,1004,147,1694,1014,1678,101,7.09%
2014-02,הצפון,525,סאג'ור,יישוב,127,48,79,3,124,75,124,3,6.95%
2014-02,הצפון,7500,סח'נין,יישוב,2071,912,1159,14,2057,1755,2062,11,14.85%
2014-02,הצפון,4501,ע'ג'ר,יישוב,97,46,51,1,96,68,97,0,9.38%
2014-02,הצפון,530,עיילבון,יישוב,216,90,126,2,214,153,213,3,7.74%
2014-02,הצפון,511,עילוט,יישוב,320,127,193,3,317,261,312,2,11.13%
2014-02,הצפון,532,עין מאהל,יישוב,587,272,315,10,577,476,572,3,10.83%
2014-02,הצפון,7600,עכו,יישוב,3158,1445,1713,113,3045,2397,3086,43,11.60%
2014-02,הצפון,7700,עפולה,יישוב,1703,747,956,142,1561,813,1629,76,6.55%
2014-02,הצפון,531,עראבה,יישוב,1543,653,890,25,1518,1308,1536,11,15.25%
2014-02,הצפון,535,פסוטה,יישוב,123,58,65,6,117,84,123,2,7.17%
2014-02,הצפון,536,פקיעין (בוקייעה),יישוב,136,77,59,5,131,85,130,4,4.75%
2014-02,הצפון,8000,צפת,יישוב,1469,781,688,66,1403,1114,1410,30,10.48%
2014-02,הצפון,4100,קצרין,יישוב,210,84,126,14,196,100,204,4,5.17%
2014-02,הצפון,2800,קריית שמונה,יישוב,867,385,482,37,830,381,838,25,6.41%
2014-02,הצפון,543,ראמה,יישוב,334,131,203,9,325,250,327,1,8.37%
2014-02,הצפון,26,ראש פינה,יישוב,63,22,41,12,51,21,62,0,3.89%
2014-02,הצפון,542,ריינה,יישוב,687,292,395,10,677,556,673,4,9.87%
2014-02,הצפון,122,רמת ישי,יישוב,100,38,62,29,71,14,95,1,2.30%
2014-02,הצפון,913,שבלי - אום אל-גנם,יישוב,259,117,142,5,254,166,253,4,9.70%
2014-02,הצפון,812,שלומי,יישוב,244,112,132,10,234,141,236,15,6.57%
2014-02,הצפון,538,שעב,יישוב,548,227,321,1,547,475,545,3,17.70%
2014-02,הצפון,8800,שפרעם,יישוב,2073,791,1282,38,2035,1732,2053,25,11.59%
2014-02,חיפה,2710,אום אל-פחם,יישוב,3838,1575,2263,21,3817,3312,3770,29,17.85%
2014-02,חיפה,1020,אור עקיבא,יישוב,614,266,348,36,578,214,591,21,5.88%
2014-02,חיפה,6000,באקה אל-גרביה,יישוב,800,384,416,6,794,498,792,23,6.78%
2014-02,חיפה,9800,בנימינה-גבעת עדה*,יישוב,238,93,145,56,182,67,237,4,3.35%
2014-02,חיפה,1326,"בסמ""ה",יישוב,439,189,250,2,437,361,433,1,10.85%
2014-02,חיפה,541,ג'סר א-זרקא,יישוב,436,242,194,1,435,314,433,4,7.43%
2014-02,חיפה,628,ג'ת,יישוב,275,134,141,13,262,163,274,2,5.23%
2014-02,חיפה,494,דאלית אל-כרמל,יישוב,535,227,308,11,524,314,521,6,6.63%
2014-02,חיפה,9300,זכרון יעקב,יישוב,264,125,139,57,207,59,264,3,2.44%
2014-02,חיפה,6500,חדרה,יישוב,2427,1021,1406,248,2179,961,2336,74,4.74%
2014-02,חיפה,4000,חיפה,יישוב,6682,3234,3448,1084,5598,3552,6476,169,4.56%
2014-02,חיפה,1247,חריש,יישוב,28,14,14,5,23,10,24,1,1.63%
2014-02,חיפה,2100,טירת כרמל,יישוב,730,360,370,17,713,438,723,27,6.76%
2014-02,חיפה,654,כפר קרע,יישוב,458,205,253,7,451,262,450,7,5.39%
2014-02,חיפה,45,מ.א. אלונה,מועצה איזורית,42,16,26,13,29,4,42,0,4.08%
2014-02,חיפה,12,מ.א. זבולון,מועצה איזורית,283,137,146,29,254,189,281,0,5.16%
2014-02,חיפה,15,מ.א. חוף הכרמל,מועצה איזורית,314,132,182,58,256,66,309,0,2.28%
2014-02,חיפה,14,מ.א. מנשה,מועצה איזורית,246,120,126,53,193,75,244,0,3.13%
2014-02,חיפה,1327,מעלה עירון,יישוב,948,368,580,3,945,811,941,6,15.98%
2014-02,חיפה,2500,נשר,יישוב,471,232,239,87,384,186,459,8,3.61%
2014-02,חיפה,534,עספיא,יישוב,324,150,174,8,316,181,310,3,5.68%
2014-02,חיפה,637,ערערה,יישוב,618,238,380,7,611,413,603,20,7.46%
2014-02,חיפה,537,פוריידיס,יישוב,426,224,202,7,419,284,419,2,7.54%
2014-02,חיפה,7800,פרדס חנה-כרכור,יישוב,848,389,459,106,742,283,839,32,4.20%
2014-02,חיפה,6800,קריית אתא,יישוב,1641,755,886,143,1498,914,1612,37,5.41%
2014-02,חיפה,9500,קריית ביאליק,יישוב,1132,481,651,138,994,547,1121,30,5.22%
2014-02,חיפה,2300,קריית טבעון,יישוב,185,93,92,58,127,41,183,0,2.15%
2014-02,חיפה,9600,קריית ים,יישוב,1579,743,836,124,1455,923,1553,35,7.26%
2014-02,חיפה,8200,קריית מוצקין,יישוב,1084,475,609,137,947,507,1065,22,4.66%
2014-02,חיפה,922,רכסים,יישוב,154,69,85,8,146,82,146,4,4.27%
2014-02,ירושלים,472,אבו גוש,יישוב,266,130,136,6,260,190,265,3,8.65%
2014-02,ירושלים,2610,בית שמש,יישוב,1277,570,707,82,1195,525,1237,40,3.91%
2014-02,ירושלים,3000,ירושלים,יישוב,12181,5636,6545,1260,10921,7389,11971,175,4.03%
2014-02,ירושלים,26,מ.א. מטה יהודה,מועצה איזורית,586,289,297,99,487,129,574,0,2.50%
2014-02,ירושלים,1015,מבשרת ציון,יישוב,366,178,188,57,309,152,360,6,2.71%
2014-02,ירושלים,1137,קריית יערים,יישוב,34,16,18,4,30,18,32,1,2.45%
2014-02,תל אביב,2400,אור יהודה,יישוב,819,390,429,23,796,255,783,36,4.16%
2014-02,תל אביב,565,אזור,יישוב,186,97,89,27,159,35,183,2,2.86%
2014-02,תל אביב,6100,בני ברק,יישוב,2224,1127,1097,79,2145,1277,2144,24,3.85%
2014-02,תל אביב,6200,בת ים,יישוב,3272,1562,1710,397,2875,1253,3146,106,4.43%
2014-02,תל אביב,6300,גבעתיים,יישוב,737,333,404,254,483,107,730,3,2.41%
2014-02,תל אביב,6400,הרצלייה,יישוב,1103,470,633,211,892,37,1084,37,2.24%
2014-02,תל אביב,6600,חולון,יישוב,3233,1498,1735,404,2829,870,3137,59,3.16%
2014-02,תל אביב,2620,קריית אונו,יישוב,403,200,203,96,307,40,401,3,2.13%
2014-02,תל אביב,8600,רמת גן,יישוב,2181,1012,1169,557,1624,467,2140,25,2.74%
2014-02,תל אביב,2650,רמת השרון,יישוב,385,178,207,113,272,5,384,2,1.71%
2014-02,תל אביב,5000,תל אביב -יפו,יישוב,7883,3868,4015,2083,5800,2412,7719,97,3.06%
2014-03,אזור יהודה והשומרון,3760,אורנית,יישוב,109,44,65,42,67,2,108,0,2.30%
2014-03,אזור יהודה והשומרון,3750,אלפי מנשה,יישוב,92,43,49,13,79,1,92,4,2.16%
2014-03,אזור יהודה והשומרון,3560,אלקנה,יישוב,37,19,18,14,23,1,36,0,1.89%
2014-03,אזור יהודה והשומרון,3650,אפרת,יישוב,58,30,28,14,44,7,58,1,1.42%
2014-03,אזור יהודה והשומרון,3570,אריאל,יישוב,378,174,204,55,323,85,372,7,3.53%
2014-03,אזור יהודה והשומרון,3574,בית אל,יישוב,56,24,32,13,43,16,56,0,2.28%
2014-03,אזור יהודה והשומרון,3652,בית אריה,יישוב,63,27,36,14,49,5,62,1,2.42%
2014-03,אזור יהודה והשומרון,3780,ביתר עילית,יישוב,498,229,269,7,491,212,493,1,4.06%
2014-03,אזור יהודה והשומרון,3730,גבעת זאב,יישוב,171,79,92,39,132,39,171,2,2.28%
2014-03,אזור יהודה והשומרון,3769,הר אדר,יישוב,36,16,20,10,26,4,35,0,1.69%
2014-03,אזור יהודה והשומרון,76,מ.א. גוש עציון,מועצה איזורית,166,75,91,45,121,16,165,0,1.78%
2014-03,אזור יהודה והשומרון,78,מ.א. הר חברון,מועצה איזורית,61,30,31,12,49,7,60,0,1.86%
2014-03,אזור יהודה והשומרון,74,מ.א. מגילות ים המלח,מועצה איזורית,12,4,8,2,10,1,12,0,1.58%
2014-03,אזור יהודה והשומרון,73,מ.א. מטה בנימין,מועצה איזורית,610,289,321,134,476,144,601,0,2.52%
2014-03,אזור יהודה והשומרון,75,מ.א. ערבות הירדן,מועצה איזורית,47,20,27,9,38,2,47,0,2.02%
2014-03,אזור יהודה והשומרון,72,מ.א. שומרון,מועצה איזורית,389,209,180,72,317,60,386,0,2.44%
2014-03,אזור יהודה והשומרון,3797,מודיעין עילית,יישוב,396,155,241,26,370,84,387,7,2.97%
2014-03,אזור יהודה והשומרון,3616,מעלה אדומים,יישוב,634,261,373,54,580,219,621,16,3.06%
2014-03,אזור יהודה והשומרון,3660,עמנואל,יישוב,84,48,36,0,84,54,82,0,7.20%
2014-03,אזור יהודה והשומרון,3557,קדומים,יישוב,31,14,17,10,21,9,31,0,1.67%
2014-03,אזור יהודה והשומרון,3611,קריית ארבע,יישוב,127,63,64,12,115,64,123,2,3.85%
2014-03,אזור יהודה והשומרון,3640,קרני שומרון,יישוב,76,36,40,20,56,10,75,2,2.06%
2014-03,הדרום,31,אופקים,יישוב,1248,561,687,74,1174,814,1203,47,9.40%
2014-03,הדרום,2600,אילת,יישוב,1516,708,808,38,1478,562,1490,54,4.45%
2014-03,הדרום,70,אשדוד,יישוב,6734,2831,3903,713,6021,3419,6573,210,6.05%
2014-03,הדרום,7100,אשקלון,יישוב,4212,1808,2404,305,3907,2271,3901,122,5.67%
2014-03,הדרום,9000,באר שבע,יישוב,7193,3273,3920,770,6423,4325,6937,204,6.67%
2014-03,הדרום,2200,דימונה,יישוב,2138,968,1170,120,2018,1358,2061,57,11.17%
2014-03,הדרום,1303,חורה,יישוב,831,366,465,2,829,755,820,1,20.15%
2014-03,הדרום,831,ירוחם,יישוב,474,240,234,14,460,271,449,25,9.79%
2014-03,הדרום,1059,כסיפה,יישוב,1039,424,615,1,1038,923,1029,3,22.04%
2014-03,הדרום,1271,להבים,יישוב,41,20,21,19,22,4,41,0,1.18%
2014-03,הדרום,1060,לקיה,יישוב,993,432,561,3,990,929,986,0,23.13%
2014-03,הדרום,69,מ.א. אל קסום,מועצה איזורית,787,332,455,2,785,717,777,0,60.33%
2014-03,הדרום,38,מ.א. אשכול,מועצה איזורית,113,51,62,11,102,19,109,0,1.65%
2014-03,הדרום,33,מ.א. באר טוביה,מועצה איזורית,277,112,165,38,239,56,275,1,2.66%
2014-03,הדרום,41,מ.א. בני שמעון,מועצה איזורית,76,27,49,19,57,17,74,4,1.84%
2014-03,הדרום,54,מ.א. הערבה התיכונה,מועצה איזורית,22,10,12,5,17,1,22,0,1.22%
2014-03,הדרום,53,מ.א. חבל אילות,מועצה איזורית,21,14,7,2,19,1,21,2,0.98%
2014-03,הדרום,36,מ.א. חוף אשקלון,מועצה איזורית,240,114,126,19,221,66,220,0,2.81%
2014-03,הדרום,35,מ.א. יואב,מועצה איזורית,117,52,65,23,94,21,116,0,3.02%
2014-03,הדרום,50,מ.א. לכיש,מועצה איזורית,156,71,85,10,146,61,154,0,3.25%
2014-03,הדרום,42,מ.א. מרחבים,מועצה איזורית,189,76,113,25,164,42,187,0,3.51%
2014-03,הדרום,68,מ.א. נווה מדבר,מועצה איזורית,114,45,69,0,114,95,111,0,17.87%
2014-03,הדרום,48,מ.א. רמת נגב,מועצה איזורית,201,102,99,8,193,163,199,1,6.92%
2014-03,הדרום,39,מ.א. שדות נגב,מועצה איזורית,129,60,69,17,112,33,125,0,2.99%
2014-03,הדרום,37,מ.א. שער הנגב,מועצה איזורית,169,92,77,31,138,91,167,0,4.50%
2014-03,הדרום,34,מ.א. שפיר,מועצה איזורית,186,99,87,9,177,77,186,0,4.10%
2014-03,הדרום,51,מ.א. תמר,מועצה איזורית,6,2,4,1,5,1,6,0,0.97%
2014-03,הדרום,1268,מיתר,יישוב,64,27,37,15,49,5,62,0,1.45%
2014-03,הדרום,99,מצפה רמון,יישוב,249,100,149,13,236,164,235,11,9.62%
2014-03,הדרום,246,נתיבות,יישוב,975,449,526,41,934,520,942,49,6.79%
2014-03,הדרום,666,עומר,יישוב,58,21,37,16,42,6,56,0,1.39%
2014-03,הדרום,2560,ערד,יישוב,898,408,490,98,800,438,857,33,6.93%
2014-03,הדרום,1192,ערערה-בנגב,יישוב,1014,432,582,4,1010,930,1008,5,24.20%
2014-03,הדרום,2630,קריית גת,יישוב,2178,899,1279,132,2046,1273,2121,56,7.46%
2014-03,הדרום,1034,קריית מלאכי,יישוב,1276,572,704,24,1252,737,1230,86,10.45%
2014-03,הדרום,1161,רהט,יישוב,3286,1392,1894,5,3281,2803,3249,42,17.04%
2014-03,הדרום,1286,שגב-שלום,יישוב,564,212,352,3,561,488,559,1,20.81%
2014-03,הדרום,1031,שדרות,יישוב,1099,516,583,48,1051,659,1060,26,8.29%
2014-03,הדרום,1054,תל שבע,יישוב,1234,603,631,1,1233,1137,1224,5,24.62%
2014-03,המרכז,182,אבן יהודה,יישוב,172,81,91,62,110,19,169,3,2.51%
2014-03,המרכז,41,אליכין,יישוב,59,27,32,6,53,17,55,4,2.94%
2014-03,המרכז,1309,אלעד,יישוב,389,198,191,16,373,96,380,5,3.05%
2014-03,המרכז,2530,באר יעקב,יישוב,278,116,162,48,230,59,275,5,3.02%
2014-03,המרכז,466,בית דגן,יישוב,99,60,39,12,87,36,98,2,2.75%
2014-03,המרכז,1066,"בני עי""ש",יישוב,197,94,103,24,173,70,196,2,4.93%
2014-03,המרכז,681,גבעת שמואל,יישוב,310,154,156,81,229,71,305,3,2.55%
2014-03,המרכז,2550,גדרה,יישוב,377,147,230,67,310,112,370,9,3.17%
2014-03,המרכז,627,ג'לג'וליה,יישוב,92,43,49,2,90,50,90,4,2.49%
2014-03,המרכז,166,גן יבנה,יישוב,369,154,215,44,325,93,361,14,3.17%
2014-03,המרכז,229,גני תקווה,יישוב,196,81,115,54,142,21,194,0,2.33%
2014-03,המרכז,9700,הוד השרון,יישוב,672,296,376,208,464,62,662,8,2.24%
2014-03,המרכז,1290,זמר,יישוב,182,61,121,2,180,131,179,2,6.06%
2014-03,המרכז,2730,טייבה,יישוב,1923,836,1087,10,1913,1641,1817,28,10.31%
2014-03,המרכז,2720,טירה,יישוב,371,178,193,8,363,175,361,12,3.17%
2014-03,המרכז,2660,יבנה,יישוב,944,451,493,99,845,356,922,42,3.96%
2014-03,המרכז,9400,יהוד,יישוב,544,232,312,77,467,79,531,13,3.34%
2014-03,המרכז,1224,כוכב יאיר,יישוב,85,28,57,43,42,0,85,0,1.51%
2014-03,המרכז,633,כפר ברא,יישוב,35,24,11,1,34,16,35,1,2.54%
2014-03,המרכז,168,כפר יונה,יישוב,329,152,177,59,270,63,325,6,3.00%
2014-03,המרכז,6900,כפר סבא,יישוב,1262,591,671,333,929,177,1241,15,2.34%
2014-03,המרכז,634,כפר קאסם,יישוב,247,120,127,5,242,134,241,6,2.73%
2014-03,המרכז,7000,לוד,יישוב,2160,1014,1146,150,2010,1204,2123,53,6.03%
2014-03,המרכז,28,מ.א. ברנר,מועצה איזורית,76,34,42,26,50,3,76,2,1.99%
2014-03,המרכז,32,מ.א. גדרות,מועצה איזורית,38,17,21,19,19,2,38,0,1.67%
2014-03,המרכז,30,מ.א. גזר,מועצה איזורית,289,125,164,83,206,29,282,0,2.22%
2014-03,המרכז,27,מ.א. גן רווה,מועצה איזורית,54,25,29,14,40,2,54,0,1.98%
2014-03,המרכז,20,מ.א. דרום השרון,מועצה איזורית,332,156,176,108,224,12,328,0,2.16%
2014-03,המרכז,29,מ.א. חבל יבנה,מועצה איזורית,36,15,21,8,28,2,36,0,1.50%
2014-03,המרכז,25,מ.א. חבל מודיעין,מועצה איזורית,268,117,151,55,213,22,265,0,2.54%
2014-03,המרכז,19,מ.א. חוף השרון,מועצה איזורית,105,42,63,43,62,4,105,0,1.92%
2014-03,המרכז,18,מ.א. לב השרון,מועצה איזורית,239,120,119,79,160,30,238,0,2.20%
2014-03,המרכז,31,מ.א. נחל שורק,מועצה איזורית,47,23,24,13,34,7,47,47,1.09%
2014-03,המרכז,16,מ.א. עמק חפר,מועצה איזורית,404,188,216,149,255,29,392,0,2.00%
2014-03,המרכז,40,מ.א. עמק לוד,מועצה איזורית,147,69,78,18,129,18,144,0,2.37%
2014-03,המרכז,1200,מודיעין-מכבים-רעות*,יישוב,980,418,562,309,671,58,956,20,2.22%
2014-03,המרכז,28,מזכרת בתיה,יישוב,152,70,82,31,121,31,149,2,2.13%
2014-03,המרכז,7200,נס ציונה,יישוב,716,320,396,152,564,218,706,8,3.02%
2014-03,המרכז,7400,נתניה,יישוב,4536,2108,2428,592,3944,1638,4422,123,4.22%
2014-03,המרכז,587,סביון*,יישוב,25,6,19,9,16,0,24,0,1.23%
2014-03,המרכז,171,פרדסייה,יישוב,78,39,39,8,70,9,77,1,2.14%
2014-03,המרכז,7900,פתח תקווה,יישוב,4140,1795,2345,827,3313,1082,4070,81,3.28%
2014-03,המרכז,195,קדימה-צורן,יישוב,237,111,126,68,169,39,234,0,2.22%
2014-03,המרכז,638,קלנסווה,יישוב,758,317,441,4,754,628,716,13,8.20%
2014-03,המרכז,469,קריית עקרון,יישוב,329,164,165,20,309,141,322,10,5.44%
2014-03,המרכז,2640,ראש העין,יישוב,754,379,375,72,682,173,738,13,3.19%
2014-03,המרכז,8300,ראשון לציון,יישוב,4411,1994,2417,688,3723,1383,4379,120,3.18%
2014-03,המרכז,8400,רחובות,יישוב,2615,1153,1462,495,2120,981,2542,63,3.76%
2014-03,המרכז,8500,רמלה,יישוב,1839,910,929,104,1735,754,1774,50,4.81%
2014-03,המרכז,8700,רעננה,יישוב,821,401,420,277,544,72,814,7,2.19%
2014-03,המרכז,1304,שוהם,יישוב,180,81,99,68,112,11,179,0,1.63%
2014-03,המרכז,154,תל מונד,יישוב,145,57,88,54,91,18,144,1,2.34%
2014-03,הצפון,473,אבו סנאן,יישוב,700,287,413,5,695,566,697,11,12.00%
2014-03,הצפון,478,אכסאל,יישוב,527,230,297,16,511,451,522,5,9.25%
2014-03,הצפון,529,אעבלין,יישוב,632,258,374,9,623,531,626,13,11.08%
2014-03,הצפון,482,בועיינה-נוג'ידאת,יישוב,457,185,272,5,452,344,449,8,11.54%
2014-03,הצפון,4001,בוקעאתא,יישוב,424,170,254,3,421,352,414,9,15.02%
2014-03,הצפון,998,ביר אל-מכסור,יישוב,442,175,267,2,440,336,440,8,11.92%
2014-03,הצפון,480,בית ג'ן,יישוב,442,134,308,12,430,316,424,3,8.00%
2014-03,הצפון,9200,בית שאן,יישוב,818,363,455,14,804,417,786,64,7.86%
2014-03,הצפון,944,בסמת טבעון,יישוב,224,113,111,5,219,155,220,0,6.86%
2014-03,הצפון,483,בענה,יישוב,395,159,236,5,390,330,394,9,11.81%
2014-03,הצפון,1292,ג'דיידה-מכר,יישוב,1468,635,833,8,1460,1236,1450,25,15.74%
2014-03,הצפון,485,ג'ולס,יישוב,254,73,181,0,254,158,254,20,8.67%
2014-03,הצפון,487,ג'ש (גוש חלב),יישוב,72,39,33,3,69,38,72,1,4.38%
2014-03,הצפון,489,דבורייה,יישוב,400,176,224,13,387,326,397,2,9.31%
2014-03,הצפון,490,דייר אל-אסד,יישוב,399,160,239,8,391,312,397,10,7.78%
2014-03,הצפון,492,דייר חנא,יישוב,672,310,362,12,660,496,670,2,13.79%
2014-03,הצפון,975,זרזיר,יישוב,304,144,160,2,302,215,291,10,9.44%
2014-03,הצפון,496,חורפיש,יישוב,111,43,68,6,105,64,108,2,4.08%
2014-03,הצפון,2034,חצור הגלילית,יישוב,346,158,188,13,333,151,322,16,6.76%
2014-03,הצפון,6700,טבריה,יישוב,1842,840,1002,62,1780,1129,1588,76,7.32%
2014-03,הצפון,962,טובא-זנגרייה,יישוב,377,182,195,3,374,251,366,1,12.05%
2014-03,הצפון,498,טורעאן,יישוב,552,197,355,9,543,468,533,10,9.37%
2014-03,הצפון,8900,טמרה,יישוב,2024,871,1153,13,2011,1787,1997,19,14.16%
2014-03,הצפון,1295,יאנוח-ג'ת,יישוב,166,61,105,3,163,100,163,5,5.82%
2014-03,הצפון,46,יבנאל,יישוב,165,110,55,8,157,125,139,2,8.78%
2014-03,הצפון,499,יפיע,יישוב,669,308,361,13,656,523,655,12,8.38%
2014-03,הצפון,240,יקנעם עילית,יישוב,549,233,316,56,493,164,539,30,4.64%
2014-03,הצפון,502,ירכא,יישוב,572,233,339,1,571,446,567,8,9.71%
2014-03,הצפון,504,כאבול,יישוב,699,294,405,11,688,606,691,5,14.10%
2014-03,הצפון,505,כאוכב אבו אל-היג'א,יישוב,219,98,121,4,215,190,219,1,12.75%
2014-03,הצפון,1296,כסרא-סמיע,יישוב,231,88,143,5,226,160,228,1,6.64%
2014-03,הצפון,978,כעביה-טבאש-חג'אג'רה,יישוב,229,102,127,6,223,146,224,4,9.74%
2014-03,הצפון,1263,כפר ורדים,יישוב,62,28,34,25,37,6,60,0,1.92%
2014-03,הצפון,507,כפר יאסיף,יישוב,490,209,281,5,485,391,481,8,9.28%
2014-03,הצפון,508,כפר כמא,יישוב,79,31,48,4,75,32,79,0,4.82%
2014-03,הצפון,509,כפר כנא,יישוב,1174,466,708,23,1151,1011,1126,18,12.72%
2014-03,הצפון,510,כפר מנדא,יישוב,1016,465,551,13,1003,714,999,4,13.54%
2014-03,הצפון,47,כפר תבור,יישוב,33,19,14,6,27,3,32,0,1.48%
2014-03,הצפון,1139,כרמיאל,יישוב,1754,715,1039,299,1455,838,1684,58,6.49%
2014-03,הצפון,65,מ.א. אל-בטוף,מועצה איזורית,409,143,266,5,404,340,394,2,14.74%
2014-03,הצפון,66,מ.א. בוסתן אל-מרג,מועצה איזורית,49,18,31,3,46,39,49,0,1.60%
2014-03,הצפון,71,מ.א. גולן,מועצה איזורית,204,94,110,19,185,22,203,1,2.48%
2014-03,הצפון,8,מ.א. הגלבוע,מועצה איזורית,825,348,477,47,778,531,808,0,5.78%
2014-03,הצפון,1,מ.א. הגליל העליון,מועצה איזורית,265,126,139,36,229,83,263,0,2.96%
2014-03,הצפון,3,מ.א. הגליל התחתון,מועצה איזורית,149,67,82,26,123,20,142,0,2.49%
2014-03,הצפון,55,מ.א. מבואות החרמון,מועצה איזורית,105,34,71,15,90,13,104,0,2.70%
2014-03,הצפון,13,מ.א. מגידו,מועצה איזורית,105,45,60,22,83,8,105,0,1.86%
2014-03,הצפון,4,מ.א. מטה אשר,מועצה איזורית,461,212,249,64,397,199,454,0,3.44%
2014-03,הצפון,52,מ.א. מעלה יוסף,מועצה איזורית,205,94,111,26,179,61,203,0,3.87%
2014-03,הצפון,2,מ.א. מרום הגליל,מועצה איזורית,327,155,172,11,316,145,318,0,4.91%
2014-03,הצפון,56,מ.א. משגב,מועצה איזורית,569,242,327,101,468,274,554,0,4.50%
2014-03,הצפון,6,מ.א. עמק הירדן,מועצה איזורית,176,83,93,15,161,41,155,0,2.33%
2014-03,הצפון,7,מ.א. עמק המעיינות,מועצה איזורית,168,76,92,15,153,49,163,0,2.63%
2014-03,הצפון,9,מ.א. עמק יזרעאל,מועצה איזורית,320,145,175,109,211,32,314,0,1.70%
2014-03,הצפון,481,מגאר,יישוב,1507,609,898,11,1496,1266,1487,8,15.85%
2014-03,הצפון,516,מג'ד אל-כרום,יישוב,556,252,304,5,551,439,549,18,8.49%
2014-03,הצפון,874,מגדל העמק,יישוב,1052,458,594,77,975,422,938,81,7.00%
2014-03,הצפון,4201,מג'דל שמס,יישוב,521,189,332,9,512,407,511,0,10.63%
2014-03,הצפון,517,מזרעה,יישוב,179,75,104,5,174,145,174,2,8.89%
2014-03,הצפון,4203,מסעדה,יישוב,218,81,137,3,215,175,213,5,12.67%
2014-03,הצפון,518,מעיליא,יישוב,67,34,33,7,60,32,66,2,4.00%
2014-03,הצפון,1063,מעלות-תרשיחא,יישוב,919,442,477,87,832,510,899,45,7.48%
2014-03,הצפון,520,משהד,יישוב,277,104,173,6,271,243,273,2,8.56%
2014-03,הצפון,9100,נהרייה,יישוב,2044,958,1086,189,1855,1211,1993,81,6.43%
2014-03,הצפון,522,נחף,יישוב,410,189,221,8,402,322,405,11,8.18%
2014-03,הצפון,7300,נצרת,יישוב,3310,1439,1871,82,3228,2602,3239,61,9.34%
2014-03,הצפון,1061,נצרת עילית,יישוב,1828,825,1003,146,1682,1026,1656,112,7.00%
2014-03,הצפון,525,סאג'ור,יישוב,144,50,94,5,139,86,140,1,7.78%
2014-03,הצפון,7500,סח'נין,יישוב,2109,933,1176,16,2093,1783,2102,18,15.10%
2014-03,הצפון,4501,ע'ג'ר,יישוב,100,49,51,0,100,70,100,0,9.64%
2014-03,הצפון,530,עיילבון,יישוב,221,88,133,2,219,154,217,2,7.87%
2014-03,הצפון,511,עילוט,יישוב,322,130,192,2,320,261,320,2,11.38%
2014-03,הצפון,532,עין מאהל,יישוב,601,275,326,10,591,492,579,3,10.95%
2014-03,הצפון,7600,עכו,יישוב,3256,1471,1785,123,3133,2451,3163,68,11.85%
2014-03,הצפון,7700,עפולה,יישוב,1786,770,1016,140,1646,844,1704,88,6.84%
2014-03,הצפון,531,עראבה,יישוב,1567,665,902,26,1541,1325,1554,15,15.40%
2014-03,הצפון,535,פסוטה,יישוב,121,57,64,8,113,81,121,0,7.06%
2014-03,הצפון,536,פקיעין (בוקייעה),יישוב,136,75,61,5,131,87,133,1,4.86%
2014-03,הצפון,8000,צפת,יישוב,1460,809,651,63,1397,1120,1390,26,10.35%
2014-03,הצפון,4100,קצרין,יישוב,214,94,120,14,200,91,210,6,5.31%
2014-03,הצפון,2800,קריית שמונה,יישוב,882,390,492,39,843,390,844,40,6.46%
2014-03,הצפון,543,ראמה,יישוב,336,127,209,10,326,249,328,3,8.39%
2014-03,הצפון,26,ראש פינה,יישוב,59,22,37,11,48,20,57,2,3.59%
2014-03,הצפון,542,ריינה,יישוב,684,289,395,11,673,548,664,8,9.75%
2014-03,הצפון,122,רמת ישי,יישוב,104,37,67,32,72,13,97,1,2.35%
2014-03,הצפון,913,שבלי - אום אל-גנם,יישוב,260,122,138,7,253,164,256,1,9.80%
2014-03,הצפון,812,שלומי,יישוב,252,112,140,12,240,142,248,11,6.88%
2014-03,הצפון,538,שעב,יישוב,559,232,327,1,558,486,554,7,17.94%
2014-03,הצפון,8800,שפרעם,יישוב,2135,823,1312,35,2100,1764,2110,40,11.87%
2014-03,חיפה,2710,אום אל-פחם,יישוב,3847,1597,2250,19,3828,3322,3767,25,17.84%
2014-03,חיפה,1020,אור עקיבא,יישוב,624,268,356,34,590,219,601,25,5.98%
2014-03,חיפה,6000,באקה אל-גרביה,יישוב,764,359,405,7,757,495,754,19,6.48%
2014-03,חיפה,9800,בנימינה-גבעת עדה*,יישוב,244,98,146,57,187,68,243,3,3.43%
2014-03,חיפה,1326,"בסמ""ה",יישוב,434,185,249,2,432,357,426,2,10.69%
2014-03,חיפה,541,ג'סר א-זרקא,יישוב,452,252,200,1,451,315,448,3,7.66%
2014-03,חיפה,628,ג'ת,יישוב,287,143,144,14,273,172,281,10,5.36%
2014-03,חיפה,494,דאלית אל-כרמל,יישוב,539,233,306,11,528,312,524,5,6.67%
2014-03,חיפה,9300,זכרון יעקב,יישוב,255,115,140,57,198,60,253,0,2.34%
2014-03,חיפה,6500,חדרה,יישוב,2458,1044,1414,269,2189,986,2353,73,4.77%
2014-03,חיפה,4000,חיפה,יישוב,6735,3253,3482,1095,5640,3588,6486,160,4.57%
2014-03,חיפה,1247,חריש,יישוב,22,12,10,5,17,8,21,1,1.43%
2014-03,חיפה,2100,טירת כרמל,יישוב,740,367,373,17,723,439,732,28,6.84%
2014-03,חיפה,654,כפר קרע,יישוב,459,199,260,6,453,276,450,6,5.39%
2014-03,חיפה,45,מ.א. אלונה,מועצה איזורית,40,17,23,13,27,3,40,0,3.89%
2014-03,חיפה,12,מ.א. זבולון,מועצה איזורית,297,143,154,26,271,193,292,0,5.36%
2014-03,חיפה,15,מ.א. חוף הכרמל,מועצה איזורית,308,139,169,56,252,63,304,0,2.24%
2014-03,חיפה,14,מ.א. מנשה,מועצה איזורית,244,115,129,53,191,78,241,0,3.09%
2014-03,חיפה,1327,מעלה עירון,יישוב,959,373,586,4,955,808,948,7,16.08%
2014-03,חיפה,2500,נשר,יישוב,455,226,229,79,376,184,447,6,3.52%
2014-03,חיפה,534,עספיא,יישוב,340,152,188,7,333,184,329,5,6.00%
2014-03,חיפה,637,ערערה,יישוב,612,227,385,6,606,418,592,29,7.33%
2014-03,חיפה,537,פוריידיס,יישוב,416,224,192,5,411,277,411,0,7.41%
2014-03,חיפה,7800,פרדס חנה-כרכור,יישוב,877,399,478,108,769,293,864,30,4.32%
2014-03,חיפה,6800,קריית אתא,יישוב,1680,781,899,147,1533,940,1650,48,5.53%
2014-03,חיפה,9500,קריית ביאליק,יישוב,1144,501,643,139,1005,563,1130,21,5.26%
2014-03,חיפה,2300,קריית טבעון,יישוב,186,97,89,61,125,43,183,1,2.15%
2014-03,חיפה,9600,קריית ים,יישוב,1609,744,865,140,1469,937,1575,58,7.35%
2014-03,חיפה,8200,קריית מוצקין,יישוב,1114,492,622,151,963,518,1093,36,4.78%
2014-03,חיפה,922,רכסים,יישוב,146,66,80,8,138,84,132,6,3.87%
2014-03,ירושלים,472,אבו גוש,יישוב,270,133,137,7,263,194,269,1,8.77%
2014-03,ירושלים,2610,בית שמש,יישוב,1284,571,713,102,1182,514,1242,36,3.92%
2014-03,ירושלים,3000,ירושלים,יישוב,12192,5638,6554,1310,10882,7440,11971,172,4.03%
2014-03,ירושלים,26,מ.א. מטה יהודה,מועצה איזורית,583,281,302,107,476,135,573,2,2.49%
2014-03,ירושלים,1015,מבשרת ציון,יישוב,385,189,196,71,314,154,377,6,2.83%
2014-03,ירושלים,1137,קריית יערים,יישוב,37,18,19,8,29,19,36,0,2.75%
2014-03,תל אביב,2400,אור יהודה,יישוב,810,392,418,25,785,249,778,24,4.14%
2014-03,תל אביב,565,אזור,יישוב,193,101,92,24,169,32,190,2,2.96%
2014-03,תל אביב,6100,בני ברק,יישוב,2279,1133,1145,73,2206,1285,2184,36,3.92%
2014-03,תל אביב,6200,בת ים,יישוב,3211,1492,1719,362,2849,1230,3093,119,4.35%
2014-03,תל אביב,6300,גבעתיים,יישוב,720,318,402,268,452,99,708,9,2.34%
2014-03,תל אביב,6400,הרצלייה,יישוב,1068,455,613,202,866,40,1041,30,2.15%
2014-03,תל אביב,6600,חולון,יישוב,3172,1478,1694,391,2781,851,3097,57,3.12%
2014-03,תל אביב,2620,קריית אונו,יישוב,415,192,223,107,308,48,408,2,2.17%
2014-03,תל אביב,8600,רמת גן,יישוב,2145,974,1171,563,1582,443,2102,29,2.69%
2014-03,תל אביב,2650,רמת השרון,יישוב,385,164,221,101,284,10,381,4,1.70%
2014-03,תל אביב,5000,תל אביב -יפו,יישוב,7750,3791,3959,2126,5624,2371,7613,119,3.02%
2014-04,אזור יהודה והשומרון,3760,אורנית,יישוב,113,48,65,44,69,2,110,0,2.35%
2014-04,אזור יהודה והשומרון,3750,אלפי מנשה,יישוב,83,40,43,14,69,0,83,0,1.96%
2014-04,אזור יהודה והשומרון,3560,אלקנה,יישוב,32,15,17,12,20,2,32,0,1.69%
2014-04,אזור יהודה והשומרון,3650,אפרת,יישוב,57,32,25,18,39,4,56,1,1.37%
2014-04,אזור יהודה והשומרון,3570,אריאל,יישוב,350,166,184,47,303,85,339,10,3.23%
2014-04,אזור יהודה והשומרון,3574,בית אל,יישוב,51,20,31,13,38,16,51,2,2.08%
2014-04,אזור יהודה והשומרון,3652,בית אריה,יישוב,58,26,32,12,46,5,58,1,2.27%
2014-04,אזור יהודה והשומרון,3780,ביתר עילית,יישוב,476,229,247,7,469,212,467,7,3.85%
2014-04,אזור יהודה והשומרון,3730,גבעת זאב,יישוב,172,78,94,39,133,39,170,2,2.26%
2014-04,אזור יהודה והשומרון,3769,הר אדר,יישוב,33,14,19,8,25,4,32,0,1.55%
2014-04,אזור יהודה והשומרון,76,מ.א. גוש עציון,מועצה איזורית,165,78,87,42,123,16,164,0,1.77%
2014-04,אזור יהודה והשומרון,78,מ.א. הר חברון,מועצה איזורית,57,27,30,13,44,5,57,0,1.77%
2014-04,אזור יהודה והשומרון,74,מ.א. מגילות ים המלח,מועצה איזורית,12,3,9,3,9,1,12,0,1.58%
2014-04,אזור יהודה והשומרון,73,מ.א. מטה בנימין,מועצה איזורית,606,288,318,147,459,145,596,0,2.50%
2014-04,אזור יהודה והשומרון,75,מ.א. ערבות הירדן,מועצה איזורית,45,21,24,8,37,3,45,0,1.93%
2014-04,אזור יהודה והשומרון,72,מ.א. שומרון,מועצה איזורית,382,200,182,72,310,56,377,0,2.39%
2014-04,אזור יהודה והשומרון,3797,מודיעין עילית,יישוב,376,139,237,21,355,84,365,4,2.81%
2014-04,אזור יהודה והשומרון,3616,מעלה אדומים,יישוב,599,241,358,49,550,213,589,12,2.90%
2014-04,אזור יהודה והשומרון,3660,עמנואל,יישוב,79,50,29,1,78,53,77,1,6.79%
2014-04,אזור יהודה והשומרון,3557,קדומים,יישוב,29,11,18,10,19,8,29,0,1.56%
2014-04,אזור יהודה והשומרון,3611,קריית ארבע,יישוב,111,59,52,11,100,65,108,1,3.40%
2014-04,אזור יהודה והשומרון,3640,קרני שומרון,יישוב,79,36,43,23,56,9,78,0,2.14%
2014-04,הדרום,31,אופקים,יישוב,1167,517,650,69,1098,781,1144,33,8.98%
2014-04,הדרום,2600,אילת,יישוב,1301,613,688,35,1266,540,1276,32,3.84%
2014-04,הדרום,70,אשדוד,יישוב,6414,2673,3741,686,5728,3333,6265,151,5.78%
2014-04,הדרום,7100,אשקלון,יישוב,4142,1757,2385,281,3861,2238,3817,89,5.55%
2014-04,הדרום,9000,באר שבע,יישוב,6869,3142,3727,704,6165,4184,6641,117,6.40%
2014-04,הדרום,2200,דימונה,יישוב,2051,927,1124,108,1943,1365,1985,25,10.81%
2014-04,הדרום,1303,חורה,יישוב,838,358,480,2,836,757,825,3,20.25%
2014-04,הדרום,831,ירוחם,יישוב,458,222,236,14,444,269,438,15,9.57%
2014-04,הדרום,1059,כסיפה,יישוב,1038,405,633,0,1038,933,1028,1,22.02%
2014-04,הדרום,1271,להבים,יישוב,36,18,18,17,19,3,36,0,1.04%
2014-04,הדרום,1060,לקיה,יישוב,990,432,558,3,987,929,982,2,23.06%
2014-04,הדרום,69,מ.א. אל קסום,מועצה איזורית,787,332,455,2,785,721,778,0,60.36%
2014-04,הדרום,38,מ.א. אשכול,מועצה איזורית,106,46,60,10,96,18,106,0,1.60%
2014-04,הדרום,33,מ.א. באר טוביה,מועצה איזורית,243,103,140,34,209,51,243,0,2.35%
2014-04,הדרום,41,מ.א. בני שמעון,מועצה איזורית,67,26,41,18,49,16,66,0,1.64%
2014-04,הדרום,54,מ.א. הערבה התיכונה,מועצה איזורית,23,11,12,5,18,1,23,0,1.28%
2014-04,הדרום,53,מ.א. חבל אילות,מועצה איזורית,20,12,8,1,19,1,20,0,0.94%
2014-04,הדרום,36,מ.א. חוף אשקלון,מועצה איזורית,227,97,130,16,211,69,210,0,2.69%
2014-04,הדרום,35,מ.א. יואב,מועצה איזורית,109,47,62,25,84,19,108,0,2.82%
2014-04,הדרום,50,מ.א. לכיש,מועצה איזורית,142,68,74,8,134,58,141,0,2.98%
2014-04,הדרום,42,מ.א. מרחבים,מועצה איזורית,182,73,109,18,164,41,180,0,3.38%
2014-04,הדרום,68,מ.א. נווה מדבר,מועצה איזורית,111,44,67,0,111,90,111,0,17.87%
2014-04,הדרום,48,מ.א. רמת נגב,מועצה איזורית,191,98,93,10,181,156,189,2,6.58%
2014-04,הדרום,39,מ.א. שדות נגב,מועצה איזורית,114,48,66,15,99,31,108,0,2.59%
2014-04,הדרום,37,מ.א. שער הנגב,מועצה איזורית,157,88,69,27,130,84,154,0,4.15%
2014-04,הדרום,34,מ.א. שפיר,מועצה איזורית,183,92,91,10,173,80,182,0,4.01%
2014-04,הדרום,51,מ.א. תמר,מועצה איזורית,4,2,2,0,4,0,4,0,0.64%
2014-04,הדרום,1268,מיתר,יישוב,55,25,30,12,43,6,53,0,1.25%
2014-04,הדרום,99,מצפה רמון,יישוב,236,89,147,12,224,161,225,4,9.24%
2014-04,הדרום,246,נתיבות,יישוב,982,445,537,38,944,522,949,22,6.84%
2014-04,הדרום,666,עומר,יישוב,52,22,30,16,36,6,52,0,1.29%
2014-04,הדרום,2560,ערד,יישוב,835,380,455,94,741,417,800,23,6.50%
2014-04,הדרום,1192,ערערה-בנגב,יישוב,1011,426,585,4,1007,921,1004,1,24.13%
2014-04,הדרום,2630,קריית גת,יישוב,2067,851,1216,117,1950,1245,2022,45,7.13%
2014-04,הדרום,1034,קריית מלאכי,יישוב,1185,531,654,25,1160,705,1144,52,9.79%
2014-04,הדרום,1161,רהט,יישוב,3284,1364,1920,6,3278,2784,3253,26,17.05%
2014-04,הדרום,1286,שגב-שלום,יישוב,560,208,352,3,557,496,556,1,20.72%
2014-04,הדרום,1031,שדרות,יישוב,1078,487,591,43,1035,652,1045,13,8.18%
2014-04,הדרום,1054,תל שבע,יישוב,1214,583,631,3,1211,1127,1204,3,24.31%
2014-04,המרכז,182,אבן יהודה,יישוב,164,80,84,61,103,17,161,2,2.40%
2014-04,המרכז,41,אליכין,יישוב,62,28,34,6,56,22,57,0,3.05%
2014-04,המרכז,1309,אלעד,יישוב,392,199,193,18,374,92,384,3,3.08%
2014-04,המרכז,2530,באר יעקב,יישוב,265,113,152,42,223,58,263,0,2.90%
2014-04,המרכז,466,בית דגן,יישוב,106,63,43,11,95,38,105,2,2.94%
2014-04,המרכז,1066,"בני עי""ש",יישוב,182,92,90,27,155,66,181,3,4.57%
2014-04,המרכז,681,גבעת שמואל,יישוב,292,140,152,73,219,68,286,1,2.39%
2014-04,המרכז,2550,גדרה,יישוב,369,146,223,70,299,113,362,4,3.11%
2014-04,המרכז,627,ג'לג'וליה,יישוב,85,36,49,2,83,47,81,2,2.24%
2014-04,המרכז,166,גן יבנה,יישוב,321,122,199,37,284,85,317,7,2.79%
2014-04,המרכז,229,גני תקווה,יישוב,193,80,113,58,135,24,192,0,2.31%
2014-04,המרכז,9700,הוד השרון,יישוב,632,288,344,199,433,59,624,10,2.11%
2014-04,המרכז,1290,זמר,יישוב,177,61,116,3,174,128,174,2,5.90%
2014-04,המרכז,2730,טייבה,יישוב,1815,791,1024,8,1807,1568,1694,33,9.68%
2014-04,המרכז,2720,טירה,יישוב,322,152,170,8,314,166,313,9,2.76%
2014-04,המרכז,2660,יבנה,יישוב,875,411,464,97,778,346,861,16,3.71%
2014-04,המרכז,9400,יהוד,יישוב,513,221,292,85,428,73,494,8,3.11%
2014-04,המרכז,1224,כוכב יאיר,יישוב,76,26,50,40,36,1,76,0,1.35%
2014-04,המרכז,633,כפר ברא,יישוב,28,16,12,1,27,16,28,1,2.04%
2014-04,המרכז,168,כפר יונה,יישוב,322,152,170,62,260,65,319,1,2.95%
2014-04,המרכז,6900,כפר סבא,יישוב,1215,570,645,335,880,173,1196,5,2.26%
2014-04,המרכז,634,כפר קאסם,יישוב,229,111,118,4,225,125,225,8,2.56%
2014-04,המרכז,7000,לוד,יישוב,2118,994,1124,151,1967,1199,2082,39,5.92%
2014-04,המרכז,28,מ.א. ברנר,מועצה איזורית,73,35,38,31,42,3,73,4,1.91%
2014-04,המרכז,32,מ.א. גדרות,מועצה איזורית,36,15,21,19,17,2,36,0,1.58%
2014-04,המרכז,30,מ.א. גזר,מועצה איזורית,265,115,150,74,191,28,263,0,2.07%
2014-04,המרכז,27,מ.א. גן רווה,מועצה איזורית,59,29,30,18,41,2,59,0,2.16%
2014-04,המרכז,20,מ.א. דרום השרון,מועצה איזורית,322,148,174,111,211,12,318,0,2.09%
2014-04,המרכז,29,מ.א. חבל יבנה,מועצה איזורית,32,16,16,7,25,2,31,1,1.29%
2014-04,המרכז,25,מ.א. חבל מודיעין,מועצה איזורית,268,123,145,56,212,25,264,0,2.53%
2014-04,המרכז,19,מ.א. חוף השרון,מועצה איזורית,108,44,64,42,66,4,108,0,1.98%
2014-04,המרכז,18,מ.א. לב השרון,מועצה איזורית,207,108,99,67,140,28,206,0,1.90%
2014-04,המרכז,31,מ.א. נחל שורק,מועצה איזורית,38,23,15,9,29,9,37,33,0.87%
2014-04,המרכז,16,מ.א. עמק חפר,מועצה איזורית,376,160,216,142,234,32,369,0,1.89%
2014-04,המרכז,40,מ.א. עמק לוד,מועצה איזורית,149,69,80,19,130,22,147,0,2.42%
2014-04,המרכז,1200,מודיעין-מכבים-רעות*,יישוב,923,397,526,298,625,62,903,21,2.09%
2014-04,המרכז,28,מזכרת בתיה,יישוב,155,74,81,34,121,34,152,4,2.17%
2014-04,המרכז,7200,נס ציונה,יישוב,691,323,368,152,539,203,685,5,2.93%
2014-04,המרכז,7400,נתניה,יישוב,4239,1939,2300,530,3709,1608,4144,98,3.97%
2014-04,המרכז,587,סביון*,יישוב,21,8,13,8,13,0,21,0,1.08%
2014-04,המרכז,171,פרדסייה,יישוב,72,33,39,11,61,10,72,0,2.00%
2014-04,המרכז,7900,פתח תקווה,יישוב,3892,1715,2177,799,3093,1041,3838,46,3.10%
2014-04,המרכז,195,קדימה-צורן,יישוב,231,112,119,63,168,39,229,2,2.17%
2014-04,המרכז,638,קלנסווה,יישוב,727,304,423,3,724,596,684,9,7.86%
2014-04,המרכז,469,קריית עקרון,יישוב,321,164,157,20,301,142,316,10,5.34%
2014-04,המרכז,2640,ראש העין,יישוב,715,355,360,57,658,171,703,10,3.05%
2014-04,המרכז,8300,ראשון לציון,יישוב,4204,1913,2291,648,3556,1347,4179,78,3.04%
2014-04,המרכז,8400,רחובות,יישוב,2486,1108,1378,463,2023,962,2419,25,3.59%
2014-04,המרכז,8500,רמלה,יישוב,1663,784,879,90,1573,726,1611,43,4.39%
2014-04,המרכז,8700,רעננה,יישוב,792,389,403,265,527,72,786,8,2.12%
2014-04,המרכז,1304,שוהם,יישוב,168,74,94,68,100,11,167,1,1.52%
2014-04,המרכז,154,תל מונד,יישוב,134,57,77,48,86,17,133,0,2.16%
2014-04,הצפון,473,אבו סנאן,יישוב,688,283,405,6,682,559,685,10,11.82%
2014-04,הצפון,478,אכסאל,יישוב,510,225,285,14,496,449,503,1,8.95%
2014-04,הצפון,529,אעבלין,יישוב,608,240,368,9,599,513,605,2,10.75%
2014-04,הצפון,482,בועיינה-נוג'ידאת,יישוב,438,172,266,5,433,336,431,4,11.13%
2014-04,הצפון,4001,בוקעאתא,יישוב,432,173,259,2,430,359,417,2,15.11%
2014-04,הצפון,998,ביר אל-מכסור,יישוב,437,179,258,1,436,330,435,3,11.80%
2014-04,הצפון,480,בית ג'ן,יישוב,412,125,287,13,399,299,401,1,7.60%
2014-04,הצפון,9200,בית שאן,יישוב,787,359,428,13,774,405,764,52,7.66%
2014-04,הצפון,944,בסמת טבעון,יישוב,221,110,111,4,217,158,218,5,6.80%
2014-04,הצפון,483,בענה,יישוב,365,147,218,3,362,307,364,12,11.01%
2014-04,הצפון,1292,ג'דיידה-מכר,יישוב,1413,605,808,8,1405,1174,1398,23,15.27%
2014-04,הצפון,485,ג'ולס,יישוב,235,69,166,0,235,156,235,2,8.08%
2014-04,הצפון,487,ג'ש (גוש חלב),יישוב,67,34,33,2,65,37,67,3,4.09%
2014-04,הצפון,489,דבורייה,יישוב,388,167,221,13,375,312,385,2,9.06%
2014-04,הצפון,490,דייר אל-אסד,יישוב,377,154,223,4,373,295,375,11,7.38%
2014-04,הצפון,492,דייר חנא,יישוב,677,309,368,11,666,503,675,1,13.87%
2014-04,הצפון,975,זרזיר,יישוב,291,137,154,2,289,206,282,10,9.18%
2014-04,הצפון,496,חורפיש,יישוב,98,36,62,7,91,64,95,0,3.61%
2014-04,הצפון,2034,חצור הגלילית,יישוב,293,138,155,14,279,135,274,5,5.81%
2014-04,הצפון,6700,טבריה,יישוב,1694,783,911,67,1627,1072,1473,47,6.83%
2014-04,הצפון,962,טובא-זנגרייה,יישוב,363,173,190,3,360,246,352,1,11.64%
2014-04,הצפון,498,טורעאן,יישוב,508,183,325,5,503,436,493,4,8.73%
2014-04,הצפון,8900,טמרה,יישוב,1997,858,1139,14,1983,1777,1973,15,14.02%
2014-04,הצפון,1295,יאנוח-ג'ת,יישוב,155,57,98,3,152,97,154,3,5.52%
2014-04,הצפון,46,יבנאל,יישוב,157,102,55,7,150,127,131,1,8.31%
2014-04,הצפון,499,יפיע,יישוב,647,290,357,13,634,516,636,6,8.16%
2014-04,הצפון,240,יקנעם עילית,יישוב,512,216,296,52,460,158,505,22,4.36%
2014-04,הצפון,502,ירכא,יישוב,563,232,331,0,563,434,558,4,9.57%
2014-04,הצפון,504,כאבול,יישוב,681,278,403,8,673,600,676,7,13.84%
2014-04,הצפון,505,כאוכב אבו אל-היג'א,יישוב,220,102,118,4,216,188,216,4,12.59%
2014-04,הצפון,1296,כסרא-סמיע,יישוב,201,76,125,3,198,142,199,3,5.84%
2014-04,הצפון,978,כעביה-טבאש-חג'אג'רה,יישוב,214,92,122,4,210,150,206,2,9.03%
2014-04,הצפון,1263,כפר ורדים,יישוב,62,35,27,27,35,4,61,0,1.96%
2014-04,הצפון,507,כפר יאסיף,יישוב,482,207,275,4,478,375,472,5,9.13%
2014-04,הצפון,508,כפר כמא,יישוב,74,31,43,3,71,30,71,0,4.36%
2014-04,הצפון,509,כפר כנא,יישוב,1127,444,683,21,1106,975,1094,16,12.41%
2014-04,הצפון,510,כפר מנדא,יישוב,990,455,535,12,978,699,972,11,13.22%
2014-04,הצפון,47,כפר תבור,יישוב,35,22,13,6,29,3,33,1,1.53%
2014-04,הצפון,1139,כרמיאל,יישוב,1665,680,985,272,1393,814,1599,44,6.19%
2014-04,הצפון,65,מ.א. אל-בטוף,מועצה איזורית,386,136,250,5,381,314,378,0,14.16%
2014-04,הצפון,66,מ.א. בוסתן אל-מרג,מועצה איזורית,49,17,32,3,46,40,49,0,1.60%
2014-04,הצפון,71,מ.א. גולן,מועצה איזורית,178,84,94,17,161,18,178,0,2.17%
2014-04,הצפון,8,מ.א. הגלבוע,מועצה איזורית,824,352,472,43,781,522,808,0,5.78%
2014-04,הצפון,1,מ.א. הגליל העליון,מועצה איזורית,249,111,138,32,217,79,248,0,2.79%
2014-04,הצפון,3,מ.א. הגליל התחתון,מועצה איזורית,128,66,62,20,108,17,121,0,2.12%
2014-04,הצפון,55,מ.א. מבואות החרמון,מועצה איזורית,101,39,62,14,87,11,100,1,2.60%
2014-04,הצפון,13,מ.א. מגידו,מועצה איזורית,100,45,55,17,83,8,100,0,1.77%
2014-04,הצפון,4,מ.א. מטה אשר,מועצה איזורית,448,203,245,61,387,202,442,0,3.35%
2014-04,הצפון,52,מ.א. מעלה יוסף,מועצה איזורית,194,87,107,25,169,55,191,0,3.64%
2014-04,הצפון,2,מ.א. מרום הגליל,מועצה איזורית,293,144,149,7,286,138,286,0,4.41%
2014-04,הצפון,56,מ.א. משגב,מועצה איזורית,513,211,302,84,429,264,502,0,4.08%
2014-04,הצפון,6,מ.א. עמק הירדן,מועצה איזורית,168,80,88,20,148,33,151,0,2.27%
2014-04,הצפון,7,מ.א. עמק המעיינות,מועצה איזורית,168,74,94,16,152,41,165,0,2.67%
2014-04,הצפון,9,מ.א. עמק יזרעאל,מועצה איזורית,314,140,174,110,204,32,311,0,1.68%
2014-04,הצפון,481,מגאר,יישוב,1552,614,938,10,1542,1321,1519,8,16.13%
2014-04,הצפון,516,מג'ד אל-כרום,יישוב,524,238,286,5,519,416,520,15,8.07%
2014-04,הצפון,874,מגדל העמק,יישוב,930,406,524,71,859,407,837,67,6.29%
2014-04,הצפון,4201,מג'דל שמס,יישוב,510,183,327,9,501,403,499,2,10.41%
2014-04,הצפון,517,מזרעה,יישוב,171,68,103,3,168,141,169,6,8.65%
2014-04,הצפון,4203,מסעדה,יישוב,214,76,138,3,211,174,208,5,12.41%
2014-04,הצפון,518,מעיליא,יישוב,57,30,27,5,52,28,55,1,3.36%
2014-04,הצפון,1063,מעלות-תרשיחא,יישוב,869,419,450,89,780,491,856,22,7.15%
2014-04,הצפון,520,משהד,יישוב,281,103,178,5,276,233,269,3,8.44%
2014-04,הצפון,9100,נהרייה,יישוב,1954,903,1051,186,1768,1184,1905,71,6.16%
2014-04,הצפון,522,נחף,יישוב,397,186,211,10,387,312,394,10,7.98%
2014-04,הצפון,7300,נצרת,יישוב,3212,1402,1810,78,3134,2557,3135,18,9.07%
2014-04,הצפון,1061,נצרת עילית,יישוב,1707,792,915,143,1564,1001,1548,64,6.58%
2014-04,הצפון,525,סאג'ור,יישוב,142,50,92,3,139,86,140,4,7.78%
2014-04,הצפון,7500,סח'נין,יישוב,2057,903,1154,14,2043,1752,2051,15,14.79%
2014-04,הצפון,4501,ע'ג'ר,יישוב,98,45,53,0,98,73,97,1,9.38%
2014-04,הצפון,530,עיילבון,יישוב,212,83,129,2,210,153,210,4,7.64%
2014-04,הצפון,511,עילוט,יישוב,316,126,190,1,315,257,313,2,11.16%
2014-04,הצפון,532,עין מאהל,יישוב,574,266,308,9,565,476,554,6,10.53%
2014-04,הצפון,7600,עכו,יישוב,3158,1437,1721,127,3031,2394,3073,38,11.55%
2014-04,הצפון,7700,עפולה,יישוב,1673,697,976,126,1547,821,1604,63,6.46%
2014-04,הצפון,531,עראבה,יישוב,1534,641,893,23,1511,1311,1522,14,15.13%
2014-04,הצפון,535,פסוטה,יישוב,122,53,69,8,114,83,122,6,7.11%
2014-04,הצפון,536,פקיעין (בוקייעה),יישוב,124,65,59,4,120,85,120,1,4.40%
2014-04,הצפון,8000,צפת,יישוב,1387,768,619,61,1326,1087,1326,13,9.92%
2014-04,הצפון,4100,קצרין,יישוב,210,91,119,13,197,91,206,4,5.22%
2014-04,הצפון,2800,קריית שמונה,יישוב,829,373,456,37,792,372,798,43,6.13%
2014-04,הצפון,543,ראמה,יישוב,341,136,205,7,334,248,333,5,8.51%
2014-04,הצפון,26,ראש פינה,יישוב,55,21,34,8,47,20,54,0,3.41%
2014-04,הצפון,542,ריינה,יישוב,653,277,376,6,647,527,641,4,9.44%
2014-04,הצפון,122,רמת ישי,יישוב,96,35,61,28,68,11,90,3,2.18%
2014-04,הצפון,913,שבלי - אום אל-גנם,יישוב,238,109,129,7,231,158,235,2,9.07%
2014-04,הצפון,812,שלומי,יישוב,243,105,138,14,229,135,238,12,6.62%
2014-04,הצפון,538,שעב,יישוב,545,220,325,1,544,477,543,3,17.65%
2014-04,הצפון,8800,שפרעם,יישוב,2085,810,1275,30,2055,1736,2056,24,11.60%
2014-04,חיפה,2710,אום אל-פחם,יישוב,3810,1555,2255,19,3791,3297,3734,21,17.71%
2014-04,חיפה,1020,אור עקיבא,יישוב,603,254,349,35,568,211,580,12,5.78%
2014-04,חיפה,6000,באקה אל-גרביה,יישוב,732,330,402,5,727,483,727,11,6.26%
2014-04,חיפה,9800,בנימינה-גבעת עדה*,יישוב,212,86,126,54,158,67,211,1,2.99%
2014-04,חיפה,1326,"בסמ""ה",יישוב,437,189,248,2,435,352,432,0,10.82%
2014-04,חיפה,541,ג'סר א-זרקא,יישוב,459,254,205,1,458,322,456,3,7.79%
2014-04,חיפה,628,ג'ת,יישוב,270,129,141,11,259,169,266,8,5.08%
2014-04,חיפה,494,דאלית אל-כרמל,יישוב,519,223,296,10,509,306,502,2,6.41%
2014-04,חיפה,9300,זכרון יעקב,יישוב,232,104,128,52,180,54,231,1,2.14%
2014-04,חיפה,6500,חדרה,יישוב,2392,1006,1386,267,2125,962,2301,57,4.67%
2014-04,חיפה,4000,חיפה,יישוב,6368,3067,3301,1051,5317,3485,6149,113,4.34%
2014-04,חיפה,1247,חריש,יישוב,17,9,8,3,14,4,16,0,1.10%
2014-04,חיפה,2100,טירת כרמל,יישוב,709,339,370,14,695,422,695,14,6.51%
2014-04,חיפה,654,כפר קרע,יישוב,449,189,260,7,442,267,439,4,5.27%
2014-04,חיפה,45,מ.א. אלונה,מועצה איזורית,39,17,22,14,25,4,39,0,3.79%
2014-04,חיפה,12,מ.א. זבולון,מועצה איזורית,280,132,148,22,258,189,276,0,5.07%
2014-04,חיפה,15,מ.א. חוף הכרמל,מועצה איזורית,294,136,158,52,242,62,291,0,2.15%
2014-04,חיפה,14,מ.א. מנשה,מועצה איזורית,243,115,128,51,192,76,242,0,3.10%
2014-04,חיפה,1327,מעלה עירון,יישוב,937,357,580,6,931,793,927,4,15.78%
2014-04,חיפה,2500,נשר,יישוב,436,217,219,77,359,174,428,3,3.37%
2014-04,חיפה,534,עספיא,יישוב,319,136,183,9,310,178,305,7,5.59%
2014-04,חיפה,637,ערערה,יישוב,607,228,379,5,602,422,587,11,7.27%
2014-04,חיפה,537,פוריידיס,יישוב,421,222,199,3,418,277,416,0,7.49%
2014-04,חיפה,7800,פרדס חנה-כרכור,יישוב,832,363,469,121,711,278,826,18,4.14%
2014-04,חיפה,6800,קריית אתא,יישוב,1624,728,896,128,1496,939,1592,25,5.35%
2014-04,חיפה,9500,קריית ביאליק,יישוב,1046,460,586,134,912,540,1031,19,4.82%
2014-04,חיפה,2300,קריית טבעון,יישוב,179,88,91,57,122,41,176,3,2.07%
2014-04,חיפה,9600,קריית ים,יישוב,1524,698,826,132,1392,903,1498,40,7.02%
2014-04,חיפה,8200,קריית מוצקין,יישוב,1057,459,598,143,914,516,1044,20,4.57%
2014-04,חיפה,922,רכסים,יישוב,136,63,73,8,128,78,130,1,3.82%
2014-04,ירושלים,472,אבו גוש,יישוב,256,125,131,5,251,182,256,4,8.39%
2014-04,ירושלים,2610,בית שמש,יישוב,1260,588,672,91,1169,512,1206,29,3.82%
2014-04,ירושלים,3000,ירושלים,יישוב,11642,5317,6325,1184,10458,7295,11455,143,3.86%
2014-04,ירושלים,26,מ.א. מטה יהודה,מועצה איזורית,549,260,289,108,441,128,543,0,2.36%
2014-04,ירושלים,1015,מבשרת ציון,יישוב,369,177,192,69,300,158,361,7,2.71%
2014-04,ירושלים,1137,קריית יערים,יישוב,35,19,16,5,30,16,34,0,2.60%
2014-04,תל אביב,2400,אור יהודה,יישוב,778,372,406,30,748,250,749,14,3.99%
2014-04,תל אביב,565,אזור,יישוב,159,91,68,23,136,36,156,4,2.44%
2014-04,תל אביב,6100,בני ברק,יישוב,2199,1093,1105,67,2132,1231,2119,19,3.80%
2014-04,תל אביב,6200,בת ים,יישוב,2972,1406,1566,344,2628,1183,2882,66,4.07%
2014-04,תל אביב,6300,גבעתיים,יישוב,692,314,378,251,441,91,686,3,2.27%
2014-04,תל אביב,6400,הרצלייה,יישוב,991,422,569,176,815,31,973,26,2.02%
2014-04,תל אביב,6600,חולון,יישוב,2961,1405,1556,349,2612,828,2905,39,2.93%
2014-04,תל אביב,2620,קריית אונו,יישוב,378,182,196,96,282,51,372,1,1.98%
2014-04,תל אביב,8600,רמת גן,יישוב,1994,903,1091,521,1473,441,1955,19,2.51%
2014-04,תל אביב,2650,רמת השרון,יישוב,359,148,211,92,267,4,356,2,1.59%
2014-04,תל אביב,5000,תל אביב -יפו,יישוב,7298,3619,3679,2013,5285,2289,7161,83,2.85%
2014-05,אזור יהודה והשומרון,3760,אורנית,יישוב,111,47,64,40,71,3,109,0,2.33%
2014-05,אזור יהודה והשומרון,3750,אלפי מנשה,יישוב,84,40,44,16,68,1,84,0,1.98%
2014-05,אזור יהודה והשומרון,3560,אלקנה,יישוב,32,15,17,15,17,1,32,0,1.69%
2014-05,אזור יהודה והשומרון,3650,אפרת,יישוב,57,32,25,20,37,4,57,1,1.40%
2014-05,אזור יהודה והשומרון,3570,אריאל,יישוב,364,169,195,47,317,85,354,11,3.36%
2014-05,אזור יהודה והשומרון,3574,בית אל,יישוב,49,21,28,10,39,16,49,1,2.00%
2014-05,אזור יהודה והשומרון,3652,בית אריה,יישוב,57,27,30,11,46,4,57,1,2.23%
2014-05,אזור יהודה והשומרון,3780,ביתר עילית,יישוב,472,226,246,6,466,191,466,2,3.84%
2014-05,אזור יהודה והשומרון,3730,גבעת זאב,יישוב,196,91,105,42,154,39,196,0,2.60%
2014-05,אזור יהודה והשומרון,3769,הר אדר,יישוב,36,13,23,12,24,4,36,1,1.74%
2014-05,אזור יהודה והשומרון,76,מ.א. גוש עציון,מועצה איזורית,183,84,99,51,132,20,182,0,1.97%
2014-05,אזור יהודה והשומרון,78,מ.א. הר חברון,מועצה איזורית,59,31,28,14,45,8,59,0,1.83%
2014-05,אזור יהודה והשומרון,74,מ.א. מגילות ים המלח,מועצה איזורית,11,3,8,4,7,1,11,0,1.45%
2014-05,אזור יהודה והשומרון,73,מ.א. מטה בנימין,מועצה איזורית,623,303,320,154,469,154,605,0,2.54%
2014-05,אזור יהודה והשומרון,75,מ.א. ערבות הירדן,מועצה איזורית,44,21,23,6,38,3,44,0,1.89%
2014-05,אזור יהודה והשומרון,72,מ.א. שומרון,מועצה איזורית,388,190,198,81,307,52,384,0,2.43%
2014-05,אזור יהודה והשומרון,3797,מודיעין עילית,יישוב,389,149,240,20,369,90,377,7,2.89%
2014-05,אזור יהודה והשומרון,3616,מעלה אדומים,יישוב,597,267,330,48,549,207,590,17,2.91%
2014-05,אזור יהודה והשומרון,3660,עמנואל,יישוב,75,45,30,0,75,54,73,0,6.46%
2014-05,אזור יהודה והשומרון,3557,קדומים,יישוב,32,15,17,8,24,7,32,0,1.72%
2014-05,אזור יהודה והשומרון,3611,קריית ארבע,יישוב,113,59,54,10,103,66,109,0,3.43%
2014-05,אזור יהודה והשומרון,3640,קרני שומרון,יישוב,89,37,52,27,62,10,87,2,2.39%
2014-05,הדרום,31,אופקים,יישוב,1226,542,684,67,1159,782,1202,43,9.40%
2014-05,הדרום,2600,אילת,יישוב,1292,620,672,34,1258,537,1250,54,3.76%
2014-05,הדרום,70,אשדוד,יישוב,6653,2754,3899,725,5928,3333,6479,213,5.97%
2014-05,הדרום,7100,אשקלון,יישוב,4209,1802,2407,294,3915,2225,3871,121,5.63%
2014-05,הדרום,9000,באר שבע,יישוב,7117,3214,3903,717,6400,4245,6859,245,6.60%
2014-05,הדרום,2200,דימונה,יישוב,2019,903,1116,100,1919,1354,1956,69,10.67%
2014-05,הדרום,1303,חורה,יישוב,828,353,475,2,826,760,817,5,20.09%
2014-05,הדרום,831,ירוחם,יישוב,467,226,241,14,453,271,439,48,9.59%
2014-05,הדרום,1059,כסיפה,יישוב,1033,403,630,1,1032,936,1021,4,21.91%
2014-05,הדרום,1271,להבים,יישוב,42,20,22,17,25,3,42,0,1.21%
2014-05,הדרום,1060,לקיה,יישוב,999,445,554,4,995,936,988,1,23.17%
2014-05,הדרום,69,מ.א. אל קסום,מועצה איזורית,780,327,453,4,776,722,774,0,60.05%
2014-05,הדרום,38,מ.א. אשכול,מועצה איזורית,107,44,63,11,96,18,105,0,1.59%
2014-05,הדרום,33,מ.א. באר טוביה,מועצה איזורית,251,103,148,36,215,46,250,0,2.42%
2014-05,הדרום,41,מ.א. בני שמעון,מועצה איזורית,62,27,35,20,42,16,61,1,1.52%
2014-05,הדרום,54,מ.א. הערבה התיכונה,מועצה איזורית,32,14,18,6,26,1,32,0,1.77%
2014-05,הדרום,53,מ.א. חבל אילות,מועצה איזורית,19,11,8,2,17,0,19,5,0.89%
2014-05,הדרום,36,מ.א. חוף אשקלון,מועצה איזורית,232,114,118,13,219,62,219,1,2.80%
2014-05,הדרום,35,מ.א. יואב,מועצה איזורית,106,44,62,24,82,19,105,0,2.74%
2014-05,הדרום,50,מ.א. לכיש,מועצה איזורית,157,73,84,14,143,60,155,0,3.27%
2014-05,הדרום,42,מ.א. מרחבים,מועצה איזורית,168,73,95,15,153,39,166,0,3.12%
2014-05,הדרום,68,מ.א. נווה מדבר,מועצה איזורית,109,43,66,0,109,86,109,0,17.55%
2014-05,הדרום,48,מ.א. רמת נגב,מועצה איזורית,190,95,95,11,179,155,187,1,6.52%
2014-05,הדרום,39,מ.א. שדות נגב,מועצה איזורית,120,55,65,16,104,34,113,0,2.71%
2014-05,הדרום,37,מ.א. שער הנגב,מועצה איזורית,153,84,69,35,118,70,152,0,4.09%
2014-05,הדרום,34,מ.א. שפיר,מועצה איזורית,188,94,94,11,177,79,185,0,4.08%
2014-05,הדרום,51,מ.א. תמר,מועצה איזורית,6,2,4,0,6,0,6,0,0.97%
2014-05,הדרום,1268,מיתר,יישוב,64,30,34,14,50,6,62,1,1.45%
2014-05,הדרום,99,מצפה רמון,יישוב,247,89,158,10,237,168,239,2,9.76%
2014-05,הדרום,246,נתיבות,יישוב,1023,469,554,44,979,526,986,31,7.08%
2014-05,הדרום,666,עומר,יישוב,63,28,35,19,44,9,62,1,1.53%
2014-05,הדרום,2560,ערד,יישוב,853,371,482,88,765,423,819,36,6.64%
2014-05,הדרום,1192,ערערה-בנגב,יישוב,1024,427,597,5,1019,942,1017,0,24.37%
2014-05,הדרום,2630,קריית גת,יישוב,2136,867,1269,127,2009,1244,2069,63,7.29%
2014-05,הדרום,1034,קריית מלאכי,יישוב,1240,565,675,23,1217,711,1195,95,10.19%
2014-05,הדרום,1161,רהט,יישוב,3369,1372,1997,7,3362,2756,3331,51,17.39%
2014-05,הדרום,1286,שגב-שלום,יישוב,578,211,367,2,576,509,572,1,21.19%
2014-05,הדרום,1031,שדרות,יישוב,1089,483,606,49,1040,661,1049,16,8.21%
2014-05,הדרום,1054,תל שבע,יישוב,1223,580,643,2,1221,1130,1211,4,24.42%
2014-05,המרכז,182,אבן יהודה,יישוב,165,78,87,62,103,19,164,2,2.44%
2014-05,המרכז,41,אליכין,יישוב,64,28,36,6,58,18,62,1,3.30%
2014-05,המרכז,1309,אלעד,יישוב,386,191,195,20,366,97,371,4,2.98%
2014-05,המרכז,2530,באר יעקב,יישוב,281,120,161,48,233,60,279,3,3.07%
2014-05,המרכז,466,בית דגן,יישוב,103,58,45,11,92,40,103,2,2.89%
2014-05,המרכז,1066,"בני עי""ש",יישוב,181,90,91,30,151,71,179,6,4.52%
2014-05,המרכז,681,גבעת שמואל,יישוב,300,146,154,67,233,73,293,2,2.45%
2014-05,המרכז,2550,גדרה,יישוב,368,157,211,73,295,119,358,5,3.07%
2014-05,המרכז,627,ג'לג'וליה,יישוב,77,32,45,2,75,44,76,0,2.11%
2014-05,המרכז,166,גן יבנה,יישוב,342,139,203,42,300,87,339,9,2.98%
2014-05,המרכז,229,גני תקווה,יישוב,192,80,112,60,132,24,189,2,2.27%
2014-05,המרכז,9700,הוד השרון,יישוב,631,281,350,196,435,62,623,5,2.11%
2014-05,המרכז,1290,זמר,יישוב,176,55,121,2,174,128,173,10,5.87%
2014-05,המרכז,2730,טייבה,יישוב,1784,768,1016,11,1773,1543,1660,26,9.51%
2014-05,המרכז,2720,טירה,יישוב,325,150,175,5,320,167,313,4,2.76%
2014-05,המרכז,2660,יבנה,יישוב,899,447,452,96,803,330,883,44,3.80%
2014-05,המרכז,9400,יהוד,יישוב,510,222,288,88,422,73,491,12,3.09%
2014-05,המרכז,1224,כוכב יאיר,יישוב,75,25,50,41,34,1,75,1,1.33%
2014-05,המרכז,633,כפר ברא,יישוב,23,13,10,1,22,15,23,1,1.68%
2014-05,המרכז,168,כפר יונה,יישוב,319,150,169,62,257,65,316,4,2.92%
2014-05,המרכז,6900,כפר סבא,יישוב,1259,590,669,349,910,169,1231,22,2.33%
2014-05,המרכז,634,כפר קאסם,יישוב,241,114,127,5,236,131,233,1,2.64%
2014-05,המרכז,7000,לוד,יישוב,2136,1037,1099,149,1987,1166,2109,49,5.99%
2014-05,המרכז,28,מ.א. ברנר,מועצה איזורית,77,33,44,31,46,4,77,1,2.02%
2014-05,המרכז,32,מ.א. גדרות,מועצה איזורית,38,16,22,20,18,3,38,0,1.67%
2014-05,המרכז,30,מ.א. גזר,מועצה איזורית,284,128,156,81,203,34,280,0,2.20%
2014-05,המרכז,27,מ.א. גן רווה,מועצה איזורית,62,32,30,21,41,0,62,1,2.27%
2014-05,המרכז,20,מ.א. דרום השרון,מועצה איזורית,308,138,170,106,202,13,307,0,2.02%
2014-05,המרכז,29,מ.א. חבל יבנה,מועצה איזורית,36,17,19,10,26,2,35,0,1.46%
2014-05,המרכז,25,מ.א. חבל מודיעין,מועצה איזורית,271,128,143,68,203,23,266,0,2.54%
2014-05,המרכז,19,מ.א. חוף השרון,מועצה איזורית,120,52,68,47,73,5,120,0,2.20%
2014-05,המרכז,18,מ.א. לב השרון,מועצה איזורית,217,114,103,70,147,32,215,0,1.99%
2014-05,המרכז,31,מ.א. נחל שורק,מועצה איזורית,47,29,18,10,37,9,46,43,1.06%
2014-05,המרכז,16,מ.א. עמק חפר,מועצה איזורית,389,164,225,150,239,33,380,0,1.94%
2014-05,המרכז,40,מ.א. עמק לוד,מועצה איזורית,157,76,81,20,137,24,156,0,2.56%
2014-05,המרכז,1200,מודיעין-מכבים-רעות*,יישוב,923,389,534,318,605,63,898,19,2.08%
2014-05,המרכז,28,מזכרת בתיה,יישוב,152,73,79,37,115,31,149,1,2.13%
2014-05,המרכז,7200,נס ציונה,יישוב,695,328,367,156,539,208,687,11,2.94%
2014-05,המרכז,7400,נתניה,יישוב,4397,2039,2358,566,3831,1604,4294,126,4.11%
2014-05,המרכז,587,סביון*,יישוב,22,10,12,8,14,0,21,0,1.08%
2014-05,המרכז,171,פרדסייה,יישוב,66,29,37,15,51,8,66,0,1.84%
2014-05,המרכז,7900,פתח תקווה,יישוב,3998,1766,2232,845,3153,1065,3933,70,3.17%
2014-05,המרכז,195,קדימה-צורן,יישוב,245,117,128,68,177,39,241,1,2.29%
2014-05,המרכז,638,קלנסווה,יישוב,688,284,404,3,685,572,641,16,7.40%
2014-05,המרכז,469,קריית עקרון,יישוב,329,168,161,21,308,147,321,17,5.42%
2014-05,המרכז,2640,ראש העין,יישוב,721,344,377,70,651,162,706,18,3.06%
2014-05,המרכז,8300,ראשון לציון,יישוב,4309,1929,2380,659,3650,1349,4278,103,3.11%
2014-05,המרכז,8400,רחובות,יישוב,2539,1153,1386,471,2068,977,2466,51,3.65%
2014-05,המרכז,8500,רמלה,יישוב,1744,850,894,90,1654,726,1694,45,4.60%
2014-05,המרכז,8700,רעננה,יישוב,823,379,444,279,544,74,812,16,2.19%
2014-05,המרכז,1304,שוהם,יישוב,175,82,93,67,108,10,174,2,1.58%
2014-05,המרכז,154,תל מונד,יישוב,146,60,86,56,90,17,144,1,2.34%
2014-05,הצפון,473,אבו סנאן,יישוב,666,279,387,7,659,544,663,13,11.48%
2014-05,הצפון,478,אכסאל,יישוב,509,225,284,10,499,443,504,2,8.96%
2014-05,הצפון,529,אעבלין,יישוב,617,248,369,7,610,519,612,10,10.86%
2014-05,הצפון,482,בועיינה-נוג'ידאת,יישוב,409,169,240,5,404,335,397,7,10.34%
2014-05,הצפון,4001,בוקעאתא,יישוב,437,177,260,2,435,363,423,4,15.30%
2014-05,הצפון,998,ביר אל-מכסור,יישוב,427,176,251,3,424,321,425,1,11.56%
2014-05,הצפון,480,בית ג'ן,יישוב,438,135,303,14,424,303,425,3,8.01%
2014-05,הצפון,9200,בית שאן,יישוב,796,367,429,13,783,412,766,77,7.68%
2014-05,הצפון,944,בסמת טבעון,יישוב,217,111,106,3,214,158,212,0,6.63%
2014-05,הצפון,483,בענה,יישוב,368,151,217,3,365,306,365,11,11.04%
2014-05,הצפון,1292,ג'דיידה-מכר,יישוב,1366,591,775,9,1357,1143,1352,43,14.84%
2014-05,הצפון,485,ג'ולס,יישוב,235,70,165,0,235,162,235,3,8.08%
2014-05,הצפון,487,ג'ש (גוש חלב),יישוב,76,34,42,3,73,42,75,0,4.56%
2014-05,הצפון,489,דבורייה,יישוב,386,170,216,13,373,304,384,3,9.04%
2014-05,הצפון,490,דייר אל-אסד,יישוב,381,158,223,5,376,298,378,12,7.43%
2014-05,הצפון,492,דייר חנא,יישוב,671,300,371,8,663,512,669,10,13.77%
2014-05,הצפון,975,זרזיר,יישוב,287,131,156,2,285,203,280,9,9.12%
2014-05,הצפון,496,חורפיש,יישוב,103,40,63,7,96,61,100,0,3.79%
2014-05,הצפון,2034,חצור הגלילית,יישוב,301,132,169,15,286,136,285,18,6.03%
2014-05,הצפון,6700,טבריה,יישוב,1720,789,931,70,1650,1049,1492,52,6.91%
2014-05,הצפון,962,טובא-זנגרייה,יישוב,408,184,224,5,403,258,393,2,12.83%
2014-05,הצפון,498,טורעאן,יישוב,495,182,313,4,491,434,482,5,8.55%
2014-05,הצפון,8900,טמרה,יישוב,1991,841,1150,12,1979,1774,1969,13,13.99%
2014-05,הצפון,1295,יאנוח-ג'ת,יישוב,158,58,100,6,152,96,157,1,5.62%
2014-05,הצפון,46,יבנאל,יישוב,165,107,58,9,156,134,136,1,8.60%
2014-05,הצפון,499,יפיע,יישוב,635,282,353,14,621,514,628,9,8.07%
2014-05,הצפון,240,יקנעם עילית,יישוב,507,224,283,49,458,154,500,26,4.32%
2014-05,הצפון,502,ירכא,יישוב,566,240,326,1,565,429,560,10,9.60%
2014-05,הצפון,504,כאבול,יישוב,683,280,403,8,675,599,677,8,13.86%
2014-05,הצפון,505,כאוכב אבו אל-היג'א,יישוב,215,100,115,3,212,185,212,6,12.39%
2014-05,הצפון,1296,כסרא-סמיע,יישוב,206,79,127,3,203,147,201,2,5.90%
2014-05,הצפון,978,כעביה-טבאש-חג'אג'רה,יישוב,208,83,125,3,205,144,198,3,8.71%
2014-05,הצפון,1263,כפר ורדים,יישוב,59,29,30,28,31,4,58,2,1.86%
2014-05,הצפון,507,כפר יאסיף,יישוב,464,196,268,4,460,373,456,9,8.84%
2014-05,הצפון,508,כפר כמא,יישוב,68,32,36,3,65,29,65,1,4.00%
2014-05,הצפון,509,כפר כנא,יישוב,1123,442,681,21,1102,950,1084,17,12.31%
2014-05,הצפון,510,כפר מנדא,יישוב,956,430,526,11,945,697,931,35,12.73%
2014-05,הצפון,47,כפר תבור,יישוב,33,21,12,4,29,4,31,1,1.44%
2014-05,הצפון,1139,כרמיאל,יישוב,1690,680,1010,283,1407,824,1605,70,6.21%
2014-05,הצפון,65,מ.א. אל-בטוף,מועצה איזורית,375,134,241,4,371,310,369,1,13.82%
2014-05,הצפון,66,מ.א. בוסתן אל-מרג,מועצה איזורית,48,16,32,3,45,40,48,0,1.56%
2014-05,הצפון,71,מ.א. גולן,מועצה איזורית,168,76,92,13,155,18,168,1,2.05%
2014-05,הצפון,8,מ.א. הגלבוע,מועצה איזורית,793,334,459,46,747,509,782,0,5.60%
2014-05,הצפון,1,מ.א. הגליל העליון,מועצה איזורית,232,100,132,25,207,70,231,0,2.60%
2014-05,הצפון,3,מ.א. הגליל התחתון,מועצה איזורית,123,63,60,19,104,19,116,0,2.03%
2014-05,הצפון,55,מ.א. מבואות החרמון,מועצה איזורית,113,42,71,19,94,15,112,0,2.91%
2014-05,הצפון,13,מ.א. מגידו,מועצה איזורית,102,45,57,17,85,11,102,0,1.80%
2014-05,הצפון,4,מ.א. מטה אשר,מועצה איזורית,426,191,235,65,361,196,421,0,3.19%
2014-05,הצפון,52,מ.א. מעלה יוסף,מועצה איזורית,188,88,100,24,164,59,187,1,3.56%
2014-05,הצפון,2,מ.א. מרום הגליל,מועצה איזורית,309,154,155,17,292,135,302,0,4.66%
2014-05,הצפון,56,מ.א. משגב,מועצה איזורית,518,221,297,79,439,270,507,0,4.12%
2014-05,הצפון,6,מ.א. עמק הירדן,מועצה איזורית,171,81,90,17,154,39,157,0,2.36%
2014-05,הצפון,7,מ.א. עמק המעיינות,מועצה איזורית,158,68,90,19,139,42,155,0,2.51%
2014-05,הצפון,9,מ.א. עמק יזרעאל,מועצה איזורית,333,146,187,113,220,33,329,0,1.78%
2014-05,הצפון,481,מגאר,יישוב,1533,601,932,11,1522,1295,1507,6,16.03%
2014-05,הצפון,516,מג'ד אל-כרום,יישוב,529,232,297,6,523,422,524,18,8.13%
2014-05,הצפון,874,מגדל העמק,יישוב,986,445,541,73,913,417,884,78,6.62%
2014-05,הצפון,4201,מג'דל שמס,יישוב,506,181,325,10,496,400,494,5,10.32%
2014-05,הצפון,517,מזרעה,יישוב,172,70,102,3,169,136,170,3,8.70%
2014-05,הצפון,4203,מסעדה,יישוב,219,78,141,3,216,176,213,4,12.67%
2014-05,הצפון,518,מעיליא,יישוב,60,28,32,8,52,33,58,4,3.53%
2014-05,הצפון,1063,מעלות-תרשיחא,יישוב,905,436,469,92,813,507,888,35,7.39%
2014-05,הצפון,520,משהד,יישוב,296,112,184,5,291,241,283,6,8.84%
2014-05,הצפון,9100,נהרייה,יישוב,1994,905,1089,193,1801,1193,1940,67,6.27%
2014-05,הצפון,522,נחף,יישוב,399,186,213,9,390,309,397,15,8.03%
2014-05,הצפון,7300,נצרת,יישוב,3169,1373,1796,78,3091,2554,3109,42,9.00%
2014-05,הצפון,1061,נצרת עילית,יישוב,1796,843,953,144,1652,1014,1599,111,6.78%
2014-05,הצפון,525,סאג'ור,יישוב,141,52,89,4,137,85,139,2,7.73%
2014-05,הצפון,7500,סח'נין,יישוב,2035,890,1145,11,2024,1756,2028,12,14.65%
2014-05,הצפון,4501,ע'ג'ר,יישוב,91,38,53,0,91,68,91,1,8.85%
2014-05,הצפון,530,עיילבון,יישוב,195,78,117,2,193,139,193,3,7.06%
2014-05,הצפון,511,עילוט,יישוב,317,132,185,0,317,258,310,4,11.06%
2014-05,הצפון,532,עין מאהל,יישוב,561,263,298,7,554,465,542,8,10.32%
2014-05,הצפון,7600,עכו,יישוב,3230,1497,1733,121,3109,2450,3133,48,11.75%
2014-05,הצפון,7700,עפולה,יישוב,1733,712,1021,131,1602,825,1649,87,6.63%
2014-05,הצפון,531,עראבה,יישוב,1503,625,878,21,1482,1294,1494,18,14.89%
2014-05,הצפון,535,פסוטה,יישוב,120,57,63,7,113,79,119,3,6.95%
2014-05,הצפון,536,פקיעין (בוקייעה),יישוב,133,66,67,4,129,91,129,6,4.72%
2014-05,הצפון,8000,צפת,יישוב,1435,790,645,64,1371,1111,1371,42,10.22%
2014-05,הצפון,4100,קצרין,יישוב,220,95,125,14,206,95,218,9,5.50%
2014-05,הצפון,2800,קריית שמונה,יישוב,853,379,474,32,821,384,811,45,6.22%
2014-05,הצפון,543,ראמה,יישוב,345,126,219,9,336,253,338,4,8.62%
2014-05,הצפון,26,ראש פינה,יישוב,54,21,33,7,47,22,52,2,3.28%
2014-05,הצפון,542,ריינה,יישוב,671,288,383,8,663,531,652,15,9.59%
2014-05,הצפון,122,רמת ישי,יישוב,101,36,65,32,69,13,94,0,2.28%
2014-05,הצפון,913,שבלי - אום אל-גנם,יישוב,220,103,117,6,214,152,215,2,8.36%
2014-05,הצפון,812,שלומי,יישוב,271,114,157,17,254,145,264,13,7.29%
2014-05,הצפון,538,שעב,יישוב,547,214,333,2,545,472,545,16,17.70%
2014-05,הצפון,8800,שפרעם,יישוב,2085,806,1279,27,2058,1737,2057,56,11.61%
2014-05,חיפה,2710,אום אל-פחם,יישוב,3791,1565,2226,15,3776,3269,3718,48,17.65%
2014-05,חיפה,1020,אור עקיבא,יישוב,616,258,358,40,576,214,591,23,5.88%
2014-05,חיפה,6000,באקה אל-גרביה,יישוב,740,323,417,9,731,480,735,36,6.32%
2014-05,חיפה,9800,בנימינה-גבעת עדה*,יישוב,216,88,128,56,160,65,215,0,3.05%
2014-05,חיפה,1326,"בסמ""ה",יישוב,422,178,244,2,420,349,416,7,10.47%
2014-05,חיפה,541,ג'סר א-זרקא,יישוב,479,250,229,2,477,320,475,3,8.09%
2014-05,חיפה,628,ג'ת,יישוב,255,119,136,11,244,167,252,6,4.83%
2014-05,חיפה,494,דאלית אל-כרמל,יישוב,542,228,314,11,531,312,520,8,6.62%
2014-05,חיפה,9300,זכרון יעקב,יישוב,236,108,128,63,173,54,235,2,2.18%
2014-05,חיפה,6500,חדרה,יישוב,2456,1058,1398,282,2174,948,2349,61,4.77%
2014-05,חיפה,4000,חיפה,יישוב,6483,3114,3369,1130,5353,3536,6229,186,4.40%
2014-05,חיפה,1247,חריש,יישוב,17,7,10,2,15,4,16,0,1.10%
2014-05,חיפה,2100,טירת כרמל,יישוב,730,352,378,15,715,430,714,24,6.68%
2014-05,חיפה,654,כפר קרע,יישוב,439,183,256,10,429,258,432,21,5.19%
2014-05,חיפה,45,מ.א. אלונה,מועצה איזורית,38,18,20,13,25,4,37,0,3.60%
2014-05,חיפה,12,מ.א. זבולון,מועצה איזורית,277,131,146,19,258,197,272,0,5.00%
2014-05,חיפה,15,מ.א. חוף הכרמל,מועצה איזורית,295,141,154,44,251,64,290,0,2.14%
2014-05,חיפה,14,מ.א. מנשה,מועצה איזורית,273,129,144,62,211,82,268,0,3.43%
2014-05,חיפה,1327,מעלה עירון,יישוב,952,358,594,5,947,799,942,7,15.99%
2014-05,חיפה,2500,נשר,יישוב,469,219,250,83,386,180,456,7,3.58%
2014-05,חיפה,534,עספיא,יישוב,321,145,176,7,314,176,307,2,5.63%
2014-05,חיפה,637,ערערה,יישוב,611,229,382,5,606,417,595,23,7.37%
2014-05,חיפה,537,פוריידיס,יישוב,414,222,192,1,413,277,409,2,7.38%
2014-05,חיפה,7800,פרדס חנה-כרכור,יישוב,861,393,468,111,750,282,852,25,4.26%
2014-05,חיפה,6800,קריית אתא,יישוב,1644,747,897,131,1513,914,1618,59,5.43%
2014-05,חיפה,9500,קריית ביאליק,יישוב,1066,461,605,133,933,548,1053,38,4.92%
2014-05,חיפה,2300,קריית טבעון,יישוב,185,97,88,62,123,37,180,1,2.11%
2014-05,חיפה,9600,קריית ים,יישוב,1543,710,833,135,1408,905,1505,41,7.05%
2014-05,חיפה,8200,קריית מוצקין,יישוב,1027,447,580,137,890,506,1014,28,4.45%
2014-05,חיפה,922,רכסים,יישוב,129,59,70,4,125,77,122,0,3.59%
2014-05,ירושלים,472,אבו גוש,יישוב,258,129,129,3,255,179,257,2,8.42%
2014-05,ירושלים,2610,בית שמש,יישוב,1257,573,684,98,1159,530,1215,53,3.84%
2014-05,ירושלים,3000,ירושלים,יישוב,12056,5542,6514,1285,10771,7420,11814,167,3.98%
2014-05,ירושלים,26,מ.א. מטה יהודה,מועצה איזורית,557,262,295,121,436,121,546,2,2.38%
2014-05,ירושלים,1015,מבשרת ציון,יישוב,387,185,202,77,310,163,379,5,2.85%
2014-05,ירושלים,1137,קריית יערים,יישוב,35,16,19,4,31,16,35,0,2.68%
2014-05,תל אביב,2400,אור יהודה,יישוב,788,383,405,36,752,250,757,35,4.03%
2014-05,תל אביב,565,אזור,יישוב,175,96,79,22,153,39,170,5,2.66%
2014-05,תל אביב,6100,בני ברק,יישוב,2235,1120,1114,69,2166,1239,2143,42,3.84%
2014-05,תל אביב,6200,בת ים,יישוב,3060,1452,1608,379,2681,1186,2961,87,4.18%
2014-05,תל אביב,6300,גבעתיים,יישוב,706,320,386,261,445,86,700,9,2.31%
2014-05,תל אביב,6400,הרצלייה,יישוב,994,407,587,192,802,32,983,37,2.04%
2014-05,תל אביב,6600,חולון,יישוב,3016,1455,1561,357,2659,857,2943,68,2.97%
2014-05,תל אביב,2620,קריית אונו,יישוב,389,184,205,112,277,48,383,3,2.04%
2014-05,תל אביב,8600,רמת גן,יישוב,2050,916,1134,584,1466,447,2012,21,2.58%
2014-05,תל אביב,2650,רמת השרון,יישוב,385,158,227,103,282,5,379,5,1.69%
2014-05,תל אביב,5000,תל אביב -יפו,יישוב,7605,3819,3786,2245,5360,2316,7461,128,2.96%
2014-06,אזור יהודה והשומרון,3760,אורנית,יישוב,114,44,70,39,75,2,113,1,2.41%
2014-06,אזור יהודה והשומרון,3750,אלפי מנשה,יישוב,83,34,49,22,61,1,83,0,1.96%
2014-06,אזור יהודה והשומרון,3560,אלקנה,יישוב,35,17,18,19,16,1,35,0,1.84%
2014-06,אזור יהודה והשומרון,3650,אפרת,יישוב,55,31,24,17,38,4,55,0,1.35%
2014-06,אזור יהודה והשומרון,3570,אריאל,יישוב,349,168,181,45,304,81,341,14,3.24%
2014-06,אזור יהודה והשומרון,3574,בית אל,יישוב,52,22,30,13,39,18,52,3,2.12%
2014-06,אזור יהודה והשומרון,3652,בית אריה,יישוב,62,27,35,10,52,4,60,2,2.35%
2014-06,אזור יהודה והשומרון,3780,ביתר עילית,יישוב,493,236,257,8,485,202,486,5,4.00%
2014-06,אזור יהודה והשומרון,3730,גבעת זאב,יישוב,190,94,96,33,157,40,189,2,2.51%
2014-06,אזור יהודה והשומרון,3769,הר אדר,יישוב,26,9,17,11,15,2,26,1,1.26%
2014-06,אזור יהודה והשומרון,76,מ.א. גוש עציון,מועצה איזורית,172,84,88,50,122,16,171,0,1.85%
2014-06,אזור יהודה והשומרון,78,מ.א. הר חברון,מועצה איזורית,58,28,30,14,44,8,58,0,1.80%
2014-06,אזור יהודה והשומרון,74,מ.א. מגילות ים המלח,מועצה איזורית,11,1,10,4,7,1,11,0,1.46%
2014-06,אזור יהודה והשומרון,73,מ.א. מטה בנימין,מועצה איזורית,614,303,311,143,471,140,600,0,2.52%
2014-06,אזור יהודה והשומרון,75,מ.א. ערבות הירדן,מועצה איזורית,44,21,23,5,39,4,44,0,1.89%
2014-06,אזור יהודה והשומרון,72,מ.א. שומרון,מועצה איזורית,389,194,195,79,310,54,382,0,2.42%
2014-06,אזור יהודה והשומרון,3797,מודיעין עילית,יישוב,428,148,280,18,410,85,415,9,3.18%
2014-06,אזור יהודה והשומרון,3616,מעלה אדומים,יישוב,649,293,356,55,594,213,643,17,3.16%
2014-06,אזור יהודה והשומרון,3660,עמנואל,יישוב,80,48,32,0,80,57,76,4,6.71%
2014-06,אזור יהודה והשומרון,3557,קדומים,יישוב,36,16,20,11,25,7,36,0,1.93%
2014-06,אזור יהודה והשומרון,3611,קריית ארבע,יישוב,110,64,46,7,103,58,107,4,3.37%
2014-06,אזור יהודה והשומרון,3640,קרני שומרון,יישוב,77,38,39,24,53,10,75,3,2.06%
2014-06,הדרום,31,אופקים,יישוב,1231,528,703,63,1168,773,1203,45,9.40%
2014-06,הדרום,2600,אילת,יישוב,1267,600,667,28,1239,534,1235,51,3.72%
2014-06,הדרום,70,אשדוד,יישוב,6620,2743,3876,711,5909,3316,6426,218,5.92%
2014-06,הדרום,7100,אשקלון,יישוב,4278,1806,2472,278,4000,2224,3916,107,5.69%
2014-06,הדרום,9000,באר שבע,יישוב,7127,3195,3932,736,6391,4251,6826,232,6.57%
2014-06,הדרום,2200,דימונה,יישוב,2060,905,1155,100,1960,1353,1981,50,10.79%
2014-06,הדרום,1303,חורה,יישוב,829,355,474,1,828,760,819,4,20.13%
2014-06,הדרום,831,ירוחם,יישוב,456,215,241,15,441,261,429,34,9.39%
2014-06,הדרום,1059,כסיפה,יישוב,1048,404,644,3,1045,939,1039,4,22.21%
2014-06,הדרום,1271,להבים,יישוב,45,19,26,15,30,3,45,0,1.29%
2014-06,הדרום,1060,לקיה,יישוב,988,437,551,3,985,923,977,2,22.97%
2014-06,הדרום,69,מ.א. אל קסום,מועצה איזורית,788,337,451,6,782,726,781,0,60.59%
2014-06,הדרום,38,מ.א. אשכול,מועצה איזורית,104,44,60,15,89,16,101,0,1.53%
2014-06,הדרום,33,מ.א. באר טוביה,מועצה איזורית,280,113,167,32,248,51,278,0,2.69%
2014-06,הדרום,41,מ.א. בני שמעון,מועצה איזורית,65,28,37,18,47,17,63,1,1.56%
2014-06,הדרום,54,מ.א. הערבה התיכונה,מועצה איזורית,35,15,20,6,29,3,34,0,1.89%
2014-06,הדרום,53,מ.א. חבל אילות,מועצה איזורית,17,10,7,2,15,0,17,3,0.80%
2014-06,הדרום,36,מ.א. חוף אשקלון,מועצה איזורית,221,105,116,8,213,60,210,0,2.69%
2014-06,הדרום,35,מ.א. יואב,מועצה איזורית,102,45,57,27,75,19,101,0,2.63%
2014-06,הדרום,50,מ.א. לכיש,מועצה איזורית,163,71,92,16,147,62,159,0,3.36%
2014-06,הדרום,42,מ.א. מרחבים,מועצה איזורית,187,79,108,22,165,42,183,0,3.43%
2014-06,הדרום,68,מ.א. נווה מדבר,מועצה איזורית,110,43,67,0,110,90,108,0,17.39%
2014-06,הדרום,48,מ.א. רמת נגב,מועצה איזורית,194,96,98,10,184,151,190,2,6.61%
2014-06,הדרום,39,מ.א. שדות נגב,מועצה איזורית,129,61,68,11,118,33,125,0,2.99%
2014-06,הדרום,37,מ.א. שער הנגב,מועצה איזורית,145,74,71,39,106,61,141,0,3.80%
2014-06,הדרום,34,מ.א. שפיר,מועצה איזורית,181,87,94,11,170,73,177,0,3.90%
2014-06,הדרום,51,מ.א. תמר,מועצה איזורית,6,2,4,0,6,0,6,0,0.97%
2014-06,הדרום,1268,מיתר,יישוב,62,30,32,10,52,6,60,3,1.41%
2014-06,הדרום,99,מצפה רמון,יישוב,262,100,162,9,253,179,241,5,9.84%
2014-06,הדרום,246,נתיבות,יישוב,1055,467,588,45,1010,537,1010,35,7.24%
2014-06,הדרום,666,עומר,יישוב,54,26,28,16,38,5,54,1,1.34%
2014-06,הדרום,2560,ערד,יישוב,856,378,478,95,761,416,824,59,6.68%
2014-06,הדרום,1192,ערערה-בנגב,יישוב,1049,436,613,6,1043,956,1039,1,24.76%
2014-06,הדרום,2630,קריית גת,יישוב,2166,887,1279,128,2038,1243,2084,79,7.34%
2014-06,הדרום,1034,קריית מלאכי,יישוב,1216,572,644,19,1197,684,1173,79,10.02%
2014-06,הדרום,1161,רהט,יישוב,3321,1356,1965,6,3315,2749,3278,47,17.16%
2014-06,הדרום,1286,שגב-שלום,יישוב,601,215,386,4,597,520,591,1,21.74%
2014-06,הדרום,1031,שדרות,יישוב,1089,488,601,50,1039,652,1047,27,8.19%
2014-06,הדרום,1054,תל שבע,יישוב,1221,580,641,2,1219,1140,1209,3,24.39%
2014-06,המרכז,182,אבן יהודה,יישוב,161,76,85,66,95,19,159,0,2.37%
2014-06,המרכז,41,אליכין,יישוב,65,34,31,6,59,17,63,1,3.36%
2014-06,המרכז,1309,אלעד,יישוב,373,180,193,20,353,85,364,3,2.93%
2014-06,המרכז,2530,באר יעקב,יישוב,293,131,162,53,240,56,289,2,3.17%
2014-06,המרכז,466,בית דגן,יישוב,111,63,48,13,98,39,110,3,3.08%
2014-06,המרכז,1066,"בני עי""ש",יישוב,171,90,81,27,144,73,170,1,4.31%
2014-06,המרכז,681,גבעת שמואל,יישוב,300,146,154,54,246,71,292,3,2.44%
2014-06,המרכז,2550,גדרה,יישוב,379,156,223,84,295,118,371,4,3.18%
2014-06,המרכז,627,ג'לג'וליה,יישוב,87,36,51,3,84,47,84,2,2.32%
2014-06,המרכז,166,גן יבנה,יישוב,339,143,196,55,284,82,335,12,2.95%
2014-06,המרכז,229,גני תקווה,יישוב,187,80,107,62,125,27,184,2,2.22%
2014-06,המרכז,9700,הוד השרון,יישוב,629,278,351,221,408,62,623,14,2.11%
2014-06,המרכז,1290,זמר,יישוב,193,60,133,2,191,128,189,11,6.38%
2014-06,המרכז,2730,טייבה,יישוב,1748,749,999,6,1742,1505,1610,32,9.25%
2014-06,המרכז,2720,טירה,יישוב,321,156,165,5,316,161,317,12,2.79%
2014-06,המרכז,2660,יבנה,יישוב,865,437,428,82,783,317,848,20,3.66%
2014-06,המרכז,9400,יהוד,יישוב,511,217,294,93,418,75,495,11,3.12%
2014-06,המרכז,1224,כוכב יאיר,יישוב,76,28,48,40,36,0,75,0,1.33%
2014-06,המרכז,633,כפר ברא,יישוב,22,10,12,0,22,13,22,0,1.61%
2014-06,המרכז,168,כפר יונה,יישוב,326,142,184,65,261,72,321,9,2.97%
2014-06,המרכז,6900,כפר סבא,יישוב,1237,576,661,360,877,164,1215,21,2.30%
2014-06,המרכז,634,כפר קאסם,יישוב,247,123,124,4,243,130,242,3,2.74%
2014-06,המרכז,7000,לוד,יישוב,2125,1001,1124,149,1976,1182,2092,49,5.94%
2014-06,המרכז,28,מ.א. ברנר,מועצה איזורית,79,38,41,31,48,5,78,3,2.03%
2014-06,המרכז,32,מ.א. גדרות,מועצה איזורית,40,16,24,17,23,3,40,1,1.76%
2014-06,המרכז,30,מ.א. גזר,מועצה איזורית,288,129,159,76,212,36,286,0,2.25%
2014-06,המרכז,27,מ.א. גן רווה,מועצה איזורית,60,27,33,19,41,2,59,0,2.17%
2014-06,המרכז,20,מ.א. דרום השרון,מועצה איזורית,322,144,178,111,211,14,320,0,2.10%
2014-06,המרכז,29,מ.א. חבל יבנה,מועצה איזורית,32,13,19,8,24,3,32,0,1.33%
2014-06,המרכז,25,מ.א. חבל מודיעין,מועצה איזורית,260,120,140,61,199,24,255,0,2.44%
2014-06,המרכז,19,מ.א. חוף השרון,מועצה איזורית,114,54,60,45,69,6,114,0,2.09%
2014-06,המרכז,18,מ.א. לב השרון,מועצה איזורית,226,120,106,80,146,29,225,0,2.08%
2014-06,המרכז,31,מ.א. נחל שורק,מועצה איזורית,50,30,20,11,39,7,50,45,1.16%
2014-06,המרכז,16,מ.א. עמק חפר,מועצה איזורית,381,160,221,147,234,33,374,0,1.91%
2014-06,המרכז,40,מ.א. עמק לוד,מועצה איזורית,153,74,79,21,132,22,153,0,2.52%
2014-06,המרכז,1200,מודיעין-מכבים-רעות*,יישוב,921,382,539,323,598,64,896,24,2.08%
2014-06,המרכז,28,מזכרת בתיה,יישוב,172,83,89,40,132,33,169,3,2.41%
2014-06,המרכז,7200,נס ציונה,יישוב,704,330,374,159,545,201,698,2,2.98%
2014-06,המרכז,7400,נתניה,יישוב,4366,2053,2313,576,3790,1587,4275,88,4.09%
2014-06,המרכז,587,סביון*,יישוב,21,11,10,8,13,1,21,0,1.08%
2014-06,המרכז,171,פרדסייה,יישוב,69,29,40,18,51,8,69,0,1.92%
2014-06,המרכז,7900,פתח תקווה,יישוב,4009,1776,2233,863,3146,1069,3942,41,3.18%
2014-06,המרכז,195,קדימה-צורן,יישוב,246,111,135,66,180,39,242,1,2.29%
2014-06,המרכז,638,קלנסווה,יישוב,685,283,402,5,680,576,640,9,7.39%
2014-06,המרכז,469,קריית עקרון,יישוב,311,163,148,23,288,142,306,4,5.18%
2014-06,המרכז,2640,ראש העין,יישוב,696,333,363,78,618,162,682,17,2.96%
2014-06,המרכז,8300,ראשון לציון,יישוב,4334,1931,2403,629,3705,1343,4294,95,3.12%
2014-06,המרכז,8400,רחובות,יישוב,2619,1171,1448,472,2147,970,2547,49,3.77%
2014-06,המרכז,8500,רמלה,יישוב,1778,860,918,104,1674,742,1712,53,4.65%
2014-06,המרכז,8700,רעננה,יישוב,798,384,414,273,525,69,794,4,2.14%
2014-06,המרכז,1304,שוהם,יישוב,168,82,86,70,98,10,167,1,1.52%
2014-06,המרכז,154,תל מונד,יישוב,145,62,83,58,87,16,144,2,2.34%
2014-06,הצפון,473,אבו סנאן,יישוב,660,282,378,8,652,527,656,12,11.38%
2014-06,הצפון,478,אכסאל,יישוב,518,233,285,11,507,449,512,1,9.09%
2014-06,הצפון,529,אעבלין,יישוב,609,247,362,6,603,518,607,15,10.78%
2014-06,הצפון,482,בועיינה-נוג'ידאת,יישוב,405,166,239,5,400,338,394,8,10.27%
2014-06,הצפון,4001,בוקעאתא,יישוב,427,176,251,2,425,362,411,5,14.93%
2014-06,הצפון,998,ביר אל-מכסור,יישוב,439,182,257,4,435,335,436,15,11.82%
2014-06,הצפון,480,בית ג'ן,יישוב,438,131,307,14,424,303,421,2,7.94%
2014-06,הצפון,9200,בית שאן,יישוב,804,370,434,12,792,407,780,71,7.81%
2014-06,הצפון,944,בסמת טבעון,יישוב,216,110,106,1,215,161,209,3,6.54%
2014-06,הצפון,483,בענה,יישוב,357,153,204,3,354,302,354,12,10.74%
2014-06,הצפון,1292,ג'דיידה-מכר,יישוב,1364,598,766,8,1356,1127,1345,20,14.77%
2014-06,הצפון,485,ג'ולס,יישוב,230,70,160,0,230,156,229,8,7.89%
2014-06,הצפון,487,ג'ש (גוש חלב),יישוב,71,34,37,2,69,41,69,3,4.21%
2014-06,הצפון,489,דבורייה,יישוב,380,165,215,13,367,306,377,3,8.89%
2014-06,הצפון,490,דייר אל-אסד,יישוב,375,153,222,4,371,300,373,9,7.34%
2014-06,הצפון,492,דייר חנא,יישוב,675,308,367,7,668,508,673,5,13.84%
2014-06,הצפון,975,זרזיר,יישוב,298,143,155,4,294,202,289,8,9.39%
2014-06,הצפון,496,חורפיש,יישוב,111,46,65,8,103,63,109,2,4.12%
2014-06,הצפון,2034,חצור הגלילית,יישוב,308,140,168,14,294,138,288,15,6.09%
2014-06,הצפון,6700,טבריה,יישוב,1711,783,928,75,1636,1059,1483,58,6.87%
2014-06,הצפון,962,טובא-זנגרייה,יישוב,411,179,232,3,408,252,399,2,13.00%
2014-06,הצפון,498,טורעאן,יישוב,511,184,327,5,506,446,489,6,8.67%
2014-06,הצפון,8900,טמרה,יישוב,2005,831,1174,10,1995,1784,1981,16,14.06%
2014-06,הצפון,1295,יאנוח-ג'ת,יישוב,173,70,103,6,167,96,172,4,6.12%
2014-06,הצפון,46,יבנאל,יישוב,150,96,54,6,144,126,120,1,7.67%
2014-06,הצפון,499,יפיע,יישוב,644,288,356,15,629,515,632,6,8.11%
2014-06,הצפון,240,יקנעם עילית,יישוב,540,244,296,58,482,153,531,28,4.58%
2014-06,הצפון,502,ירכא,יישוב,578,241,337,1,577,427,569,16,9.74%
2014-06,הצפון,504,כאבול,יישוב,682,289,393,8,674,594,676,6,13.84%
2014-06,הצפון,505,כאוכב אבו אל-היג'א,יישוב,217,100,117,3,214,187,214,2,12.49%
2014-06,הצפון,1296,כסרא-סמיע,יישוב,216,85,131,3,213,150,210,6,6.15%
2014-06,הצפון,978,כעביה-טבאש-חג'אג'רה,יישוב,202,78,124,3,199,144,196,3,8.63%
2014-06,הצפון,1263,כפר ורדים,יישוב,70,30,40,27,43,5,69,0,2.21%
2014-06,הצפון,507,כפר יאסיף,יישוב,466,200,266,5,461,366,458,11,8.88%
2014-06,הצפון,508,כפר כמא,יישוב,64,27,37,3,61,25,64,0,3.94%
2014-06,הצפון,509,כפר כנא,יישוב,1141,472,669,21,1120,968,1085,13,12.32%
2014-06,הצפון,510,כפר מנדא,יישוב,999,457,542,14,985,729,963,17,13.11%
2014-06,הצפון,47,כפר תבור,יישוב,33,19,14,6,27,3,30,1,1.39%
2014-06,הצפון,1139,כרמיאל,יישוב,1715,691,1024,302,1413,828,1630,66,6.30%
2014-06,הצפון,65,מ.א. אל-בטוף,מועצה איזורית,372,134,238,5,367,309,365,2,13.66%
2014-06,הצפון,66,מ.א. בוסתן אל-מרג,מועצה איזורית,50,16,34,3,47,39,50,0,1.63%
2014-06,הצפון,71,מ.א. גולן,מועצה איזורית,168,72,96,13,155,17,168,1,2.05%
2014-06,הצפון,8,מ.א. הגלבוע,מועצה איזורית,796,340,456,44,752,505,782,0,5.60%
2014-06,הצפון,1,מ.א. הגליל העליון,מועצה איזורית,226,104,122,29,197,54,223,0,2.51%
2014-06,הצפון,3,מ.א. הגליל התחתון,מועצה איזורית,132,68,64,20,112,17,126,0,2.21%
2014-06,הצפון,55,מ.א. מבואות החרמון,מועצה איזורית,129,54,75,21,108,17,127,0,3.30%
2014-06,הצפון,13,מ.א. מגידו,מועצה איזורית,105,41,64,16,89,11,105,0,1.86%
2014-06,הצפון,4,מ.א. מטה אשר,מועצה איזורית,457,203,254,68,389,201,451,0,3.42%
2014-06,הצפון,52,מ.א. מעלה יוסף,מועצה איזורית,184,85,99,30,154,54,184,0,3.50%
2014-06,הצפון,2,מ.א. מרום הגליל,מועצה איזורית,306,149,157,21,285,134,298,0,4.60%
2014-06,הצפון,56,מ.א. משגב,מועצה איזורית,523,218,305,88,435,281,512,0,4.16%
2014-06,הצפון,6,מ.א. עמק הירדן,מועצה איזורית,174,84,90,18,156,40,157,0,2.36%
2014-06,הצפון,7,מ.א. עמק המעיינות,מועצה איזורית,166,77,89,20,146,53,162,0,2.62%
2014-06,הצפון,9,מ.א. עמק יזרעאל,מועצה איזורית,333,139,194,107,226,37,329,0,1.78%
2014-06,הצפון,481,מגאר,יישוב,1546,603,943,11,1535,1320,1510,17,16.05%
2014-06,הצפון,516,מג'ד אל-כרום,יישוב,537,237,300,6,531,424,533,11,8.26%
2014-06,הצפון,874,מגדל העמק,יישוב,999,442,557,76,923,436,876,75,6.57%
2014-06,הצפון,4201,מג'דל שמס,יישוב,491,177,314,9,482,400,476,5,9.98%
2014-06,הצפון,517,מזרעה,יישוב,172,69,103,3,169,142,167,5,8.56%
2014-06,הצפון,4203,מסעדה,יישוב,215,73,142,2,213,176,210,5,12.51%
2014-06,הצפון,518,מעיליא,יישוב,67,35,32,9,58,30,65,0,3.94%
2014-06,הצפון,1063,מעלות-תרשיחא,יישוב,927,458,469,94,833,505,912,36,7.58%
2014-06,הצפון,520,משהד,יישוב,282,103,179,5,277,234,274,6,8.59%
2014-06,הצפון,9100,נהרייה,יישוב,1981,911,1070,213,1768,1158,1925,82,6.22%
2014-06,הצפון,522,נחף,יישוב,397,180,217,12,385,305,393,13,7.96%
2014-06,הצפון,7300,נצרת,יישוב,3284,1425,1859,82,3202,2608,3193,30,9.22%
2014-06,הצפון,1061,נצרת עילית,יישוב,1796,834,962,152,1644,1011,1591,120,6.75%
2014-06,הצפון,525,סאג'ור,יישוב,126,44,82,6,120,79,124,2,6.95%
2014-06,הצפון,7500,סח'נין,יישוב,2072,909,1163,13,2059,1788,2062,11,14.85%
2014-06,הצפון,4501,ע'ג'ר,יישוב,100,45,55,2,98,67,100,0,9.64%
2014-06,הצפון,530,עיילבון,יישוב,190,74,116,2,188,140,188,0,6.89%
2014-06,הצפון,511,עילוט,יישוב,329,140,189,1,328,264,320,0,11.38%
2014-06,הצפון,532,עין מאהל,יישוב,561,265,296,8,553,464,538,3,10.26%
2014-06,הצפון,7600,עכו,יישוב,3299,1533,1766,123,3176,2448,3186,55,11.93%
2014-06,הצפון,7700,עפולה,יישוב,1715,711,1004,131,1584,817,1619,82,6.52%
2014-06,הצפון,531,עראבה,יישוב,1515,632,883,19,1496,1295,1505,8,14.99%
2014-06,הצפון,535,פסוטה,יישוב,119,54,65,6,113,81,118,4,6.90%
2014-06,הצפון,536,פקיעין (בוקייעה),יישוב,143,74,69,4,139,93,138,4,5.03%
2014-06,הצפון,8000,צפת,יישוב,1484,811,673,59,1425,1114,1413,40,10.50%
2014-06,הצפון,4100,קצרין,יישוב,218,97,121,13,205,95,214,10,5.41%
2014-06,הצפון,2800,קריית שמונה,יישוב,894,418,476,31,863,358,859,26,6.56%
2014-06,הצפון,543,ראמה,יישוב,332,118,214,8,324,241,324,4,8.30%
2014-06,הצפון,26,ראש פינה,יישוב,65,30,35,11,54,22,63,2,3.95%
2014-06,הצפון,542,ריינה,יישוב,673,289,384,7,666,534,647,14,9.52%
2014-06,הצפון,122,רמת ישי,יישוב,97,37,60,30,67,12,91,3,2.20%
2014-06,הצפון,913,שבלי - אום אל-גנם,יישוב,230,102,128,6,224,155,227,3,8.79%
2014-06,הצפון,812,שלומי,יישוב,251,108,143,18,233,144,245,7,6.80%
2014-06,הצפון,538,שעב,יישוב,547,219,328,3,544,471,545,3,17.70%
2014-06,הצפון,8800,שפרעם,יישוב,2073,812,1261,29,2044,1728,2041,42,11.53%
2014-06,חיפה,2710,אום אל-פחם,יישוב,3826,1581,2245,15,3811,3289,3739,29,17.73%
2014-06,חיפה,1020,אור עקיבא,יישוב,612,262,350,48,564,207,588,20,5.86%
2014-06,חיפה,6000,באקה אל-גרביה,יישוב,777,365,412,9,768,473,770,23,6.61%
2014-06,חיפה,9800,בנימינה-גבעת עדה*,יישוב,213,97,116,54,159,62,212,0,3.00%
2014-06,חיפה,1326,"בסמ""ה",יישוב,435,192,243,2,433,354,427,3,10.71%
2014-06,חיפה,541,ג'סר א-זרקא,יישוב,484,248,236,2,482,329,480,1,8.17%
2014-06,חיפה,628,ג'ת,יישוב,288,156,132,8,280,166,288,4,5.48%
2014-06,חיפה,494,דאלית אל-כרמל,יישוב,529,220,309,10,519,305,509,10,6.49%
2014-06,חיפה,9300,זכרון יעקב,יישוב,233,114,119,68,165,57,232,0,2.15%
2014-06,חיפה,6500,חדרה,יישוב,2440,1060,1380,280,2160,952,2321,57,4.71%
2014-06,חיפה,4000,חיפה,יישוב,6485,3124,3361,1192,5293,3494,6226,172,4.40%
2014-06,חיפה,1247,חריש,יישוב,22,9,13,3,19,4,20,1,1.37%
2014-06,חיפה,2100,טירת כרמל,יישוב,734,351,383,17,717,439,713,27,6.67%
2014-06,חיפה,654,כפר קרע,יישוב,443,187,256,8,435,262,436,10,5.23%
2014-06,חיפה,45,מ.א. אלונה,מועצה איזורית,35,16,19,8,27,4,35,0,3.40%
2014-06,חיפה,12,מ.א. זבולון,מועצה איזורית,268,128,140,20,248,190,262,0,4.81%
2014-06,חיפה,15,מ.א. חוף הכרמל,מועצה איזורית,298,142,156,48,250,67,295,0,2.18%
2014-06,חיפה,14,מ.א. מנשה,מועצה איזורית,269,131,138,62,207,82,265,0,3.39%
2014-06,חיפה,1327,מעלה עירון,יישוב,945,364,581,5,940,795,933,8,15.86%
2014-06,חיפה,2500,נשר,יישוב,481,240,241,81,400,188,472,10,3.70%
2014-06,חיפה,534,עספיא,יישוב,345,157,188,9,336,182,329,2,6.00%
2014-06,חיפה,637,ערערה,יישוב,618,246,372,5,613,415,600,21,7.42%
2014-06,חיפה,537,פוריידיס,יישוב,419,221,198,1,418,282,414,0,7.46%
2014-06,חיפה,7800,פרדס חנה-כרכור,יישוב,860,388,472,105,755,277,852,22,4.26%
2014-06,חיפה,6800,קריית אתא,יישוב,1656,746,910,135,1521,914,1625,57,5.45%
2014-06,חיפה,9500,קריית ביאליק,יישוב,1047,446,601,131,916,532,1032,37,4.82%
2014-06,חיפה,2300,קריית טבעון,יישוב,203,104,99,73,130,42,199,2,2.33%
2014-06,חיפה,9600,קריית ים,יישוב,1545,703,842,148,1397,916,1507,61,7.06%
2014-06,חיפה,8200,קריית מוצקין,יישוב,1039,449,590,148,891,509,1020,30,4.47%
2014-06,חיפה,922,רכסים,יישוב,137,63,74,4,133,77,127,1,3.73%
2014-06,ירושלים,472,אבו גוש,יישוב,262,134,128,2,260,179,260,3,8.51%
2014-06,ירושלים,2610,בית שמש,יישוב,1312,615,697,93,1219,531,1263,54,3.99%
2014-06,ירושלים,3000,ירושלים,יישוב,12091,5569,6522,1299,10792,7398,11853,137,3.99%
2014-06,ירושלים,26,מ.א. מטה יהודה,מועצה איזורית,572,282,290,116,456,126,562,2,2.45%
2014-06,ירושלים,1015,מבשרת ציון,יישוב,404,201,203,74,330,162,396,4,2.97%
2014-06,ירושלים,1137,קריית יערים,יישוב,36,16,20,3,33,17,35,0,2.68%
2014-06,תל אביב,2400,אור יהודה,יישוב,801,393,408,32,769,247,762,42,4.05%
2014-06,תל אביב,565,אזור,יישוב,155,86,69,18,137,31,152,1,2.38%
2014-06,תל אביב,6100,בני ברק,יישוב,2278,1097,1180,63,2215,1225,2185,38,3.92%
2014-06,תל אביב,6200,בת ים,יישוב,3081,1440,1641,386,2695,1183,2962,88,4.18%
2014-06,תל אביב,6300,גבעתיים,יישוב,752,342,410,281,471,88,745,6,2.46%
2014-06,תל אביב,6400,הרצלייה,יישוב,1020,406,614,196,824,39,998,27,2.07%
2014-06,תל אביב,6600,חולון,יישוב,3061,1442,1619,350,2711,838,2974,55,3.00%
2014-06,תל אביב,2620,קריית אונו,יישוב,387,176,211,123,264,45,383,4,2.04%
2014-06,תל אביב,8600,רמת גן,יישוב,2004,929,1075,587,1417,432,1967,31,2.52%
2014-06,תל אביב,2650,רמת השרון,יישוב,379,165,214,110,269,7,373,10,1.66%
2014-06,תל אביב,5000,תל אביב -יפו,יישוב,7502,3721,3781,2320,5182,2262,7349,104,2.92%
2014-07,אזור יהודה והשומרון,3760,אורנית,יישוב,131,55,76,38,93,1,130,2,2.76%
2014-07,אזור יהודה והשומרון,3750,אלפי מנשה,יישוב,104,43,61,25,79,0,103,2,2.42%
2014-07,אזור יהודה והשומרון,3560,אלקנה,יישוב,42,21,21,20,22,1,42,0,2.20%
2014-07,אזור יהודה והשומרון,3650,אפרת,יישוב,55,33,22,20,35,5,55,0,1.35%
2014-07,אזור יהודה והשומרון,3570,אריאל,יישוב,373,181,192,46,327,78,366,12,3.47%
2014-07,אזור יהודה והשומרון,3574,בית אל,יישוב,61,29,32,14,47,20,61,0,2.48%
2014-07,אזור יהודה והשומרון,3652,בית אריה,יישוב,63,27,36,8,55,3,62,1,2.42%
2014-07,אזור יהודה והשומרון,3780,ביתר עילית,יישוב,711,281,430,8,703,238,703,3,5.69%
2014-07,אזור יהודה והשומרון,3730,גבעת זאב,יישוב,205,98,107,41,164,43,202,1,2.68%
2014-07,אזור יהודה והשומרון,3769,הר אדר,יישוב,29,14,15,13,16,4,29,0,1.41%
2014-07,אזור יהודה והשומרון,76,מ.א. גוש עציון,מועצה איזורית,199,97,102,56,143,18,196,0,2.12%
2014-07,אזור יהודה והשומרון,78,מ.א. הר חברון,מועצה איזורית,62,29,33,12,50,8,60,0,1.86%
2014-07,אזור יהודה והשומרון,74,מ.א. מגילות ים המלח,מועצה איזורית,13,1,12,2,11,1,13,0,1.72%
2014-07,אזור יהודה והשומרון,73,מ.א. מטה בנימין,מועצה איזורית,682,328,354,156,526,150,672,0,2.82%
2014-07,אזור יהודה והשומרון,75,מ.א. ערבות הירדן,מועצה איזורית,44,20,24,4,40,6,43,0,1.85%
2014-07,אזור יהודה והשומרון,72,מ.א. שומרון,מועצה איזורית,431,213,218,81,350,54,423,0,2.68%
2014-07,אזור יהודה והשומרון,3797,מודיעין עילית,יישוב,819,168,651,18,801,84,808,4,6.01%
2014-07,אזור יהודה והשומרון,3616,מעלה אדומים,יישוב,764,326,438,55,709,210,754,20,3.69%
2014-07,אזור יהודה והשומרון,3660,עמנואל,יישוב,88,47,41,1,87,48,87,1,7.60%
2014-07,אזור יהודה והשומרון,3557,קדומים,יישוב,46,25,21,13,33,7,46,1,2.46%
2014-07,אזור יהודה והשומרון,3611,קריית ארבע,יישוב,128,77,51,8,120,64,127,2,3.97%
2014-07,אזור יהודה והשומרון,3640,קרני שומרון,יישוב,98,49,49,33,65,12,97,2,2.65%
2014-07,הדרום,31,אופקים,יישוב,1217,500,717,65,1152,756,1193,11,9.33%
2014-07,הדרום,2600,אילת,יישוב,1369,599,770,31,1338,519,1342,48,4.03%
2014-07,הדרום,70,אשדוד,יישוב,7398,2921,4476,778,6620,3396,7206,127,6.60%
2014-07,הדרום,7100,אשקלון,יישוב,4615,1915,2700,285,4330,2302,4244,63,6.14%
2014-07,הדרום,9000,באר שבע,יישוב,7409,3299,4110,783,6626,4337,7114,110,6.83%
2014-07,הדרום,2200,דימונה,יישוב,2215,923,1292,107,2108,1378,2127,60,11.49%
2014-07,הדרום,1303,חורה,יישוב,850,363,487,2,848,776,837,2,20.48%
2014-07,הדרום,831,ירוחם,יישוב,523,243,280,15,508,276,495,33,10.68%
2014-07,הדרום,1059,כסיפה,יישוב,1052,403,649,3,1049,920,1045,4,22.31%
2014-07,הדרום,1271,להבים,יישוב,49,20,29,16,33,4,49,1,1.41%
2014-07,הדרום,1060,לקיה,יישוב,997,441,556,5,992,922,986,2,23.13%
2014-07,הדרום,69,מ.א. אל קסום,מועצה איזורית,795,337,458,4,791,723,790,0,61.34%
2014-07,הדרום,38,מ.א. אשכול,מועצה איזורית,96,40,56,13,83,15,95,0,1.44%
2014-07,הדרום,33,מ.א. באר טוביה,מועצה איזורית,317,110,207,30,287,48,315,0,3.04%
2014-07,הדרום,41,מ.א. בני שמעון,מועצה איזורית,62,25,37,16,46,15,61,1,1.51%
2014-07,הדרום,54,מ.א. הערבה התיכונה,מועצה איזורית,42,15,27,10,32,1,42,0,2.33%
2014-07,הדרום,53,מ.א. חבל אילות,מועצה איזורית,20,9,11,3,17,0,20,3,0.94%
2014-07,הדרום,36,מ.א. חוף אשקלון,מועצה איזורית,244,105,139,10,234,61,232,0,2.97%
2014-07,הדרום,35,מ.א. יואב,מועצה איזורית,92,44,48,23,69,19,90,0,2.35%
2014-07,הדרום,50,מ.א. לכיש,מועצה איזורית,170,70,100,15,155,62,168,0,3.55%
2014-07,הדרום,42,מ.א. מרחבים,מועצה איזורית,194,80,114,24,170,39,191,0,3.58%
2014-07,הדרום,68,מ.א. נווה מדבר,מועצה איזורית,115,43,72,0,115,90,115,0,18.52%
2014-07,הדרום,48,מ.א. רמת נגב,מועצה איזורית,193,96,97,13,180,146,189,1,6.58%
2014-07,הדרום,39,מ.א. שדות נגב,מועצה איזורית,151,73,78,12,139,35,146,0,3.49%
2014-07,הדרום,37,מ.א. שער הנגב,מועצה איזורית,166,85,81,35,131,78,161,0,4.34%
2014-07,הדרום,34,מ.א. שפיר,מועצה איזורית,180,88,92,9,171,77,178,0,3.92%
2014-07,הדרום,51,מ.א. תמר,מועצה איזורית,6,3,3,0,6,0,6,0,0.97%
2014-07,הדרום,1268,מיתר,יישוב,76,31,45,15,61,7,74,0,1.73%
2014-07,הדרום,99,מצפה רמון,יישוב,282,111,171,8,274,173,267,12,10.78%
2014-07,הדרום,246,נתיבות,יישוב,1245,531,714,44,1201,566,1196,22,8.47%
2014-07,הדרום,666,עומר,יישוב,53,22,31,14,39,4,53,0,1.31%
2014-07,הדרום,2560,ערד,יישוב,897,382,515,94,803,415,859,35,6.94%
2014-07,הדרום,1192,ערערה-בנגב,יישוב,1062,433,629,8,1054,961,1053,2,25.01%
2014-07,הדרום,2630,קריית גת,יישוב,1981,791,1190,114,1867,1164,1924,44,6.81%
2014-07,הדרום,1034,קריית מלאכי,יישוב,1061,496,565,19,1042,642,1029,81,8.90%
2014-07,הדרום,1161,רהט,יישוב,3422,1373,2049,5,3417,2761,3371,80,17.56%
2014-07,הדרום,1286,שגב-שלום,יישוב,608,214,394,4,604,519,598,2,21.94%
2014-07,הדרום,1031,שדרות,יישוב,1199,542,657,49,1150,663,1154,22,8.96%
2014-07,הדרום,1054,תל שבע,יישוב,1219,567,652,2,1217,1123,1205,4,24.33%
2014-07,המרכז,182,אבן יהודה,יישוב,171,77,94,70,101,17,169,4,2.51%
2014-07,המרכז,41,אליכין,יישוב,83,38,45,6,77,19,80,1,4.22%
2014-07,המרכז,1309,אלעד,יישוב,546,213,333,20,526,92,535,6,4.24%
2014-07,המרכז,2530,באר יעקב,יישוב,325,127,198,54,271,58,320,6,3.50%
2014-07,המרכז,466,בית דגן,יישוב,105,57,48,10,95,36,104,0,2.92%
2014-07,המרכז,1066,"בני עי""ש",יישוב,197,95,102,26,171,76,194,2,4.89%
2014-07,המרכז,681,גבעת שמואל,יישוב,315,152,163,48,267,72,305,6,2.55%
2014-07,המרכז,2550,גדרה,יישוב,442,185,257,94,348,117,435,7,3.71%
2014-07,המרכז,627,ג'לג'וליה,יישוב,79,37,42,2,77,44,77,0,2.13%
2014-07,המרכז,166,גן יבנה,יישוב,400,166,234,61,339,87,394,6,3.45%
2014-07,המרכז,229,גני תקווה,יישוב,194,83,111,62,132,23,194,1,2.33%
2014-07,המרכז,9700,הוד השרון,יישוב,685,321,364,214,471,68,674,11,2.28%
2014-07,המרכז,1290,זמר,יישוב,168,50,118,2,166,123,167,1,5.68%
2014-07,המרכז,2730,טייבה,יישוב,1750,735,1015,8,1742,1471,1625,28,9.32%
2014-07,המרכז,2720,טירה,יישוב,305,145,160,8,297,159,298,5,2.63%
2014-07,המרכז,2660,יבנה,יישוב,800,396,404,81,719,313,785,10,3.40%
2014-07,המרכז,9400,יהוד,יישוב,550,222,328,90,460,70,525,15,3.30%
2014-07,המרכז,1224,כוכב יאיר,יישוב,88,33,55,42,46,0,87,0,1.54%
2014-07,המרכז,633,כפר ברא,יישוב,19,8,11,0,19,13,19,0,1.40%
2014-07,המרכז,168,כפר יונה,יישוב,332,139,193,76,256,69,327,3,3.02%
2014-07,המרכז,6900,כפר סבא,יישוב,1331,599,732,368,963,160,1312,23,2.47%
2014-07,המרכז,634,כפר קאסם,יישוב,246,113,133,3,243,131,239,1,2.71%
2014-07,המרכז,7000,לוד,יישוב,2296,1035,1261,155,2141,1193,2263,48,6.40%
2014-07,המרכז,28,מ.א. ברנר,מועצה איזורית,98,42,56,35,63,4,97,1,2.52%
2014-07,המרכז,32,מ.א. גדרות,מועצה איזורית,44,18,26,16,28,3,44,0,1.93%
2014-07,המרכז,30,מ.א. גזר,מועצה איזורית,309,125,184,71,238,33,308,0,2.42%
2014-07,המרכז,27,מ.א. גן רווה,מועצה איזורית,56,27,29,19,37,3,56,0,2.06%
2014-07,המרכז,20,מ.א. דרום השרון,מועצה איזורית,336,144,192,115,221,12,334,0,2.20%
2014-07,המרכז,29,מ.א. חבל יבנה,מועצה איזורית,37,12,25,12,25,2,37,0,1.54%
2014-07,המרכז,25,מ.א. חבל מודיעין,מועצה איזורית,272,126,146,59,213,24,264,0,2.53%
2014-07,המרכז,19,מ.א. חוף השרון,מועצה איזורית,121,55,66,46,75,4,120,0,2.20%
2014-07,המרכז,18,מ.א. לב השרון,מועצה איזורית,231,128,103,80,151,28,231,0,2.13%
2014-07,המרכז,31,מ.א. נחל שורק,מועצה איזורית,52,27,25,10,42,5,52,11,1.21%
2014-07,המרכז,16,מ.א. עמק חפר,מועצה איזורית,429,169,260,155,274,32,423,0,2.16%
2014-07,המרכז,40,מ.א. עמק לוד,מועצה איזורית,159,71,88,24,135,20,159,0,2.61%
2014-07,המרכז,1200,מודיעין-מכבים-רעות*,יישוב,1050,401,649,296,754,70,1022,16,2.36%
2014-07,המרכז,28,מזכרת בתיה,יישוב,190,79,111,38,152,37,188,1,2.67%
2014-07,המרכז,7200,נס ציונה,יישוב,740,331,409,156,584,197,733,7,3.13%
2014-07,המרכז,7400,נתניה,יישוב,4867,2112,2755,630,4237,1623,4738,105,4.51%
2014-07,המרכז,587,סביון*,יישוב,22,10,12,8,14,1,22,0,1.13%
2014-07,המרכז,171,פרדסייה,יישוב,67,29,38,19,48,6,67,0,1.86%
2014-07,המרכז,7900,פתח תקווה,יישוב,4323,1812,2511,905,3418,1062,4246,59,3.42%
2014-07,המרכז,195,קדימה-צורן,יישוב,278,127,151,76,202,43,272,2,2.57%
2014-07,המרכז,638,קלנסווה,יישוב,670,278,392,6,664,561,628,13,7.26%
2014-07,המרכז,469,קריית עקרון,יישוב,356,174,182,23,333,141,349,5,5.87%
2014-07,המרכז,2640,ראש העין,יישוב,787,345,442,87,700,166,765,24,3.31%
2014-07,המרכז,8300,ראשון לציון,יישוב,4600,2014,2586,602,3998,1374,4555,84,3.30%
2014-07,המרכז,8400,רחובות,יישוב,2987,1225,1762,547,2440,975,2918,30,4.30%
2014-07,המרכז,8500,רמלה,יישוב,1970,898,1072,123,1847,746,1902,44,5.14%
2014-07,המרכז,8700,רעננה,יישוב,910,396,514,287,623,75,902,6,2.43%
2014-07,המרכז,1304,שוהם,יישוב,179,79,100,66,113,11,179,0,1.63%
2014-07,המרכז,154,תל מונד,יישוב,171,70,101,64,107,19,171,0,2.76%
2014-07,הצפון,473,אבו סנאן,יישוב,660,278,382,9,651,522,652,21,11.31%
2014-07,הצפון,478,אכסאל,יישוב,523,232,291,13,510,448,515,6,9.14%
2014-07,הצפון,529,אעבלין,יישוב,630,250,380,7,623,526,626,10,11.08%
2014-07,הצפון,482,בועיינה-נוג'ידאת,יישוב,401,165,236,3,398,335,388,8,10.13%
2014-07,הצפון,4001,בוקעאתא,יישוב,425,172,253,3,422,362,410,0,14.90%
2014-07,הצפון,998,ביר אל-מכסור,יישוב,442,176,266,5,437,331,439,1,11.89%
2014-07,הצפון,480,בית ג'ן,יישוב,403,121,282,7,396,294,392,1,7.44%
2014-07,הצפון,9200,בית שאן,יישוב,917,417,500,12,905,431,885,54,8.77%
2014-07,הצפון,944,בסמת טבעון,יישוב,222,105,117,1,221,163,217,2,6.77%
2014-07,הצפון,483,בענה,יישוב,367,144,223,4,363,306,363,11,10.99%
2014-07,הצפון,1292,ג'דיידה-מכר,יישוב,1379,594,785,11,1368,1119,1356,39,14.87%
2014-07,הצפון,485,ג'ולס,יישוב,236,69,167,1,235,156,236,1,8.11%
2014-07,הצפון,487,ג'ש (גוש חלב),יישוב,78,38,40,3,75,42,75,1,4.56%
2014-07,הצפון,489,דבורייה,יישוב,401,165,236,12,389,308,399,2,9.36%
2014-07,הצפון,490,דייר אל-אסד,יישוב,392,160,232,6,386,306,391,9,7.67%
2014-07,הצפון,492,דייר חנא,יישוב,673,299,374,9,664,505,670,1,13.79%
2014-07,הצפון,975,זרזיר,יישוב,297,140,157,4,293,200,289,4,9.39%
2014-07,הצפון,496,חורפיש,יישוב,116,51,65,9,107,65,113,4,4.27%
2014-07,הצפון,2034,חצור הגלילית,יישוב,334,153,181,15,319,148,315,12,6.62%
2014-07,הצפון,6700,טבריה,יישוב,1858,791,1067,87,1771,1078,1607,54,7.40%
2014-07,הצפון,962,טובא-זנגרייה,יישוב,391,163,228,4,387,254,377,1,12.37%
2014-07,הצפון,498,טורעאן,יישוב,574,197,377,10,564,457,546,9,9.58%
2014-07,הצפון,8900,טמרה,יישוב,2054,820,1234,15,2039,1780,2023,19,14.32%
2014-07,הצפון,1295,יאנוח-ג'ת,יישוב,161,58,103,9,152,92,158,5,5.65%
2014-07,הצפון,46,יבנאל,יישוב,166,107,59,8,158,132,130,1,8.25%
2014-07,הצפון,499,יפיע,יישוב,664,284,380,19,645,523,652,3,8.35%
2014-07,הצפון,240,יקנעם עילית,יישוב,563,241,322,57,506,148,551,29,4.74%
2014-07,הצפון,502,ירכא,יישוב,547,240,307,1,546,425,538,8,9.26%
2014-07,הצפון,504,כאבול,יישוב,701,287,414,11,690,594,693,1,14.14%
2014-07,הצפון,505,כאוכב אבו אל-היג'א,יישוב,222,97,125,7,215,191,216,2,12.59%
2014-07,הצפון,1296,כסרא-סמיע,יישוב,215,95,120,3,212,161,205,3,6.01%
2014-07,הצפון,978,כעביה-טבאש-חג'אג'רה,יישוב,182,69,113,2,180,139,176,5,7.82%
2014-07,הצפון,1263,כפר ורדים,יישוב,74,25,49,25,49,4,74,0,2.36%
2014-07,הצפון,507,כפר יאסיף,יישוב,456,197,259,5,451,351,449,7,8.72%
2014-07,הצפון,508,כפר כמא,יישוב,75,28,47,3,72,27,75,0,4.59%
2014-07,הצפון,509,כפר כנא,יישוב,1194,472,722,27,1167,979,1128,40,12.74%
2014-07,הצפון,510,כפר מנדא,יישוב,965,424,541,11,954,694,942,1,12.86%
2014-07,הצפון,47,כפר תבור,יישוב,38,18,20,6,32,2,37,0,1.71%
2014-07,הצפון,1139,כרמיאל,יישוב,1772,710,1062,304,1468,822,1674,70,6.46%
2014-07,הצפון,65,מ.א. אל-בטוף,מועצה איזורית,375,144,231,5,370,320,362,3,13.54%
2014-07,הצפון,66,מ.א. בוסתן אל-מרג,מועצה איזורית,52,17,35,2,50,43,52,0,1.69%
2014-07,הצפון,71,מ.א. גולן,מועצה איזורית,174,82,92,14,160,17,172,0,2.10%
2014-07,הצפון,8,מ.א. הגלבוע,מועצה איזורית,836,348,488,47,789,512,821,0,5.88%
2014-07,הצפון,1,מ.א. הגליל העליון,מועצה איזורית,239,108,131,34,205,52,235,0,2.64%
2014-07,הצפון,3,מ.א. הגליל התחתון,מועצה איזורית,147,73,74,22,125,20,138,0,2.42%
2014-07,הצפון,55,מ.א. מבואות החרמון,מועצה איזורית,123,53,70,16,107,16,120,0,3.11%
2014-07,הצפון,13,מ.א. מגידו,מועצה איזורית,107,43,64,20,87,7,107,0,1.89%
2014-07,הצפון,4,מ.א. מטה אשר,מועצה איזורית,458,207,251,68,390,204,450,0,3.41%
2014-07,הצפון,52,מ.א. מעלה יוסף,מועצה איזורית,190,82,108,33,157,54,187,0,3.55%
2014-07,הצפון,2,מ.א. מרום הגליל,מועצה איזורית,311,150,161,19,292,128,304,0,4.69%
2014-07,הצפון,56,מ.א. משגב,מועצה איזורית,566,230,336,105,461,293,553,0,4.50%
2014-07,הצפון,6,מ.א. עמק הירדן,מועצה איזורית,199,93,106,25,174,35,182,0,2.74%
2014-07,הצפון,7,מ.א. עמק המעיינות,מועצה איזורית,174,78,96,18,156,47,171,0,2.76%
2014-07,הצפון,9,מ.א. עמק יזרעאל,מועצה איזורית,374,161,213,118,256,45,368,0,1.99%
2014-07,הצפון,481,מגאר,יישוב,1546,593,953,14,1532,1335,1509,13,16.04%
2014-07,הצפון,516,מג'ד אל-כרום,יישוב,566,234,332,8,558,436,563,13,8.68%
2014-07,הצפון,874,מגדל העמק,יישוב,1098,472,626,76,1022,424,987,79,7.34%
2014-07,הצפון,4201,מג'דל שמס,יישוב,479,177,302,8,471,397,469,3,9.85%
2014-07,הצפון,517,מזרעה,יישוב,175,70,105,2,173,142,171,8,8.75%
2014-07,הצפון,4203,מסעדה,יישוב,213,69,144,2,211,178,208,0,12.41%
2014-07,הצפון,518,מעיליא,יישוב,62,30,32,10,52,28,61,0,3.71%
2014-07,הצפון,1063,מעלות-תרשיחא,יישוב,998,477,520,93,905,496,971,33,8.03%
2014-07,הצפון,520,משהד,יישוב,299,112,187,4,295,247,287,8,8.96%
2014-07,הצפון,9100,נהרייה,יישוב,2066,929,1137,212,1854,1174,2008,75,6.47%
2014-07,הצפון,522,נחף,יישוב,404,188,216,10,394,311,399,17,8.07%
2014-07,הצפון,7300,נצרת,יישוב,3334,1417,1917,84,3250,2608,3264,18,9.41%
2014-07,הצפון,1061,נצרת עילית,יישוב,1931,883,1048,167,1764,1023,1699,121,7.17%
2014-07,הצפון,525,סאג'ור,יישוב,122,43,79,3,119,80,121,0,6.79%
2014-07,הצפון,7500,סח'נין,יישוב,2114,912,1202,25,2089,1791,2100,14,15.09%
2014-07,הצפון,4501,ע'ג'ר,יישוב,102,46,56,2,100,67,102,1,9.82%
2014-07,הצפון,530,עיילבון,יישוב,196,72,124,2,194,137,193,0,7.06%
2014-07,הצפון,511,עילוט,יישוב,359,146,213,3,356,266,353,1,12.41%
2014-07,הצפון,532,עין מאהל,יישוב,561,276,285,6,555,457,537,6,10.24%
2014-07,הצפון,7600,עכו,יישוב,3383,1536,1847,138,3245,2419,3279,57,12.23%
2014-07,הצפון,7700,עפולה,יישוב,1838,730,1108,132,1706,813,1742,101,6.98%
2014-07,הצפון,531,עראבה,יישוב,1553,627,926,22,1531,1328,1538,3,15.26%
2014-07,הצפון,535,פסוטה,יישוב,133,53,80,8,125,79,133,8,7.71%
2014-07,הצפון,536,פקיעין (בוקייעה),יישוב,146,77,69,5,141,93,142,6,5.17%
2014-07,הצפון,8000,צפת,יישוב,1594,852,742,70,1524,1069,1513,55,11.16%
2014-07,הצפון,4100,קצרין,יישוב,240,111,129,17,223,99,237,7,5.95%
2014-07,הצפון,2800,קריית שמונה,יישוב,957,448,509,36,921,353,925,20,7.03%
2014-07,הצפון,543,ראמה,יישוב,320,116,204,10,310,230,315,3,8.09%
2014-07,הצפון,26,ראש פינה,יישוב,70,32,38,8,62,22,68,1,4.25%
2014-07,הצפון,542,ריינה,יישוב,693,287,406,8,685,538,669,8,9.81%
2014-07,הצפון,122,רמת ישי,יישוב,110,42,68,32,78,13,106,0,2.56%
2014-07,הצפון,913,שבלי - אום אל-גנם,יישוב,241,98,143,9,232,161,236,3,9.10%
2014-07,הצפון,812,שלומי,יישוב,263,111,152,21,242,137,258,10,7.13%
2014-07,הצפון,538,שעב,יישוב,546,218,328,5,541,469,543,6,17.65%
2014-07,הצפון,8800,שפרעם,יישוב,2090,803,1287,33,2057,1712,2064,34,11.64%
2014-07,חיפה,2710,אום אל-פחם,יישוב,3896,1563,2333,25,3871,3255,3812,26,18.02%
2014-07,חיפה,1020,אור עקיבא,יישוב,645,274,371,43,602,205,619,17,6.15%
2014-07,חיפה,6000,באקה אל-גרביה,יישוב,730,327,403,11,719,470,726,25,6.25%
2014-07,חיפה,9800,בנימינה-גבעת עדה*,יישוב,214,99,115,48,166,60,213,0,3.02%
2014-07,חיפה,1326,"בסמ""ה",יישוב,433,186,247,4,429,354,425,4,10.67%
2014-07,חיפה,541,ג'סר א-זרקא,יישוב,470,240,230,0,470,325,464,4,7.92%
2014-07,חיפה,628,ג'ת,יישוב,256,116,140,6,250,162,255,6,4.88%
2014-07,חיפה,494,דאלית אל-כרמל,יישוב,559,230,329,7,552,305,536,3,6.81%
2014-07,חיפה,9300,זכרון יעקב,יישוב,266,120,146,69,197,58,264,0,2.44%
2014-07,חיפה,6500,חדרה,יישוב,2664,1134,1530,291,2373,971,2528,65,5.11%
2014-07,חיפה,4000,חיפה,יישוב,6743,3238,3505,1222,5521,3521,6464,156,4.56%
2014-07,חיפה,1247,חריש,יישוב,33,15,18,3,30,6,32,2,2.17%
2014-07,חיפה,2100,טירת כרמל,יישוב,751,363,388,17,734,440,732,21,6.84%
2014-07,חיפה,654,כפר קרע,יישוב,455,194,261,7,448,263,449,10,5.38%
2014-07,חיפה,45,מ.א. אלונה,מועצה איזורית,35,15,20,8,27,4,35,0,3.40%
2014-07,חיפה,12,מ.א. זבולון,מועצה איזורית,276,133,143,21,255,194,271,0,4.98%
2014-07,חיפה,15,מ.א. חוף הכרמל,מועצה איזורית,298,139,159,48,250,62,293,0,2.16%
2014-07,חיפה,14,מ.א. מנשה,מועצה איזורית,277,128,149,61,216,82,273,0,3.50%
2014-07,חיפה,1327,מעלה עירון,יישוב,955,367,588,6,949,787,942,3,15.99%
2014-07,חיפה,2500,נשר,יישוב,494,246,248,85,409,189,482,13,3.78%
2014-07,חיפה,534,עספיא,יישוב,369,169,200,10,359,187,349,9,6.35%
2014-07,חיפה,637,ערערה,יישוב,618,247,371,5,613,422,597,10,7.39%
2014-07,חיפה,537,פוריידיס,יישוב,420,211,209,4,416,270,415,2,7.48%
2014-07,חיפה,7800,פרדס חנה-כרכור,יישוב,911,412,499,121,790,285,896,23,4.47%
2014-07,חיפה,6800,קריית אתא,יישוב,1807,772,1035,144,1663,932,1774,55,5.92%
2014-07,חיפה,9500,קריית ביאליק,יישוב,1069,451,618,128,941,548,1050,43,4.90%
2014-07,חיפה,2300,קריית טבעון,יישוב,208,102,106,72,136,44,203,2,2.38%
2014-07,חיפה,9600,קריית ים,יישוב,1561,716,845,155,1406,896,1530,40,7.16%
2014-07,חיפה,8200,קריית מוצקין,יישוב,1129,497,632,157,972,530,1106,32,4.83%
2014-07,חיפה,922,רכסים,יישוב,212,67,145,8,204,75,207,0,5.94%
2014-07,ירושלים,472,אבו גוש,יישוב,253,133,120,4,249,178,252,2,8.27%
2014-07,ירושלים,2610,בית שמש,יישוב,1569,639,930,90,1479,526,1526,51,4.78%
2014-07,ירושלים,3000,ירושלים,יישוב,13164,5766,7398,1402,11762,7379,12903,137,4.33%
2014-07,ירושלים,26,מ.א. מטה יהודה,מועצה איזורית,703,320,383,126,577,133,688,1,2.99%
2014-07,ירושלים,1015,מבשרת ציון,יישוב,412,200,212,74,338,165,406,4,3.04%
2014-07,ירושלים,1137,קריית יערים,יישוב,49,19,30,5,44,16,48,1,3.64%
2014-07,תל אביב,2400,אור יהודה,יישוב,925,449,476,34,891,249,886,41,4.68%
2014-07,תל אביב,565,אזור,יישוב,181,88,93,15,166,32,179,2,2.79%
2014-07,תל אביב,6100,בני ברק,יישוב,2921,1133,1787,59,2862,1203,2818,23,4.99%
2014-07,תל אביב,6200,בת ים,יישוב,3257,1546,1711,413,2844,1174,3124,87,4.40%
2014-07,תל אביב,6300,גבעתיים,יישוב,805,352,453,315,490,87,800,5,2.63%
2014-07,תל אביב,6400,הרצלייה,יישוב,1139,428,711,215,924,44,1111,41,2.30%
2014-07,תל אביב,6600,חולון,יישוב,3299,1515,1784,357,2942,839,3210,74,3.23%
2014-07,תל אביב,2620,קריית אונו,יישוב,398,178,220,122,276,51,392,4,2.08%
2014-07,תל אביב,8600,רמת גן,יישוב,2138,948,1190,616,1522,438,2103,24,2.69%
2014-07,תל אביב,2650,רמת השרון,יישוב,406,165,241,108,298,3,404,6,1.80%
2014-07,תל אביב,5000,תל אביב -יפו,יישוב,7740,3823,3917,2383,5357,2277,7564,108,3.00%
2014-08,אזור יהודה והשומרון,3760,אורנית,יישוב,126,50,76,39,87,1,125,0,2.66%
2014-08,אזור יהודה והשומרון,3750,אלפי מנשה,יישוב,116,46,70,32,84,1,115,1,2.69%
2014-08,אזור יהודה והשומרון,3560,אלקנה,יישוב,49,24,25,20,29,2,49,0,2.56%
2014-08,אזור יהודה והשומרון,3650,אפרת,יישוב,55,31,24,18,37,3,55,1,1.35%
2014-08,אזור יהודה והשומרון,3570,אריאל,יישוב,369,175,194,48,321,73,361,11,3.43%
2014-08,אזור יהודה והשומרון,3574,בית אל,יישוב,59,29,30,14,45,16,59,2,2.40%
2014-08,אזור יהודה והשומרון,3652,בית אריה,יישוב,69,26,43,8,61,3,68,3,2.65%
2014-08,אזור יהודה והשומרון,3780,ביתר עילית,יישוב,767,285,482,8,759,246,760,6,6.12%
2014-08,אזור יהודה והשומרון,3730,גבעת זאב,יישוב,234,109,125,41,193,45,229,1,3.03%
2014-08,אזור יהודה והשומרון,3769,הר אדר,יישוב,31,16,15,11,20,4,31,0,1.50%
2014-08,אזור יהודה והשומרון,76,מ.א. גוש עציון,מועצה איזורית,180,87,93,53,127,15,178,1,1.92%
2014-08,אזור יהודה והשומרון,78,מ.א. הר חברון,מועצה איזורית,68,31,37,14,54,10,66,0,2.04%
2014-08,אזור יהודה והשומרון,74,מ.א. מגילות ים המלח,מועצה איזורית,13,2,11,3,10,1,13,0,1.72%
2014-08,אזור יהודה והשומרון,73,מ.א. מטה בנימין,מועצה איזורית,678,320,358,145,533,146,669,0,2.81%
2014-08,אזור יהודה והשומרון,75,מ.א. ערבות הירדן,מועצה איזורית,42,16,26,5,37,6,41,0,1.76%
2014-08,אזור יהודה והשומרון,72,מ.א. שומרון,מועצה איזורית,428,212,216,84,344,54,422,0,2.67%
2014-08,אזור יהודה והשומרון,3797,מודיעין עילית,יישוב,852,160,692,17,835,76,843,3,6.25%
2014-08,אזור יהודה והשומרון,3616,מעלה אדומים,יישוב,768,314,454,53,715,199,752,20,3.68%
2014-08,אזור יהודה והשומרון,3660,עמנואל,יישוב,106,53,53,1,105,48,104,0,8.96%
2014-08,אזור יהודה והשומרון,3557,קדומים,יישוב,43,27,16,13,30,7,43,0,2.30%
2014-08,אזור יהודה והשומרון,3611,קריית ארבע,יישוב,140,82,58,6,134,69,135,2,4.21%
2014-08,אזור יהודה והשומרון,3640,קרני שומרון,יישוב,95,48,47,29,66,11,95,0,2.60%
2014-08,הדרום,31,אופקים,יישוב,1445,587,858,75,1370,791,1409,26,10.84%
2014-08,הדרום,2600,אילת,יישוב,1406,598,808,34,1372,502,1381,42,4.14%
2014-08,הדרום,70,אשדוד,יישוב,7869,3093,4776,802,7067,3332,7640,131,6.97%
2014-08,הדרום,7100,אשקלון,יישוב,4898,2008,2890,279,4619,2234,4522,67,6.51%
2014-08,הדרום,9000,באר שבע,יישוב,7774,3411,4362,837,6937,4255,7457,128,7.13%
2014-08,הדרום,2200,דימונה,יישוב,2212,905,1307,106,2106,1368,2134,50,11.53%
2014-08,הדרום,1303,חורה,יישוב,857,364,493,3,854,770,843,1,20.60%
2014-08,הדרום,831,ירוחם,יישוב,540,250,290,15,525,282,501,33,10.80%
2014-08,הדרום,1059,כסיפה,יישוב,1058,403,655,3,1055,927,1051,3,22.40%
2014-08,הדרום,1271,להבים,יישוב,50,19,31,17,33,3,49,1,1.41%
2014-08,הדרום,1060,לקיה,יישוב,1031,463,568,5,1026,930,1016,1,23.67%
2014-08,הדרום,69,מ.א. אל קסום,מועצה איזורית,807,343,464,3,804,724,802,0,62.32%
2014-08,הדרום,38,מ.א. אשכול,מועצה איזורית,137,59,78,17,120,17,136,0,2.05%
2014-08,הדרום,33,מ.א. באר טוביה,מועצה איזורית,389,132,257,42,347,51,387,0,3.74%
2014-08,הדרום,41,מ.א. בני שמעון,מועצה איזורית,68,27,41,19,49,14,66,1,1.63%
2014-08,הדרום,54,מ.א. הערבה התיכונה,מועצה איזורית,38,15,23,9,29,1,38,0,2.11%
2014-08,הדרום,53,מ.א. חבל אילות,מועצה איזורית,29,12,17,4,25,0,29,5,1.36%
2014-08,הדרום,36,מ.א. חוף אשקלון,מועצה איזורית,282,129,153,11,271,59,268,0,3.43%
2014-08,הדרום,35,מ.א. יואב,מועצה איזורית,111,51,60,27,84,21,109,1,2.84%
2014-08,הדרום,50,מ.א. לכיש,מועצה איזורית,221,88,133,21,200,68,219,0,4.62%
2014-08,הדרום,42,מ.א. מרחבים,מועצה איזורית,257,96,161,28,229,46,255,0,4.79%
2014-08,הדרום,68,מ.א. נווה מדבר,מועצה איזורית,124,48,76,0,124,90,122,0,19.65%
2014-08,הדרום,48,מ.א. רמת נגב,מועצה איזורית,193,99,94,14,179,144,189,1,6.58%
2014-08,הדרום,39,מ.א. שדות נגב,מועצה איזורית,169,78,91,10,159,34,163,0,3.90%
2014-08,הדרום,37,מ.א. שער הנגב,מועצה איזורית,159,71,88,37,122,56,156,0,4.20%
2014-08,הדרום,34,מ.א. שפיר,מועצה איזורית,213,97,116,13,200,75,210,0,4.63%
2014-08,הדרום,51,מ.א. תמר,מועצה איזורית,7,3,4,0,7,1,7,0,1.13%
2014-08,הדרום,1268,מיתר,יישוב,88,33,55,20,68,8,85,2,1.98%
2014-08,הדרום,99,מצפה רמון,יישוב,293,107,186,9,284,172,278,20,11.18%
2014-08,הדרום,246,נתיבות,יישוב,1416,590,826,50,1366,580,1362,36,9.53%
2014-08,הדרום,666,עומר,יישוב,65,28,37,23,42,4,65,0,1.61%
2014-08,הדרום,2560,ערד,יישוב,952,401,551,92,860,425,912,34,7.34%
2014-08,הדרום,1192,ערערה-בנגב,יישוב,1081,451,630,7,1074,961,1073,3,25.37%
2014-08,הדרום,2630,קריית גת,יישוב,2349,906,1443,135,2214,1204,2277,20,7.96%
2014-08,הדרום,1034,קריית מלאכי,יישוב,1295,591,704,22,1273,688,1250,32,10.60%
2014-08,הדרום,1161,רהט,יישוב,3540,1474,2066,9,3531,2787,3485,39,18.05%
2014-08,הדרום,1286,שגב-שלום,יישוב,613,217,396,5,608,509,605,1,22.14%
2014-08,הדרום,1031,שדרות,יישוב,1243,545,698,55,1188,656,1196,25,9.25%
2014-08,הדרום,1054,תל שבע,יישוב,1269,595,674,3,1266,1159,1252,1,25.04%
2014-08,המרכז,182,אבן יהודה,יישוב,166,78,88,69,97,16,165,4,2.45%
2014-08,המרכז,41,אליכין,יישוב,87,36,51,6,81,19,83,1,4.38%
2014-08,המרכז,1309,אלעד,יישוב,607,215,392,12,595,92,600,1,4.74%
2014-08,המרכז,2530,באר יעקב,יישוב,329,124,205,52,277,52,326,7,3.57%
2014-08,המרכז,466,בית דגן,יישוב,109,61,48,7,102,36,109,1,3.05%
2014-08,המרכז,1066,"בני עי""ש",יישוב,201,100,101,27,174,74,197,2,4.96%
2014-08,המרכז,681,גבעת שמואל,יישוב,308,155,153,42,266,67,301,0,2.52%
2014-08,המרכז,2550,גדרה,יישוב,479,194,285,100,379,122,465,6,3.96%
2014-08,המרכז,627,ג'לג'וליה,יישוב,85,37,48,2,83,47,81,2,2.24%
2014-08,המרכז,166,גן יבנה,יישוב,466,183,283,71,395,87,460,4,4.00%
2014-08,המרכז,229,גני תקווה,יישוב,215,89,126,61,154,24,212,0,2.54%
2014-08,המרכז,9700,הוד השרון,יישוב,688,311,377,202,486,72,682,6,2.30%
2014-08,המרכז,1290,זמר,יישוב,182,59,123,2,180,120,180,6,6.10%
2014-08,המרכז,2730,טייבה,יישוב,1757,734,1023,11,1746,1448,1625,33,9.32%
2014-08,המרכז,2720,טירה,יישוב,323,146,177,11,312,156,311,5,2.74%
2014-08,המרכז,2660,יבנה,יישוב,1028,492,536,94,934,336,1010,5,4.33%
2014-08,המרכז,9400,יהוד,יישוב,519,204,315,80,439,71,506,15,3.18%
2014-08,המרכז,1224,כוכב יאיר,יישוב,98,40,58,43,55,0,96,0,1.70%
2014-08,המרכז,633,כפר ברא,יישוב,20,10,10,0,20,11,20,0,1.47%
2014-08,המרכז,168,כפר יונה,יישוב,347,134,213,69,278,67,342,5,3.16%
2014-08,המרכז,6900,כפר סבא,יישוב,1339,601,738,370,969,152,1321,10,2.49%
2014-08,המרכז,634,כפר קאסם,יישוב,264,128,136,3,261,133,254,4,2.88%
2014-08,המרכז,7000,לוד,יישוב,2362,1054,1308,153,2209,1182,2328,34,6.57%
2014-08,המרכז,28,מ.א. ברנר,מועצה איזורית,98,41,57,34,64,4,98,2,2.51%
2014-08,המרכז,32,מ.א. גדרות,מועצה איזורית,46,17,29,19,27,5,46,0,2.02%
2014-08,המרכז,30,מ.א. גזר,מועצה איזורית,302,113,189,67,235,31,301,0,2.37%
2014-08,המרכז,27,מ.א. גן רווה,מועצה איזורית,63,28,35,20,43,1,63,0,2.31%
2014-08,המרכז,20,מ.א. דרום השרון,מועצה איזורית,352,152,200,111,241,14,348,0,2.29%
2014-08,המרכז,29,מ.א. חבל יבנה,מועצה איזורית,46,17,29,13,33,3,45,0,1.88%
2014-08,המרכז,25,מ.א. חבל מודיעין,מועצה איזורית,276,120,156,61,215,26,273,0,2.61%
2014-08,המרכז,19,מ.א. חוף השרון,מועצה איזורית,108,51,57,38,70,5,107,0,1.96%
2014-08,המרכז,18,מ.א. לב השרון,מועצה איזורית,244,125,119,66,178,30,243,0,2.24%
2014-08,המרכז,31,מ.א. נחל שורק,מועצה איזורית,71,35,36,16,55,5,71,26,1.57%
2014-08,המרכז,16,מ.א. עמק חפר,מועצה איזורית,428,154,274,143,285,30,421,0,2.15%
2014-08,המרכז,40,מ.א. עמק לוד,מועצה איזורית,160,67,93,25,135,20,160,0,2.63%
2014-08,המרכז,1200,מודיעין-מכבים-רעות*,יישוב,1115,439,676,278,837,62,1095,17,2.53%
2014-08,המרכז,28,מזכרת בתיה,יישוב,238,91,147,56,182,36,237,2,3.35%
2014-08,המרכז,7200,נס ציונה,יישוב,796,356,440,160,636,202,791,7,3.37%
2014-08,המרכז,7400,נתניה,יישוב,4980,2125,2855,632,4348,1568,4869,93,4.63%
2014-08,המרכז,587,סביון*,יישוב,26,15,11,10,16,1,26,0,1.34%
2014-08,המרכז,171,פרדסייה,יישוב,66,32,34,19,47,5,66,0,1.84%
2014-08,המרכז,7900,פתח תקווה,יישוב,4492,1872,2620,885,3607,1102,4414,58,3.55%
2014-08,המרכז,195,קדימה-צורן,יישוב,281,113,168,78,203,43,277,2,2.62%
2014-08,המרכז,638,קלנסווה,יישוב,683,295,388,8,675,566,638,7,7.37%
2014-08,המרכז,469,קריית עקרון,יישוב,403,184,219,25,378,143,396,11,6.61%
2014-08,המרכז,2640,ראש העין,יישוב,868,361,507,94,774,162,847,11,3.65%
2014-08,המרכז,8300,ראשון לציון,יישוב,4736,2038,2698,561,4175,1350,4682,99,3.39%
2014-08,המרכז,8400,רחובות,יישוב,3112,1200,1912,546,2566,969,3037,47,4.46%
2014-08,המרכז,8500,רמלה,יישוב,2007,913,1094,120,1887,749,1937,51,5.23%
2014-08,המרכז,8700,רעננה,יישוב,900,379,521,288,612,71,895,8,2.41%
2014-08,המרכז,1304,שוהם,יישוב,172,76,96,61,111,10,172,1,1.56%
2014-08,המרכז,154,תל מונד,יישוב,185,73,112,68,117,19,184,2,2.96%
2014-08,הצפון,473,אבו סנאן,יישוב,652,277,375,8,644,521,643,15,11.17%
2014-08,הצפון,478,אכסאל,יישוב,531,237,294,12,519,456,523,1,9.27%
2014-08,הצפון,529,אעבלין,יישוב,639,256,383,4,635,528,633,5,11.19%
2014-08,הצפון,482,בועיינה-נוג'ידאת,יישוב,404,171,233,8,396,339,391,3,10.20%
2014-08,הצפון,4001,בוקעאתא,יישוב,430,175,255,3,427,361,409,1,14.87%
2014-08,הצפון,998,ביר אל-מכסור,יישוב,446,177,269,5,441,341,443,4,11.99%
2014-08,הצפון,480,בית ג'ן,יישוב,404,130,274,5,399,298,393,1,7.46%
2014-08,הצפון,9200,בית שאן,יישוב,937,431,506,17,920,434,899,54,8.89%
2014-08,הצפון,944,בסמת טבעון,יישוב,221,107,114,1,220,159,216,4,6.74%
2014-08,הצפון,483,בענה,יישוב,376,144,232,4,372,314,373,12,11.26%
2014-08,הצפון,1292,ג'דיידה-מכר,יישוב,1382,597,785,12,1370,1111,1355,49,14.87%
2014-08,הצפון,485,ג'ולס,יישוב,234,70,164,1,233,155,234,3,8.04%
2014-08,הצפון,487,ג'ש (גוש חלב),יישוב,72,38,34,1,71,42,69,2,4.21%
2014-08,הצפון,489,דבורייה,יישוב,405,165,240,12,393,303,402,1,9.42%
2014-08,הצפון,490,דייר אל-אסד,יישוב,399,156,243,6,393,305,397,10,7.78%
2014-08,הצפון,492,דייר חנא,יישוב,668,297,371,9,659,502,663,2,13.66%
2014-08,הצפון,975,זרזיר,יישוב,300,147,153,3,297,195,285,12,9.27%
2014-08,הצפון,496,חורפיש,יישוב,115,56,59,6,109,63,114,1,4.30%
2014-08,הצפון,2034,חצור הגלילית,יישוב,306,132,174,13,293,146,286,12,6.05%
2014-08,הצפון,6700,טבריה,יישוב,1849,776,1073,92,1757,1025,1624,65,7.47%
2014-08,הצפון,962,טובא-זנגרייה,יישוב,381,163,218,4,377,260,369,8,12.14%
2014-08,הצפון,498,טורעאן,יישוב,591,222,369,14,577,467,545,7,9.56%
2014-08,הצפון,8900,טמרה,יישוב,2064,827,1237,14,2050,1778,2033,23,14.38%
2014-08,הצפון,1295,יאנוח-ג'ת,יישוב,157,55,102,10,147,92,156,2,5.59%
2014-08,הצפון,46,יבנאל,יישוב,172,110,62,10,162,124,140,2,8.83%
2014-08,הצפון,499,יפיע,יישוב,664,280,384,13,651,531,653,2,8.36%
2014-08,הצפון,240,יקנעם עילית,יישוב,565,239,326,59,506,143,554,31,4.77%
2014-08,הצפון,502,ירכא,יישוב,556,245,311,1,555,425,545,7,9.36%
2014-08,הצפון,504,כאבול,יישוב,697,284,413,10,687,591,690,4,14.08%
2014-08,הצפון,505,כאוכב אבו אל-היג'א,יישוב,222,93,129,9,213,188,217,0,12.65%
2014-08,הצפון,1296,כסרא-סמיע,יישוב,199,81,118,2,197,144,193,3,5.68%
2014-08,הצפון,978,כעביה-טבאש-חג'אג'רה,יישוב,176,65,111,4,172,137,172,1,7.65%
2014-08,הצפון,1263,כפר ורדים,יישוב,80,35,45,38,42,5,80,1,2.55%
2014-08,הצפון,507,כפר יאסיף,יישוב,448,195,253,4,444,348,438,9,8.52%
2014-08,הצפון,508,כפר כמא,יישוב,73,28,45,4,69,27,73,2,4.47%
2014-08,הצפון,509,כפר כנא,יישוב,1209,493,716,24,1185,999,1134,25,12.80%
2014-08,הצפון,510,כפר מנדא,יישוב,964,410,554,8,956,700,946,21,12.91%
2014-08,הצפון,47,כפר תבור,יישוב,39,17,22,10,29,2,37,0,1.71%
2014-08,הצפון,1139,כרמיאל,יישוב,1767,715,1052,298,1469,797,1673,63,6.45%
2014-08,הצפון,65,מ.א. אל-בטוף,מועצה איזורית,396,163,233,7,389,329,377,0,14.11%
2014-08,הצפון,66,מ.א. בוסתן אל-מרג,מועצה איזורית,51,17,34,2,49,43,51,0,1.66%
2014-08,הצפון,71,מ.א. גולן,מועצה איזורית,184,83,101,16,168,18,184,3,2.24%
2014-08,הצפון,8,מ.א. הגלבוע,מועצה איזורית,863,329,534,44,819,522,844,0,6.04%
2014-08,הצפון,1,מ.א. הגליל העליון,מועצה איזורית,247,110,137,40,207,47,242,0,2.72%
2014-08,הצפון,3,מ.א. הגליל התחתון,מועצה איזורית,151,72,79,31,120,15,142,0,2.49%
2014-08,הצפון,55,מ.א. מבואות החרמון,מועצה איזורית,120,54,66,18,102,18,119,0,3.09%
2014-08,הצפון,13,מ.א. מגידו,מועצה איזורית,110,47,63,13,97,8,110,0,1.94%
2014-08,הצפון,4,מ.א. מטה אשר,מועצה איזורית,465,220,245,63,402,205,458,0,3.47%
2014-08,הצפון,52,מ.א. מעלה יוסף,מועצה איזורית,196,92,104,35,161,53,194,1,3.69%
2014-08,הצפון,2,מ.א. מרום הגליל,מועצה איזורית,312,159,153,18,294,121,302,0,4.66%
2014-08,הצפון,56,מ.א. משגב,מועצה איזורית,573,228,345,109,464,290,561,0,4.56%
2014-08,הצפון,6,מ.א. עמק הירדן,מועצה איזורית,202,98,104,22,180,35,183,0,2.75%
2014-08,הצפון,7,מ.א. עמק המעיינות,מועצה איזורית,175,84,91,20,155,44,169,0,2.73%
2014-08,הצפון,9,מ.א. עמק יזרעאל,מועצה איזורית,387,166,221,130,257,43,380,0,2.06%
2014-08,הצפון,481,מגאר,יישוב,1546,607,939,14,1532,1333,1505,13,16.01%
2014-08,הצפון,516,מג'ד אל-כרום,יישוב,579,241,338,7,572,430,574,14,8.84%
2014-08,הצפון,874,מגדל העמק,יישוב,1098,460,638,70,1028,418,993,72,7.38%
2014-08,הצפון,4201,מג'דל שמס,יישוב,471,166,305,8,463,402,459,7,9.66%
2014-08,הצפון,517,מזרעה,יישוב,178,68,110,1,177,148,171,5,8.75%
2014-08,הצפון,4203,מסעדה,יישוב,208,71,137,2,206,178,201,4,12.04%
2014-08,הצפון,518,מעיליא,יישוב,55,26,29,8,47,27,54,1,3.30%
2014-08,הצפון,1063,מעלות-תרשיחא,יישוב,893,427,466,94,799,480,874,34,7.29%
2014-08,הצפון,520,משהד,יישוב,293,115,178,4,289,240,282,1,8.82%
2014-08,הצפון,9100,נהרייה,יישוב,2054,930,1124,197,1857,1174,1980,87,6.39%
2014-08,הצפון,522,נחף,יישוב,409,193,216,9,400,315,402,13,8.13%
2014-08,הצפון,7300,נצרת,יישוב,3364,1427,1937,83,3281,2629,3286,19,9.47%
2014-08,הצפון,1061,נצרת עילית,יישוב,1945,892,1053,174,1771,974,1754,117,7.39%
2014-08,הצפון,525,סאג'ור,יישוב,115,41,74,4,111,73,114,0,6.43%
2014-08,הצפון,7500,סח'נין,יישוב,2125,903,1222,27,2098,1795,2111,7,15.15%
2014-08,הצפון,4501,ע'ג'ר,יישוב,109,51,58,3,106,69,108,0,10.33%
2014-08,הצפון,530,עיילבון,יישוב,190,75,115,1,189,132,188,2,6.89%
2014-08,הצפון,511,עילוט,יישוב,364,147,217,3,361,267,360,1,12.62%
2014-08,הצפון,532,עין מאהל,יישוב,542,254,288,7,535,444,522,3,9.98%
2014-08,הצפון,7600,עכו,יישוב,3362,1528,1834,138,3224,2398,3251,63,12.14%
2014-08,הצפון,7700,עפולה,יישוב,1867,755,1112,126,1741,804,1765,77,7.06%
2014-08,הצפון,531,עראבה,יישוב,1555,631,924,22,1533,1321,1543,7,15.31%
2014-08,הצפון,535,פסוטה,יישוב,121,48,73,7,114,76,121,4,7.06%
2014-08,הצפון,536,פקיעין (בוקייעה),יישוב,147,76,71,6,141,90,144,4,5.24%
2014-08,הצפון,8000,צפת,יישוב,1548,801,747,66,1482,1048,1476,41,10.92%
2014-08,הצפון,4100,קצרין,יישוב,229,105,124,16,213,97,225,9,5.67%
2014-08,הצפון,2800,קריית שמונה,יישוב,900,406,494,38,862,372,863,25,6.59%
2014-08,הצפון,543,ראמה,יישוב,318,118,200,11,307,230,313,2,8.04%
2014-08,הצפון,26,ראש פינה,יישוב,69,31,38,11,58,22,67,1,4.19%
2014-08,הצפון,542,ריינה,יישוב,703,290,413,10,693,546,670,13,9.83%
2014-08,הצפון,122,רמת ישי,יישוב,109,42,67,34,75,15,106,0,2.56%
2014-08,הצפון,913,שבלי - אום אל-גנם,יישוב,266,109,157,10,256,171,262,0,10.01%
2014-08,הצפון,812,שלומי,יישוב,261,108,153,17,244,141,255,5,7.06%
2014-08,הצפון,538,שעב,יישוב,543,218,325,5,538,464,542,2,17.62%
2014-08,הצפון,8800,שפרעם,יישוב,2105,804,1301,34,2071,1704,2076,34,11.70%
2014-08,חיפה,2710,אום אל-פחם,יישוב,3972,1604,2368,28,3944,3303,3879,31,18.27%
2014-08,חיפה,1020,אור עקיבא,יישוב,607,245,362,46,561,201,588,16,5.86%
2014-08,חיפה,6000,באקה אל-גרביה,יישוב,741,333,408,8,733,451,734,24,6.32%
2014-08,חיפה,9800,בנימינה-גבעת עדה*,יישוב,208,98,110,40,168,61,207,1,2.94%
2014-08,חיפה,1326,"בסמ""ה",יישוב,441,194,247,4,437,352,436,6,10.91%
2014-08,חיפה,541,ג'סר א-זרקא,יישוב,499,257,242,1,498,326,495,0,8.40%
2014-08,חיפה,628,ג'ת,יישוב,258,122,136,9,249,155,255,9,4.88%
2014-08,חיפה,494,דאלית אל-כרמל,יישוב,551,218,333,9,542,297,531,5,6.75%
2014-08,חיפה,9300,זכרון יעקב,יישוב,278,118,160,76,202,55,275,1,2.54%
2014-08,חיפה,6500,חדרה,יישוב,2666,1097,1569,285,2381,943,2532,62,5.12%
2014-08,חיפה,4000,חיפה,יישוב,6784,3238,3546,1215,5569,3483,6507,193,4.58%
2014-08,חיפה,1247,חריש,יישוב,31,14,17,2,29,8,30,0,2.04%
2014-08,חיפה,2100,טירת כרמל,יישוב,761,367,394,17,744,428,740,15,6.90%
2014-08,חיפה,654,כפר קרע,יישוב,451,193,258,8,443,270,442,12,5.30%
2014-08,חיפה,45,מ.א. אלונה,מועצה איזורית,32,18,14,7,25,5,32,0,3.11%
2014-08,חיפה,12,מ.א. זבולון,מועצה איזורית,273,124,149,19,254,198,268,0,4.92%
2014-08,חיפה,15,מ.א. חוף הכרמל,מועצה איזורית,305,136,169,50,255,59,298,1,2.20%
2014-08,חיפה,14,מ.א. מנשה,מועצה איזורית,272,121,151,59,213,78,268,0,3.43%
2014-08,חיפה,1327,מעלה עירון,יישוב,972,370,602,8,964,790,960,6,16.25%
2014-08,חיפה,2500,נשר,יישוב,496,239,257,90,406,191,483,8,3.79%
2014-08,חיפה,534,עספיא,יישוב,365,169,196,15,350,174,352,8,6.40%
2014-08,חיפה,637,ערערה,יישוב,628,262,366,5,623,421,612,19,7.56%
2014-08,חיפה,537,פוריידיס,יישוב,448,228,220,3,445,282,443,8,7.94%
2014-08,חיפה,7800,פרדס חנה-כרכור,יישוב,923,421,502,124,799,288,915,31,4.56%
2014-08,חיפה,6800,קריית אתא,יישוב,1822,767,1055,152,1670,917,1787,44,5.96%
2014-08,חיפה,9500,קריית ביאליק,יישוב,1061,446,615,121,940,528,1045,41,4.88%
2014-08,חיפה,2300,קריית טבעון,יישוב,211,111,100,71,140,44,204,1,2.39%
2014-08,חיפה,9600,קריית ים,יישוב,1570,721,849,153,1417,866,1537,49,7.19%
2014-08,חיפה,8200,קריית מוצקין,יישוב,1091,458,633,145,946,514,1068,32,4.67%
2014-08,חיפה,922,רכסים,יישוב,220,71,149,6,214,78,213,1,6.10%
2014-08,ירושלים,472,אבו גוש,יישוב,259,133,126,5,254,177,258,6,8.45%
2014-08,ירושלים,2610,בית שמש,יישוב,1631,629,1002,75,1556,511,1589,34,4.97%
2014-08,ירושלים,3000,ירושלים,יישוב,13666,5965,7701,1406,12260,7432,13412,124,4.49%
2014-08,ירושלים,26,מ.א. מטה יהודה,מועצה איזורית,729,329,400,115,614,131,711,1,3.09%
2014-08,ירושלים,1015,מבשרת ציון,יישוב,433,204,229,74,359,167,426,4,3.19%
2014-08,ירושלים,1137,קריית יערים,יישוב,51,18,33,6,45,17,51,0,3.85%
2014-08,תל אביב,2400,אור יהודה,יישוב,948,419,529,28,920,235,906,38,4.78%
2014-08,תל אביב,565,אזור,יישוב,183,93,90,18,165,34,179,1,2.79%
2014-08,תל אביב,6100,בני ברק,יישוב,3109,1092,2016,57,3052,1172,3005,21,5.31%
2014-08,תל אביב,6200,בת ים,יישוב,3247,1509,1738,420,2827,1178,3110,97,4.38%
2014-08,תל אביב,6300,גבעתיים,יישוב,830,362,468,327,503,85,825,9,2.71%
2014-08,תל אביב,6400,הרצלייה,יישוב,1226,452,774,232,994,38,1196,48,2.47%
2014-08,תל אביב,6600,חולון,יישוב,3321,1512,1809,329,2992,847,3236,70,3.26%
2014-08,תל אביב,2620,קריית אונו,יישוב,413,185,228,126,287,53,407,3,2.16%
2014-08,תל אביב,8600,רמת גן,יישוב,2188,952,1236,629,1559,443,2150,25,2.75%
2014-08,תל אביב,2650,רמת השרון,יישוב,430,169,261,121,309,2,427,1,1.90%
2014-08,תל אביב,5000,תל אביב -יפו,יישוב,7838,3902,3936,2335,5503,2237,7667,142,3.04%
2014-09,אזור יהודה והשומרון,3760,אורנית,יישוב,120,45,75,41,79,1,119,0,2.53%
2014-09,אזור יהודה והשומרון,3750,אלפי מנשה,יישוב,106,40,66,33,73,2,106,2,2.48%
2014-09,אזור יהודה והשומרון,3560,אלקנה,יישוב,44,21,23,17,27,1,44,0,2.30%
2014-09,אזור יהודה והשומרון,3650,אפרת,יישוב,65,36,29,21,44,3,63,1,1.54%
2014-09,אזור יהודה והשומרון,3570,אריאל,יישוב,371,174,197,52,319,71,363,9,3.45%
2014-09,אזור יהודה והשומרון,3574,בית אל,יישוב,58,28,30,14,44,20,57,1,2.32%
2014-09,אזור יהודה והשומרון,3652,בית אריה,יישוב,63,24,39,8,55,3,63,0,2.46%
2014-09,אזור יהודה והשומרון,3780,ביתר עילית,יישוב,692,276,416,8,684,255,686,7,5.56%
2014-09,אזור יהודה והשומרון,3730,גבעת זאב,יישוב,231,95,136,42,189,45,227,5,3.00%
2014-09,אזור יהודה והשומרון,3769,הר אדר,יישוב,34,18,16,12,22,3,34,0,1.65%
2014-09,אזור יהודה והשומרון,76,מ.א. גוש עציון,מועצה איזורית,182,86,96,48,134,15,179,0,1.93%
2014-09,אזור יהודה והשומרון,78,מ.א. הר חברון,מועצה איזורית,77,37,40,20,57,8,75,0,2.32%
2014-09,אזור יהודה והשומרון,74,מ.א. מגילות ים המלח,מועצה איזורית,15,4,11,4,11,1,15,0,1.98%
2014-09,אזור יהודה והשומרון,73,מ.א. מטה בנימין,מועצה איזורית,677,311,366,142,535,150,666,0,2.79%
2014-09,אזור יהודה והשומרון,75,מ.א. ערבות הירדן,מועצה איזורית,49,24,25,7,42,5,49,0,2.10%
2014-09,אזור יהודה והשומרון,72,מ.א. שומרון,מועצה איזורית,426,207,219,88,338,49,419,0,2.65%
2014-09,אזור יהודה והשומרון,3797,מודיעין עילית,יישוב,640,146,494,17,623,89,627,7,4.72%
2014-09,אזור יהודה והשומרון,3616,מעלה אדומים,יישוב,696,301,395,55,641,199,684,20,3.36%
2014-09,אזור יהודה והשומרון,3660,עמנואל,יישוב,84,47,37,1,83,46,84,5,7.36%
2014-09,אזור יהודה והשומרון,3557,קדומים,יישוב,45,20,25,15,30,7,43,1,2.30%
2014-09,אזור יהודה והשומרון,3611,קריית ארבע,יישוב,138,74,64,10,128,65,133,4,4.15%
2014-09,אזור יהודה והשומרון,3640,קרני שומרון,יישוב,92,46,46,28,64,11,90,1,2.47%
2014-09,הדרום,31,אופקים,יישוב,1497,599,898,77,1420,794,1448,45,11.11%
2014-09,הדרום,2600,אילת,יישוב,1428,637,791,38,1390,508,1401,54,4.20%
2014-09,הדרום,70,אשדוד,יישוב,7052,2837,4215,771,6281,3325,6831,233,6.27%
2014-09,הדרום,7100,אשקלון,יישוב,4662,1885,2777,263,4399,2266,4270,112,6.17%
2014-09,הדרום,9000,באר שבע,יישוב,7376,3200,4175,803,6573,4232,7077,184,6.79%
2014-09,הדרום,2200,דימונה,יישוב,2141,903,1238,115,2026,1361,2052,44,11.13%
2014-09,הדרום,1303,חורה,יישוב,846,350,496,5,841,771,835,2,20.44%
2014-09,הדרום,831,ירוחם,יישוב,509,238,271,14,495,273,476,19,10.31%
2014-09,הדרום,1059,כסיפה,יישוב,1035,399,636,4,1031,926,1028,3,22.02%
2014-09,הדרום,1271,להבים,יישוב,55,23,32,20,35,4,54,2,1.55%
2014-09,הדרום,1060,לקיה,יישוב,1017,457,560,5,1012,930,1003,5,23.44%
2014-09,הדרום,69,מ.א. אל קסום,מועצה איזורית,794,335,459,4,790,725,786,0,61.12%
2014-09,הדרום,38,מ.א. אשכול,מועצה איזורית,158,69,89,25,133,17,155,0,2.34%
2014-09,הדרום,33,מ.א. באר טוביה,מועצה איזורית,345,123,222,43,302,53,341,0,3.30%
2014-09,הדרום,41,מ.א. בני שמעון,מועצה איזורית,59,26,33,20,39,12,58,0,1.44%
2014-09,הדרום,54,מ.א. הערבה התיכונה,מועצה איזורית,34,14,20,5,29,2,33,0,1.83%
2014-09,הדרום,53,מ.א. חבל אילות,מועצה איזורית,26,9,17,2,24,0,26,2,1.22%
2014-09,הדרום,36,מ.א. חוף אשקלון,מועצה איזורית,258,111,147,11,247,59,250,0,3.20%
2014-09,הדרום,35,מ.א. יואב,מועצה איזורית,127,56,71,25,102,22,124,0,3.23%
2014-09,הדרום,50,מ.א. לכיש,מועצה איזורית,237,90,147,23,214,72,234,0,4.94%
2014-09,הדרום,42,מ.א. מרחבים,מועצה איזורית,258,92,166,27,231,49,256,0,4.80%
2014-09,הדרום,68,מ.א. נווה מדבר,מועצה איזורית,119,45,74,0,119,95,117,0,18.84%
2014-09,הדרום,48,מ.א. רמת נגב,מועצה איזורית,205,104,101,17,188,148,201,0,6.99%
2014-09,הדרום,39,מ.א. שדות נגב,מועצה איזורית,185,84,101,12,173,37,174,0,4.17%
2014-09,הדרום,37,מ.א. שער הנגב,מועצה איזורית,150,63,87,32,118,61,144,1,3.87%
2014-09,הדרום,34,מ.א. שפיר,מועצה איזורית,223,92,131,16,207,70,218,0,4.80%
2014-09,הדרום,51,מ.א. תמר,מועצה איזורית,8,2,6,1,7,0,8,0,1.29%
2014-09,הדרום,1268,מיתר,יישוב,72,30,42,24,48,7,68,1,1.59%
2014-09,הדרום,99,מצפה רמון,יישוב,285,110,175,10,275,172,272,16,10.96%
2014-09,הדרום,246,נתיבות,יישוב,1325,528,797,51,1274,569,1267,68,8.92%
2014-09,הדרום,666,עומר,יישוב,68,27,41,22,46,4,65,0,1.61%
2014-09,הדרום,2560,ערד,יישוב,920,399,521,82,838,422,884,38,7.13%
2014-09,הדרום,1192,ערערה-בנגב,יישוב,1094,463,631,5,1089,978,1081,1,25.51%
2014-09,הדרום,2630,קריית גת,יישוב,2516,972,1544,124,2392,1210,2433,68,8.46%
2014-09,הדרום,1034,קריית מלאכי,יישוב,1390,624,766,21,1369,681,1340,65,11.28%
2014-09,הדרום,1161,רהט,יישוב,3386,1384,2002,4,3382,2819,3348,31,17.46%
2014-09,הדרום,1286,שגב-שלום,יישוב,609,219,390,4,605,520,600,2,22.00%
2014-09,הדרום,1031,שדרות,יישוב,1209,521,688,57,1152,653,1159,23,8.99%
2014-09,הדרום,1054,תל שבע,יישוב,1255,587,668,4,1251,1167,1238,6,24.83%
2014-09,המרכז,182,אבן יהודה,יישוב,171,84,87,64,107,16,170,1,2.53%
2014-09,המרכז,41,אליכין,יישוב,80,37,43,5,75,18,76,0,4.02%
2014-09,המרכז,1309,אלעד,יישוב,559,210,349,11,548,87,550,3,4.36%
2014-09,המרכז,2530,באר יעקב,יישוב,316,113,203,55,261,57,310,2,3.40%
2014-09,המרכז,466,בית דגן,יישוב,105,56,49,7,98,35,105,1,2.94%
2014-09,המרכז,1066,"בני עי""ש",יישוב,197,100,97,29,168,72,195,2,4.91%
2014-09,המרכז,681,גבעת שמואל,יישוב,321,164,157,37,284,68,314,1,2.62%
2014-09,המרכז,2550,גדרה,יישוב,443,181,262,91,352,115,435,12,3.71%
2014-09,המרכז,627,ג'לג'וליה,יישוב,91,42,49,4,87,53,87,2,2.41%
2014-09,המרכז,166,גן יבנה,יישוב,439,160,279,79,360,95,436,10,3.80%
2014-09,המרכז,229,גני תקווה,יישוב,196,86,110,62,134,23,196,0,2.36%
2014-09,המרכז,9700,הוד השרון,יישוב,666,283,383,203,463,70,660,9,2.23%
2014-09,המרכז,1290,זמר,יישוב,180,58,122,3,177,114,179,2,6.06%
2014-09,המרכז,2730,טייבה,יישוב,1725,742,983,15,1710,1419,1581,40,9.10%
2014-09,המרכז,2720,טירה,יישוב,349,156,193,15,334,157,339,6,2.98%
2014-09,המרכז,2660,יבנה,יישוב,1078,504,574,108,970,328,1053,36,4.50%
2014-09,המרכז,9400,יהוד,יישוב,495,204,291,73,422,71,485,18,3.06%
2014-09,המרכז,1224,כוכב יאיר,יישוב,94,39,55,40,54,0,92,0,1.63%
2014-09,המרכז,633,כפר ברא,יישוב,18,8,10,0,18,9,18,0,1.32%
2014-09,המרכז,168,כפר יונה,יישוב,357,144,213,69,288,68,349,8,3.22%
2014-09,המרכז,6900,כפר סבא,יישוב,1311,575,736,367,944,161,1298,22,2.45%
2014-09,המרכז,634,כפר קאסם,יישוב,253,123,130,6,247,130,246,4,2.79%
2014-09,המרכז,7000,לוד,יישוב,2307,1045,1262,155,2152,1191,2266,40,6.41%
2014-09,המרכז,28,מ.א. ברנר,מועצה איזורית,83,34,49,27,56,5,83,3,2.15%
2014-09,המרכז,32,מ.א. גדרות,מועצה איזורית,42,13,29,15,27,6,41,1,1.80%
2014-09,המרכז,30,מ.א. גזר,מועצה איזורית,280,102,178,71,209,32,277,0,2.18%
2014-09,המרכז,27,מ.א. גן רווה,מועצה איזורית,68,32,36,21,47,2,68,0,2.50%
2014-09,המרכז,20,מ.א. דרום השרון,מועצה איזורית,334,142,192,107,227,11,331,0,2.18%
2014-09,המרכז,29,מ.א. חבל יבנה,מועצה איזורית,49,20,29,12,37,3,49,1,2.04%
2014-09,המרכז,25,מ.א. חבל מודיעין,מועצה איזורית,262,112,150,69,193,24,259,0,2.48%
2014-09,המרכז,19,מ.א. חוף השרון,מועצה איזורית,106,53,53,41,65,6,106,0,1.94%
2014-09,המרכז,18,מ.א. לב השרון,מועצה איזורית,238,119,119,70,168,27,236,0,2.18%
2014-09,המרכז,31,מ.א. נחל שורק,מועצה איזורית,79,38,41,16,63,4,77,45,1.69%
2014-09,המרכז,16,מ.א. עמק חפר,מועצה איזורית,392,159,233,136,256,26,385,0,1.97%
2014-09,המרכז,40,מ.א. עמק לוד,מועצה איזורית,159,72,87,29,130,21,155,0,2.55%
2014-09,המרכז,1200,מודיעין-מכבים-רעות*,יישוב,1014,414,600,259,755,64,990,13,2.29%
2014-09,המרכז,28,מזכרת בתיה,יישוב,188,81,107,43,145,38,187,3,2.66%
2014-09,המרכז,7200,נס ציונה,יישוב,729,346,383,159,570,205,723,9,3.09%
2014-09,המרכז,7400,נתניה,יישוב,4744,2076,2668,652,4092,1530,4629,104,4.41%
2014-09,המרכז,587,סביון*,יישוב,24,16,8,8,16,1,24,0,1.23%
2014-09,המרכז,171,פרדסייה,יישוב,67,32,35,18,49,7,66,0,1.84%
2014-09,המרכז,7900,פתח תקווה,יישוב,4294,1797,2497,875,3419,1106,4213,73,3.39%
2014-09,המרכז,195,קדימה-צורן,יישוב,278,123,155,82,196,36,274,1,2.59%
2014-09,המרכז,638,קלנסווה,יישוב,657,268,389,9,648,545,613,19,7.10%
2014-09,המרכז,469,קריית עקרון,יישוב,317,151,166,17,300,137,313,12,5.29%
2014-09,המרכז,2640,ראש העין,יישוב,816,350,466,88,728,158,795,15,3.43%
2014-09,המרכז,8300,ראשון לציון,יישוב,4626,1958,2668,528,4098,1353,4591,108,3.33%
2014-09,המרכז,8400,רחובות,יישוב,2854,1211,1643,538,2316,970,2789,49,4.11%
2014-09,המרכז,8500,רמלה,יישוב,1918,865,1053,126,1792,758,1836,65,4.97%
2014-09,המרכז,8700,רעננה,יישוב,875,373,502,275,600,75,867,14,2.33%
2014-09,המרכז,1304,שוהם,יישוב,173,81,92,59,114,9,173,0,1.57%
2014-09,המרכז,154,תל מונד,יישוב,163,72,91,65,98,17,163,0,2.63%
2014-09,הצפון,473,אבו סנאן,יישוב,665,273,392,7,658,522,658,22,11.41%
2014-09,הצפון,478,אכסאל,יישוב,523,240,283,12,511,453,516,1,9.16%
2014-09,הצפון,529,אעבלין,יישוב,634,247,387,6,628,512,626,18,11.08%
2014-09,הצפון,482,בועיינה-נוג'ידאת,יישוב,414,176,238,14,400,345,398,1,10.37%
2014-09,הצפון,4001,בוקעאתא,יישוב,422,163,259,3,419,356,410,1,14.90%
2014-09,הצפון,998,ביר אל-מכסור,יישוב,433,169,264,4,429,322,431,0,11.70%
2014-09,הצפון,480,בית ג'ן,יישוב,382,119,263,6,376,280,368,1,7.01%
2014-09,הצפון,9200,בית שאן,יישוב,931,407,524,23,908,432,895,80,8.86%
2014-09,הצפון,944,בסמת טבעון,יישוב,229,111,118,1,228,169,222,2,6.92%
2014-09,הצפון,483,בענה,יישוב,365,144,221,5,360,308,362,12,10.96%
2014-09,הצפון,1292,ג'דיידה-מכר,יישוב,1360,591,769,9,1351,1100,1341,32,14.73%
2014-09,הצפון,485,ג'ולס,יישוב,233,67,166,1,232,155,232,7,7.98%
2014-09,הצפון,487,ג'ש (גוש חלב),יישוב,67,37,30,1,66,39,65,1,3.97%
2014-09,הצפון,489,דבורייה,יישוב,399,168,231,18,381,296,395,2,9.27%
2014-09,הצפון,490,דייר אל-אסד,יישוב,397,152,245,6,391,309,396,8,7.76%
2014-09,הצפון,492,דייר חנא,יישוב,681,301,380,9,672,516,676,4,13.89%
2014-09,הצפון,975,זרזיר,יישוב,282,136,146,2,280,187,269,4,8.79%
2014-09,הצפון,496,חורפיש,יישוב,117,55,62,5,112,65,115,2,4.34%
2014-09,הצפון,2034,חצור הגלילית,יישוב,297,126,171,17,280,143,279,11,5.91%
2014-09,הצפון,6700,טבריה,יישוב,1849,797,1052,98,1751,1002,1642,66,7.55%
2014-09,הצפון,962,טובא-זנגרייה,יישוב,376,169,207,6,370,253,363,10,11.96%
2014-09,הצפון,498,טורעאן,יישוב,546,205,341,12,534,444,512,14,9.04%
2014-09,הצפון,8900,טמרה,יישוב,2019,805,1214,14,2005,1746,1978,19,14.05%
2014-09,הצפון,1295,יאנוח-ג'ת,יישוב,158,56,102,10,148,98,156,4,5.59%
2014-09,הצפון,46,יבנאל,יישוב,166,106,60,8,158,108,135,2,8.54%
2014-09,הצפון,499,יפיע,יישוב,675,279,396,11,664,529,659,7,8.43%
2014-09,הצפון,240,יקנעם עילית,יישוב,547,225,322,63,484,149,536,32,4.62%
2014-09,הצפון,502,ירכא,יישוב,559,255,304,1,558,431,554,4,9.50%
2014-09,הצפון,504,כאבול,יישוב,678,276,402,4,674,576,668,2,13.70%
2014-09,הצפון,505,כאוכב אבו אל-היג'א,יישוב,221,91,130,9,212,190,216,1,12.59%
2014-09,הצפון,1296,כסרא-סמיע,יישוב,209,90,119,2,207,148,204,2,5.98%
2014-09,הצפון,978,כעביה-טבאש-חג'אג'רה,יישוב,192,77,115,4,188,143,187,4,8.27%
2014-09,הצפון,1263,כפר ורדים,יישוב,82,32,50,39,43,6,81,1,2.58%
2014-09,הצפון,507,כפר יאסיף,יישוב,455,201,254,4,451,350,445,16,8.65%
2014-09,הצפון,508,כפר כמא,יישוב,69,27,42,4,65,27,68,0,4.18%
2014-09,הצפון,509,כפר כנא,יישוב,1196,496,700,27,1169,981,1123,24,12.69%
2014-09,הצפון,510,כפר מנדא,יישוב,970,421,549,11,959,722,935,21,12.78%
2014-09,הצפון,47,כפר תבור,יישוב,36,14,22,12,24,1,36,0,1.67%
2014-09,הצפון,1139,כרמיאל,יישוב,1753,717,1036,294,1459,791,1665,62,6.43%
2014-09,הצפון,65,מ.א. אל-בטוף,מועצה איזורית,385,150,235,7,378,315,373,3,13.92%
2014-09,הצפון,66,מ.א. בוסתן אל-מרג,מועצה איזורית,49,15,34,2,47,42,49,1,1.60%
2014-09,הצפון,71,מ.א. גולן,מועצה איזורית,220,96,124,22,198,18,220,0,2.68%
2014-09,הצפון,8,מ.א. הגלבוע,מועצה איזורית,824,308,516,48,776,499,809,0,5.79%
2014-09,הצפון,1,מ.א. הגליל העליון,מועצה איזורית,254,120,134,47,207,49,250,0,2.81%
2014-09,הצפון,3,מ.א. הגליל התחתון,מועצה איזורית,159,68,91,41,118,15,149,0,2.61%
2014-09,הצפון,55,מ.א. מבואות החרמון,מועצה איזורית,112,43,69,17,95,14,110,0,2.85%
2014-09,הצפון,13,מ.א. מגידו,מועצה איזורית,115,42,73,20,95,9,115,0,2.03%
2014-09,הצפון,4,מ.א. מטה אשר,מועצה איזורית,492,213,279,58,434,202,484,0,3.67%
2014-09,הצפון,52,מ.א. מעלה יוסף,מועצה איזורית,187,94,93,34,153,54,182,0,3.46%
2014-09,הצפון,2,מ.א. מרום הגליל,מועצה איזורית,321,151,170,26,295,121,313,0,4.83%
2014-09,הצפון,56,מ.א. משגב,מועצה איזורית,572,232,340,111,461,288,558,0,4.54%
2014-09,הצפון,6,מ.א. עמק הירדן,מועצה איזורית,216,88,128,36,180,37,197,0,2.96%
2014-09,הצפון,7,מ.א. עמק המעיינות,מועצה איזורית,190,83,107,29,161,45,184,0,2.97%
2014-09,הצפון,9,מ.א. עמק יזרעאל,מועצה איזורית,405,170,235,146,259,42,398,0,2.15%
2014-09,הצפון,481,מגאר,יישוב,1545,624,921,17,1528,1346,1509,17,16.04%
2014-09,הצפון,516,מג'ד אל-כרום,יישוב,553,237,316,7,546,409,548,11,8.47%
2014-09,הצפון,874,מגדל העמק,יישוב,1111,443,668,80,1031,420,999,70,7.42%
2014-09,הצפון,4201,מג'דל שמס,יישוב,475,167,308,9,466,400,461,8,9.70%
2014-09,הצפון,517,מזרעה,יישוב,175,69,106,2,173,150,170,4,8.70%
2014-09,הצפון,4203,מסעדה,יישוב,208,71,137,3,205,179,201,2,12.04%
2014-09,הצפון,518,מעיליא,יישוב,53,26,27,7,46,21,53,1,3.24%
2014-09,הצפון,1063,מעלות-תרשיחא,יישוב,892,415,477,98,794,475,876,44,7.30%
2014-09,הצפון,520,משהד,יישוב,291,117,174,9,282,241,276,3,8.64%
2014-09,הצפון,9100,נהרייה,יישוב,2108,969,1139,190,1918,1179,2049,72,6.60%
2014-09,הצפון,522,נחף,יישוב,407,191,216,6,401,322,400,11,8.09%
2014-09,הצפון,7300,נצרת,יישוב,3375,1421,1954,84,3291,2634,3289,27,9.47%
2014-09,הצפון,1061,נצרת עילית,יישוב,1900,869,1031,182,1718,955,1708,117,7.21%
2014-09,הצפון,525,סאג'ור,יישוב,115,40,75,2,113,71,112,0,6.32%
2014-09,הצפון,7500,סח'נין,יישוב,2130,917,1213,27,2103,1806,2112,10,15.16%
2014-09,הצפון,4501,ע'ג'ר,יישוב,100,44,56,3,97,67,99,1,9.56%
2014-09,הצפון,530,עיילבון,יישוב,196,77,119,3,193,138,194,3,7.10%
2014-09,הצפון,511,עילוט,יישוב,355,149,206,4,351,277,345,3,12.16%
2014-09,הצפון,532,עין מאהל,יישוב,540,254,286,9,531,447,523,1,10.00%
2014-09,הצפון,7600,עכו,יישוב,3287,1488,1799,129,3158,2413,3160,72,11.84%
2014-09,הצפון,7700,עפולה,יישוב,1800,701,1099,127,1673,788,1707,87,6.85%
2014-09,הצפון,531,עראבה,יישוב,1565,646,919,26,1539,1335,1553,7,15.39%
2014-09,הצפון,535,פסוטה,יישוב,112,46,66,8,104,69,111,4,6.51%
2014-09,הצפון,536,פקיעין (בוקייעה),יישוב,143,76,67,6,137,88,140,2,5.10%
2014-09,הצפון,8000,צפת,יישוב,1495,779,716,71,1424,1030,1430,53,10.61%
2014-09,הצפון,4100,קצרין,יישוב,238,99,139,19,219,101,233,8,5.86%
2014-09,הצפון,2800,קריית שמונה,יישוב,905,417,488,44,861,372,862,44,6.58%
2014-09,הצפון,543,ראמה,יישוב,313,123,190,14,299,233,309,3,7.94%
2014-09,הצפון,26,ראש פינה,יישוב,61,28,33,9,52,21,59,0,3.71%
2014-09,הצפון,542,ריינה,יישוב,694,283,411,9,685,541,666,6,9.77%
2014-09,הצפון,122,רמת ישי,יישוב,105,43,62,27,78,15,104,0,2.51%
2014-09,הצפון,913,שבלי - אום אל-גנם,יישוב,258,108,150,10,248,173,250,3,9.59%
2014-09,הצפון,812,שלומי,יישוב,263,105,158,14,249,140,258,8,7.13%
2014-09,הצפון,538,שעב,יישוב,557,222,335,6,551,478,553,2,17.91%
2014-09,הצפון,8800,שפרעם,יישוב,2080,800,1280,28,2052,1666,2044,43,11.54%
2014-09,חיפה,2710,אום אל-פחם,יישוב,3857,1555,2302,29,3828,3221,3786,17,17.91%
2014-09,חיפה,1020,אור עקיבא,יישוב,644,267,377,51,593,204,619,18,6.15%
2014-09,חיפה,6000,באקה אל-גרביה,יישוב,738,341,397,10,728,430,731,29,6.29%
2014-09,חיפה,9800,בנימינה-גבעת עדה*,יישוב,221,102,119,42,179,62,220,5,3.11%
2014-09,חיפה,1326,"בסמ""ה",יישוב,431,187,244,3,428,338,427,10,10.71%
2014-09,חיפה,541,ג'סר א-זרקא,יישוב,500,254,246,1,499,323,496,2,8.42%
2014-09,חיפה,628,ג'ת,יישוב,238,117,121,9,229,146,238,7,4.57%
2014-09,חיפה,494,דאלית אל-כרמל,יישוב,541,214,327,7,534,289,523,6,6.66%
2014-09,חיפה,9300,זכרון יעקב,יישוב,284,110,174,84,200,56,281,0,2.59%
2014-09,חיפה,6500,חדרה,יישוב,2664,1089,1575,291,2373,943,2511,60,5.08%
2014-09,חיפה,4000,חיפה,יישוב,6797,3231,3566,1216,5581,3432,6517,179,4.59%
2014-09,חיפה,1247,חריש,יישוב,30,13,17,3,27,7,29,0,1.97%
2014-09,חיפה,2100,טירת כרמל,יישוב,760,353,407,23,737,436,734,22,6.85%
2014-09,חיפה,654,כפר קרע,יישוב,450,199,251,6,444,271,439,10,5.27%
2014-09,חיפה,45,מ.א. אלונה,מועצה איזורית,23,10,13,5,18,5,23,0,2.24%
2014-09,חיפה,12,מ.א. זבולון,מועצה איזורית,267,122,145,21,246,191,262,0,4.81%
2014-09,חיפה,15,מ.א. חוף הכרמל,מועצה איזורית,316,130,186,59,257,55,314,0,2.32%
2014-09,חיפה,14,מ.א. מנשה,מועצה איזורית,275,120,155,57,218,74,270,0,3.46%
2014-09,חיפה,1327,מעלה עירון,יישוב,956,368,588,9,947,762,948,4,16.08%
2014-09,חיפה,2500,נשר,יישוב,485,220,265,92,393,192,471,10,3.70%
2014-09,חיפה,534,עספיא,יישוב,348,165,183,14,334,176,332,5,6.06%
2014-09,חיפה,637,ערערה,יישוב,618,248,370,2,616,416,604,18,7.47%
2014-09,חיפה,537,פוריידיס,יישוב,463,231,232,2,461,272,458,4,8.19%
2014-09,חיפה,7800,פרדס חנה-כרכור,יישוב,968,420,548,141,827,274,958,28,4.77%
2014-09,חיפה,6800,קריית אתא,יישוב,1698,749,949,151,1547,896,1668,44,5.59%
2014-09,חיפה,9500,קריית ביאליק,יישוב,1066,439,627,125,941,547,1047,27,4.89%
2014-09,חיפה,2300,קריית טבעון,יישוב,215,108,107,67,148,47,207,5,2.42%
2014-09,חיפה,9600,קריית ים,יישוב,1515,688,827,151,1364,871,1480,41,6.94%
2014-09,חיפה,8200,קריית מוצקין,יישוב,1084,446,638,157,927,498,1057,29,4.63%
2014-09,חיפה,922,רכסים,יישוב,197,76,121,8,189,85,191,1,5.51%
2014-09,ירושלים,472,אבו גוש,יישוב,258,129,129,6,252,181,258,1,8.45%
2014-09,ירושלים,2610,בית שמש,יישוב,1532,573,959,70,1462,524,1488,38,4.67%
2014-09,ירושלים,3000,ירושלים,יישוב,13368,5909,7459,1440,11928,7543,13094,138,4.39%
2014-09,ירושלים,26,מ.א. מטה יהודה,מועצה איזורית,665,297,368,100,565,134,647,0,2.82%
2014-09,ירושלים,1015,מבשרת ציון,יישוב,422,190,232,82,340,171,412,3,3.09%
2014-09,ירושלים,1137,קריית יערים,יישוב,47,23,24,7,40,15,47,0,3.56%
2014-09,תל אביב,2400,אור יהודה,יישוב,885,416,469,35,850,232,844,41,4.47%
2014-09,תל אביב,565,אזור,יישוב,186,101,85,20,166,35,182,0,2.84%
2014-09,תל אביב,6100,בני ברק,יישוב,2719,1091,1627,50,2669,1153,2611,25,4.65%
2014-09,תל אביב,6200,בת ים,יישוב,3242,1494,1748,397,2845,1147,3121,88,4.39%
2014-09,תל אביב,6300,גבעתיים,יישוב,778,358,420,316,462,85,770,4,2.54%
2014-09,תל אביב,6400,הרצלייה,יישוב,1209,468,741,236,973,39,1175,58,2.42%
2014-09,תל אביב,6600,חולון,יישוב,3331,1525,1806,307,3024,831,3241,58,3.26%
2014-09,תל אביב,2620,קריית אונו,יישוב,377,173,204,109,268,51,373,3,1.99%
2014-09,תל אביב,8600,רמת גן,יישוב,2161,968,1193,642,1519,461,2123,30,2.71%
2014-09,תל אביב,2650,רמת השרון,יישוב,440,168,272,119,321,4,438,3,1.94%
2014-09,תל אביב,5000,תל אביב -יפו,יישוב,7740,3835,3905,2290,5450,2179,7590,137,3.01%
2014-10,אזור יהודה והשומרון,3760,אורנית,יישוב,97,36,61,35,62,1,97,0,2.07%
2014-10,אזור יהודה והשומרון,3750,אלפי מנשה,יישוב,85,37,48,27,58,1,85,0,2.00%
2014-10,אזור יהודה והשומרון,3560,אלקנה,יישוב,33,16,17,14,19,1,33,0,1.74%
2014-10,אזור יהודה והשומרון,3650,אפרת,יישוב,55,29,26,22,33,3,55,1,1.35%
2014-10,אזור יהודה והשומרון,3570,אריאל,יישוב,313,151,162,44,269,69,307,5,2.93%
2014-10,אזור יהודה והשומרון,3574,בית אל,יישוב,44,18,26,12,32,19,43,0,1.76%
2014-10,אזור יהודה והשומרון,3652,בית אריה,יישוב,57,25,32,8,49,3,57,0,2.23%
2014-10,אזור יהודה והשומרון,3780,ביתר עילית,יישוב,563,238,325,8,555,248,559,0,4.58%
2014-10,אזור יהודה והשומרון,3730,גבעת זאב,יישוב,186,74,112,30,156,45,182,1,2.42%
2014-10,אזור יהודה והשומרון,3769,הר אדר,יישוב,27,13,14,9,18,3,27,0,1.31%
2014-10,אזור יהודה והשומרון,76,מ.א. גוש עציון,מועצה איזורית,147,72,75,37,110,13,145,0,1.57%
2014-10,אזור יהודה והשומרון,78,מ.א. הר חברון,מועצה איזורית,58,27,31,14,44,8,56,0,1.73%
2014-10,אזור יהודה והשומרון,74,מ.א. מגילות ים המלח,מועצה איזורית,8,3,5,3,5,1,8,0,1.06%
2014-10,אזור יהודה והשומרון,73,מ.א. מטה בנימין,מועצה איזורית,575,261,314,127,448,147,568,0,2.38%
2014-10,אזור יהודה והשומרון,75,מ.א. ערבות הירדן,מועצה איזורית,48,23,25,8,40,5,48,0,2.06%
2014-10,אזור יהודה והשומרון,72,מ.א. שומרון,מועצה איזורית,357,174,183,78,279,52,348,0,2.20%
2014-10,אזור יהודה והשומרון,3797,מודיעין עילית,יישוב,455,120,335,13,442,78,448,1,3.42%
2014-10,אזור יהודה והשומרון,3616,מעלה אדומים,יישוב,591,262,329,51,540,198,582,17,2.87%
2014-10,אזור יהודה והשומרון,3660,עמנואל,יישוב,68,36,32,1,67,45,68,1,6.04%
2014-10,אזור יהודה והשומרון,3557,קדומים,יישוב,38,18,20,15,23,5,38,0,2.04%
2014-10,אזור יהודה והשומרון,3611,קריית ארבע,יישוב,116,60,56,8,108,63,114,1,3.58%
2014-10,אזור יהודה והשומרון,3640,קרני שומרון,יישוב,75,41,34,22,53,11,75,0,2.06%
2014-10,הדרום,31,אופקים,יישוב,1196,482,714,62,1134,786,1171,35,9.18%
2014-10,הדרום,2600,אילת,יישוב,1212,544,668,32,1180,505,1193,27,3.60%
2014-10,הדרום,70,אשדוד,יישוב,6276,2534,3742,705,5571,3307,6096,118,5.64%
2014-10,הדרום,7100,אשקלון,יישוב,4232,1706,2526,242,3990,2258,3891,50,5.65%
2014-10,הדרום,9000,באר שבע,יישוב,6644,2915,3729,715,5929,4172,6412,64,6.20%
2014-10,הדרום,2200,דימונה,יישוב,1941,817,1124,108,1833,1356,1874,33,10.27%
2014-10,הדרום,1303,חורה,יישוב,818,332,486,4,814,773,807,4,19.89%
2014-10,הדרום,831,ירוחם,יישוב,429,191,238,13,416,266,409,12,8.99%
2014-10,הדרום,1059,כסיפה,יישוב,1001,379,622,3,998,925,993,15,21.43%
2014-10,הדרום,1271,להבים,יישוב,45,20,25,18,27,4,45,0,1.29%
2014-10,הדרום,1060,לקיה,יישוב,980,434,546,2,978,928,970,10,22.85%
2014-10,הדרום,69,מ.א. אל קסום,מועצה איזורית,764,318,446,4,760,717,758,0,58.90%
2014-10,הדרום,38,מ.א. אשכול,מועצה איזורית,117,50,67,18,99,16,117,0,1.77%
2014-10,הדרום,33,מ.א. באר טוביה,מועצה איזורית,261,103,158,35,226,57,259,0,2.50%
2014-10,הדרום,41,מ.א. בני שמעון,מועצה איזורית,54,24,30,20,34,12,53,0,1.32%
2014-10,הדרום,54,מ.א. הערבה התיכונה,מועצה איזורית,29,12,17,4,25,1,29,0,1.61%
2014-10,הדרום,53,מ.א. חבל אילות,מועצה איזורית,23,10,13,1,22,0,23,1,1.08%
2014-10,הדרום,36,מ.א. חוף אשקלון,מועצה איזורית,220,96,124,5,215,58,212,0,2.71%
2014-10,הדרום,35,מ.א. יואב,מועצה איזורית,94,41,53,14,80,25,93,0,2.42%
2014-10,הדרום,50,מ.א. לכיש,מועצה איזורית,202,81,121,19,183,69,202,0,4.26%
2014-10,הדרום,42,מ.א. מרחבים,מועצה איזורית,193,73,120,21,172,51,193,0,3.62%
2014-10,הדרום,68,מ.א. נווה מדבר,מועצה איזורית,103,36,67,0,103,91,102,0,16.43%
2014-10,הדרום,48,מ.א. רמת נגב,מועצה איזורית,183,91,92,13,170,142,180,0,6.26%
2014-10,הדרום,39,מ.א. שדות נגב,מועצה איזורית,151,76,75,13,138,38,140,0,3.35%
2014-10,הדרום,37,מ.א. שער הנגב,מועצה איזורית,130,55,75,25,105,60,126,0,3.39%
2014-10,הדרום,34,מ.א. שפיר,מועצה איזורית,174,75,99,11,163,69,172,0,3.79%
2014-10,הדרום,51,מ.א. תמר,מועצה איזורית,6,2,4,1,5,0,6,0,0.97%
2014-10,הדרום,1268,מיתר,יישוב,56,24,32,20,36,6,54,0,1.27%
2014-10,הדרום,99,מצפה רמון,יישוב,236,90,146,7,229,169,228,7,9.36%
2014-10,הדרום,246,נתיבות,יישוב,1135,478,657,43,1092,555,1092,44,7.79%
2014-10,הדרום,666,עומר,יישוב,51,19,32,19,32,3,51,0,1.26%
2014-10,הדרום,2560,ערד,יישוב,839,359,480,76,763,416,817,16,6.63%
2014-10,הדרום,1192,ערערה-בנגב,יישוב,1070,440,630,4,1066,983,1063,14,25.19%
2014-10,הדרום,2630,קריית גת,יישוב,2046,811,1235,100,1946,1180,1994,29,7.04%
2014-10,הדרום,1034,קריית מלאכי,יישוב,1079,473,606,17,1062,675,1046,38,9.03%
2014-10,הדרום,1161,רהט,יישוב,3096,1277,1819,3,3093,2799,3069,22,16.25%
2014-10,הדרום,1286,שגב-שלום,יישוב,582,204,378,3,579,519,574,10,21.25%
2014-10,הדרום,1031,שדרות,יישוב,1077,453,624,52,1025,646,1037,11,8.12%
2014-10,הדרום,1054,תל שבע,יישוב,1219,559,660,4,1215,1160,1208,14,24.37%
2014-10,המרכז,182,אבן יהודה,יישוב,138,70,68,49,89,16,138,2,2.06%
2014-10,המרכז,41,אליכין,יישוב,65,34,31,9,56,16,62,0,3.30%
2014-10,המרכז,1309,אלעד,יישוב,428,174,254,10,418,85,419,0,3.35%
2014-10,המרכז,2530,באר יעקב,יישוב,262,95,167,48,214,56,259,5,2.85%
2014-10,המרכז,466,בית דגן,יישוב,91,49,42,5,86,34,91,1,2.56%
2014-10,המרכז,1066,"בני עי""ש",יישוב,177,86,91,26,151,71,176,5,4.45%
2014-10,המרכז,681,גבעת שמואל,יישוב,286,150,136,30,256,67,280,0,2.35%
2014-10,המרכז,2550,גדרה,יישוב,385,156,229,82,303,116,377,1,3.23%
2014-10,המרכז,627,ג'לג'וליה,יישוב,77,34,43,1,76,52,76,0,2.11%
2014-10,המרכז,166,גן יבנה,יישוב,377,135,242,68,309,96,373,5,3.27%
2014-10,המרכז,229,גני תקווה,יישוב,165,73,92,54,111,23,165,0,1.99%
2014-10,המרכז,9700,הוד השרון,יישוב,551,247,304,166,385,64,547,4,1.86%
2014-10,המרכז,1290,זמר,יישוב,146,40,106,3,143,113,145,0,4.97%
2014-10,המרכז,2730,טייבה,יישוב,1568,671,897,15,1553,1378,1462,12,8.47%
2014-10,המרכז,2720,טירה,יישוב,259,112,147,10,249,144,255,7,2.26%
2014-10,המרכז,2660,יבנה,יישוב,763,381,382,73,690,316,751,11,3.25%
2014-10,המרכז,9400,יהוד,יישוב,427,162,265,61,366,71,420,3,2.66%
2014-10,המרכז,1224,כוכב יאיר,יישוב,79,33,46,35,44,0,78,0,1.38%
2014-10,המרכז,633,כפר ברא,יישוב,15,5,10,0,15,8,15,0,1.11%
2014-10,המרכז,168,כפר יונה,יישוב,305,122,183,58,247,67,301,2,2.79%
2014-10,המרכז,6900,כפר סבא,יישוב,1101,503,598,310,791,149,1092,16,2.07%
2014-10,המרכז,634,כפר קאסם,יישוב,210,93,117,6,204,127,204,2,2.32%
2014-10,המרכז,7000,לוד,יישוב,1987,916,1071,131,1856,1170,1959,11,5.59%
2014-10,המרכז,28,מ.א. ברנר,מועצה איזורית,66,31,35,24,42,5,66,0,1.72%
2014-10,המרכז,32,מ.א. גדרות,מועצה איזורית,38,12,26,14,24,5,38,0,1.67%
2014-10,המרכז,30,מ.א. גזר,מועצה איזורית,234,97,137,54,180,31,232,0,1.82%
2014-10,המרכז,27,מ.א. גן רווה,מועצה איזורית,52,24,28,16,36,2,52,0,1.91%
2014-10,המרכז,20,מ.א. דרום השרון,מועצה איזורית,282,126,156,89,193,10,279,0,1.83%
2014-10,המרכז,29,מ.א. חבל יבנה,מועצה איזורית,39,19,20,12,27,3,38,0,1.59%
2014-10,המרכז,25,מ.א. חבל מודיעין,מועצה איזורית,233,98,135,61,172,24,230,0,2.20%
2014-10,המרכז,19,מ.א. חוף השרון,מועצה איזורית,80,38,42,30,50,5,80,0,1.47%
2014-10,המרכז,18,מ.א. לב השרון,מועצה איזורית,208,105,103,65,143,28,206,0,1.90%
2014-10,המרכז,31,מ.א. נחל שורק,מועצה איזורית,51,25,26,11,40,4,51,35,1.19%
2014-10,המרכז,16,מ.א. עמק חפר,מועצה איזורית,321,135,186,111,210,25,316,0,1.61%
2014-10,המרכז,40,מ.א. עמק לוד,מועצה איזורית,134,64,70,24,110,23,133,0,2.19%
2014-10,המרכז,1200,מודיעין-מכבים-רעות*,יישוב,814,345,469,210,604,66,810,9,1.88%
2014-10,המרכז,28,מזכרת בתיה,יישוב,170,72,98,40,130,37,169,0,2.41%
2014-10,המרכז,7200,נס ציונה,יישוב,621,297,324,135,486,204,617,1,2.65%
2014-10,המרכז,7400,נתניה,יישוב,3994,1793,2201,521,3473,1478,3909,30,3.75%
2014-10,המרכז,587,סביון*,יישוב,19,13,6,4,15,1,19,0,0.98%
2014-10,המרכז,171,פרדסייה,יישוב,55,29,26,13,42,7,55,0,1.54%
2014-10,המרכז,7900,פתח תקווה,יישוב,3661,1571,2090,716,2945,1080,3611,16,2.92%
2014-10,המרכז,195,קדימה-צורן,יישוב,242,108,134,68,174,37,238,0,2.26%
2014-10,המרכז,638,קלנסווה,יישוב,613,249,364,9,604,538,583,5,6.78%
2014-10,המרכז,469,קריית עקרון,יישוב,276,131,145,11,265,137,274,4,4.67%
2014-10,המרכז,2640,ראש העין,יישוב,632,293,339,77,555,159,617,10,2.68%
2014-10,המרכז,8300,ראשון לציון,יישוב,4007,1748,2259,439,3568,1332,3986,38,2.90%
2014-10,המרכז,8400,רחובות,יישוב,2364,1037,1327,439,1925,959,2310,11,3.43%
2014-10,המרכז,8500,רמלה,יישוב,1584,730,854,99,1485,748,1523,28,4.16%
2014-10,המרכז,8700,רעננה,יישוב,730,320,410,244,486,70,725,2,1.96%
2014-10,המרכז,1304,שוהם,יישוב,149,65,84,52,97,8,149,0,1.36%
2014-10,המרכז,154,תל מונד,יישוב,140,63,77,54,86,18,140,0,2.27%
2014-10,הצפון,473,אבו סנאן,יישוב,611,253,358,6,605,508,607,4,10.62%
2014-10,הצפון,478,אכסאל,יישוב,500,226,274,8,492,448,491,1,8.75%
2014-10,הצפון,529,אעבלין,יישוב,589,234,355,5,584,504,586,8,10.45%
2014-10,הצפון,482,בועיינה-נוג'ידאת,יישוב,395,160,235,11,384,344,381,2,9.97%
2014-10,הצפון,4001,בוקעאתא,יישוב,396,153,243,2,394,342,387,0,14.18%
2014-10,הצפון,998,ביר אל-מכסור,יישוב,400,148,252,1,399,323,398,0,10.90%
2014-10,הצפון,480,בית ג'ן,יישוב,352,111,241,5,347,280,342,0,6.55%
2014-10,הצפון,9200,בית שאן,יישוב,763,324,439,22,741,412,742,32,7.46%
2014-10,הצפון,944,בסמת טבעון,יישוב,210,97,113,0,210,170,203,0,6.36%
2014-10,הצפון,483,בענה,יישוב,333,126,207,4,329,305,330,1,10.09%
2014-10,הצפון,1292,ג'דיידה-מכר,יישוב,1256,544,712,8,1248,1078,1241,6,13.79%
2014-10,הצפון,485,ג'ולס,יישוב,200,57,143,0,200,151,200,1,6.96%
2014-10,הצפון,487,ג'ש (גוש חלב),יישוב,58,29,29,1,57,37,56,4,3.44%
2014-10,הצפון,489,דבורייה,יישוב,346,148,198,9,337,286,345,1,8.19%
2014-10,הצפון,490,דייר אל-אסד,יישוב,356,129,227,3,353,308,356,1,7.03%
2014-10,הצפון,492,דייר חנא,יישוב,634,266,368,4,630,508,631,0,13.09%
2014-10,הצפון,975,זרזיר,יישוב,283,131,152,4,279,195,272,4,8.88%
2014-10,הצפון,496,חורפיש,יישוב,88,37,51,3,85,57,86,1,3.28%
2014-10,הצפון,2034,חצור הגלילית,יישוב,261,112,149,14,247,143,245,6,5.23%
2014-10,הצפון,6700,טבריה,יישוב,1598,691,907,75,1523,1003,1412,15,6.56%
2014-10,הצפון,962,טובא-זנגרייה,יישוב,317,143,174,4,313,251,309,0,10.37%
2014-10,הצפון,498,טורעאן,יישוב,486,180,306,8,478,423,465,0,8.28%
2014-10,הצפון,8900,טמרה,יישוב,1880,736,1144,12,1868,1716,1856,6,13.30%
2014-10,הצפון,1295,יאנוח-ג'ת,יישוב,137,46,91,6,131,92,137,0,4.94%
2014-10,הצפון,46,יבנאל,יישוב,137,88,49,5,132,108,110,0,7.07%
2014-10,הצפון,499,יפיע,יישוב,623,255,368,13,610,514,611,2,7.87%
2014-10,הצפון,240,יקנעם עילית,יישוב,449,183,266,56,393,141,440,20,3.82%
2014-10,הצפון,502,ירכא,יישוב,522,227,295,1,521,424,517,3,8.93%
2014-10,הצפון,504,כאבול,יישוב,638,251,387,5,633,571,635,2,13.11%
2014-10,הצפון,505,כאוכב אבו אל-היג'א,יישוב,212,87,125,6,206,188,207,0,12.13%
2014-10,הצפון,1296,כסרא-סמיע,יישוב,161,69,92,2,159,131,159,5,4.73%
2014-10,הצפון,978,כעביה-טבאש-חג'אג'רה,יישוב,202,83,119,3,199,144,195,2,8.59%
2014-10,הצפון,1263,כפר ורדים,יישוב,73,30,43,36,37,5,73,1,2.33%
2014-10,הצפון,507,כפר יאסיף,יישוב,415,181,234,3,412,333,407,1,7.97%
2014-10,הצפון,508,כפר כמא,יישוב,61,23,38,3,58,25,61,0,3.77%
2014-10,הצפון,509,כפר כנא,יישוב,1084,444,640,22,1062,941,1045,11,11.92%
2014-10,הצפון,510,כפר מנדא,יישוב,868,375,493,6,862,702,855,3,11.82%
2014-10,הצפון,47,כפר תבור,יישוב,35,14,21,13,22,1,35,0,1.62%
2014-10,הצפון,1139,כרמיאל,יישוב,1581,640,941,265,1316,794,1508,29,5.85%
2014-10,הצפון,65,מ.א. אל-בטוף,מועצה איזורית,354,127,227,5,349,314,347,0,13.02%
2014-10,הצפון,66,מ.א. בוסתן אל-מרג,מועצה איזורית,49,16,33,2,47,42,49,0,1.60%
2014-10,הצפון,71,מ.א. גולן,מועצה איזורית,182,77,105,21,161,17,182,1,2.22%
2014-10,הצפון,8,מ.א. הגלבוע,מועצה איזורית,766,285,481,41,725,491,753,0,5.39%
2014-10,הצפון,1,מ.א. הגליל העליון,מועצה איזורית,196,97,99,37,159,42,193,0,2.17%
2014-10,הצפון,3,מ.א. הגליל התחתון,מועצה איזורית,131,52,79,28,103,14,125,0,2.19%
2014-10,הצפון,55,מ.א. מבואות החרמון,מועצה איזורית,91,35,56,12,79,14,90,0,2.33%
2014-10,הצפון,13,מ.א. מגידו,מועצה איזורית,98,33,65,18,80,9,98,0,1.73%
2014-10,הצפון,4,מ.א. מטה אשר,מועצה איזורית,425,189,236,48,377,203,419,0,3.18%
2014-10,הצפון,52,מ.א. מעלה יוסף,מועצה איזורית,164,80,84,27,137,51,163,0,3.10%
2014-10,הצפון,2,מ.א. מרום הגליל,מועצה איזורית,277,128,149,21,256,118,273,0,4.21%
2014-10,הצפון,56,מ.א. משגב,מועצה איזורית,513,210,303,86,427,287,504,0,4.10%
2014-10,הצפון,6,מ.א. עמק הירדן,מועצה איזורית,187,79,108,26,161,40,171,0,2.57%
2014-10,הצפון,7,מ.א. עמק המעיינות,מועצה איזורית,162,73,89,26,136,42,159,0,2.57%
2014-10,הצפון,9,מ.א. עמק יזרעאל,מועצה איזורית,357,149,208,128,229,40,355,0,1.92%
2014-10,הצפון,481,מגאר,יישוב,1478,581,897,15,1463,1339,1445,23,15.47%
2014-10,הצפון,516,מג'ד אל-כרום,יישוב,480,185,295,6,474,403,478,4,7.47%
2014-10,הצפון,874,מגדל העמק,יישוב,1017,412,605,76,941,437,901,52,6.74%
2014-10,הצפון,4201,מג'דל שמס,יישוב,431,161,270,7,424,378,423,1,8.97%
2014-10,הצפון,517,מזרעה,יישוב,167,66,101,2,165,145,163,0,8.37%
2014-10,הצפון,4203,מסעדה,יישוב,188,68,120,3,185,168,182,0,11.03%
2014-10,הצפון,518,מעיליא,יישוב,37,18,19,6,31,18,37,0,2.28%
2014-10,הצפון,1063,מעלות-תרשיחא,יישוב,783,369,414,90,693,459,768,27,6.46%
2014-10,הצפון,520,משהד,יישוב,272,107,165,9,263,233,262,2,8.24%
2014-10,הצפון,9100,נהרייה,יישוב,1869,868,1001,162,1707,1136,1830,53,5.93%
2014-10,הצפון,522,נחף,יישוב,346,144,202,4,342,308,343,1,7.02%
2014-10,הצפון,7300,נצרת,יישוב,3149,1317,1832,64,3085,2640,3074,8,8.91%
2014-10,הצפון,1061,נצרת עילית,יישוב,1604,737,867,153,1451,939,1447,45,6.17%
2014-10,הצפון,525,סאג'ור,יישוב,100,35,65,1,99,71,97,0,5.52%
2014-10,הצפון,7500,סח'נין,יישוב,2030,865,1165,19,2011,1811,2019,0,14.59%
2014-10,הצפון,4501,ע'ג'ר,יישוב,85,35,50,1,84,66,85,0,8.32%
2014-10,הצפון,530,עיילבון,יישוב,185,74,111,3,182,137,182,1,6.69%
2014-10,הצפון,511,עילוט,יישוב,328,132,196,4,324,272,323,0,11.47%
2014-10,הצפון,532,עין מאהל,יישוב,514,240,274,7,507,438,497,1,9.55%
2014-10,הצפון,7600,עכו,יישוב,3038,1373,1665,114,2924,2372,2942,19,11.12%
2014-10,הצפון,7700,עפולה,יישוב,1468,576,892,110,1358,756,1409,49,5.72%
2014-10,הצפון,531,עראבה,יישוב,1471,598,873,16,1455,1329,1460,0,14.60%
2014-10,הצפון,535,פסוטה,יישוב,96,41,55,7,89,68,94,0,5.57%
2014-10,הצפון,536,פקיעין (בוקייעה),יישוב,115,60,55,5,110,87,113,1,4.16%
2014-10,הצפון,8000,צפת,יישוב,1323,706,617,62,1261,1001,1265,20,9.50%
2014-10,הצפון,4100,קצרין,יישוב,203,80,123,18,185,98,200,4,5.07%
2014-10,הצפון,2800,קריית שמונה,יישוב,718,339,379,38,680,363,688,14,5.33%
2014-10,הצפון,543,ראמה,יישוב,297,115,182,12,285,233,293,2,7.56%
2014-10,הצפון,26,ראש פינה,יישוב,57,26,31,9,48,19,55,0,3.47%
2014-10,הצפון,542,ריינה,יישוב,634,256,378,6,628,528,612,9,9.05%
2014-10,הצפון,122,רמת ישי,יישוב,105,45,60,23,82,21,102,0,2.46%
2014-10,הצפון,913,שבלי - אום אל-גנם,יישוב,215,90,125,9,206,160,207,0,8.08%
2014-10,הצפון,812,שלומי,יישוב,231,96,135,15,216,137,227,7,6.33%
2014-10,הצפון,538,שעב,יישוב,541,211,330,6,535,475,539,0,17.54%
2014-10,הצפון,8800,שפרעם,יישוב,1933,730,1203,24,1909,1658,1907,13,10.85%
2014-10,חיפה,2710,אום אל-פחם,יישוב,3581,1431,2150,22,3559,3206,3519,4,16.86%
2014-10,חיפה,1020,אור עקיבא,יישוב,530,212,318,40,490,195,514,9,5.16%
2014-10,חיפה,6000,באקה אל-גרביה,יישוב,597,270,327,4,593,417,593,9,5.17%
2014-10,חיפה,9800,בנימינה-גבעת עדה*,יישוב,178,81,97,36,142,58,175,1,2.49%
2014-10,חיפה,1326,"בסמ""ה",יישוב,384,160,224,3,381,328,381,0,9.67%
2014-10,חיפה,541,ג'סר א-זרקא,יישוב,439,223,216,0,439,318,435,2,7.46%
2014-10,חיפה,628,ג'ת,יישוב,204,100,104,9,195,145,203,2,3.93%
2014-10,חיפה,494,דאלית אל-כרמל,יישוב,458,181,277,4,454,286,446,2,5.73%
2014-10,חיפה,9300,זכרון יעקב,יישוב,257,104,153,78,179,55,255,1,2.36%
2014-10,חיפה,6500,חדרה,יישוב,2184,922,1262,261,1923,893,2080,27,4.24%
2014-10,חיפה,4000,חיפה,יישוב,6034,2927,3107,1064,4970,3333,5831,30,4.13%
2014-10,חיפה,1247,חריש,יישוב,29,13,16,4,25,8,27,0,1.84%
2014-10,חיפה,2100,טירת כרמל,יישוב,735,345,390,21,714,428,720,9,6.73%
2014-10,חיפה,654,כפר קרע,יישוב,356,154,202,3,353,248,350,7,4.24%
2014-10,חיפה,45,מ.א. אלונה,מועצה איזורית,21,9,12,4,17,5,21,0,2.04%
2014-10,חיפה,12,מ.א. זבולון,מועצה איזורית,247,107,140,16,231,188,243,0,4.46%
2014-10,חיפה,15,מ.א. חוף הכרמל,מועצה איזורית,288,115,173,53,235,57,286,0,2.11%
2014-10,חיפה,14,מ.א. מנשה,מועצה איזורית,231,97,134,47,184,73,227,0,2.91%
2014-10,חיפה,1327,מעלה עירון,יישוב,889,336,553,6,883,765,881,1,15.11%
2014-10,חיפה,2500,נשר,יישוב,434,199,235,84,350,184,421,4,3.32%
2014-10,חיפה,534,עספיא,יישוב,287,133,154,7,280,177,273,2,5.03%
2014-10,חיפה,637,ערערה,יישוב,502,199,303,1,501,390,489,3,6.13%
2014-10,חיפה,537,פוריידיס,יישוב,395,197,198,1,394,263,391,2,7.07%
2014-10,חיפה,7800,פרדס חנה-כרכור,יישוב,806,357,449,124,682,264,801,12,4.02%
2014-10,חיפה,6800,קריית אתא,יישוב,1547,691,856,134,1413,888,1518,22,5.11%
2014-10,חיפה,9500,קריית ביאליק,יישוב,954,404,550,110,844,532,940,15,4.41%
2014-10,חיפה,2300,קריית טבעון,יישוב,189,94,95,57,132,46,184,1,2.16%
2014-10,חיפה,9600,קריית ים,יישוב,1403,640,763,142,1261,875,1371,12,6.46%
2014-10,חיפה,8200,קריית מוצקין,יישוב,947,393,554,139,808,486,926,12,4.08%
2014-10,חיפה,922,רכסים,יישוב,152,69,83,6,146,80,149,0,4.35%
2014-10,ירושלים,472,אבו גוש,יישוב,227,108,119,4,223,181,227,0,7.51%
2014-10,ירושלים,2610,בית שמש,יישוב,1214,479,735,61,1153,512,1184,10,3.75%
2014-10,ירושלים,3000,ירושלים,יישוב,11879,5351,6528,1232,10647,7504,11679,50,3.93%
2014-10,ירושלים,26,מ.א. מטה יהודה,מועצה איזורית,546,245,301,87,459,132,537,0,2.34%
2014-10,ירושלים,1015,מבשרת ציון,יישוב,376,169,207,71,305,167,367,2,2.76%
2014-10,ירושלים,1137,קריית יערים,יישוב,38,21,17,6,32,14,38,0,2.90%
2014-10,תל אביב,2400,אור יהודה,יישוב,689,345,344,31,658,232,665,14,3.56%
2014-10,תל אביב,565,אזור,יישוב,154,89,65,13,141,32,152,2,2.38%
2014-10,תל אביב,6100,בני ברק,יישוב,2202,999,1202,45,2157,1142,2111,9,3.79%
2014-10,תל אביב,6200,בת ים,יישוב,2771,1310,1461,359,2412,1136,2683,18,3.80%
2014-10,תל אביב,6300,גבעתיים,יישוב,679,298,381,271,408,85,671,3,2.22%
2014-10,תל אביב,6400,הרצלייה,יישוב,916,393,523,196,720,26,905,17,1.88%
2014-10,תל אביב,6600,חולון,יישוב,2753,1295,1458,256,2497,813,2697,23,2.73%
2014-10,תל אביב,2620,קריית אונו,יישוב,322,148,174,91,231,50,319,0,1.70%
2014-10,תל אביב,8600,רמת גן,יישוב,1853,845,1008,529,1324,437,1829,10,2.35%
2014-10,תל אביב,2650,רמת השרון,יישוב,339,139,200,92,247,3,338,9,1.51%
2014-10,תל אביב,5000,תל אביב -יפו,יישוב,6581,3286,3295,1869,4712,2126,6482,57,2.58%
2014-11,אזור יהודה והשומרון,3760,אורנית,יישוב,114,43,71,47,67,2,114,0,2.43%
2014-11,אזור יהודה והשומרון,3750,אלפי מנשה,יישוב,89,34,55,23,66,1,89,1,2.09%
2014-11,אזור יהודה והשומרון,3560,אלקנה,יישוב,33,18,15,14,19,1,33,0,1.74%
2014-11,אזור יהודה והשומרון,3650,אפרת,יישוב,56,30,26,24,32,3,56,0,1.37%
2014-11,אזור יהודה והשומרון,3570,אריאל,יישוב,295,146,149,39,256,72,291,1,2.78%
2014-11,אזור יהודה והשומרון,3574,בית אל,יישוב,40,17,23,10,30,20,39,0,1.60%
2014-11,אזור יהודה והשומרון,3652,בית אריה,יישוב,56,28,28,9,47,3,56,0,2.19%
2014-11,אזור יהודה והשומרון,3780,ביתר עילית,יישוב,563,264,299,8,555,258,559,0,4.58%
2014-11,אזור יהודה והשומרון,3730,גבעת זאב,יישוב,190,82,108,31,159,47,187,3,2.48%
2014-11,אזור יהודה והשומרון,3769,הר אדר,יישוב,32,16,16,12,20,4,32,0,1.55%
2014-11,אזור יהודה והשומרון,76,מ.א. גוש עציון,מועצה איזורית,145,70,75,34,111,15,143,0,1.55%
2014-11,אזור יהודה והשומרון,78,מ.א. הר חברון,מועצה איזורית,54,27,27,11,43,9,53,0,1.64%
2014-11,אזור יהודה והשומרון,74,מ.א. מגילות ים המלח,מועצה איזורית,10,4,6,3,7,1,10,0,1.32%
2014-11,אזור יהודה והשומרון,73,מ.א. מטה בנימין,מועצה איזורית,590,284,306,134,456,151,588,0,2.47%
2014-11,אזור יהודה והשומרון,75,מ.א. ערבות הירדן,מועצה איזורית,55,27,28,9,46,5,55,0,2.36%
2014-11,אזור יהודה והשומרון,72,מ.א. שומרון,מועצה איזורית,345,168,177,76,269,58,340,0,2.15%
2014-11,אזור יהודה והשומרון,3797,מודיעין עילית,יישוב,422,126,296,14,408,85,413,3,3.16%
2014-11,אזור יהודה והשומרון,3616,מעלה אדומים,יישוב,595,257,338,40,555,203,587,8,2.89%
2014-11,אזור יהודה והשומרון,3660,עמנואל,יישוב,62,34,28,2,60,47,62,0,5.54%
2014-11,אזור יהודה והשומרון,3557,קדומים,יישוב,45,17,28,21,24,5,45,0,2.41%
2014-11,אזור יהודה והשומרון,3611,קריית ארבע,יישוב,130,73,57,8,122,65,127,3,3.97%
2014-11,אזור יהודה והשומרון,3640,קרני שומרון,יישוב,89,45,44,20,69,11,89,0,2.44%
2014-11,הדרום,31,אופקים,יישוב,1181,516,665,59,1122,810,1158,11,9.08%
2014-11,הדרום,2600,אילת,יישוב,1221,554,667,32,1189,520,1201,13,3.62%
2014-11,הדרום,70,אשדוד,יישוב,6226,2526,3700,713,5513,3421,6050,37,5.60%
2014-11,הדרום,7100,אשקלון,יישוב,4233,1775,2458,222,4011,2338,3869,38,5.62%
2014-11,הדרום,9000,באר שבע,יישוב,6550,2914,3636,658,5892,4191,6304,66,6.10%
2014-11,הדרום,2200,דימונה,יישוב,2002,871,1131,105,1897,1419,1926,19,10.52%
2014-11,הדרום,1303,חורה,יישוב,819,341,478,2,817,762,807,4,19.89%
2014-11,הדרום,831,ירוחם,יישוב,454,212,242,15,439,275,419,24,9.19%
2014-11,הדרום,1059,כסיפה,יישוב,1024,403,621,1,1023,938,1017,2,21.84%
2014-11,הדרום,1271,להבים,יישוב,41,18,23,15,26,4,41,1,1.18%
2014-11,הדרום,1060,לקיה,יישוב,968,448,520,5,963,908,954,11,22.55%
2014-11,הדרום,69,מ.א. אל קסום,מועצה איזורית,762,320,442,4,758,715,756,0,58.79%
2014-11,הדרום,38,מ.א. אשכול,מועצה איזורית,113,49,64,19,94,18,113,0,1.71%
2014-11,הדרום,33,מ.א. באר טוביה,מועצה איזורית,239,85,154,34,205,59,237,0,2.29%
2014-11,הדרום,41,מ.א. בני שמעון,מועצה איזורית,63,27,36,20,43,16,61,0,1.52%
2014-11,הדרום,54,מ.א. הערבה התיכונה,מועצה איזורית,23,9,14,4,19,1,23,0,1.28%
2014-11,הדרום,53,מ.א. חבל אילות,מועצה איזורית,19,10,9,2,17,0,19,0,0.89%
2014-11,הדרום,36,מ.א. חוף אשקלון,מועצה איזורית,208,97,111,6,202,62,198,0,2.53%
2014-11,הדרום,35,מ.א. יואב,מועצה איזורית,95,40,55,14,81,27,94,0,2.45%
2014-11,הדרום,50,מ.א. לכיש,מועצה איזורית,182,70,112,14,168,74,182,0,3.84%
2014-11,הדרום,42,מ.א. מרחבים,מועצה איזורית,181,75,106,17,164,52,181,0,3.40%
2014-11,הדרום,68,מ.א. נווה מדבר,מועצה איזורית,102,34,68,0,102,92,101,0,16.26%
2014-11,הדרום,48,מ.א. רמת נגב,מועצה איזורית,195,98,97,12,183,145,192,0,6.67%
2014-11,הדרום,39,מ.א. שדות נגב,מועצה איזורית,138,64,74,5,133,40,131,0,3.14%
2014-11,הדרום,37,מ.א. שער הנגב,מועצה איזורית,119,54,65,24,95,54,115,0,3.09%
2014-11,הדרום,34,מ.א. שפיר,מועצה איזורית,175,82,93,11,164,72,170,0,3.75%
2014-11,הדרום,51,מ.א. תמר,מועצה איזורית,9,4,5,2,7,0,9,0,1.45%
2014-11,הדרום,1268,מיתר,יישוב,59,22,37,15,44,6,57,0,1.34%
2014-11,הדרום,99,מצפה רמון,יישוב,258,109,149,8,250,177,249,9,10.13%
2014-11,הדרום,246,נתיבות,יישוב,1039,471,568,44,995,568,1007,32,7.22%
2014-11,הדרום,666,עומר,יישוב,49,18,31,18,31,3,49,0,1.21%
2014-11,הדרום,2560,ערד,יישוב,901,398,503,76,825,441,877,27,7.08%
2014-11,הדרום,1192,ערערה-בנגב,יישוב,1082,448,634,3,1079,999,1073,0,25.37%
2014-11,הדרום,2630,קריית גת,יישוב,2087,855,1232,93,1994,1250,2029,20,7.16%
2014-11,הדרום,1034,קריית מלאכי,יישוב,1121,507,614,17,1104,706,1084,18,9.33%
2014-11,הדרום,1161,רהט,יישוב,3059,1272,1787,4,3055,2754,3021,29,16.03%
2014-11,הדרום,1286,שגב-שלום,יישוב,563,199,364,2,561,515,556,7,20.72%
2014-11,הדרום,1031,שדרות,יישוב,1046,453,593,48,998,668,1003,3,7.88%
2014-11,הדרום,1054,תל שבע,יישוב,1211,574,637,3,1208,1146,1200,3,24.25%
2014-11,המרכז,182,אבן יהודה,יישוב,128,66,62,35,93,16,128,0,1.92%
2014-11,המרכז,41,אליכין,יישוב,63,34,29,7,56,18,60,0,3.20%
2014-11,המרכז,1309,אלעד,יישוב,436,184,252,8,428,85,423,0,3.39%
2014-11,המרכז,2530,באר יעקב,יישוב,273,107,166,51,222,60,271,2,2.98%
2014-11,המרכז,466,בית דגן,יישוב,97,53,44,3,94,33,97,0,2.73%
2014-11,המרכז,1066,"בני עי""ש",יישוב,189,95,94,28,161,71,189,0,4.77%
2014-11,המרכז,681,גבעת שמואל,יישוב,271,139,132,26,245,68,266,0,2.23%
2014-11,המרכז,2550,גדרה,יישוב,370,150,220,83,287,124,363,0,3.12%
2014-11,המרכז,627,ג'לג'וליה,יישוב,78,32,46,2,76,54,76,0,2.11%
2014-11,המרכז,166,גן יבנה,יישוב,374,153,221,55,319,104,371,2,3.25%
2014-11,המרכז,229,גני תקווה,יישוב,170,77,93,52,118,24,169,0,2.04%
2014-11,המרכז,9700,הוד השרון,יישוב,574,265,309,182,392,65,569,2,1.93%
2014-11,המרכז,1290,זמר,יישוב,158,50,108,3,155,114,157,0,5.36%
2014-11,המרכז,2730,טייבה,יישוב,1595,681,914,12,1583,1396,1474,4,8.53%
2014-11,המרכז,2720,טירה,יישוב,273,124,149,11,262,149,268,2,2.37%
2014-11,המרכז,2660,יבנה,יישוב,807,405,402,73,734,336,794,2,3.43%
2014-11,המרכז,9400,יהוד,יישוב,436,174,262,58,378,74,429,0,2.71%
2014-11,המרכז,1224,כוכב יאיר,יישוב,89,38,51,41,48,0,87,0,1.54%
2014-11,המרכז,633,כפר ברא,יישוב,16,5,11,0,16,9,16,0,1.18%
2014-11,המרכז,168,כפר יונה,יישוב,297,132,165,56,241,70,293,0,2.72%
2014-11,המרכז,6900,כפר סבא,יישוב,1175,526,649,346,829,158,1165,6,2.20%
2014-11,המרכז,634,כפר קאסם,יישוב,211,91,120,6,205,132,203,0,2.31%
2014-11,המרכז,7000,לוד,יישוב,2023,953,1070,129,1894,1217,2001,9,5.70%
2014-11,המרכז,28,מ.א. ברנר,מועצה איזורית,66,28,38,25,41,6,66,0,1.72%
2014-11,המרכז,32,מ.א. גדרות,מועצה איזורית,38,13,25,15,23,6,38,0,1.67%
2014-11,המרכז,30,מ.א. גזר,מועצה איזורית,224,95,129,62,162,32,222,0,1.75%
2014-11,המרכז,27,מ.א. גן רווה,מועצה איזורית,45,19,26,13,32,2,45,0,1.65%
2014-11,המרכז,20,מ.א. דרום השרון,מועצה איזורית,258,117,141,80,178,11,255,0,1.68%
2014-11,המרכז,29,מ.א. חבל יבנה,מועצה איזורית,28,11,17,7,21,3,28,0,1.17%
2014-11,המרכז,25,מ.א. חבל מודיעין,מועצה איזורית,239,100,139,68,171,26,236,0,2.26%
2014-11,המרכז,19,מ.א. חוף השרון,מועצה איזורית,82,40,42,24,58,7,82,0,1.50%
2014-11,המרכז,18,מ.א. לב השרון,מועצה איזורית,204,97,107,52,152,30,203,0,1.88%
2014-11,המרכז,31,מ.א. נחל שורק,מועצה איזורית,53,28,25,9,44,5,53,11,1.24%
2014-11,המרכז,16,מ.א. עמק חפר,מועצה איזורית,317,138,179,96,221,26,314,0,1.60%
2014-11,המרכז,40,מ.א. עמק לוד,מועצה איזורית,118,55,63,23,95,23,117,0,1.92%
2014-11,המרכז,1200,מודיעין-מכבים-רעות*,יישוב,845,350,495,194,651,70,840,8,1.95%
2014-11,המרכז,28,מזכרת בתיה,יישוב,164,73,91,42,122,37,163,0,2.33%
2014-11,המרכז,7200,נס ציונה,יישוב,627,304,323,133,494,214,624,0,2.68%
2014-11,המרכז,7400,נתניה,יישוב,4070,1857,2213,459,3611,1541,3984,4,3.82%
2014-11,המרכז,587,סביון*,יישוב,16,10,6,5,11,1,16,0,0.83%
2014-11,המרכז,171,פרדסייה,יישוב,66,29,37,9,57,8,66,0,1.84%
2014-11,המרכז,7900,פתח תקווה,יישוב,3647,1608,2039,654,2993,1126,3591,1,2.91%
2014-11,המרכז,195,קדימה-צורן,יישוב,238,113,125,60,178,40,233,1,2.21%
2014-11,המרכז,638,קלנסווה,יישוב,621,252,369,8,613,543,587,2,6.82%
2014-11,המרכז,469,קריית עקרון,יישוב,278,132,146,12,266,145,275,0,4.68%
2014-11,המרכז,2640,ראש העין,יישוב,689,319,370,95,594,162,679,2,2.95%
2014-11,המרכז,8300,ראשון לציון,יישוב,4215,1855,2360,446,3769,1399,4191,7,3.05%
2014-11,המרכז,8400,רחובות,יישוב,2391,1074,1317,433,1958,1000,2333,0,3.46%
2014-11,המרכז,8500,רמלה,יישוב,1631,760,871,99,1532,778,1567,5,4.27%
2014-11,המרכז,8700,רעננה,יישוב,762,340,422,261,501,74,755,0,2.04%
2014-11,המרכז,1304,שוהם,יישוב,156,71,85,59,97,8,156,0,1.42%
2014-11,המרכז,154,תל מונד,יישוב,125,56,69,43,82,20,125,0,2.03%
2014-11,הצפון,473,אבו סנאן,יישוב,636,262,374,5,631,523,629,0,10.96%
2014-11,הצפון,478,אכסאל,יישוב,532,247,285,13,519,466,519,0,9.20%
2014-11,הצפון,529,אעבלין,יישוב,594,242,352,5,589,509,592,0,10.54%
2014-11,הצפון,482,בועיינה-נוג'ידאת,יישוב,418,176,242,7,411,361,402,0,10.46%
2014-11,הצפון,4001,בוקעאתא,יישוב,413,166,247,2,411,349,401,0,14.62%
2014-11,הצפון,998,ביר אל-מכסור,יישוב,415,153,262,3,412,338,411,0,11.22%
2014-11,הצפון,480,בית ג'ן,יישוב,387,125,262,4,383,293,376,0,7.16%
2014-11,הצפון,9200,בית שאן,יישוב,776,343,433,25,751,434,754,11,7.57%
2014-11,הצפון,944,בסמת טבעון,יישוב,220,104,116,0,220,175,214,0,6.68%
2014-11,הצפון,483,בענה,יישוב,367,151,216,4,363,315,363,0,10.99%
2014-11,הצפון,1292,ג'דיידה-מכר,יישוב,1295,561,734,6,1289,1106,1278,1,14.14%
2014-11,הצפון,485,ג'ולס,יישוב,218,66,152,0,218,157,217,2,7.50%
2014-11,הצפון,487,ג'ש (גוש חלב),יישוב,60,33,27,2,58,39,58,0,3.56%
2014-11,הצפון,489,דבורייה,יישוב,362,158,204,14,348,286,360,2,8.52%
2014-11,הצפון,490,דייר אל-אסד,יישוב,392,159,233,6,386,323,391,2,7.67%
2014-11,הצפון,492,דייר חנא,יישוב,661,291,370,9,652,518,658,0,13.57%
2014-11,הצפון,975,זרזיר,יישוב,287,127,160,4,283,203,274,10,8.94%
2014-11,הצפון,496,חורפיש,יישוב,92,37,55,4,88,60,89,0,3.39%
2014-11,הצפון,2034,חצור הגלילית,יישוב,258,118,140,17,241,145,243,8,5.19%
2014-11,הצפון,6700,טבריה,יישוב,1613,708,905,63,1550,1041,1421,10,6.60%
2014-11,הצפון,962,טובא-זנגרייה,יישוב,342,157,185,6,336,259,333,0,11.09%
2014-11,הצפון,498,טורעאן,יישוב,508,195,313,7,501,444,479,1,8.50%
2014-11,הצפון,8900,טמרה,יישוב,1918,781,1137,8,1910,1739,1889,0,13.50%
2014-11,הצפון,1295,יאנוח-ג'ת,יישוב,144,50,94,6,138,92,144,4,5.18%
2014-11,הצפון,46,יבנאל,יישוב,141,89,52,6,135,111,117,0,7.49%
2014-11,הצפון,499,יפיע,יישוב,668,273,395,17,651,527,650,0,8.33%
2014-11,הצפון,240,יקנעם עילית,יישוב,423,170,253,49,374,149,417,18,3.63%
2014-11,הצפון,502,ירכא,יישוב,545,238,307,1,544,445,539,0,9.27%
2014-11,הצפון,504,כאבול,יישוב,660,265,395,6,654,583,655,0,13.47%
2014-11,הצפון,505,כאוכב אבו אל-היג'א,יישוב,216,87,129,8,208,191,210,0,12.29%
2014-11,הצפון,1296,כסרא-סמיע,יישוב,173,76,97,2,171,136,170,1,5.04%
2014-11,הצפון,978,כעביה-טבאש-חג'אג'רה,יישוב,210,89,121,3,207,150,202,4,8.87%
2014-11,הצפון,1263,כפר ורדים,יישוב,73,26,47,36,37,4,72,0,2.30%
2014-11,הצפון,507,כפר יאסיף,יישוב,435,190,245,4,431,351,425,1,8.29%
2014-11,הצפון,508,כפר כמא,יישוב,66,28,38,1,65,31,66,1,4.06%
2014-11,הצפון,509,כפר כנא,יישוב,1117,473,644,25,1092,974,1052,0,11.99%
2014-11,הצפון,510,כפר מנדא,יישוב,933,420,513,7,926,739,910,0,12.48%
2014-11,הצפון,47,כפר תבור,יישוב,39,16,23,16,23,1,39,0,1.80%
2014-11,הצפון,1139,כרמיאל,יישוב,1578,650,928,267,1311,829,1508,12,5.85%
2014-11,הצפון,65,מ.א. אל-בטוף,מועצה איזורית,373,144,229,6,367,323,357,1,13.37%
2014-11,הצפון,66,מ.א. בוסתן אל-מרג,מועצה איזורית,48,16,32,2,46,42,47,0,1.53%
2014-11,הצפון,71,מ.א. גולן,מועצה איזורית,184,74,110,18,166,19,184,1,2.25%
2014-11,הצפון,8,מ.א. הגלבוע,מועצה איזורית,755,296,459,38,717,509,742,0,5.31%
2014-11,הצפון,1,מ.א. הגליל העליון,מועצה איזורית,197,103,94,25,172,42,195,0,2.19%
2014-11,הצפון,3,מ.א. הגליל התחתון,מועצה איזורית,131,45,86,32,99,17,123,0,2.15%
2014-11,הצפון,55,מ.א. מבואות החרמון,מועצה איזורית,107,43,64,14,93,17,106,0,2.75%
2014-11,הצפון,13,מ.א. מגידו,מועצה איזורית,98,34,64,19,79,11,98,0,1.73%
2014-11,הצפון,4,מ.א. מטה אשר,מועצה איזורית,448,197,251,50,398,212,439,0,3.33%
2014-11,הצפון,52,מ.א. מעלה יוסף,מועצה איזורית,163,70,93,27,136,55,159,0,3.03%
2014-11,הצפון,2,מ.א. מרום הגליל,מועצה איזורית,281,130,151,14,267,127,275,0,4.24%
2014-11,הצפון,56,מ.א. משגב,מועצה איזורית,538,227,311,73,465,301,528,0,4.29%
2014-11,הצפון,6,מ.א. עמק הירדן,מועצה איזורית,184,83,101,31,153,42,169,0,2.54%
2014-11,הצפון,7,מ.א. עמק המעיינות,מועצה איזורית,180,93,87,24,156,46,176,0,2.85%
2014-11,הצפון,9,מ.א. עמק יזרעאל,מועצה איזורית,377,154,223,132,245,47,370,0,2.00%
2014-11,הצפון,481,מגאר,יישוב,1530,605,925,15,1515,1372,1490,5,15.87%
2014-11,הצפון,516,מג'ד אל-כרום,יישוב,531,230,301,5,526,414,528,2,8.19%
2014-11,הצפון,874,מגדל העמק,יישוב,1099,477,622,72,1027,466,966,67,7.19%
2014-11,הצפון,4201,מג'דל שמס,יישוב,458,164,294,7,451,391,446,2,9.41%
2014-11,הצפון,517,מזרעה,יישוב,172,70,102,2,170,148,168,1,8.61%
2014-11,הצפון,4203,מסעדה,יישוב,197,73,124,3,194,175,191,1,11.51%
2014-11,הצפון,518,מעיליא,יישוב,47,26,21,4,43,20,46,0,2.82%
2014-11,הצפון,1063,מעלות-תרשיחא,יישוב,778,375,403,83,695,470,766,11,6.44%
2014-11,הצפון,520,משהד,יישוב,282,113,169,10,272,240,265,0,8.33%
2014-11,הצפון,9100,נהרייה,יישוב,1885,871,1014,138,1747,1182,1837,27,5.95%
2014-11,הצפון,522,נחף,יישוב,392,186,206,6,386,325,388,2,7.87%
2014-11,הצפון,7300,נצרת,יישוב,3337,1431,1906,79,3258,2729,3244,0,9.36%
2014-11,הצפון,1061,נצרת עילית,יישוב,1630,752,878,150,1480,988,1469,16,6.26%
2014-11,הצפון,525,סאג'ור,יישוב,109,40,69,1,108,72,103,0,5.84%
2014-11,הצפון,7500,סח'נין,יישוב,2105,901,1204,19,2086,1835,2093,0,15.04%
2014-11,הצפון,4501,ע'ג'ר,יישוב,91,39,52,1,90,67,91,0,8.85%
2014-11,הצפון,530,עיילבון,יישוב,186,75,111,3,183,137,182,0,6.69%
2014-11,הצפון,511,עילוט,יישוב,348,141,207,3,345,281,340,0,12.01%
2014-11,הצפון,532,עין מאהל,יישוב,516,251,265,6,510,436,497,0,9.55%
2014-11,הצפון,7600,עכו,יישוב,3124,1405,1719,119,3005,2460,3021,0,11.38%
2014-11,הצפון,7700,עפולה,יישוב,1449,582,867,111,1338,782,1405,19,5.70%
2014-11,הצפון,531,עראבה,יישוב,1547,642,905,23,1524,1364,1527,0,15.17%
2014-11,הצפון,535,פסוטה,יישוב,99,46,53,7,92,69,97,0,5.74%
2014-11,הצפון,536,פקיעין (בוקייעה),יישוב,131,73,58,8,123,86,130,0,4.75%
2014-11,הצפון,8000,צפת,יישוב,1314,718,596,57,1257,1011,1254,22,9.43%
2014-11,הצפון,4100,קצרין,יישוב,223,93,130,16,207,99,219,1,5.53%
2014-11,הצפון,2800,קריית שמונה,יישוב,765,346,419,29,736,381,732,50,5.65%
2014-11,הצפון,543,ראמה,יישוב,296,118,178,8,288,237,293,0,7.56%
2014-11,הצפון,26,ראש פינה,יישוב,54,26,28,8,46,21,52,0,3.28%
2014-11,הצפון,542,ריינה,יישוב,650,273,377,7,643,536,629,0,9.28%
2014-11,הצפון,122,רמת ישי,יישוב,101,43,58,19,82,21,98,3,2.37%
2014-11,הצפון,913,שבלי - אום אל-גנם,יישוב,221,90,131,9,212,162,213,0,8.29%
2014-11,הצפון,812,שלומי,יישוב,230,103,127,12,218,142,226,5,6.31%
2014-11,הצפון,538,שעב,יישוב,562,225,337,7,555,484,559,0,18.07%
2014-11,הצפון,8800,שפרעם,יישוב,1993,763,1230,17,1976,1687,1961,12,11.12%
2014-11,חיפה,2710,אום אל-פחם,יישוב,3648,1473,2175,24,3624,3243,3580,0,17.11%
2014-11,חיפה,1020,אור עקיבא,יישוב,530,230,300,41,489,195,516,2,5.18%
2014-11,חיפה,6000,באקה אל-גרביה,יישוב,636,292,344,6,630,430,628,0,5.45%
2014-11,חיפה,9800,בנימינה-גבעת עדה*,יישוב,172,75,97,30,142,60,171,0,2.44%
2014-11,חיפה,1326,"בסמ""ה",יישוב,401,174,227,3,398,328,396,0,10.01%
2014-11,חיפה,541,ג'סר א-זרקא,יישוב,444,228,216,0,444,322,439,0,7.52%
2014-11,חיפה,628,ג'ת,יישוב,215,108,107,10,205,147,213,0,4.11%
2014-11,חיפה,494,דאלית אל-כרמל,יישוב,492,205,287,6,486,297,479,0,6.13%
2014-11,חיפה,9300,זכרון יעקב,יישוב,267,112,155,77,190,54,265,0,2.45%
2014-11,חיפה,6500,חדרה,יישוב,2143,908,1235,234,1909,922,2036,5,4.16%
2014-11,חיפה,4000,חיפה,יישוב,6362,3129,3233,1121,5241,3538,6118,4,4.32%
2014-11,חיפה,1247,חריש,יישוב,32,15,17,2,30,10,31,0,2.10%
2014-11,חיפה,2100,טירת כרמל,יישוב,749,356,393,20,729,439,730,4,6.82%
2014-11,חיפה,654,כפר קרע,יישוב,377,164,213,2,375,254,371,0,4.49%
2014-11,חיפה,45,מ.א. אלונה,מועצה איזורית,24,8,16,3,21,5,24,0,2.33%
2014-11,חיפה,12,מ.א. זבולון,מועצה איזורית,258,118,140,17,241,194,252,0,4.63%
2014-11,חיפה,15,מ.א. חוף הכרמל,מועצה איזורית,291,118,173,43,248,64,288,0,2.13%
2014-11,חיפה,14,מ.א. מנשה,מועצה איזורית,219,88,131,43,176,75,217,0,2.78%
2014-11,חיפה,1327,מעלה עירון,יישוב,895,334,561,5,890,775,886,1,15.19%
2014-11,חיפה,2500,נשר,יישוב,447,210,237,79,368,194,439,0,3.45%
2014-11,חיפה,534,עספיא,יישוב,319,153,166,5,314,182,303,0,5.56%
2014-11,חיפה,637,ערערה,יישוב,558,237,321,2,556,398,540,0,6.73%
2014-11,חיפה,537,פוריידיס,יישוב,419,223,196,2,417,269,414,0,7.46%
2014-11,חיפה,7800,פרדס חנה-כרכור,יישוב,792,359,433,126,666,273,785,0,3.94%
2014-11,חיפה,6800,קריית אתא,יישוב,1578,738,840,120,1458,936,1545,2,5.20%
2014-11,חיפה,9500,קריית ביאליק,יישוב,976,425,551,105,871,551,963,0,4.52%
2014-11,חיפה,2300,קריית טבעון,יישוב,175,90,85,51,124,51,169,0,1.99%
2014-11,חיפה,9600,קריית ים,יישוב,1448,666,782,135,1313,915,1409,2,6.63%
2014-11,חיפה,8200,קריית מוצקין,יישוב,954,395,559,135,819,508,933,2,4.11%
2014-11,חיפה,922,רכסים,יישוב,148,73,75,4,144,81,144,0,4.21%
2014-11,ירושלים,472,אבו גוש,יישוב,246,118,128,4,242,188,246,0,8.08%
2014-11,ירושלים,2610,בית שמש,יישוב,1203,491,712,52,1151,544,1171,2,3.71%
2014-11,ירושלים,3000,ירושלים,יישוב,11978,5369,6609,1228,10750,7663,11778,18,3.96%
2014-11,ירושלים,26,מ.א. מטה יהודה,מועצה איזורית,547,252,295,73,474,140,540,0,2.35%
2014-11,ירושלים,1015,מבשרת ציון,יישוב,379,173,206,75,304,167,370,0,2.78%
2014-11,ירושלים,1137,קריית יערים,יישוב,36,18,18,6,30,16,36,0,2.75%
2014-11,תל אביב,2400,אור יהודה,יישוב,714,370,344,27,687,245,689,0,3.68%
2014-11,תל אביב,565,אזור,יישוב,154,85,69,16,138,30,152,1,2.38%
2014-11,תל אביב,6100,בני ברק,יישוב,2185,1020,1164,43,2142,1176,2087,5,3.75%
2014-11,תל אביב,6200,בת ים,יישוב,2868,1362,1506,365,2503,1204,2769,10,3.92%
2014-11,תל אביב,6300,גבעתיים,יישוב,695,301,394,263,432,96,689,1,2.28%
2014-11,תל אביב,6400,הרצלייה,יישוב,949,420,529,206,743,39,938,4,1.95%
2014-11,תל אביב,6600,חולון,יישוב,2878,1373,1505,259,2619,861,2827,0,2.86%
2014-11,תל אביב,2620,קריית אונו,יישוב,364,150,214,103,261,57,360,0,1.92%
2014-11,תל אביב,8600,רמת גן,יישוב,1939,875,1064,541,1398,460,1912,6,2.45%
2014-11,תל אביב,2650,רמת השרון,יישוב,355,143,212,110,245,3,354,1,1.58%
2014-11,תל אביב,5000,תל אביב -יפו,יישוב,6754,3344,3410,1893,4861,2217,6656,11,2.65%
2014-12,אזור יהודה והשומרון,3760,אורנית,יישוב,129,50,79,51,78,4,129,0,2.74%
2014-12,אזור יהודה והשומרון,3750,אלפי מנשה,יישוב,113,42,71,34,79,2,113,1,2.64%
2014-12,אזור יהודה והשומרון,3560,אלקנה,יישוב,32,16,16,15,17,0,31,0,1.63%
2014-12,אזור יהודה והשומרון,3650,אפרת,יישוב,64,34,30,24,40,3,64,0,1.56%
2014-12,אזור יהודה והשומרון,3570,אריאל,יישוב,337,170,167,48,289,72,330,3,3.14%
2014-12,אזור יהודה והשומרון,3574,בית אל,יישוב,35,14,21,8,27,16,34,0,1.40%
2014-12,אזור יהודה והשומרון,3652,בית אריה,יישוב,67,29,38,12,55,4,67,1,2.61%
2014-12,אזור יהודה והשומרון,3780,ביתר עילית,יישוב,598,280,318,5,593,256,591,0,4.83%
2014-12,אזור יהודה והשומרון,3730,גבעת זאב,יישוב,211,98,113,40,171,45,208,3,2.76%
2014-12,אזור יהודה והשומרון,3769,הר אדר,יישוב,37,17,20,14,23,4,37,0,1.79%
2014-12,אזור יהודה והשומרון,76,מ.א. גוש עציון,מועצה איזורית,180,91,89,45,135,19,178,0,1.92%
2014-12,אזור יהודה והשומרון,78,מ.א. הר חברון,מועצה איזורית,78,39,39,17,61,8,75,0,2.32%
2014-12,אזור יהודה והשומרון,74,מ.א. מגילות ים המלח,מועצה איזורית,13,4,9,3,10,1,13,0,1.72%
2014-12,אזור יהודה והשומרון,73,מ.א. מטה בנימין,מועצה איזורית,663,326,337,144,519,138,660,0,2.77%
2014-12,אזור יהודה והשומרון,75,מ.א. ערבות הירדן,מועצה איזורית,47,18,29,8,39,3,46,0,1.97%
2014-12,אזור יהודה והשומרון,72,מ.א. שומרון,מועצה איזורית,406,200,206,79,327,52,401,0,2.54%
2014-12,אזור יהודה והשומרון,3797,מודיעין עילית,יישוב,469,155,314,15,454,89,454,1,3.47%
2014-12,אזור יהודה והשומרון,3616,מעלה אדומים,יישוב,662,288,374,49,613,180,650,16,3.20%
2014-12,אזור יהודה והשומרון,3660,עמנואל,יישוב,65,39,26,2,63,48,64,0,5.71%
2014-12,אזור יהודה והשומרון,3557,קדומים,יישוב,47,19,28,23,24,5,47,1,2.51%
2014-12,אזור יהודה והשומרון,3611,קריית ארבע,יישוב,136,72,64,10,126,74,131,3,4.09%
2014-12,אזור יהודה והשומרון,3640,קרני שומרון,יישוב,97,51,46,21,76,12,94,1,2.57%
2014-12,הדרום,31,אופקים,יישוב,1213,525,688,56,1157,764,1170,41,9.17%
2014-12,הדרום,2600,אילת,יישוב,1411,671,740,38,1373,529,1354,45,4.06%
2014-12,הדרום,70,אשדוד,יישוב,6622,2700,3922,730,5892,3321,6386,94,5.89%
2014-12,הדרום,7100,אשקלון,יישוב,4457,1910,2547,240,4217,2295,4018,78,5.83%
2014-12,הדרום,9000,באר שבע,יישוב,7100,3102,3998,722,6378,4079,6768,69,6.52%
2014-12,הדרום,2200,דימונה,יישוב,2049,902,1147,102,1947,1351,1953,48,10.65%
2014-12,הדרום,1303,חורה,יישוב,831,351,480,5,826,741,815,5,20.05%
2014-12,הדרום,831,ירוחם,יישוב,440,207,233,14,426,257,409,21,8.99%
2014-12,הדרום,1059,כסיפה,יישוב,1052,432,620,0,1052,924,1035,4,22.14%
2014-12,הדרום,1271,להבים,יישוב,43,18,25,16,27,5,42,1,1.21%
2014-12,הדרום,1060,לקיה,יישוב,996,457,539,4,992,909,977,5,22.97%
2014-12,הדרום,69,מ.א. אל קסום,מועצה איזורית,797,343,454,3,794,724,789,0,61.35%
2014-12,הדרום,38,מ.א. אשכול,מועצה איזורית,140,67,73,24,116,19,137,0,2.07%
2014-12,הדרום,33,מ.א. באר טוביה,מועצה איזורית,254,96,158,39,215,57,251,0,2.43%
2014-12,הדרום,41,מ.א. בני שמעון,מועצה איזורית,68,28,40,19,49,15,65,2,1.61%
2014-12,הדרום,54,מ.א. הערבה התיכונה,מועצה איזורית,25,10,15,3,22,1,25,0,1.39%
2014-12,הדרום,53,מ.א. חבל אילות,מועצה איזורית,17,7,10,1,16,0,17,3,0.80%
2014-12,הדרום,36,מ.א. חוף אשקלון,מועצה איזורית,242,106,136,8,234,61,231,0,2.95%
2014-12,הדרום,35,מ.א. יואב,מועצה איזורית,99,37,62,19,80,23,99,0,2.58%
2014-12,הדרום,50,מ.א. לכיש,מועצה איזורית,202,79,123,16,186,67,202,0,4.26%
2014-12,הדרום,42,מ.א. מרחבים,מועצה איזורית,179,76,103,16,163,43,177,0,3.32%
2014-12,הדרום,68,מ.א. נווה מדבר,מועצה איזורית,106,39,67,0,106,85,105,0,16.91%
2014-12,הדרום,48,מ.א. רמת נגב,מועצה איזורית,216,112,104,15,201,148,214,2,7.44%
2014-12,הדרום,39,מ.א. שדות נגב,מועצה איזורית,151,72,79,8,143,35,145,0,3.47%
2014-12,הדרום,37,מ.א. שער הנגב,מועצה איזורית,120,51,69,26,94,40,114,0,3.07%
2014-12,הדרום,34,מ.א. שפיר,מועצה איזורית,187,83,104,14,173,75,180,0,3.97%
2014-12,הדרום,51,מ.א. תמר,מועצה איזורית,12,4,8,2,10,1,11,0,1.77%
2014-12,הדרום,1268,מיתר,יישוב,72,29,43,14,58,8,70,0,1.64%
2014-12,הדרום,99,מצפה רמון,יישוב,273,118,155,12,261,180,254,14,10.31%
2014-12,הדרום,246,נתיבות,יישוב,1046,493,553,39,1007,549,996,45,7.15%
2014-12,הדרום,666,עומר,יישוב,51,20,31,15,36,4,51,0,1.26%
2014-12,הדרום,2560,ערד,יישוב,973,431,542,72,901,424,922,30,7.42%
2014-12,הדרום,1192,ערערה-בנגב,יישוב,1098,477,621,3,1095,990,1085,2,25.58%
2014-12,הדרום,2630,קריית גת,יישוב,2242,929,1312,103,2139,1150,2146,21,7.54%
2014-12,הדרום,1034,קריית מלאכי,יישוב,1281,574,707,21,1260,698,1225,57,10.41%
2014-12,הדרום,1161,רהט,יישוב,3243,1375,1868,6,3237,2695,3180,32,16.74%
2014-12,הדרום,1286,שגב-שלום,יישוב,559,208,351,1,558,499,549,3,20.52%
2014-12,הדרום,1031,שדרות,יישוב,1128,500,628,57,1071,632,1081,26,8.44%
2014-12,הדרום,1054,תל שבע,יישוב,1219,589,630,3,1216,1130,1202,10,24.28%
2014-12,המרכז,182,אבן יהודה,יישוב,156,74,82,44,112,18,156,2,2.32%
2014-12,המרכז,41,אליכין,יישוב,70,38,32,8,62,17,66,2,3.51%
2014-12,המרכז,1309,אלעד,יישוב,490,210,280,10,480,82,474,1,3.78%
2014-12,המרכז,2530,באר יעקב,יישוב,303,114,189,53,250,56,299,0,3.28%
2014-12,המרכז,466,בית דגן,יישוב,105,56,49,4,101,36,104,2,2.92%
2014-12,המרכז,1066,"בני עי""ש",יישוב,194,94,100,24,170,65,191,2,4.81%
2014-12,המרכז,681,גבעת שמואל,יישוב,291,148,143,28,263,65,282,0,2.36%
2014-12,המרכז,2550,גדרה,יישוב,405,170,235,91,314,118,396,3,3.39%
2014-12,המרכז,627,ג'לג'וליה,יישוב,94,42,52,3,91,60,90,0,2.49%
2014-12,המרכז,166,גן יבנה,יישוב,415,173,242,60,355,94,408,8,3.56%
2014-12,המרכז,229,גני תקווה,יישוב,171,74,97,53,118,24,171,0,2.06%
2014-12,המרכז,9700,הוד השרון,יישוב,641,281,360,206,435,60,635,3,2.15%
2014-12,המרכז,1290,זמר,יישוב,166,51,115,3,163,117,164,3,5.58%
2014-12,המרכז,2730,טייבה,יישוב,1638,709,929,14,1624,1355,1505,13,8.70%
2014-12,המרכז,2720,טירה,יישוב,306,150,156,13,293,148,297,5,2.62%
2014-12,המרכז,2660,יבנה,יישוב,923,460,463,82,841,314,907,23,3.90%
2014-12,המרכז,9400,יהוד,יישוב,476,194,282,62,414,61,464,8,2.93%
2014-12,המרכז,1224,כוכב יאיר,יישוב,95,41,54,42,53,0,92,1,1.63%
2014-12,המרכז,633,כפר ברא,יישוב,19,6,13,0,19,10,19,0,1.40%
2014-12,המרכז,168,כפר יונה,יישוב,356,159,197,59,297,73,345,2,3.18%
2014-12,המרכז,6900,כפר סבא,יישוב,1307,587,720,386,921,154,1280,9,2.42%
2014-12,המרכז,634,כפר קאסם,יישוב,224,103,121,5,219,121,214,1,2.43%
2014-12,המרכז,7000,לוד,יישוב,2223,1037,1186,153,2070,1213,2176,26,6.17%
2014-12,המרכז,28,מ.א. ברנר,מועצה איזורית,70,32,38,26,44,6,70,1,1.82%
2014-12,המרכז,32,מ.א. גדרות,מועצה איזורית,44,15,29,13,31,6,44,0,1.94%
2014-12,המרכז,30,מ.א. גזר,מועצה איזורית,269,120,149,76,193,26,264,0,2.08%
2014-12,המרכז,27,מ.א. גן רווה,מועצה איזורית,47,19,28,15,32,1,47,0,1.73%
2014-12,המרכז,20,מ.א. דרום השרון,מועצה איזורית,306,135,171,99,207,11,303,0,1.99%
2014-12,המרכז,29,מ.א. חבל יבנה,מועצה איזורית,34,18,16,11,23,3,33,0,1.38%
2014-12,המרכז,25,מ.א. חבל מודיעין,מועצה איזורית,286,116,170,82,204,30,282,0,2.70%
2014-12,המרכז,19,מ.א. חוף השרון,מועצה איזורית,94,49,45,32,62,4,94,0,1.72%
2014-12,המרכז,18,מ.א. לב השרון,מועצה איזורית,245,115,130,55,190,31,243,0,2.24%
2014-12,המרכז,31,מ.א. נחל שורק,מועצה איזורית,56,29,27,9,47,4,56,41,1.31%
2014-12,המרכז,16,מ.א. עמק חפר,מועצה איזורית,379,163,216,107,272,26,374,0,1.91%
2014-12,המרכז,40,מ.א. עמק לוד,מועצה איזורית,141,68,73,24,117,24,139,0,2.29%
2014-12,המרכז,1200,מודיעין-מכבים-רעות*,יישוב,964,401,563,231,733,66,943,9,2.19%
2014-12,המרכז,28,מזכרת בתיה,יישוב,179,74,105,41,138,38,177,1,2.52%
2014-12,המרכז,7200,נס ציונה,יישוב,705,341,364,157,548,197,696,3,2.98%
2014-12,המרכז,7400,נתניה,יישוב,4696,2142,2554,472,4224,1666,4491,76,4.29%
2014-12,המרכז,587,סביון*,יישוב,16,7,9,5,11,1,16,0,0.83%
2014-12,המרכז,171,פרדסייה,יישוב,78,33,45,15,63,5,78,0,2.16%
2014-12,המרכז,7900,פתח תקווה,יישוב,4111,1856,2255,781,3330,1069,4020,17,3.24%
2014-12,המרכז,195,קדימה-צורן,יישוב,277,126,151,60,217,41,272,1,2.57%
2014-12,המרכז,638,קלנסווה,יישוב,634,264,370,7,627,529,587,13,6.82%
2014-12,המרכז,469,קריית עקרון,יישוב,324,146,178,17,307,151,313,9,5.29%
2014-12,המרכז,2640,ראש העין,יישוב,768,363,405,100,668,162,748,9,3.24%
2014-12,המרכז,8300,ראשון לציון,יישוב,4532,1992,2540,467,4065,1337,4481,58,3.25%
2014-12,המרכז,8400,רחובות,יישוב,2618,1163,1455,498,2120,991,2529,28,3.74%
2014-12,המרכז,8500,רמלה,יישוב,1840,834,1006,114,1726,768,1763,26,4.78%
2014-12,המרכז,8700,רעננה,יישוב,825,351,474,290,535,67,816,2,2.20%
2014-12,המרכז,1304,שוהם,יישוב,186,83,103,68,118,9,186,1,1.69%
2014-12,המרכז,154,תל מונד,יישוב,145,64,81,47,98,19,145,1,2.35%
2014-12,הצפון,473,אבו סנאן,יישוב,669,270,399,5,664,536,657,3,11.39%
2014-12,הצפון,478,אכסאל,יישוב,539,262,277,14,525,459,521,1,9.24%
2014-12,הצפון,529,אעבלין,יישוב,616,248,368,5,611,505,609,9,10.81%
2014-12,הצפון,482,בועיינה-נוג'ידאת,יישוב,452,198,254,10,442,371,424,1,10.97%
2014-12,הצפון,4001,בוקעאתא,יישוב,421,167,254,2,419,346,396,1,14.46%
2014-12,הצפון,998,ביר אל-מכסור,יישוב,441,167,274,3,438,336,435,1,11.80%
2014-12,הצפון,480,בית ג'ן,יישוב,415,136,279,6,409,303,399,2,7.56%
2014-12,הצפון,9200,בית שאן,יישוב,873,387,486,21,852,432,840,37,8.36%
2014-12,הצפון,944,בסמת טבעון,יישוב,233,112,121,0,233,181,224,2,6.97%
2014-12,הצפון,483,בענה,יישוב,377,153,224,9,368,312,372,6,11.23%
2014-12,הצפון,1292,ג'דיידה-מכר,יישוב,1352,593,759,5,1347,1115,1320,11,14.54%
2014-12,הצפון,485,ג'ולס,יישוב,230,71,159,1,229,150,227,4,7.82%
2014-12,הצפון,487,ג'ש (גוש חלב),יישוב,67,35,32,1,66,38,64,0,3.91%
2014-12,הצפון,489,דבורייה,יישוב,380,161,219,17,363,277,374,0,8.82%
2014-12,הצפון,490,דייר אל-אסד,יישוב,390,155,235,6,384,312,386,2,7.58%
2014-12,הצפון,492,דייר חנא,יישוב,675,304,371,11,664,517,667,2,13.73%
2014-12,הצפון,975,זרזיר,יישוב,284,123,161,4,280,192,275,14,8.97%
2014-12,הצפון,496,חורפיש,יישוב,110,44,66,5,105,62,107,0,4.05%
2014-12,הצפון,2034,חצור הגלילית,יישוב,296,134,162,15,281,140,278,5,5.89%
2014-12,הצפון,6700,טבריה,יישוב,1841,824,1017,78,1763,1066,1589,40,7.32%
2014-12,הצפון,962,טובא-זנגרייה,יישוב,370,169,201,4,366,255,358,0,11.82%
2014-12,הצפון,498,טורעאן,יישוב,541,217,324,8,533,450,501,1,8.86%
2014-12,הצפון,8900,טמרה,יישוב,2019,834,1185,10,2009,1777,1962,19,13.95%
2014-12,הצפון,1295,יאנוח-ג'ת,יישוב,172,68,104,8,164,95,168,3,5.99%
2014-12,הצפון,46,יבנאל,יישוב,147,88,59,6,141,109,124,1,7.90%
2014-12,הצפון,499,יפיע,יישוב,659,269,390,18,641,521,640,3,8.21%
2014-12,הצפון,240,יקנעם עילית,יישוב,493,210,283,53,440,148,484,23,4.19%
2014-12,הצפון,502,ירכא,יישוב,577,241,336,2,575,434,569,2,9.74%
2014-12,הצפון,504,כאבול,יישוב,699,288,411,11,688,588,690,2,14.08%
2014-12,הצפון,505,כאוכב אבו אל-היג'א,יישוב,230,95,135,8,222,195,221,2,12.85%
2014-12,הצפון,1296,כסרא-סמיע,יישוב,209,84,125,2,207,152,199,1,5.84%
2014-12,הצפון,978,כעביה-טבאש-חג'אג'רה,יישוב,215,94,121,3,212,145,202,5,8.87%
2014-12,הצפון,1263,כפר ורדים,יישוב,72,29,43,31,41,8,72,0,2.30%
2014-12,הצפון,507,כפר יאסיף,יישוב,448,193,255,4,444,349,439,4,8.54%
2014-12,הצפון,508,כפר כמא,יישוב,63,26,37,1,62,26,61,0,3.77%
2014-12,הצפון,509,כפר כנא,יישוב,1207,527,680,28,1179,1005,1106,1,12.53%
2014-12,הצפון,510,כפר מנדא,יישוב,1000,458,542,6,994,746,956,4,13.03%
2014-12,הצפון,47,כפר תבור,יישוב,44,20,24,14,30,3,43,0,1.98%
2014-12,הצפון,1139,כרמיאל,יישוב,1680,673,1007,261,1419,802,1591,32,6.16%
2014-12,הצפון,65,מ.א. אל-בטוף,מועצה איזורית,406,163,243,5,401,338,381,1,14.24%
2014-12,הצפון,66,מ.א. בוסתן אל-מרג,מועצה איזורית,56,20,36,2,54,42,54,0,1.76%
2014-12,הצפון,71,מ.א. גולן,מועצה איזורית,193,76,117,17,176,16,192,0,2.34%
2014-12,הצפון,8,מ.א. הגלבוע,מועצה איזורית,809,313,496,43,766,494,796,0,5.70%
2014-12,הצפון,1,מ.א. הגליל העליון,מועצה איזורית,231,124,107,31,200,45,228,0,2.57%
2014-12,הצפון,3,מ.א. הגליל התחתון,מועצה איזורית,146,54,92,34,112,13,140,0,2.45%
2014-12,הצפון,55,מ.א. מבואות החרמון,מועצה איזורית,132,58,74,15,117,20,130,0,3.37%
2014-12,הצפון,13,מ.א. מגידו,מועצה איזורית,109,42,67,22,87,8,108,0,1.91%
2014-12,הצפון,4,מ.א. מטה אשר,מועצה איזורית,483,208,275,56,427,207,472,0,3.58%
2014-12,הצפון,52,מ.א. מעלה יוסף,מועצה איזורית,191,89,102,34,157,56,187,0,3.56%
2014-12,הצפון,2,מ.א. מרום הגליל,מועצה איזורית,285,130,155,15,270,125,277,0,4.27%
2014-12,הצפון,56,מ.א. משגב,מועצה איזורית,561,241,320,81,480,289,547,0,4.45%
2014-12,הצפון,6,מ.א. עמק הירדן,מועצה איזורית,199,81,118,35,164,35,182,0,2.74%
2014-12,הצפון,7,מ.א. עמק המעיינות,מועצה איזורית,190,95,95,30,160,39,186,0,3.01%
2014-12,הצפון,9,מ.א. עמק יזרעאל,מועצה איזורית,390,156,234,151,239,37,383,0,2.07%
2014-12,הצפון,481,מגאר,יישוב,1526,629,897,10,1516,1336,1481,11,15.79%
2014-12,הצפון,516,מג'ד אל-כרום,יישוב,559,246,313,3,556,418,552,14,8.53%
2014-12,הצפון,874,מגדל העמק,יישוב,1022,442,580,70,952,423,914,76,6.83%
2014-12,הצפון,4201,מג'דל שמס,יישוב,488,175,313,7,481,388,465,2,9.77%
2014-12,הצפון,517,מזרעה,יישוב,187,71,116,3,184,149,179,3,9.12%
2014-12,הצפון,4203,מסעדה,יישוב,210,77,133,3,207,177,200,1,11.99%
2014-12,הצפון,518,מעיליא,יישוב,57,29,28,8,49,24,54,0,3.30%
2014-12,הצפון,1063,מעלות-תרשיחא,יישוב,846,419,427,89,757,477,820,6,6.87%
2014-12,הצפון,520,משהד,יישוב,294,134,160,9,285,241,274,2,8.59%
2014-12,הצפון,9100,נהרייה,יישוב,2061,932,1129,154,1907,1198,1963,60,6.34%
2014-12,הצפון,522,נחף,יישוב,408,195,213,5,403,323,403,9,8.14%
2014-12,הצפון,7300,נצרת,יישוב,3401,1483,1918,82,3319,2721,3272,20,9.43%
2014-12,הצפון,1061,נצרת עילית,יישוב,1848,840,1008,152,1696,1022,1621,71,6.87%
2014-12,הצפון,525,סאג'ור,יישוב,115,45,70,0,115,71,111,0,6.27%
2014-12,הצפון,7500,סח'נין,יישוב,2164,943,1221,30,2134,1845,2146,8,15.37%
2014-12,הצפון,4501,ע'ג'ר,יישוב,93,38,55,1,92,61,92,0,8.94%
2014-12,הצפון,530,עיילבון,יישוב,190,78,112,2,188,136,187,0,6.86%
2014-12,הצפון,511,עילוט,יישוב,344,145,199,3,341,274,332,0,11.76%
2014-12,הצפון,532,עין מאהל,יישוב,553,263,290,4,549,439,529,3,10.10%
2014-12,הצפון,7600,עכו,יישוב,3237,1430,1807,128,3109,2445,3081,32,11.58%
2014-12,הצפון,7700,עפולה,יישוב,1673,685,988,118,1555,762,1584,43,6.38%
2014-12,הצפון,531,עראבה,יישוב,1582,664,918,27,1555,1364,1558,3,15.43%
2014-12,הצפון,535,פסוטה,יישוב,104,53,51,6,98,66,101,0,5.96%
2014-12,הצפון,536,פקיעין (בוקייעה),יישוב,145,80,65,9,136,98,142,1,5.17%
2014-12,הצפון,8000,צפת,יישוב,1473,823,650,62,1411,1061,1383,28,10.30%
2014-12,הצפון,4100,קצרין,יישוב,231,98,133,17,214,86,225,3,5.67%
2014-12,הצפון,2800,קריית שמונה,יישוב,780,363,417,40,740,360,746,41,5.75%
2014-12,הצפון,543,ראמה,יישוב,303,120,183,12,291,230,296,1,7.63%
2014-12,הצפון,26,ראש פינה,יישוב,65,30,35,10,55,21,64,1,4.01%
2014-12,הצפון,542,ריינה,יישוב,681,288,393,9,672,550,652,4,9.59%
2014-12,הצפון,122,רמת ישי,יישוב,109,46,63,20,89,23,106,2,2.56%
2014-12,הצפון,913,שבלי - אום אל-גנם,יישוב,246,104,142,6,240,151,240,2,9.24%
2014-12,הצפון,812,שלומי,יישוב,247,106,141,12,235,143,235,3,6.54%
2014-12,הצפון,538,שעב,יישוב,564,230,334,5,559,483,560,2,18.10%
2014-12,הצפון,8800,שפרעם,יישוב,2089,817,1272,20,2069,1699,2027,45,11.46%
2014-12,חיפה,2710,אום אל-פחם,יישוב,3816,1570,2246,24,3792,3222,3723,22,17.67%
2014-12,חיפה,1020,אור עקיבא,יישוב,633,291,342,48,585,198,617,13,6.13%
2014-12,חיפה,6000,באקה אל-גרביה,יישוב,714,347,367,8,706,426,705,20,6.08%
2014-12,חיפה,9800,בנימינה-גבעת עדה*,יישוב,200,91,109,42,158,61,196,1,2.78%
2014-12,חיפה,1326,"בסמ""ה",יישוב,429,181,248,5,424,327,422,1,10.60%
2014-12,חיפה,541,ג'סר א-זרקא,יישוב,454,241,213,1,453,319,447,5,7.65%
2014-12,חיפה,628,ג'ת,יישוב,246,130,116,10,236,143,243,3,4.67%
2014-12,חיפה,494,דאלית אל-כרמל,יישוב,550,227,323,6,544,288,535,5,6.80%
2014-12,חיפה,9300,זכרון יעקב,יישוב,291,120,171,82,209,51,290,0,2.67%
2014-12,חיפה,6500,חדרה,יישוב,2316,1000,1316,260,2056,878,2165,17,4.41%
2014-12,חיפה,4000,חיפה,יישוב,6915,3302,3613,1229,5686,3655,6466,67,4.56%
2014-12,חיפה,1247,חריש,יישוב,34,17,17,2,32,9,32,0,2.17%
2014-12,חיפה,2100,טירת כרמל,יישוב,784,379,405,20,764,422,758,23,7.06%
2014-12,חיפה,654,כפר קרע,יישוב,403,166,237,1,402,253,394,9,4.75%
2014-12,חיפה,45,מ.א. אלונה,מועצה איזורית,29,9,20,6,23,5,29,0,2.82%
2014-12,חיפה,12,מ.א. זבולון,מועצה איזורית,265,123,142,17,248,200,260,0,4.78%
2014-12,חיפה,15,מ.א. חוף הכרמל,מועצה איזורית,334,152,182,51,283,72,327,0,2.41%
2014-12,חיפה,14,מ.א. מנשה,מועצה איזורית,250,103,147,45,205,72,248,0,3.18%
2014-12,חיפה,1327,מעלה עירון,יישוב,932,351,581,5,927,777,919,1,15.66%
2014-12,חיפה,2500,נשר,יישוב,482,216,266,87,395,196,467,2,3.67%
2014-12,חיפה,534,עספיא,יישוב,359,176,183,4,355,186,336,3,6.12%
2014-12,חיפה,637,ערערה,יישוב,629,262,367,3,626,403,607,6,7.50%
2014-12,חיפה,537,פוריידיס,יישוב,469,236,233,3,466,278,461,2,8.24%
2014-12,חיפה,7800,פרדס חנה-כרכור,יישוב,909,438,471,144,765,266,891,17,4.45%
2014-12,חיפה,6800,קריית אתא,יישוב,1660,756,904,128,1532,920,1602,21,5.38%
2014-12,חיפה,9500,קריית ביאליק,יישוב,1069,455,614,122,947,530,1044,11,4.88%
2014-12,חיפה,2300,קריית טבעון,יישוב,188,93,95,56,132,42,183,1,2.15%
2014-12,חיפה,9600,קריית ים,יישוב,1570,695,875,153,1417,932,1487,17,6.97%
2014-12,חיפה,8200,קריית מוצקין,יישוב,1047,414,633,143,904,489,1013,13,4.44%
2014-12,חיפה,922,רכסים,יישוב,152,72,80,4,148,85,144,0,4.21%
2014-12,ירושלים,472,אבו גוש,יישוב,267,135,132,3,264,190,267,1,8.71%
2014-12,ירושלים,2610,בית שמש,יישוב,1341,555,786,57,1284,531,1284,25,4.05%
2014-12,ירושלים,3000,ירושלים,יישוב,12803,5761,7042,1326,11477,7657,12491,71,4.19%
2014-12,ירושלים,26,מ.א. מטה יהודה,מועצה איזורית,595,290,305,87,508,137,580,1,2.52%
2014-12,ירושלים,1015,מבשרת ציון,יישוב,404,187,217,78,326,161,396,5,2.97%
2014-12,ירושלים,1137,קריית יערים,יישוב,43,22,21,7,36,14,43,0,3.27%
2014-12,תל אביב,2400,אור יהודה,יישוב,846,445,401,35,811,247,802,20,4.26%
2014-12,תל אביב,565,אזור,יישוב,181,94,87,17,164,34,179,1,2.79%
2014-12,תל אביב,6100,בני ברק,יישוב,2309,1054,1255,46,2263,1114,2200,15,3.94%
2014-12,תל אביב,6200,בת ים,יישוב,3199,1544,1655,385,2814,1181,3024,37,4.26%
2014-12,תל אביב,6300,גבעתיים,יישוב,777,355,422,307,470,87,769,6,2.53%
2014-12,תל אביב,6400,הרצלייה,יישוב,1105,502,603,254,851,47,1083,14,2.24%
2014-12,תל אביב,6600,חולון,יישוב,3258,1548,1710,297,2961,852,3157,47,3.18%
2014-12,תל אביב,2620,קריית אונו,יישוב,404,184,220,109,295,42,400,0,2.13%
2014-12,תל אביב,8600,רמת גן,יישוב,2101,950,1151,637,1464,412,2064,13,2.64%
2014-12,תל אביב,2650,רמת השרון,יישוב,400,163,237,116,284,6,393,1,1.75%
2014-12,תל אביב,5000,תל אביב -יפו,יישוב,7724,3810,3914,2267,5457,2158,7533,53,2.99%
2015-01,אזור יהודה והשומרון,3760,אורנית,יישוב,112,44,68,37,75,4,112,1,2.30%
2015-01,אזור יהודה והשומרון,3750,אלפי מנשה,יישוב,107,43,64,28,79,2,106,3,2.40%
2015-01,אזור יהודה והשומרון,3560,אלקנה,יישוב,34,18,16,12,22,0,33,0,1.74%
2015-01,אזור יהודה והשומרון,3650,אפרת,יישוב,62,31,31,21,41,4,62,1,1.43%
2015-01,אזור יהודה והשומרון,3570,אריאל,יישוב,339,163,176,51,288,70,334,7,3.08%
2015-01,אזור יהודה והשומרון,3574,בית אל,יישוב,36,17,19,13,23,15,36,0,1.49%
2015-01,אזור יהודה והשומרון,3652,בית אריה,יישוב,60,27,33,10,50,4,60,1,2.23%
2015-01,אזור יהודה והשומרון,3780,ביתר עילית,יישוב,597,298,299,5,592,281,590,1,4.41%
2015-01,אזור יהודה והשומרון,3730,גבעת זאב,יישוב,213,99,114,35,178,40,210,2,2.69%
2015-01,אזור יהודה והשומרון,3769,הר אדר,יישוב,37,14,23,15,22,4,37,1,1.74%
2015-01,אזור יהודה והשומרון,76,מ.א. גוש עציון,מועצה איזורית,181,95,86,52,129,15,180,0,1.87%
2015-01,אזור יהודה והשומרון,78,מ.א. הר חברון,מועצה איזורית,79,41,38,19,60,8,76,0,2.17%
2015-01,אזור יהודה והשומרון,74,מ.א. מגילות ים המלח,מועצה איזורית,13,6,7,4,9,1,13,0,1.62%
2015-01,אזור יהודה והשומרון,73,מ.א. מטה בנימין,מועצה איזורית,645,314,331,136,509,144,637,0,2.54%
2015-01,אזור יהודה והשומרון,75,מ.א. ערבות הירדן,מועצה איזורית,46,21,25,10,36,2,46,0,1.89%
2015-01,אזור יהודה והשומרון,72,מ.א. שומרון,מועצה איזורית,392,196,196,74,318,49,387,0,2.29%
2015-01,אזור יהודה והשומרון,3797,מודיעין עילית,יישוב,456,163,293,18,438,92,441,9,3.13%
2015-01,אזור יהודה והשומרון,3616,מעלה אדומים,יישוב,661,285,376,42,619,186,651,22,3.16%
2015-01,אזור יהודה והשומרון,3608,מעלה אפרים,יישוב,38,15,23,2,36,12,37,2,4.44%
2015-01,אזור יהודה והשומרון,3660,עמנואל,יישוב,60,37,23,1,59,44,58,1,4.92%
2015-01,אזור יהודה והשומרון,3557,קדומים,יישוב,46,21,25,18,28,6,45,0,2.38%
2015-01,אזור יהודה והשומרון,3611,קריית ארבע,יישוב,137,71,66,13,124,75,133,4,4.02%
2015-01,אזור יהודה והשומרון,3640,קרני שומרון,יישוב,88,49,39,15,73,14,87,2,2.29%
2015-01,הדרום,31,אופקים,יישוב,1184,506,678,60,1124,753,1147,47,8.43%
2015-01,הדרום,2600,אילת,יישוב,1539,743,796,38,1501,531,1493,56,4.36%
2015-01,הדרום,70,אשדוד,יישוב,6587,2756,3831,731,5856,3274,6338,168,5.71%
2015-01,הדרום,7100,אשקלון,יישוב,4494,1958,2536,249,4245,2249,4033,119,5.62%
2015-01,הדרום,9000,באר שבע,יישוב,7126,3142,3984,782,6344,4029,6777,174,6.31%
2015-01,הדרום,2200,דימונה,יישוב,2071,904,1167,97,1974,1371,1961,74,10.28%
2015-01,הדרום,1303,חורה,יישוב,801,336,465,8,793,724,787,3,18.21%
2015-01,הדרום,831,ירוחם,יישוב,442,224,218,15,427,257,413,42,8.48%
2015-01,הדרום,1059,כסיפה,יישוב,1058,435,623,0,1058,939,1042,8,21.57%
2015-01,הדרום,1271,להבים,יישוב,42,17,25,18,24,5,41,0,1.13%
2015-01,הדרום,1060,לקיה,יישוב,982,451,531,3,979,902,959,2,21.03%
2015-01,הדרום,69,מ.א. אל קסום,מועצה איזורית,780,335,445,4,776,712,772,0,47.83%
2015-01,הדרום,38,מ.א. אשכול,מועצה איזורית,129,63,66,24,105,19,128,0,1.88%
2015-01,הדרום,33,מ.א. באר טוביה,מועצה איזורית,277,110,167,42,235,59,273,0,2.49%
2015-01,הדרום,41,מ.א. בני שמעון,מועצה איזורית,66,33,33,17,49,13,65,1,1.49%
2015-01,הדרום,54,מ.א. הערבה התיכונה,מועצה איזורית,26,10,16,4,22,2,24,0,1.32%
2015-01,הדרום,53,מ.א. חבל אילות,מועצה איזורית,20,9,11,1,19,0,19,3,0.81%
2015-01,הדרום,36,מ.א. חוף אשקלון,מועצה איזורית,241,107,134,9,232,59,231,0,2.79%
2015-01,הדרום,35,מ.א. יואב,מועצה איזורית,104,44,60,21,83,25,103,0,2.59%
2015-01,הדרום,50,מ.א. לכיש,מועצה איזורית,194,87,107,16,178,60,194,0,3.86%
2015-01,הדרום,42,מ.א. מרחבים,מועצה איזורית,181,78,103,22,159,42,178,0,3.01%
2015-01,הדרום,68,מ.א. נווה מדבר,מועצה איזורית,106,38,68,0,106,86,105,0,10.89%
2015-01,הדרום,48,מ.א. רמת נגב,מועצה איזורית,226,120,106,18,208,162,223,0,7.03%
2015-01,הדרום,39,מ.א. שדות נגב,מועצה איזורית,148,70,78,10,138,31,143,0,3.17%
2015-01,הדרום,37,מ.א. שער הנגב,מועצה איזורית,111,48,63,30,81,32,109,2,2.80%
2015-01,הדרום,34,מ.א. שפיר,מועצה איזורית,187,92,95,11,176,72,182,0,3.88%
2015-01,הדרום,51,מ.א. תמר,מועצה איזורית,13,6,7,3,10,3,13,0,2.05%
2015-01,הדרום,1268,מיתר,יישוב,77,33,44,19,58,9,76,0,1.70%
2015-01,הדרום,99,מצפה רמון,יישוב,276,120,156,9,267,179,257,12,9.27%
2015-01,הדרום,246,נתיבות,יישוב,1033,486,547,53,980,553,971,53,6.53%
2015-01,הדרום,666,עומר,יישוב,60,26,34,16,44,4,60,0,1.42%
2015-01,הדרום,2560,ערד,יישוב,1038,465,573,72,966,436,982,57,7.78%
2015-01,הדרום,1192,ערערה-בנגב,יישוב,1092,478,614,3,1089,985,1079,3,24.54%
2015-01,הדרום,2630,קריית גת,יישוב,2236,934,1302,98,2138,1121,2149,54,7.43%
2015-01,הדרום,1034,קריית מלאכי,יישוב,1214,543,671,20,1194,664,1158,73,9.60%
2015-01,הדרום,1161,רהט,יישוב,3167,1359,1808,8,3159,2682,3120,26,15.27%
2015-01,הדרום,1286,שגב-שלום,יישוב,546,202,344,0,546,492,532,5,18.05%
2015-01,הדרום,1031,שדרות,יישוב,1146,545,601,53,1093,657,1091,28,7.99%
2015-01,הדרום,1054,תל שבע,יישוב,1204,589,615,1,1203,1114,1185,9,22.47%
2015-01,המרכז,1066,"בני עי""ש",יישוב,186,87,99,24,162,66,184,1,4.56%
2015-01,המרכז,182,אבן יהודה,יישוב,156,76,80,40,116,20,155,0,2.25%
2015-01,המרכז,41,אליכין,יישוב,69,37,32,11,58,18,66,1,3.40%
2015-01,המרכז,1309,אלעד,יישוב,441,196,245,11,430,76,428,1,3.28%
2015-01,המרכז,2530,באר יעקב,יישוב,312,117,195,55,257,55,304,8,3.02%
2015-01,המרכז,466,בית דגן,יישוב,103,55,48,3,100,30,103,1,2.77%
2015-01,המרכז,681,גבעת שמואל,יישוב,292,159,133,29,263,61,285,1,2.35%
2015-01,המרכז,2550,גדרה,יישוב,400,171,229,89,311,115,387,8,3.09%
2015-01,המרכז,627,ג'לג'וליה,יישוב,104,45,59,2,102,61,96,0,2.54%
2015-01,המרכז,166,גן יבנה,יישוב,434,174,260,61,373,92,422,10,3.45%
2015-01,המרכז,229,גני תקווה,יישוב,194,83,111,59,135,29,193,1,2.14%
2015-01,המרכז,9700,הוד השרון,יישוב,632,274,358,190,442,62,623,7,2.01%
2015-01,המרכז,1290,זמר,יישוב,162,52,110,3,159,113,161,7,5.39%
2015-01,המרכז,2730,טייבה,יישוב,1665,736,929,21,1644,1364,1524,31,8.47%
2015-01,המרכז,2720,טירה,יישוב,307,150,157,12,295,137,296,11,2.57%
2015-01,המרכז,2660,יבנה,יישוב,927,463,464,91,836,316,915,35,3.72%
2015-01,המרכז,9400,יהוד,יישוב,464,190,274,50,414,65,453,8,2.80%
2015-01,המרכז,1224,כוכב יאיר,יישוב,86,33,53,33,53,0,83,1,1.44%
2015-01,המרכז,633,כפר ברא,יישוב,22,8,14,0,22,11,22,0,1.54%
2015-01,המרכז,168,כפר יונה,יישוב,331,148,183,56,275,64,326,9,2.88%
2015-01,המרכז,6900,כפר סבא,יישוב,1321,595,726,368,953,150,1298,21,2.44%
2015-01,המרכז,634,כפר קאסם,יישוב,226,106,120,5,221,120,218,7,2.36%
2015-01,המרכז,7000,לוד,יישוב,2188,1027,1161,138,2050,1183,2143,52,5.98%
2015-01,המרכז,28,מ.א. ברנר,מועצה איזורית,72,36,36,23,49,5,71,2,1.74%
2015-01,המרכז,32,מ.א. גדרות,מועצה איזורית,43,14,29,16,27,5,42,0,1.72%
2015-01,המרכז,30,מ.א. גזר,מועצה איזורית,261,112,149,83,178,26,256,0,1.94%
2015-01,המרכז,27,מ.א. גן רווה,מועצה איזורית,56,24,32,16,40,3,56,0,1.91%
2015-01,המרכז,20,מ.א. דרום השרון,מועצה איזורית,317,136,181,96,221,13,315,0,2.01%
2015-01,המרכז,29,מ.א. חבל יבנה,מועצה איזורית,33,17,16,12,21,3,32,0,1.29%
2015-01,המרכז,25,מ.א. חבל מודיעין,מועצה איזורית,277,111,166,73,204,29,271,0,2.52%
2015-01,המרכז,19,מ.א. חוף השרון,מועצה איזורית,97,47,50,30,67,7,97,0,1.73%
2015-01,המרכז,18,מ.א. לב השרון,מועצה איזורית,241,113,128,49,192,33,240,0,2.18%
2015-01,המרכז,31,מ.א. נחל שורק,מועצה איזורית,62,33,29,10,52,7,62,47,1.43%
2015-01,המרכז,16,מ.א. עמק חפר,מועצה איזורית,398,168,230,102,296,30,394,0,2.00%
2015-01,המרכז,40,מ.א. עמק לוד,מועצה איזורית,136,71,65,22,114,25,135,0,2.19%
2015-01,המרכז,1200,מודיעין-מכבים-רעות*,יישוב,948,411,537,223,725,66,934,14,2.07%
2015-01,המרכז,28,מזכרת בתיה,יישוב,180,84,96,45,135,42,177,2,2.35%
2015-01,המרכז,7200,נס ציונה,יישוב,682,325,357,170,512,181,676,9,2.82%
2015-01,המרכז,7400,נתניה,יישוב,4587,2129,2458,429,4158,1593,4444,149,4.19%
2015-01,המרכז,587,סביון*,יישוב,16,8,8,7,9,1,15,0,0.76%
2015-01,המרכז,171,פרדסייה,יישוב,82,33,49,15,67,6,82,0,2.15%
2015-01,המרכז,7900,פתח תקווה,יישוב,4202,1852,2350,841,3361,1101,4097,66,3.24%
2015-01,המרכז,195,קדימה-צורן,יישוב,277,127,150,47,230,37,272,4,2.44%
2015-01,המרכז,638,קלנסווה,יישוב,621,261,360,6,615,512,574,8,6.42%
2015-01,המרכז,469,קריית עקרון,יישוב,291,134,157,11,280,136,283,12,4.66%
2015-01,המרכז,2640,ראש העין,יישוב,779,353,426,100,679,151,764,22,3.01%
2015-01,המרכז,8300,ראשון לציון,יישוב,4546,2016,2530,487,4059,1324,4502,83,3.22%
2015-01,המרכז,8400,רחובות,יישוב,2601,1195,1406,491,2110,975,2515,50,3.63%
2015-01,המרכז,8500,רמלה,יישוב,1852,835,1017,111,1741,766,1771,62,4.66%
2015-01,המרכז,8700,רעננה,יישוב,779,335,444,268,511,55,770,10,2.07%
2015-01,המרכז,1304,שוהם,יישוב,190,83,107,70,120,8,189,1,1.62%
2015-01,המרכז,154,תל מונד,יישוב,156,78,78,44,112,19,156,2,2.42%
2015-01,הצפון,473,אבו סנאן,יישוב,687,281,406,6,681,550,669,21,11.14%
2015-01,הצפון,478,אכסאל,יישוב,566,280,286,13,553,466,548,3,9.43%
2015-01,הצפון,529,אעבלין,יישוב,630,262,368,5,625,513,623,10,10.52%
2015-01,הצפון,482,בועיינה-נוג'ידאת,יישוב,439,186,253,11,428,344,427,4,10.74%
2015-01,הצפון,4001,בוקעאתא,יישוב,434,172,262,4,430,348,410,2,14.59%
2015-01,הצפון,998,ביר אל-מכסור,יישוב,440,168,272,2,438,332,435,4,11.03%
2015-01,הצפון,480,בית ג'ן,יישוב,399,124,275,4,395,294,383,5,6.79%
2015-01,הצפון,9200,בית שאן,יישוב,862,385,477,19,843,434,820,50,7.92%
2015-01,הצפון,944,בסמת טבעון,יישוב,219,107,112,1,218,163,215,2,6.49%
2015-01,הצפון,483,בענה,יישוב,395,167,228,11,384,322,384,16,10.97%
2015-01,הצפון,1292,ג'דיידה-מכר,יישוב,1377,612,765,6,1371,1122,1352,32,14.10%
2015-01,הצפון,485,ג'ולס,יישוב,243,80,163,1,242,160,239,4,7.61%
2015-01,הצפון,487,ג'ש (גוש חלב),יישוב,81,41,40,2,79,40,78,2,4.67%
2015-01,הצפון,489,דבורייה,יישוב,389,172,217,20,369,280,385,1,8.81%
2015-01,הצפון,490,דייר אל-אסד,יישוב,389,159,230,6,383,317,385,15,7.29%
2015-01,הצפון,492,דייר חנא,יישוב,707,328,379,9,698,520,697,4,13.99%
2015-01,הצפון,975,זרזיר,יישוב,294,130,164,4,290,198,281,6,8.43%
2015-01,הצפון,496,חורפיש,יישוב,126,49,77,6,120,70,121,0,4.21%
2015-01,הצפון,2034,חצור הגלילית,יישוב,279,125,154,16,263,135,259,15,5.29%
2015-01,הצפון,6700,טבריה,יישוב,1832,835,997,73,1759,1032,1592,48,7.19%
2015-01,הצפון,962,טובא-זנגרייה,יישוב,375,172,203,5,370,251,363,2,11.84%
2015-01,הצפון,498,טורעאן,יישוב,546,215,331,10,536,447,518,5,8.90%
2015-01,הצפון,8900,טמרה,יישוב,2028,856,1172,13,2015,1794,1975,20,13.42%
2015-01,הצפון,1295,יאנוח-ג'ת,יישוב,178,68,110,8,170,95,176,1,5.92%
2015-01,הצפון,46,יבנאל,יישוב,150,92,58,5,145,121,117,2,7.27%
2015-01,הצפון,29,יסוד המעלה,יישוב,10,5,5,3,7,1,10,0,1.17%
2015-01,הצפון,499,יפיע,יישוב,663,288,375,19,644,514,647,9,8.06%
2015-01,הצפון,240,יקנעם עילית,יישוב,501,211,290,62,439,149,491,26,4.02%
2015-01,הצפון,502,ירכא,יישוב,589,252,337,2,587,462,580,3,8.88%
2015-01,הצפון,504,כאבול,יישוב,698,282,416,12,686,588,688,9,13.45%
2015-01,הצפון,505,כאוכב אבו אל-היג'א,יישוב,229,96,133,8,221,190,224,4,12.77%
2015-01,הצפון,1296,כסרא-סמיע,יישוב,238,93,145,4,234,170,230,5,6.48%
2015-01,הצפון,978,כעביה-טבאש-חג'אג'רה,יישוב,206,83,123,3,203,136,199,2,8.33%
2015-01,הצפון,1263,כפר ורדים,יישוב,64,25,39,26,38,5,64,0,2.08%
2015-01,הצפון,507,כפר יאסיף,יישוב,446,192,254,5,441,355,438,2,8.51%
2015-01,הצפון,508,כפר כמא,יישוב,63,25,38,2,61,24,61,1,3.60%
2015-01,הצפון,509,כפר כנא,יישוב,1172,493,679,30,1142,960,1102,25,12.25%
2015-01,הצפון,510,כפר מנדא,יישוב,1006,458,548,6,1000,747,979,5,13.08%
2015-01,הצפון,47,כפר תבור,יישוב,49,17,32,15,34,1,48,0,2.09%
2015-01,הצפון,1139,כרמיאל,יישוב,1668,667,1001,236,1432,779,1578,50,6.01%
2015-01,הצפון,65,מ.א. אל-בטוף,מועצה איזורית,401,162,239,5,396,331,385,0,13.23%
2015-01,הצפון,66,מ.א. בוסתן אל-מרג',מועצה איזורית,48,16,32,2,46,37,47,1,1.53%
2015-01,הצפון,71,מ.א. גולן,מועצה איזורית,193,84,109,18,175,18,193,1,2.24%
2015-01,הצפון,8,מ.א. הגלבוע,מועצה איזורית,800,326,474,43,757,497,782,0,5.42%
2015-01,הצפון,1,מ.א. הגליל העליון,מועצה איזורית,240,133,107,28,212,43,233,0,2.64%
2015-01,הצפון,3,מ.א. הגליל התחתון,מועצה איזורית,146,54,92,32,114,15,140,0,2.39%
2015-01,הצפון,55,מ.א. מבואות החרמון,מועצה איזורית,131,59,72,17,114,21,129,0,3.23%
2015-01,הצפון,13,מ.א. מגידו,מועצה איזורית,104,45,59,24,80,8,103,0,1.82%
2015-01,הצפון,4,מ.א. מטה אשר,מועצה איזורית,494,217,277,61,433,204,484,0,3.53%
2015-01,הצפון,52,מ.א. מעלה יוסף,מועצה איזורית,174,82,92,31,143,54,173,1,3.14%
2015-01,הצפון,2,מ.א. מרום הגליל,מועצה איזורית,288,134,154,15,273,128,278,0,4.07%
2015-01,הצפון,56,מ.א. משגב,מועצה איזורית,554,229,325,68,486,293,544,0,4.19%
2015-01,הצפון,6,מ.א. עמק הירדן,מועצה איזורית,197,85,112,33,164,42,180,0,2.66%
2015-01,הצפון,7,מ.א. עמק המעיינות,מועצה איזורית,190,85,105,30,160,45,188,0,2.90%
2015-01,הצפון,9,מ.א. עמק יזרעאל,מועצה איזורית,381,144,237,138,243,41,371,0,1.92%
2015-01,הצפון,481,מגאר,יישוב,1539,644,895,11,1528,1343,1479,11,14.71%
2015-01,הצפון,516,מג'ד אל-כרום,יישוב,542,239,303,3,539,413,534,14,7.93%
2015-01,הצפון,65,מגדל,יישוב,45,19,26,3,42,15,41,0,4.30%
2015-01,הצפון,874,מגדל העמק,יישוב,991,452,539,65,926,426,884,83,6.44%
2015-01,הצפון,4201,מג'דל שמס,יישוב,478,175,303,8,470,374,461,4,9.30%
2015-01,הצפון,517,מזרעה,יישוב,191,75,116,3,188,144,185,5,9.16%
2015-01,הצפון,43,מטולה,יישוב,27,17,10,3,24,6,27,0,2.57%
2015-01,הצפון,4203,מסעדה,יישוב,215,81,134,4,211,178,209,0,12.17%
2015-01,הצפון,518,מעיליא,יישוב,53,23,30,5,48,20,52,0,3.21%
2015-01,הצפון,1063,מעלות-תרשיחא,יישוב,857,421,436,94,763,470,834,27,7.01%
2015-01,הצפון,520,משהד,יישוב,287,129,158,10,277,234,277,2,8.45%
2015-01,הצפון,9100,נהרייה,יישוב,2001,931,1070,155,1846,1141,1918,68,6.15%
2015-01,הצפון,522,נחף,יישוב,414,190,224,9,405,335,405,5,7.91%
2015-01,הצפון,7300,נצרת,יישוב,3374,1472,1902,93,3281,2673,3283,35,9.39%
2015-01,הצפון,1061,נצרת עילית,יישוב,1866,845,1021,152,1714,1005,1618,94,6.89%
2015-01,הצפון,525,סאג'ור,יישוב,110,39,71,2,108,72,105,1,5.32%
2015-01,הצפון,7500,סח'נין,יישוב,2174,926,1248,31,2143,1839,2156,19,15.03%
2015-01,הצפון,4501,ע'ג'ר,יישוב,92,36,56,0,92,61,92,1,8.67%
2015-01,הצפון,530,עיילבון,יישוב,190,80,110,1,189,135,185,0,6.63%
2015-01,הצפון,511,עילוט,יישוב,353,152,201,5,348,281,343,0,11.76%
2015-01,הצפון,532,עין מאהל,יישוב,577,286,291,3,574,461,539,5,10.01%
2015-01,הצפון,4502,עין קנייא,יישוב,154,68,86,1,153,120,150,2,14.41%
2015-01,הצפון,7600,עכו,יישוב,3229,1472,1757,131,3098,2419,3090,68,11.50%
2015-01,הצפון,7700,עפולה,יישוב,1677,699,978,116,1561,740,1583,90,6.15%
2015-01,הצפון,531,עראבה,יישוב,1619,682,937,25,1594,1385,1595,8,15.29%
2015-01,הצפון,535,פסוטה,יישוב,111,53,58,8,103,67,108,1,6.21%
2015-01,הצפון,536,פקיעין (בוקייעה),יישוב,137,78,59,7,130,86,135,2,4.77%
2015-01,הצפון,8000,צפת,יישוב,1438,797,641,55,1383,1021,1365,36,9.92%
2015-01,הצפון,4100,קצרין,יישוב,231,105,126,16,215,90,229,6,5.63%
2015-01,הצפון,2800,קריית שמונה,יישוב,805,377,428,39,766,349,768,45,5.83%
2015-01,הצפון,543,ראמה,יישוב,300,121,179,11,289,225,296,1,7.48%
2015-01,הצפון,26,ראש פינה,יישוב,66,31,35,9,57,22,64,2,3.95%
2015-01,הצפון,542,ריינה,יישוב,685,287,398,14,671,547,664,13,9.50%
2015-01,הצפון,122,רמת ישי,יישוב,98,44,54,18,80,21,96,2,2.30%
2015-01,הצפון,913,שבלי - אום אל-גנם,יישוב,240,101,139,6,234,151,232,2,8.63%
2015-01,הצפון,812,שלומי,יישוב,240,106,134,12,228,130,235,7,6.47%
2015-01,הצפון,538,שעב,יישוב,551,222,329,4,547,475,548,7,17.45%
2015-01,הצפון,8800,שפרעם,יישוב,2062,812,1250,25,2037,1658,2021,37,10.87%
2015-01,חיפה,1326,"בסמ""ה",יישוב,434,185,249,5,429,328,429,9,10.44%
2015-01,חיפה,2710,אום אל-פחם,יישוב,3772,1568,2204,29,3743,3194,3689,33,16.83%
2015-01,חיפה,1020,אור עקיבא,יישוב,597,271,326,48,549,192,574,17,5.57%
2015-01,חיפה,6000,באקה אל-גרביה,יישוב,711,356,355,7,704,416,703,28,5.91%
2015-01,חיפה,9800,בנימינה-גבעת עדה*,יישוב,202,90,112,47,155,59,201,2,2.75%
2015-01,חיפה,541,ג'סר א-זרקא,יישוב,461,250,211,0,461,323,455,6,7.44%
2015-01,חיפה,628,ג'ת,יישוב,250,134,116,9,241,138,248,4,4.65%
2015-01,חיפה,494,דאלית אל-כרמל,יישוב,559,230,329,8,551,297,538,8,6.42%
2015-01,חיפה,9300,זכרון יעקב,יישוב,266,114,152,75,191,53,264,3,2.37%
2015-01,חיפה,6500,חדרה,יישוב,2387,1056,1331,269,2118,897,2224,50,4.41%
2015-01,חיפה,4000,חיפה,יישוב,6808,3334,3474,1205,5603,3474,6468,178,4.59%
2015-01,חיפה,1247,חריש,יישוב,36,17,19,2,34,10,34,0,2.12%
2015-01,חיפה,2100,טירת כרמל,יישוב,751,372,379,21,730,415,725,18,6.38%
2015-01,חיפה,654,כפר קרע,יישוב,426,192,234,2,424,261,417,14,4.85%
2015-01,חיפה,45,מ.א. אלונה,מועצה איזורית,31,11,20,6,25,4,31,0,2.90%
2015-01,חיפה,12,מ.א. זבולון,מועצה איזורית,268,126,142,24,244,193,264,0,4.74%
2015-01,חיפה,15,מ.א. חוף הכרמל,מועצה איזורית,317,137,180,61,256,67,313,0,2.21%
2015-01,חיפה,14,מ.א. מנשה,מועצה איזורית,253,101,152,58,195,74,250,0,3.12%
2015-01,חיפה,1327,מעלה עירון,יישוב,929,358,571,5,924,775,913,7,15.02%
2015-01,חיפה,2500,נשר,יישוב,472,235,237,84,388,184,455,5,3.54%
2015-01,חיפה,534,עספיא,יישוב,350,166,184,5,345,175,331,5,5.79%
2015-01,חיפה,637,ערערה,יישוב,623,266,357,4,619,399,604,31,7.34%
2015-01,חיפה,537,פוריידיס,יישוב,468,238,230,5,463,278,460,0,7.96%
2015-01,חיפה,7800,פרדס חנה-כרכור,יישוב,901,425,476,141,760,264,885,21,4.32%
2015-01,חיפה,6800,קריית אתא,יישוב,1641,752,889,139,1502,890,1591,44,5.20%
2015-01,חיפה,9500,קריית ביאליק,יישוב,1068,462,606,122,946,538,1046,32,4.85%
2015-01,חיפה,2300,קריית טבעון,יישוב,189,96,93,63,126,42,185,0,2.21%
2015-01,חיפה,9600,קריית ים,יישוב,1524,701,823,148,1376,889,1470,56,6.81%
2015-01,חיפה,8200,קריית מוצקין,יישוב,1006,419,587,139,867,470,983,23,4.25%
2015-01,חיפה,922,רכסים,יישוב,139,69,70,5,134,83,131,1,3.68%
2015-01,ירושלים,472,אבו גוש,יישוב,270,134,136,2,268,191,268,0,8.57%
2015-01,ירושלים,2610,בית שמש,יישוב,1292,555,737,48,1244,520,1237,48,3.65%
2015-01,ירושלים,3000,ירושלים,יישוב,12947,5927,7020,1361,11586,7757,12631,131,4.22%
2015-01,ירושלים,26,מ.א. מטה יהודה,מועצה איזורית,603,285,318,90,513,122,589,2,2.46%
2015-01,ירושלים,1015,מבשרת ציון,יישוב,393,185,208,80,313,155,386,6,2.96%
2015-01,ירושלים,1137,קריית יערים,יישוב,39,18,21,6,33,14,39,0,2.75%
2015-01,תל אביב,2400,אור יהודה,יישוב,820,433,387,37,783,232,777,39,4.05%
2015-01,תל אביב,565,אזור,יישוב,175,92,83,20,155,35,173,2,2.63%
2015-01,תל אביב,6100,בני ברק,יישוב,2236,1060,1176,52,2184,1090,2116,31,3.66%
2015-01,תל אביב,6200,בת ים,יישוב,3192,1483,1709,390,2802,1152,3048,67,4.30%
2015-01,תל אביב,6300,גבעתיים,יישוב,785,359,426,322,463,92,782,4,2.53%
2015-01,תל אביב,6400,הרצלייה,יישוב,1130,534,596,268,862,35,1117,27,2.28%
2015-01,תל אביב,6600,חולון,יישוב,3195,1519,1676,280,2915,815,3108,64,3.12%
2015-01,תל אביב,267,כפר שמריהו,יישוב,14,5,9,5,9,0,14,0,1.65%
2015-01,תל אביב,2620,קריית אונו,יישוב,409,183,226,109,300,39,404,2,2.11%
2015-01,תל אביב,8600,רמת גן,יישוב,2096,967,1129,620,1476,419,2066,18,2.63%
2015-01,תל אביב,2650,רמת השרון,יישוב,413,166,247,125,288,4,411,4,1.84%
2015-01,תל אביב,5000,תל אביב -יפו,יישוב,7670,3826,3844,2340,5330,2090,7514,109,2.95%
2015-02,אזור יהודה והשומרון,3760,אורנית,יישוב,102,42,60,36,66,3,102,0,2.09%
2015-02,אזור יהודה והשומרון,3750,אלפי מנשה,יישוב,110,52,58,27,83,1,110,1,2.48%
2015-02,אזור יהודה והשומרון,3560,אלקנה,יישוב,29,15,14,10,19,0,29,1,1.53%
2015-02,אזור יהודה והשומרון,3650,אפרת,יישוב,64,31,33,19,45,5,64,0,1.48%
2015-02,אזור יהודה והשומרון,3570,אריאל,יישוב,338,160,178,58,280,66,334,11,3.08%
2015-02,אזור יהודה והשומרון,3574,בית אל,יישוב,41,16,25,14,27,15,41,0,1.69%
2015-02,אזור יהודה והשומרון,3652,בית אריה,יישוב,54,24,30,7,47,3,54,2,2.01%
2015-02,אזור יהודה והשומרון,3780,ביתר עילית,יישוב,601,309,292,7,594,287,595,1,4.44%
2015-02,אזור יהודה והשומרון,3730,גבעת זאב,יישוב,217,104,113,41,176,53,214,3,2.74%
2015-02,אזור יהודה והשומרון,3769,הר אדר,יישוב,39,12,27,19,20,4,38,0,1.79%
2015-02,אזור יהודה והשומרון,76,מ.א. גוש עציון,מועצה איזורית,172,90,82,50,122,15,172,0,1.79%
2015-02,אזור יהודה והשומרון,78,מ.א. הר חברון,מועצה איזורית,74,41,33,17,57,8,72,0,2.05%
2015-02,אזור יהודה והשומרון,74,מ.א. מגילות ים המלח,מועצה איזורית,20,8,12,4,16,2,20,0,2.49%
2015-02,אזור יהודה והשומרון,73,מ.א. מטה בנימין,מועצה איזורית,656,325,331,157,499,140,647,0,2.58%
2015-02,אזור יהודה והשומרון,75,מ.א. ערבות הירדן,מועצה איזורית,55,29,26,13,42,3,55,0,2.26%
2015-02,אזור יהודה והשומרון,72,מ.א. שומרון,מועצה איזורית,394,204,190,70,324,49,388,0,2.30%
2015-02,אזור יהודה והשומרון,3797,מודיעין עילית,יישוב,431,153,278,16,415,74,421,4,2.99%
2015-02,אזור יהודה והשומרון,3616,מעלה אדומים,יישוב,634,276,358,37,597,185,624,17,3.04%
2015-02,אזור יהודה והשומרון,3608,מעלה אפרים,יישוב,30,14,16,1,29,9,30,0,3.63%
2015-02,אזור יהודה והשומרון,3660,עמנואל,יישוב,63,40,23,1,62,40,60,1,5.08%
2015-02,אזור יהודה והשומרון,3557,קדומים,יישוב,48,26,22,17,31,7,48,0,2.54%
2015-02,אזור יהודה והשומרון,3611,קריית ארבע,יישוב,131,64,67,13,118,72,127,6,3.84%
2015-02,אזור יהודה והשומרון,3640,קרני שומרון,יישוב,79,43,36,17,62,13,79,1,2.08%
2015-02,הדרום,31,אופקים,יישוב,1179,505,674,57,1122,735,1139,44,8.38%
2015-02,הדרום,2600,אילת,יישוב,1533,749,784,43,1490,533,1491,53,4.36%
2015-02,הדרום,70,אשדוד,יישוב,6432,2710,3722,708,5724,3176,6178,194,5.58%
2015-02,הדרום,7100,אשקלון,יישוב,4332,1890,2442,258,4074,2177,3881,126,5.42%
2015-02,הדרום,9000,באר שבע,יישוב,6970,3149,3821,763,6207,3917,6671,178,6.22%
2015-02,הדרום,2200,דימונה,יישוב,2122,970,1152,99,2023,1341,2017,66,10.54%
2015-02,הדרום,1303,חורה,יישוב,786,328,458,8,778,716,776,1,18.00%
2015-02,הדרום,831,ירוחם,יישוב,435,223,212,14,421,257,405,35,8.32%
2015-02,הדרום,1059,כסיפה,יישוב,1016,416,600,3,1013,911,1009,1,21.03%
2015-02,הדרום,1271,להבים,יישוב,47,18,29,20,27,6,46,0,1.27%
2015-02,הדרום,1060,לקיה,יישוב,947,434,513,4,943,866,934,3,20.60%
2015-02,הדרום,69,מ.א. אל קסום,מועצה איזורית,774,337,437,4,770,701,769,0,47.70%
2015-02,הדרום,38,מ.א. אשכול,מועצה איזורית,120,57,63,21,99,15,120,0,1.76%
2015-02,הדרום,33,מ.א. באר טוביה,מועצה איזורית,255,99,156,41,214,50,252,0,2.30%
2015-02,הדרום,41,מ.א. בני שמעון,מועצה איזורית,65,35,30,13,52,9,64,0,1.47%
2015-02,הדרום,54,מ.א. הערבה התיכונה,מועצה איזורית,26,8,18,8,18,1,26,0,1.43%
2015-02,הדרום,53,מ.א. חבל אילות,מועצה איזורית,18,9,9,3,15,0,18,1,0.76%
2015-02,הדרום,36,מ.א. חוף אשקלון,מועצה איזורית,241,104,137,11,230,58,233,0,2.81%
2015-02,הדרום,35,מ.א. יואב,מועצה איזורית,103,42,61,19,84,18,103,0,2.59%
2015-02,הדרום,50,מ.א. לכיש,מועצה איזורית,196,83,113,13,183,60,194,0,3.86%
2015-02,הדרום,42,מ.א. מרחבים,מועצה איזורית,177,75,102,23,154,42,173,0,2.93%
2015-02,הדרום,68,מ.א. נווה מדבר,מועצה איזורית,107,42,65,0,107,82,104,0,10.79%
2015-02,הדרום,48,מ.א. רמת נגב,מועצה איזורית,236,122,114,21,215,165,233,0,7.35%
2015-02,הדרום,39,מ.א. שדות נגב,מועצה איזורית,138,63,75,12,126,34,131,0,2.90%
2015-02,הדרום,37,מ.א. שער הנגב,מועצה איזורית,110,52,58,25,85,31,108,1,2.78%
2015-02,הדרום,34,מ.א. שפיר,מועצה איזורית,178,92,86,8,170,69,175,0,3.73%
2015-02,הדרום,51,מ.א. תמר,מועצה איזורית,14,7,7,3,11,3,14,0,2.21%
2015-02,הדרום,1268,מיתר,יישוב,74,30,44,14,60,10,72,0,1.61%
2015-02,הדרום,99,מצפה רמון,יישוב,268,123,145,10,258,171,255,16,9.21%
2015-02,הדרום,246,נתיבות,יישוב,1039,485,554,54,985,539,981,49,6.59%
2015-02,הדרום,666,עומר,יישוב,63,28,35,20,43,4,63,0,1.49%
2015-02,הדרום,2560,ערד,יישוב,933,424,509,60,873,435,895,36,7.14%
2015-02,הדרום,1192,ערערה-בנגב,יישוב,1073,472,601,5,1068,969,1062,0,24.25%
2015-02,הדרום,2630,קריית גת,יישוב,2146,892,1254,87,2059,1071,2084,69,7.22%
2015-02,הדרום,1034,קריית מלאכי,יישוב,1161,511,650,17,1144,617,1099,76,9.16%
2015-02,הדרום,1161,רהט,יישוב,3161,1375,1786,6,3155,2662,3128,30,15.30%
2015-02,הדרום,1286,שגב-שלום,יישוב,537,207,330,0,537,471,526,2,17.89%
2015-02,הדרום,1031,שדרות,יישוב,1102,518,584,53,1049,621,1050,34,7.71%
2015-02,הדרום,1054,תל שבע,יישוב,1176,578,598,4,1172,1077,1157,11,22.05%
2015-02,המרכז,1066,"בני עי""ש",יישוב,186,88,98,28,158,62,185,3,4.58%
2015-02,המרכז,182,אבן יהודה,יישוב,158,76,82,36,122,18,158,2,2.29%
2015-02,המרכז,41,אליכין,יישוב,69,33,36,10,59,20,65,0,3.35%
2015-02,המרכז,1309,אלעד,יישוב,414,181,233,8,406,79,400,3,3.07%
2015-02,המרכז,2530,באר יעקב,יישוב,289,117,172,55,234,53,283,6,2.82%
2015-02,המרכז,466,בית דגן,יישוב,107,58,49,4,103,33,106,1,2.85%
2015-02,המרכז,681,גבעת שמואל,יישוב,259,135,124,33,226,56,252,0,2.08%
2015-02,המרכז,2550,גדרה,יישוב,386,156,230,89,297,113,374,8,2.99%
2015-02,המרכז,627,ג'לג'וליה,יישוב,104,48,56,3,101,63,96,2,2.54%
2015-02,המרכז,166,גן יבנה,יישוב,393,159,234,48,345,90,388,9,3.19%
2015-02,המרכז,229,גני תקווה,יישוב,192,84,108,64,128,28,191,2,2.12%
2015-02,המרכז,9700,הוד השרון,יישוב,607,265,342,170,437,54,601,8,1.94%
2015-02,המרכז,1290,זמר,יישוב,160,54,106,1,159,109,159,4,5.32%
2015-02,המרכז,2730,טייבה,יישוב,1634,738,896,23,1611,1337,1484,29,8.27%
2015-02,המרכז,2720,טירה,יישוב,306,155,151,14,292,142,297,13,2.58%
2015-02,המרכז,2660,יבנה,יישוב,888,436,452,98,790,286,876,28,3.56%
2015-02,המרכז,9400,יהוד,יישוב,444,201,243,45,399,61,432,9,2.68%
2015-02,המרכז,1224,כוכב יאיר,יישוב,93,40,53,34,59,1,91,0,1.58%
2015-02,המרכז,633,כפר ברא,יישוב,26,10,16,1,25,11,26,2,1.81%
2015-02,המרכז,168,כפר יונה,יישוב,322,142,180,48,274,60,317,8,2.81%
2015-02,המרכז,6900,כפר סבא,יישוב,1325,597,728,347,978,146,1309,18,2.46%
2015-02,המרכז,634,כפר קאסם,יישוב,211,92,119,6,205,116,206,3,2.24%
2015-02,המרכז,7000,לוד,יישוב,2173,1035,1138,146,2027,1161,2134,59,5.95%
2015-02,המרכז,28,מ.א. ברנר,מועצה איזורית,70,37,33,20,50,5,70,4,1.72%
2015-02,המרכז,32,מ.א. גדרות,מועצה איזורית,38,12,26,14,24,4,38,0,1.55%
2015-02,המרכז,30,מ.א. גזר,מועצה איזורית,262,115,147,83,179,23,259,0,1.96%
2015-02,המרכז,27,מ.א. גן רווה,מועצה איזורית,46,18,28,10,36,3,46,0,1.57%
2015-02,המרכז,20,מ.א. דרום השרון,מועצה איזורית,313,133,180,102,211,12,307,0,1.96%
2015-02,המרכז,29,מ.א. חבל יבנה,מועצה איזורית,31,16,15,10,21,3,30,0,1.21%
2015-02,המרכז,25,מ.א. חבל מודיעין,מועצה איזורית,243,97,146,67,176,23,239,0,2.23%
2015-02,המרכז,19,מ.א. חוף השרון,מועצה איזורית,87,41,46,31,56,5,87,0,1.55%
2015-02,המרכז,18,מ.א. לב השרון,מועצה איזורית,237,103,134,43,194,34,234,0,2.13%
2015-02,המרכז,31,מ.א. נחל שורק,מועצה איזורית,56,28,28,6,50,6,56,44,1.29%
2015-02,המרכז,16,מ.א. עמק חפר,מועצה איזורית,364,154,210,89,275,25,361,0,1.84%
2015-02,המרכז,40,מ.א. עמק לוד,מועצה איזורית,134,69,65,22,112,20,134,0,2.17%
2015-02,המרכז,1200,מודיעין-מכבים-רעות*,יישוב,911,401,510,340,571,62,896,15,1.99%
2015-02,המרכז,28,מזכרת בתיה,יישוב,178,82,96,47,131,33,175,4,2.32%
2015-02,המרכז,7200,נס ציונה,יישוב,683,325,358,176,507,178,672,13,2.80%
2015-02,המרכז,7400,נתניה,יישוב,4390,2078,2312,381,4009,1553,4275,140,4.03%
2015-02,המרכז,587,סביון*,יישוב,16,6,10,7,9,1,16,1,0.81%
2015-02,המרכז,171,פרדסייה,יישוב,73,28,45,14,59,6,73,1,1.92%
2015-02,המרכז,7900,פתח תקווה,יישוב,4016,1791,2225,829,3187,1049,3929,40,3.11%
2015-02,המרכז,195,קדימה-צורן,יישוב,279,113,166,40,239,36,275,1,2.47%
2015-02,המרכז,638,קלנסווה,יישוב,623,273,350,9,614,511,579,10,6.48%
2015-02,המרכז,469,קריית עקרון,יישוב,282,141,141,10,272,130,273,11,4.50%
2015-02,המרכז,2640,ראש העין,יישוב,744,342,402,96,648,150,728,29,2.87%
2015-02,המרכז,8300,ראשון לציון,יישוב,4432,1975,2457,482,3950,1320,4387,102,3.14%
2015-02,המרכז,8400,רחובות,יישוב,2502,1152,1350,483,2019,956,2419,56,3.50%
2015-02,המרכז,8500,רמלה,יישוב,1790,820,970,97,1693,738,1718,65,4.52%
2015-02,המרכז,8700,רעננה,יישוב,741,336,405,233,508,61,736,5,1.98%
2015-02,המרכז,1304,שוהם,יישוב,185,81,104,68,117,8,185,2,1.59%
2015-02,המרכז,154,תל מונד,יישוב,149,73,76,33,116,22,149,0,2.31%
2015-02,הצפון,473,אבו סנאן,יישוב,701,291,410,8,693,550,685,13,11.38%
2015-02,הצפון,478,אכסאל,יישוב,566,277,289,13,553,446,557,4,9.57%
2015-02,הצפון,529,אעבלין,יישוב,622,263,359,4,618,505,613,7,10.37%
2015-02,הצפון,482,בועיינה-נוג'ידאת,יישוב,438,181,257,8,430,343,425,0,10.69%
2015-02,הצפון,4001,בוקעאתא,יישוב,443,180,263,4,439,351,421,1,14.92%
2015-02,הצפון,998,ביר אל-מכסור,יישוב,445,175,270,2,443,333,442,9,11.19%
2015-02,הצפון,480,בית ג'ן,יישוב,410,147,263,6,404,295,397,0,7.02%
2015-02,הצפון,9200,בית שאן,יישוב,850,362,488,21,829,417,815,58,7.88%
2015-02,הצפון,944,בסמת טבעון,יישוב,220,109,111,2,218,159,217,5,6.55%
2015-02,הצפון,483,בענה,יישוב,373,162,211,11,362,303,369,10,10.59%
2015-02,הצפון,1292,ג'דיידה-מכר,יישוב,1368,602,766,6,1362,1143,1339,39,13.98%
2015-02,הצפון,485,ג'ולס,יישוב,235,75,160,2,233,158,230,4,7.34%
2015-02,הצפון,487,ג'ש (גוש חלב),יישוב,81,41,40,4,77,40,77,2,4.61%
2015-02,הצפון,489,דבורייה,יישוב,388,175,213,16,372,279,385,5,8.81%
2015-02,הצפון,490,דייר אל-אסד,יישוב,367,160,207,7,360,294,366,5,6.96%
2015-02,הצפון,492,דייר חנא,יישוב,707,328,379,9,698,514,701,4,14.06%
2015-02,הצפון,975,זרזיר,יישוב,285,127,158,4,281,196,275,4,8.27%
2015-02,הצפון,496,חורפיש,יישוב,119,50,69,6,113,71,116,4,4.04%
2015-02,הצפון,2034,חצור הגלילית,יישוב,291,133,158,18,273,134,279,4,5.67%
2015-02,הצפון,6700,טבריה,יישוב,1787,823,964,69,1718,988,1574,48,7.11%
2015-02,הצפון,962,טובא-זנגרייה,יישוב,371,168,203,6,365,245,363,1,11.84%
2015-02,הצפון,498,טורעאן,יישוב,520,204,316,12,508,435,503,5,8.66%
2015-02,הצפון,8900,טמרה,יישוב,2015,879,1136,14,2001,1758,1981,20,13.45%
2015-02,הצפון,1295,יאנוח-ג'ת,יישוב,185,74,111,10,175,99,183,4,6.15%
2015-02,הצפון,46,יבנאל,יישוב,136,82,54,5,131,108,103,3,6.46%
2015-02,הצפון,29,יסוד המעלה,יישוב,17,5,12,3,14,2,17,0,1.98%
2015-02,הצפון,499,יפיע,יישוב,656,289,367,20,636,512,639,4,7.96%
2015-02,הצפון,240,יקנעם עילית,יישוב,479,199,280,60,419,141,470,27,3.85%
2015-02,הצפון,502,ירכא,יישוב,607,258,349,1,606,467,600,5,9.16%
2015-02,הצפון,504,כאבול,יישוב,677,281,396,10,667,575,669,8,13.12%
2015-02,הצפון,505,כאוכב אבו אל-היג'א,יישוב,221,97,124,8,213,188,217,0,12.42%
2015-02,הצפון,1296,כסרא-סמיע,יישוב,228,98,130,6,222,158,223,6,6.29%
2015-02,הצפון,978,כעביה-טבאש-חג'אג'רה,יישוב,206,76,130,4,202,140,197,1,8.25%
2015-02,הצפון,1263,כפר ורדים,יישוב,59,23,36,23,36,7,59,1,1.92%
2015-02,הצפון,507,כפר יאסיף,יישוב,444,196,248,3,441,346,436,5,8.47%
2015-02,הצפון,508,כפר כמא,יישוב,68,26,42,2,66,23,66,1,3.88%
2015-02,הצפון,509,כפר כנא,יישוב,1164,513,651,31,1133,947,1099,20,12.22%
2015-02,הצפון,510,כפר מנדא,יישוב,1004,453,551,7,997,741,971,9,12.99%
2015-02,הצפון,47,כפר תבור,יישוב,48,15,33,16,32,1,47,0,2.05%
2015-02,הצפון,1139,כרמיאל,יישוב,1602,649,953,234,1368,772,1517,56,5.79%
2015-02,הצפון,65,מ.א. אל-בטוף,מועצה איזורית,406,163,243,8,398,324,389,0,13.35%
2015-02,הצפון,66,מ.א. בוסתן אל-מרג',מועצה איזורית,51,18,33,2,49,39,50,1,1.63%
2015-02,הצפון,71,מ.א. גולן,מועצה איזורית,194,87,107,20,174,17,194,0,2.26%
2015-02,הצפון,8,מ.א. הגלבוע,מועצה איזורית,795,324,471,51,744,483,779,0,5.40%
2015-02,הצפון,1,מ.א. הגליל העליון,מועצה איזורית,222,123,99,23,199,39,219,0,2.48%
2015-02,הצפון,3,מ.א. הגליל התחתון,מועצה איזורית,143,52,91,33,110,15,137,0,2.34%
2015-02,הצפון,55,מ.א. מבואות החרמון,מועצה איזורית,125,55,70,15,110,18,123,0,3.08%
2015-02,הצפון,13,מ.א. מגידו,מועצה איזורית,104,42,62,25,79,5,104,0,1.83%
2015-02,הצפון,4,מ.א. מטה אשר,מועצה איזורית,478,213,265,58,420,207,468,0,3.41%
2015-02,הצפון,52,מ.א. מעלה יוסף,מועצה איזורית,177,92,85,29,148,51,175,0,3.17%
2015-02,הצפון,2,מ.א. מרום הגליל,מועצה איזורית,282,138,144,15,267,127,272,0,3.98%
2015-02,הצפון,56,מ.א. משגב,מועצה איזורית,520,218,302,61,459,277,514,0,3.96%
2015-02,הצפון,6,מ.א. עמק הירדן,מועצה איזורית,184,75,109,31,153,41,168,0,2.49%
2015-02,הצפון,7,מ.א. עמק המעיינות,מועצה איזורית,193,81,112,29,164,43,190,0,2.93%
2015-02,הצפון,9,מ.א. עמק יזרעאל,מועצה איזורית,381,137,244,147,234,42,367,0,1.90%
2015-02,הצפון,481,מגאר,יישוב,1513,633,880,8,1505,1302,1484,18,14.75%
2015-02,הצפון,516,מג'ד אל-כרום,יישוב,532,243,289,3,529,396,528,11,7.85%
2015-02,הצפון,65,מגדל,יישוב,46,18,28,2,44,14,44,0,4.60%
2015-02,הצפון,874,מגדל העמק,יישוב,946,430,516,64,882,385,843,75,6.16%
2015-02,הצפון,4201,מג'דל שמס,יישוב,497,188,309,8,489,384,477,3,9.59%
2015-02,הצפון,517,מזרעה,יישוב,186,72,114,3,183,138,179,3,8.89%
2015-02,הצפון,43,מטולה,יישוב,24,16,8,3,21,6,23,0,2.20%
2015-02,הצפון,4203,מסעדה,יישוב,227,93,134,4,223,179,220,2,12.72%
2015-02,הצפון,518,מעיליא,יישוב,58,22,36,10,48,26,57,1,3.51%
2015-02,הצפון,1063,מעלות-תרשיחא,יישוב,842,401,441,83,759,460,819,26,6.89%
2015-02,הצפון,520,משהד,יישוב,286,128,158,10,276,230,276,3,8.42%
2015-02,הצפון,9100,נהרייה,יישוב,1928,911,1016,139,1789,1121,1853,82,5.96%
2015-02,הצפון,522,נחף,יישוב,415,194,221,10,405,330,411,6,8.02%
2015-02,הצפון,7300,נצרת,יישוב,3358,1491,1867,94,3264,2646,3272,39,9.36%
2015-02,הצפון,1061,נצרת עילית,יישוב,1792,809,983,138,1654,917,1598,102,6.81%
2015-02,הצפון,525,סאג'ור,יישוב,102,33,69,2,100,68,98,1,4.98%
2015-02,הצפון,7500,סח'נין,יישוב,2163,927,1236,24,2139,1823,2143,10,14.96%
2015-02,הצפון,4501,ע'ג'ר,יישוב,95,40,55,0,95,60,95,0,8.93%
2015-02,הצפון,530,עיילבון,יישוב,185,78,107,1,184,130,182,3,6.53%
2015-02,הצפון,511,עילוט,יישוב,345,149,196,5,340,273,337,2,11.58%
2015-02,הצפון,532,עין מאהל,יישוב,535,261,274,4,531,433,514,3,9.59%
2015-02,הצפון,4502,עין קנייא,יישוב,154,66,88,1,153,125,150,0,14.41%
2015-02,הצפון,7600,עכו,יישוב,3131,1437,1694,131,3000,2335,3013,68,11.25%
2015-02,הצפון,7700,עפולה,יישוב,1665,693,972,107,1558,739,1566,81,6.09%
2015-02,הצפון,531,עראבה,יישוב,1608,675,933,27,1581,1367,1587,8,15.23%
2015-02,הצפון,535,פסוטה,יישוב,113,53,60,7,106,76,111,2,6.37%
2015-02,הצפון,536,פקיעין (בוקייעה),יישוב,136,79,57,8,128,82,132,1,4.67%
2015-02,הצפון,8000,צפת,יישוב,1392,755,637,55,1337,1011,1323,34,9.64%
2015-02,הצפון,4100,קצרין,יישוב,231,101,130,17,214,95,226,6,5.56%
2015-02,הצפון,2800,קריית שמונה,יישוב,766,357,409,35,731,351,734,36,5.58%
2015-02,הצפון,543,ראמה,יישוב,305,124,181,11,294,222,301,3,7.60%
2015-02,הצפון,26,ראש פינה,יישוב,56,24,32,6,50,20,55,0,3.41%
2015-02,הצפון,542,ריינה,יישוב,664,287,377,13,651,526,644,16,9.24%
2015-02,הצפון,122,רמת ישי,יישוב,91,44,47,18,73,17,89,1,2.14%
2015-02,הצפון,913,שבלי - אום אל-גנם,יישוב,239,99,140,9,230,149,234,3,8.70%
2015-02,הצפון,812,שלומי,יישוב,236,102,134,10,226,123,231,3,6.36%
2015-02,הצפון,538,שעב,יישוב,545,217,328,3,542,478,542,1,17.29%
2015-02,הצפון,8800,שפרעם,יישוב,1992,787,1205,19,1973,1614,1959,24,10.57%
2015-02,חיפה,1326,"בסמ""ה",יישוב,427,186,241,3,424,322,423,2,10.31%
2015-02,חיפה,2710,אום אל-פחם,יישוב,3720,1540,2180,27,3693,3170,3638,38,16.64%
2015-02,חיפה,1020,אור עקיבא,יישוב,568,266,302,48,520,171,546,22,5.31%
2015-02,חיפה,6000,באקה אל-גרביה,יישוב,696,356,340,6,690,411,688,20,5.80%
2015-02,חיפה,9800,בנימינה-גבעת עדה*,יישוב,206,97,109,49,157,56,204,3,2.79%
2015-02,חיפה,541,ג'סר א-זרקא,יישוב,452,241,211,0,452,322,446,4,7.30%
2015-02,חיפה,628,ג'ת,יישוב,243,132,111,9,234,142,243,10,4.56%
2015-02,חיפה,494,דאלית אל-כרמל,יישוב,541,226,315,7,534,292,510,10,6.10%
2015-02,חיפה,9300,זכרון יעקב,יישוב,258,111,147,70,188,55,254,1,2.28%
2015-02,חיפה,6500,חדרה,יישוב,2314,1006,1308,252,2062,850,2154,64,4.28%
2015-02,חיפה,4000,חיפה,יישוב,6565,3238,3327,1175,5390,3384,6247,169,4.44%
2015-02,חיפה,1247,חריש,יישוב,37,20,17,3,34,7,36,0,2.24%
2015-02,חיפה,2100,טירת כרמל,יישוב,730,360,370,24,706,400,708,17,6.24%
2015-02,חיפה,654,כפר קרע,יישוב,420,184,236,2,418,258,412,8,4.79%
2015-02,חיפה,45,מ.א. אלונה,מועצה איזורית,28,8,20,6,22,4,28,0,2.62%
2015-02,חיפה,12,מ.א. זבולון,מועצה איזורית,261,125,136,23,238,187,258,0,4.63%
2015-02,חיפה,15,מ.א. חוף הכרמל,מועצה איזורית,310,129,181,67,243,61,306,1,2.16%
2015-02,חיפה,14,מ.א. מנשה,מועצה איזורית,252,101,151,53,199,76,247,0,3.08%
2015-02,חיפה,1327,מעלה עירון,יישוב,936,367,569,8,928,765,924,8,15.17%
2015-02,חיפה,2500,נשר,יישוב,462,237,225,82,380,187,447,17,3.48%
2015-02,חיפה,534,עספיא,יישוב,344,154,190,6,338,171,326,3,5.71%
2015-02,חיפה,637,ערערה,יישוב,642,273,369,6,636,412,619,15,7.51%
2015-02,חיפה,537,פוריידיס,יישוב,450,224,226,4,446,273,441,1,7.66%
2015-02,חיפה,7800,פרדס חנה-כרכור,יישוב,886,425,461,138,748,258,870,28,4.25%
2015-02,חיפה,6800,קריית אתא,יישוב,1603,736,867,133,1470,868,1564,50,5.11%
2015-02,חיפה,9500,קריית ביאליק,יישוב,1029,440,589,111,918,516,1007,27,4.68%
2015-02,חיפה,2300,קריית טבעון,יישוב,187,92,95,60,127,45,182,1,2.17%
2015-02,חיפה,9600,קריית ים,יישוב,1497,702,795,137,1360,860,1456,34,6.75%
2015-02,חיפה,8200,קריית מוצקין,יישוב,1025,431,594,137,888,471,999,27,4.32%
2015-02,חיפה,922,רכסים,יישוב,149,78,71,8,141,86,138,1,3.87%
2015-02,ירושלים,472,אבו גוש,יישוב,276,136,140,5,271,198,272,4,8.69%
2015-02,ירושלים,2610,בית שמש,יישוב,1209,535,674,38,1171,494,1159,40,3.43%
2015-02,ירושלים,3000,ירושלים,יישוב,12830,5891,6939,1308,11522,7690,12556,144,4.20%
2015-02,ירושלים,26,מ.א. מטה יהודה,מועצה איזורית,589,283,306,93,496,136,575,0,2.40%
2015-02,ירושלים,1015,מבשרת ציון,יישוב,392,179,213,77,315,155,387,8,2.96%
2015-02,ירושלים,1137,קריית יערים,יישוב,37,15,22,5,32,14,37,0,2.61%
2015-02,תל אביב,2400,אור יהודה,יישוב,790,410,380,39,751,240,753,37,3.93%
2015-02,תל אביב,565,אזור,יישוב,170,90,80,17,153,34,167,2,2.54%
2015-02,תל אביב,6100,בני ברק,יישוב,2107,1019,1088,52,2055,1052,1998,38,3.47%
2015-02,תל אביב,6200,בת ים,יישוב,3128,1476,1652,391,2737,1120,2997,64,4.23%
2015-02,תל אביב,6300,גבעתיים,יישוב,746,344,402,301,445,91,739,4,2.39%
2015-02,תל אביב,6400,הרצלייה,יישוב,1118,520,598,271,847,35,1103,33,2.25%
2015-02,תל אביב,6600,חולון,יישוב,3061,1458,1603,273,2788,768,2988,71,3.00%
2015-02,תל אביב,267,כפר שמריהו,יישוב,14,5,9,4,10,0,14,1,1.65%
2015-02,תל אביב,2620,קריית אונו,יישוב,383,174,209,104,279,40,378,5,1.97%
2015-02,תל אביב,8600,רמת גן,יישוב,2047,926,1121,623,1424,407,2011,22,2.56%
2015-02,תל אביב,2650,רמת השרון,יישוב,401,166,235,121,280,6,397,3,1.78%
2015-02,תל אביב,5000,תל אביב -יפו,יישוב,7463,3695,3768,2292,5171,2053,7327,124,2.88%
2015-03,אזור יהודה והשומרון,3760,אורנית,יישוב,107,51,56,37,70,5,107,2,2.19%
2015-03,אזור יהודה והשומרון,3750,אלפי מנשה,יישוב,104,52,52,25,79,2,103,0,2.33%
2015-03,אזור יהודה והשומרון,3560,אלקנה,יישוב,31,17,14,11,20,1,31,0,1.64%
2015-03,אזור יהודה והשומרון,3650,אפרת,יישוב,60,29,31,18,42,4,60,0,1.39%
2015-03,אזור יהודה והשומרון,3570,אריאל,יישוב,334,162,172,56,278,66,331,10,3.06%
2015-03,אזור יהודה והשומרון,3574,בית אל,יישוב,43,20,23,15,28,12,42,1,1.73%
2015-03,אזור יהודה והשומרון,3652,בית אריה,יישוב,49,23,26,9,40,3,48,1,1.80%
2015-03,אזור יהודה והשומרון,3780,ביתר עילית,יישוב,578,298,280,6,572,277,574,1,4.29%
2015-03,אזור יהודה והשומרון,3730,גבעת זאב,יישוב,227,110,117,40,187,50,224,0,2.87%
2015-03,אזור יהודה והשומרון,3769,הר אדר,יישוב,37,12,25,21,16,2,37,0,1.74%
2015-03,אזור יהודה והשומרון,76,מ.א. גוש עציון,מועצה איזורית,158,89,69,47,111,16,158,0,1.64%
2015-03,אזור יהודה והשומרון,78,מ.א. הר חברון,מועצה איזורית,62,32,30,14,48,6,60,0,1.71%
2015-03,אזור יהודה והשומרון,74,מ.א. מגילות ים המלח,מועצה איזורית,19,9,10,4,15,2,19,0,2.37%
2015-03,אזור יהודה והשומרון,73,מ.א. מטה בנימין,מועצה איזורית,643,325,318,166,477,142,635,0,2.53%
2015-03,אזור יהודה והשומרון,75,מ.א. ערבות הירדן,מועצה איזורית,53,26,27,16,37,2,53,0,2.18%
2015-03,אזור יהודה והשומרון,72,מ.א. שומרון,מועצה איזורית,396,200,196,73,323,50,389,0,2.31%
2015-03,אזור יהודה והשומרון,3797,מודיעין עילית,יישוב,432,145,287,16,416,77,419,3,2.98%
2015-03,אזור יהודה והשומרון,3616,מעלה אדומים,יישוב,637,269,368,37,600,186,630,14,3.07%
2015-03,אזור יהודה והשומרון,3608,מעלה אפרים,יישוב,31,13,18,0,31,9,31,0,3.75%
2015-03,אזור יהודה והשומרון,3660,עמנואל,יישוב,56,35,21,1,55,39,55,2,4.68%
2015-03,אזור יהודה והשומרון,3557,קדומים,יישוב,38,19,19,14,24,6,38,0,2.02%
2015-03,אזור יהודה והשומרון,3611,קריית ארבע,יישוב,121,62,59,14,107,64,118,9,3.58%
2015-03,אזור יהודה והשומרון,3640,קרני שומרון,יישוב,75,40,35,16,59,13,73,1,1.93%
2015-03,הדרום,31,אופקים,יישוב,1133,504,629,55,1078,724,1094,43,8.08%
2015-03,הדרום,2600,אילת,יישוב,1450,704,746,46,1404,536,1414,56,4.14%
2015-03,הדרום,70,אשדוד,יישוב,6170,2649,3521,683,5487,3074,5959,180,5.39%
2015-03,הדרום,7100,אשקלון,יישוב,4204,1829,2375,244,3960,2138,3774,132,5.28%
2015-03,הדרום,9000,באר שבע,יישוב,6873,3145,3728,733,6140,3874,6574,169,6.13%
2015-03,הדרום,2200,דימונה,יישוב,2111,963,1148,98,2013,1337,2018,84,10.54%
2015-03,הדרום,1303,חורה,יישוב,791,333,458,6,785,712,782,7,18.12%
2015-03,הדרום,831,ירוחם,יישוב,426,215,211,16,410,249,403,23,8.29%
2015-03,הדרום,1059,כסיפה,יישוב,1036,425,611,4,1032,926,1028,5,21.35%
2015-03,הדרום,1271,להבים,יישוב,42,17,25,16,26,6,41,0,1.13%
2015-03,הדרום,1060,לקיה,יישוב,931,418,513,2,929,854,915,9,20.26%
2015-03,הדרום,69,מ.א. אל קסום,מועצה איזורית,770,344,426,4,766,698,761,0,47.21%
2015-03,הדרום,38,מ.א. אשכול,מועצה איזורית,119,57,62,20,99,15,119,0,1.75%
2015-03,הדרום,33,מ.א. באר טוביה,מועצה איזורית,251,101,150,40,211,48,249,0,2.27%
2015-03,הדרום,41,מ.א. בני שמעון,מועצה איזורית,61,33,28,13,48,8,60,3,1.37%
2015-03,הדרום,54,מ.א. הערבה התיכונה,מועצה איזורית,22,7,15,5,17,1,22,0,1.21%
2015-03,הדרום,53,מ.א. חבל אילות,מועצה איזורית,18,11,7,3,15,0,18,1,0.76%
2015-03,הדרום,36,מ.א. חוף אשקלון,מועצה איזורית,236,109,127,12,224,60,226,0,2.73%
2015-03,הדרום,35,מ.א. יואב,מועצה איזורית,108,40,68,17,91,20,108,0,2.71%
2015-03,הדרום,50,מ.א. לכיש,מועצה איזורית,189,85,104,12,177,56,186,0,3.70%
2015-03,הדרום,42,מ.א. מרחבים,מועצה איזורית,166,67,99,22,144,41,164,0,2.77%
2015-03,הדרום,68,מ.א. נווה מדבר,מועצה איזורית,108,44,64,0,108,85,104,0,10.79%
2015-03,הדרום,48,מ.א. רמת נגב,מועצה איזורית,234,124,110,16,218,164,234,0,7.37%
2015-03,הדרום,39,מ.א. שדות נגב,מועצה איזורית,134,58,76,16,118,33,128,0,2.84%
2015-03,הדרום,37,מ.א. שער הנגב,מועצה איזורית,108,51,57,29,79,33,105,0,2.70%
2015-03,הדרום,34,מ.א. שפיר,מועצה איזורית,153,84,69,6,147,61,150,0,3.19%
2015-03,הדרום,51,מ.א. תמר,מועצה איזורית,12,6,6,3,9,3,12,0,1.90%
2015-03,הדרום,1268,מיתר,יישוב,75,28,47,20,55,6,74,1,1.66%
2015-03,הדרום,99,מצפה רמון,יישוב,257,121,136,8,249,166,245,13,8.88%
2015-03,הדרום,246,נתיבות,יישוב,967,467,500,48,919,530,924,39,6.23%
2015-03,הדרום,666,עומר,יישוב,57,24,33,16,41,5,57,0,1.35%
2015-03,הדרום,2560,ערד,יישוב,903,413,490,59,844,421,865,53,6.91%
2015-03,הדרום,1192,ערערה-בנגב,יישוב,1096,481,615,7,1089,988,1083,1,24.61%
2015-03,הדרום,2630,קריית גת,יישוב,2087,887,1200,81,2006,1024,2021,73,7.02%
2015-03,הדרום,1034,קריית מלאכי,יישוב,1073,475,598,18,1055,593,1013,86,8.50%
2015-03,הדרום,1161,רהט,יישוב,3150,1376,1774,4,3146,2655,3112,35,15.24%
2015-03,הדרום,1286,שגב-שלום,יישוב,542,226,316,0,542,453,533,2,18.08%
2015-03,הדרום,1031,שדרות,יישוב,1034,485,549,51,983,611,980,32,7.24%
2015-03,הדרום,1054,תל שבע,יישוב,1156,572,584,3,1153,1054,1133,10,21.70%
2015-03,המרכז,1066,"בני עי""ש",יישוב,187,92,95,27,160,63,187,6,4.63%
2015-03,המרכז,182,אבן יהודה,יישוב,165,78,87,38,127,17,165,1,2.39%
2015-03,המרכז,41,אליכין,יישוב,69,38,31,11,58,21,66,3,3.40%
2015-03,המרכז,1309,אלעד,יישוב,420,182,238,5,415,68,408,3,3.13%
2015-03,המרכז,2530,באר יעקב,יישוב,266,103,163,56,210,45,261,5,2.60%
2015-03,המרכז,466,בית דגן,יישוב,97,54,43,5,92,32,96,3,2.59%
2015-03,המרכז,681,גבעת שמואל,יישוב,248,118,130,27,221,58,240,3,1.98%
2015-03,המרכז,2550,גדרה,יישוב,374,156,218,88,286,111,362,9,2.89%
2015-03,המרכז,627,ג'לג'וליה,יישוב,105,51,54,3,102,63,97,3,2.56%
2015-03,המרכז,166,גן יבנה,יישוב,390,149,241,54,336,87,383,13,3.15%
2015-03,המרכז,229,גני תקווה,יישוב,194,79,115,67,127,27,193,3,2.14%
2015-03,המרכז,9700,הוד השרון,יישוב,627,273,354,164,463,49,620,11,2.00%
2015-03,המרכז,1290,זמר,יישוב,168,58,110,1,167,107,167,1,5.58%
2015-03,המרכז,2730,טייבה,יישוב,1598,726,872,24,1574,1318,1449,34,8.09%
2015-03,המרכז,2720,טירה,יישוב,283,141,142,11,272,128,279,12,2.43%
2015-03,המרכז,2660,יבנה,יישוב,869,426,443,88,781,276,855,33,3.48%
2015-03,המרכז,9400,יהוד,יישוב,416,192,224,37,379,54,408,9,2.53%
2015-03,המרכז,1224,כוכב יאיר,יישוב,96,42,54,34,62,1,95,1,1.65%
2015-03,המרכז,633,כפר ברא,יישוב,22,8,14,1,21,8,22,1,1.54%
2015-03,המרכז,168,כפר יונה,יישוב,338,153,185,49,289,57,333,7,2.94%
2015-03,המרכז,6900,כפר סבא,יישוב,1288,570,718,329,959,147,1269,26,2.38%
2015-03,המרכז,634,כפר קאסם,יישוב,219,100,119,7,212,115,211,1,2.29%
2015-03,המרכז,7000,לוד,יישוב,2079,993,1086,135,1944,1134,2026,66,5.67%
2015-03,המרכז,28,מ.א. ברנר,מועצה איזורית,72,37,35,21,51,6,72,5,1.77%
2015-03,המרכז,32,מ.א. גדרות,מועצה איזורית,41,11,30,15,26,4,41,0,1.68%
2015-03,המרכז,30,מ.א. גזר,מועצה איזורית,268,115,153,90,178,27,264,0,2.00%
2015-03,המרכז,27,מ.א. גן רווה,מועצה איזורית,57,24,33,11,46,3,57,0,1.95%
2015-03,המרכז,20,מ.א. דרום השרון,מועצה איזורית,317,133,184,95,222,16,314,0,2.00%
2015-03,המרכז,29,מ.א. חבל יבנה,מועצה איזורית,36,16,20,14,22,3,36,1,1.45%
2015-03,המרכז,25,מ.א. חבל מודיעין,מועצה איזורית,242,95,147,73,169,18,241,0,2.24%
2015-03,המרכז,19,מ.א. חוף השרון,מועצה איזורית,103,51,52,29,74,6,103,0,1.84%
2015-03,המרכז,18,מ.א. לב השרון,מועצה איזורית,234,106,128,38,196,34,233,0,2.12%
2015-03,המרכז,31,מ.א. נחל שורק,מועצה איזורית,50,26,24,6,44,4,50,43,1.16%
2015-03,המרכז,16,מ.א. עמק חפר,מועצה איזורית,380,157,223,85,295,26,376,0,1.91%
2015-03,המרכז,40,מ.א. עמק לוד,מועצה איזורית,126,63,63,23,103,19,125,0,2.03%
2015-03,המרכז,1200,מודיעין-מכבים-רעות*,יישוב,905,392,513,323,582,57,894,27,1.99%
2015-03,המרכז,28,מזכרת בתיה,יישוב,171,84,87,44,127,30,170,5,2.26%
2015-03,המרכז,7200,נס ציונה,יישוב,650,314,336,153,497,176,638,15,2.66%
2015-03,המרכז,7400,נתניה,יישוב,4308,2008,2300,335,3973,1499,4191,128,3.96%
2015-03,המרכז,587,סביון*,יישוב,15,6,9,6,9,1,15,0,0.76%
2015-03,המרכז,171,פרדסייה,יישוב,72,28,44,10,62,8,72,0,1.90%
2015-03,המרכז,7900,פתח תקווה,יישוב,3980,1795,2185,787,3193,1029,3885,37,3.08%
2015-03,המרכז,195,קדימה-צורן,יישוב,285,115,170,38,247,37,281,6,2.52%
2015-03,המרכז,638,קלנסווה,יישוב,606,266,340,8,598,495,568,14,6.36%
2015-03,המרכז,469,קריית עקרון,יישוב,269,130,139,12,257,120,264,14,4.36%
2015-03,המרכז,2640,ראש העין,יישוב,736,338,398,94,642,145,720,26,2.84%
2015-03,המרכז,8300,ראשון לציון,יישוב,4336,1912,2424,459,3877,1255,4304,113,3.08%
2015-03,המרכז,8400,רחובות,יישוב,2441,1101,1340,495,1946,916,2369,57,3.43%
2015-03,המרכז,8500,רמלה,יישוב,1670,776,894,82,1588,728,1601,68,4.23%
2015-03,המרכז,8700,רעננה,יישוב,735,334,401,216,519,60,729,4,1.97%
2015-03,המרכז,1304,שוהם,יישוב,187,83,104,72,115,9,187,2,1.60%
2015-03,המרכז,154,תל מונד,יישוב,149,76,73,23,126,20,149,2,2.31%
2015-03,הצפון,473,אבו סנאן,יישוב,682,282,400,9,673,543,669,14,11.14%
2015-03,הצפון,478,אכסאל,יישוב,556,271,285,15,541,447,548,8,9.43%
2015-03,הצפון,529,אעבלין,יישוב,594,247,347,7,587,489,586,13,9.95%
2015-03,הצפון,482,בועיינה-נוג'ידאת,יישוב,460,188,272,8,452,339,448,4,11.21%
2015-03,הצפון,4001,בוקעאתא,יישוב,439,177,262,3,436,347,413,3,14.68%
2015-03,הצפון,998,ביר אל-מכסור,יישוב,438,171,267,2,436,333,434,2,11.01%
2015-03,הצפון,480,בית ג'ן,יישוב,404,142,262,6,398,291,390,5,6.91%
2015-03,הצפון,9200,בית שאן,יישוב,849,376,473,20,829,402,818,74,7.90%
2015-03,הצפון,944,בסמת טבעון,יישוב,218,103,115,2,216,164,211,1,6.38%
2015-03,הצפון,483,בענה,יישוב,357,161,196,9,348,288,354,11,10.20%
2015-03,הצפון,1292,ג'דיידה-מכר,יישוב,1369,605,764,4,1365,1150,1339,32,13.98%
2015-03,הצפון,485,ג'ולס,יישוב,225,72,153,2,223,158,221,7,7.08%
2015-03,הצפון,487,ג'ש (גוש חלב),יישוב,73,38,35,3,70,35,71,2,4.26%
2015-03,הצפון,489,דבורייה,יישוב,365,172,193,16,349,265,364,3,8.37%
2015-03,הצפון,490,דייר אל-אסד,יישוב,375,169,206,7,368,296,374,11,7.10%
2015-03,הצפון,492,דייר חנא,יישוב,700,322,378,7,693,513,691,4,13.89%
2015-03,הצפון,975,זרזיר,יישוב,279,132,147,3,276,190,266,11,8.02%
2015-03,הצפון,496,חורפיש,יישוב,124,55,69,8,116,71,118,2,4.11%
2015-03,הצפון,2034,חצור הגלילית,יישוב,282,122,160,15,267,136,266,5,5.42%
2015-03,הצפון,6700,טבריה,יישוב,1667,771,896,61,1606,940,1480,60,6.71%
2015-03,הצפון,962,טובא-זנגרייה,יישוב,370,172,198,7,363,250,364,4,11.87%
2015-03,הצפון,498,טורעאן,יישוב,536,224,312,12,524,453,504,9,8.68%
2015-03,הצפון,8900,טמרה,יישוב,1985,864,1121,12,1973,1738,1958,19,13.32%
2015-03,הצפון,1295,יאנוח-ג'ת,יישוב,174,69,105,10,164,94,174,5,5.86%
2015-03,הצפון,46,יבנאל,יישוב,127,81,46,5,122,99,100,1,6.28%
2015-03,הצפון,29,יסוד המעלה,יישוב,18,5,13,3,15,2,18,1,2.09%
2015-03,הצפון,499,יפיע,יישוב,646,286,360,20,626,505,633,3,7.89%
2015-03,הצפון,240,יקנעם עילית,יישוב,441,179,262,57,384,133,433,27,3.56%
2015-03,הצפון,502,ירכא,יישוב,608,254,354,1,607,464,600,7,9.16%
2015-03,הצפון,504,כאבול,יישוב,669,287,382,6,663,570,658,3,12.93%
2015-03,הצפון,505,כאוכב אבו אל-היג'א,יישוב,213,91,122,8,205,182,211,1,12.12%
2015-03,הצפון,1296,כסרא-סמיע,יישוב,237,104,133,8,229,151,226,5,6.37%
2015-03,הצפון,978,כעביה-טבאש-חג'אג'רה,יישוב,200,76,124,4,196,138,195,2,8.18%
2015-03,הצפון,1263,כפר ורדים,יישוב,60,30,30,25,35,9,60,0,1.95%
2015-03,הצפון,507,כפר יאסיף,יישוב,455,213,242,3,452,358,444,8,8.61%
2015-03,הצפון,508,כפר כמא,יישוב,64,27,37,3,61,25,63,1,3.71%
2015-03,הצפון,509,כפר כנא,יישוב,1148,516,632,27,1121,942,1069,21,11.93%
2015-03,הצפון,510,כפר מנדא,יישוב,1004,456,548,7,997,725,978,11,13.07%
2015-03,הצפון,47,כפר תבור,יישוב,52,19,33,14,38,1,51,0,2.22%
2015-03,הצפון,1139,כרמיאל,יישוב,1566,649,917,212,1354,766,1486,58,5.68%
2015-03,הצפון,65,מ.א. אל-בטוף,מועצה איזורית,396,156,240,8,388,328,376,2,12.90%
2015-03,הצפון,66,מ.א. בוסתן אל-מרג',מועצה איזורית,52,23,29,2,50,37,51,1,1.66%
2015-03,הצפון,71,מ.א. גולן,מועצה איזורית,180,83,97,18,162,16,180,1,2.09%
2015-03,הצפון,8,מ.א. הגלבוע,מועצה איזורית,774,320,454,49,725,482,761,0,5.28%
2015-03,הצפון,1,מ.א. הגליל העליון,מועצה איזורית,198,108,90,29,169,28,192,0,2.18%
2015-03,הצפון,3,מ.א. הגליל התחתון,מועצה איזורית,130,51,79,32,98,10,128,0,2.19%
2015-03,הצפון,55,מ.א. מבואות החרמון,מועצה איזורית,111,46,65,11,100,15,108,0,2.70%
2015-03,הצפון,13,מ.א. מגידו,מועצה איזורית,109,40,69,28,81,6,108,0,1.90%
2015-03,הצפון,4,מ.א. מטה אשר,מועצה איזורית,475,215,260,54,421,198,466,0,3.40%
2015-03,הצפון,52,מ.א. מעלה יוסף,מועצה איזורית,166,88,78,29,137,58,161,0,2.92%
2015-03,הצפון,2,מ.א. מרום הגליל,מועצה איזורית,269,136,133,14,255,132,258,0,3.78%
2015-03,הצפון,56,מ.א. משגב,מועצה איזורית,516,215,301,67,449,277,512,0,3.94%
2015-03,הצפון,6,מ.א. עמק הירדן,מועצה איזורית,175,70,105,28,147,38,160,0,2.37%
2015-03,הצפון,7,מ.א. עמק המעיינות,מועצה איזורית,195,80,115,27,168,42,190,0,2.93%
2015-03,הצפון,9,מ.א. עמק יזרעאל,מועצה איזורית,345,129,216,128,217,39,336,0,1.74%
2015-03,הצפון,481,מגאר,יישוב,1516,644,872,9,1507,1303,1485,22,14.76%
2015-03,הצפון,516,מג'ד אל-כרום,יישוב,508,241,267,5,503,374,503,7,7.51%
2015-03,הצפון,65,מגדל,יישוב,47,18,29,3,44,15,45,2,4.70%
2015-03,הצפון,874,מגדל העמק,יישוב,890,409,481,54,836,374,805,79,5.90%
2015-03,הצפון,4201,מג'דל שמס,יישוב,510,190,320,8,502,393,478,12,9.61%
2015-03,הצפון,517,מזרעה,יישוב,189,75,114,3,186,140,180,6,8.94%
2015-03,הצפון,43,מטולה,יישוב,29,19,10,3,26,6,29,1,2.76%
2015-03,הצפון,4203,מסעדה,יישוב,227,93,134,4,223,180,219,6,12.67%
2015-03,הצפון,518,מעיליא,יישוב,58,25,33,9,49,27,56,0,3.45%
2015-03,הצפון,1063,מעלות-תרשיחא,יישוב,836,395,441,88,748,469,811,23,6.83%
2015-03,הצפון,520,משהד,יישוב,278,119,159,10,268,229,263,3,8.06%
2015-03,הצפון,9100,נהרייה,יישוב,1909,911,998,140,1769,1101,1841,83,5.92%
2015-03,הצפון,522,נחף,יישוב,415,199,216,10,405,336,408,10,7.97%
2015-03,הצפון,7300,נצרת,יישוב,3352,1513,1839,102,3250,2619,3269,33,9.35%
2015-03,הצפון,1061,נצרת עילית,יישוב,1742,796,946,131,1611,910,1563,98,6.67%
2015-03,הצפון,525,סאג'ור,יישוב,97,32,65,3,94,67,96,0,4.88%
2015-03,הצפון,7500,סח'נין,יישוב,2153,916,1237,21,2132,1812,2136,13,14.92%
2015-03,הצפון,4501,ע'ג'ר,יישוב,93,44,49,0,93,56,93,0,8.76%
2015-03,הצפון,530,עיילבון,יישוב,182,76,106,1,181,130,179,1,6.42%
2015-03,הצפון,511,עילוט,יישוב,347,147,200,5,342,275,342,2,11.73%
2015-03,הצפון,532,עין מאהל,יישוב,509,251,258,5,504,415,489,6,9.16%
2015-03,הצפון,4502,עין קנייא,יישוב,157,68,89,1,156,131,151,0,14.49%
2015-03,הצפון,7600,עכו,יישוב,3069,1441,1628,127,2942,2309,2968,70,11.10%
2015-03,הצפון,7700,עפולה,יישוב,1632,694,938,116,1516,742,1543,77,6.01%
2015-03,הצפון,531,עראבה,יישוב,1604,672,932,26,1578,1368,1589,2,15.24%
2015-03,הצפון,535,פסוטה,יישוב,118,57,61,9,109,73,116,5,6.64%
2015-03,הצפון,536,פקיעין (בוקייעה),יישוב,137,83,54,9,128,85,132,6,4.67%
2015-03,הצפון,8000,צפת,יישוב,1353,741,612,52,1301,970,1291,29,9.43%
2015-03,הצפון,4100,קצרין,יישוב,214,97,117,17,197,88,212,11,5.23%
2015-03,הצפון,2800,קריית שמונה,יישוב,763,354,409,38,725,354,725,39,5.52%
2015-03,הצפון,543,ראמה,יישוב,295,123,172,11,284,217,291,1,7.37%
2015-03,הצפון,26,ראש פינה,יישוב,52,21,31,5,47,17,51,0,3.17%
2015-03,הצפון,542,ריינה,יישוב,646,284,362,12,634,513,618,7,8.90%
2015-03,הצפון,122,רמת ישי,יישוב,98,44,54,23,75,15,96,2,2.30%
2015-03,הצפון,913,שבלי - אום אל-גנם,יישוב,231,92,139,8,223,149,228,2,8.49%
2015-03,הצפון,812,שלומי,יישוב,231,103,128,12,219,123,224,2,6.18%
2015-03,הצפון,538,שעב,יישוב,552,228,324,2,550,487,548,0,17.45%
2015-03,הצפון,8800,שפרעם,יישוב,1975,792,1183,19,1956,1591,1943,23,10.49%
2015-03,חיפה,1326,"בסמ""ה",יישוב,421,188,233,4,417,324,417,8,10.18%
2015-03,חיפה,2710,אום אל-פחם,יישוב,3678,1534,2144,28,3650,3143,3600,32,16.49%
2015-03,חיפה,1020,אור עקיבא,יישוב,555,259,296,45,510,190,539,20,5.24%
2015-03,חיפה,6000,באקה אל-גרביה,יישוב,678,334,344,6,672,394,672,24,5.67%
2015-03,חיפה,9800,בנימינה-גבעת עדה*,יישוב,206,94,112,44,162,61,204,4,2.79%
2015-03,חיפה,541,ג'סר א-זרקא,יישוב,442,231,211,0,442,320,438,3,7.18%
2015-03,חיפה,628,ג'ת,יישוב,253,129,124,7,246,144,252,7,4.72%
2015-03,חיפה,494,דאלית אל-כרמל,יישוב,549,230,319,11,538,291,521,8,6.23%
2015-03,חיפה,9300,זכרון יעקב,יישוב,251,106,145,67,184,51,246,2,2.21%
2015-03,חיפה,6500,חדרה,יישוב,2276,982,1294,252,2024,861,2130,59,4.23%
2015-03,חיפה,4000,חיפה,יישוב,6409,3164,3245,1116,5293,3326,6103,163,4.34%
2015-03,חיפה,1247,חריש,יישוב,35,20,15,4,31,10,33,1,2.06%
2015-03,חיפה,2100,טירת כרמל,יישוב,744,359,385,27,717,408,719,18,6.33%
2015-03,חיפה,654,כפר קרע,יישוב,423,181,242,3,420,260,416,2,4.84%
2015-03,חיפה,45,מ.א. אלונה,מועצה איזורית,24,7,17,5,19,4,24,0,2.25%
2015-03,חיפה,12,מ.א. זבולון,מועצה איזורית,269,136,133,24,245,184,266,0,4.78%
2015-03,חיפה,15,מ.א. חוף הכרמל,מועצה איזורית,314,132,182,62,252,62,311,0,2.20%
2015-03,חיפה,14,מ.א. מנשה,מועצה איזורית,257,103,154,52,205,73,251,0,3.13%
2015-03,חיפה,1327,מעלה עירון,יישוב,927,361,566,8,919,773,911,9,14.99%
2015-03,חיפה,2500,נשר,יישוב,471,241,230,82,389,189,461,18,3.58%
2015-03,חיפה,534,עספיא,יישוב,362,155,207,9,353,178,341,10,5.95%
2015-03,חיפה,637,ערערה,יישוב,625,269,356,4,621,413,599,7,7.29%
2015-03,חיפה,537,פוריידיס,יישוב,441,221,220,3,438,270,433,2,7.53%
2015-03,חיפה,7800,פרדס חנה-כרכור,יישוב,883,434,449,128,755,273,871,35,4.26%
2015-03,חיפה,6800,קריית אתא,יישוב,1603,740,863,133,1470,851,1570,51,5.13%
2015-03,חיפה,9500,קריית ביאליק,יישוב,1016,423,593,111,905,501,998,28,4.64%
2015-03,חיפה,2300,קריית טבעון,יישוב,186,96,90,56,130,42,180,3,2.15%
2015-03,חיפה,9600,קריית ים,יישוב,1501,712,789,143,1358,864,1465,52,6.78%
2015-03,חיפה,8200,קריית מוצקין,יישוב,1001,427,574,130,871,472,974,31,4.22%
2015-03,חיפה,922,רכסים,יישוב,149,70,79,7,142,85,134,0,3.77%
2015-03,ירושלים,472,אבו גוש,יישוב,291,137,154,3,288,209,286,2,9.10%
2015-03,ירושלים,2610,בית שמש,יישוב,1185,527,658,44,1141,499,1131,38,3.35%
2015-03,ירושלים,3000,ירושלים,יישוב,12610,5810,6800,1271,11339,7692,12331,199,4.13%
2015-03,ירושלים,26,מ.א. מטה יהודה,מועצה איזורית,569,269,300,92,477,128,563,0,2.35%
2015-03,ירושלים,1015,מבשרת ציון,יישוב,387,183,204,78,309,153,382,6,2.93%
2015-03,ירושלים,1137,קריית יערים,יישוב,37,13,24,5,32,16,36,0,2.54%
2015-03,תל אביב,2400,אור יהודה,יישוב,770,393,377,35,735,220,733,45,3.83%
2015-03,תל אביב,565,אזור,יישוב,160,80,80,17,143,31,155,6,2.36%
2015-03,תל אביב,6100,בני ברק,יישוב,2010,980,1030,48,1962,985,1906,35,3.31%
2015-03,תל אביב,6200,בת ים,יישוב,3091,1430,1661,364,2727,1103,2962,80,4.18%
2015-03,תל אביב,6300,גבעתיים,יישוב,731,336,395,298,433,95,724,7,2.34%
2015-03,תל אביב,6400,הרצלייה,יישוב,1071,498,573,251,820,37,1055,33,2.16%
2015-03,תל אביב,6600,חולון,יישוב,2966,1402,1564,248,2718,746,2898,79,2.92%
2015-03,תל אביב,267,כפר שמריהו,יישוב,13,4,9,5,8,0,13,0,1.54%
2015-03,תל אביב,2620,קריית אונו,יישוב,369,169,200,95,274,42,366,1,1.91%
2015-03,תל אביב,8600,רמת גן,יישוב,2063,941,1122,614,1449,416,2027,23,2.58%
2015-03,תל אביב,2650,רמת השרון,יישוב,403,162,241,121,282,12,396,4,1.77%
2015-03,תל אביב,5000,תל אביב -יפו,יישוב,7404,3636,3768,2232,5172,2031,7254,129,2.85%
2015-04,אזור יהודה והשומרון,3760,אורנית,יישוב,110,56,54,36,74,3,110,1,2.26%
2015-04,אזור יהודה והשומרון,3750,אלפי מנשה,יישוב,95,49,46,21,74,1,95,0,2.15%
2015-04,אזור יהודה והשומרון,3560,אלקנה,יישוב,28,16,12,10,18,1,28,0,1.48%
2015-04,אזור יהודה והשומרון,3650,אפרת,יישוב,57,26,31,17,40,4,57,2,1.32%
2015-04,אזור יהודה והשומרון,3570,אריאל,יישוב,313,147,166,55,258,62,312,7,2.89%
2015-04,אזור יהודה והשומרון,3574,בית אל,יישוב,38,17,21,11,27,12,38,0,1.57%
2015-04,אזור יהודה והשומרון,3652,בית אריה,יישוב,44,21,23,6,38,2,44,0,1.65%
2015-04,אזור יהודה והשומרון,3780,ביתר עילית,יישוב,551,281,270,8,543,278,548,0,4.11%
2015-04,אזור יהודה והשומרון,3730,גבעת זאב,יישוב,207,103,104,37,170,49,206,3,2.64%
2015-04,אזור יהודה והשומרון,3769,הר אדר,יישוב,33,14,19,18,15,4,33,0,1.56%
2015-04,אזור יהודה והשומרון,76,מ.א. גוש עציון,מועצה איזורית,145,79,66,46,99,18,144,0,1.49%
2015-04,אזור יהודה והשומרון,78,מ.א. הר חברון,מועצה איזורית,63,30,33,20,43,6,62,0,1.77%
2015-04,אזור יהודה והשומרון,74,מ.א. מגילות ים המלח,מועצה איזורית,16,8,8,3,13,2,16,0,1.99%
2015-04,אזור יהודה והשומרון,73,מ.א. מטה בנימין,מועצה איזורית,606,298,308,174,432,131,602,0,2.40%
2015-04,אזור יהודה והשומרון,75,מ.א. ערבות הירדן,מועצה איזורית,52,24,28,15,37,4,52,0,2.14%
2015-04,אזור יהודה והשומרון,72,מ.א. שומרון,מועצה איזורית,377,198,179,79,298,47,373,0,2.21%
2015-04,אזור יהודה והשומרון,3797,מודיעין עילית,יישוב,400,137,263,15,385,64,398,5,2.83%
2015-04,אזור יהודה והשומרון,3616,מעלה אדומים,יישוב,624,267,357,56,568,185,621,12,3.02%
2015-04,אזור יהודה והשומרון,3608,מעלה אפרים,יישוב,33,15,18,1,32,7,33,1,3.98%
2015-04,אזור יהודה והשומרון,3660,עמנואל,יישוב,51,31,20,1,50,36,51,0,4.36%
2015-04,אזור יהודה והשומרון,3557,קדומים,יישוב,35,16,19,13,22,6,35,1,1.86%
2015-04,אזור יהודה והשומרון,3611,קריית ארבע,יישוב,114,54,60,14,100,62,111,4,3.38%
2015-04,אזור יהודה והשומרון,3640,קרני שומרון,יישוב,63,34,29,14,49,12,63,1,1.67%
2015-04,הדרום,31,אופקים,יישוב,1099,473,626,52,1047,676,1081,30,7.99%
2015-04,הדרום,2600,אילת,יישוב,1218,585,633,53,1165,510,1184,46,3.49%
2015-04,הדרום,70,אשדוד,יישוב,5898,2520,3378,654,5244,2978,5735,122,5.20%
2015-04,הדרום,7100,אשקלון,יישוב,3993,1696,2297,303,3690,2054,3654,123,5.12%
2015-04,הדרום,9000,באר שבע,יישוב,6555,2993,3562,729,5826,3733,6383,102,5.96%
2015-04,הדרום,2200,דימונה,יישוב,1962,890,1072,98,1864,1284,1896,86,9.97%
2015-04,הדרום,1303,חורה,יישוב,769,327,442,6,763,693,764,1,17.78%
2015-04,הדרום,831,ירוחם,יישוב,392,195,197,15,377,240,377,24,7.79%
2015-04,הדרום,1059,כסיפה,יישוב,1005,405,600,1,1004,914,1002,3,20.92%
2015-04,הדרום,1271,להבים,יישוב,36,17,19,16,20,5,35,0,0.97%
2015-04,הדרום,1060,לקיה,יישוב,889,401,488,2,887,815,877,0,19.58%
2015-04,הדרום,69,מ.א. אל קסום,מועצה איזורית,743,328,415,5,738,672,738,0,45.81%
2015-04,הדרום,38,מ.א. אשכול,מועצה איזורית,113,54,59,18,95,16,113,0,1.66%
2015-04,הדרום,33,מ.א. באר טוביה,מועצה איזורית,260,105,155,47,213,53,259,0,2.37%
2015-04,הדרום,41,מ.א. בני שמעון,מועצה איזורית,71,34,37,17,54,10,70,1,1.60%
2015-04,הדרום,54,מ.א. הערבה התיכונה,מועצה איזורית,29,10,19,9,20,2,29,0,1.60%
2015-04,הדרום,53,מ.א. חבל אילות,מועצה איזורית,14,8,6,2,12,0,14,1,0.59%
2015-04,הדרום,36,מ.א. חוף אשקלון,מועצה איזורית,210,89,121,17,193,57,201,0,2.43%
2015-04,הדרום,35,מ.א. יואב,מועצה איזורית,96,36,60,20,76,16,96,0,2.41%
2015-04,הדרום,50,מ.א. לכיש,מועצה איזורית,189,88,101,13,176,54,188,0,3.74%
2015-04,הדרום,42,מ.א. מרחבים,מועצה איזורית,182,76,106,23,159,44,182,0,3.08%
2015-04,הדרום,68,מ.א. נווה מדבר,מועצה איזורית,101,38,63,0,101,81,100,0,10.37%
2015-04,הדרום,48,מ.א. רמת נגב,מועצה איזורית,237,117,120,15,222,177,237,1,7.49%
2015-04,הדרום,39,מ.א. שדות נגב,מועצה איזורית,127,53,74,15,112,32,124,0,2.75%
2015-04,הדרום,37,מ.א. שער הנגב,מועצה איזורית,102,52,50,29,73,29,99,0,2.55%
2015-04,הדרום,34,מ.א. שפיר,מועצה איזורית,159,82,77,7,152,59,157,0,3.34%
2015-04,הדרום,51,מ.א. תמר,מועצה איזורית,17,8,9,3,14,4,17,0,2.69%
2015-04,הדרום,1268,מיתר,יישוב,65,25,40,19,46,9,64,1,1.43%
2015-04,הדרום,99,מצפה רמון,יישוב,242,107,135,9,233,165,234,11,8.52%
2015-04,הדרום,246,נתיבות,יישוב,1016,460,556,49,967,502,989,26,6.64%
2015-04,הדרום,666,עומר,יישוב,47,18,29,12,35,4,47,0,1.12%
2015-04,הדרום,2560,ערד,יישוב,818,375,443,70,748,399,801,25,6.44%
2015-04,הדרום,1192,ערערה-בנגב,יישוב,1074,460,614,6,1068,967,1063,0,24.26%
2015-04,הדרום,2630,קריית גת,יישוב,1962,813,1149,96,1866,993,1902,32,6.63%
2015-04,הדרום,1034,קריית מלאכי,יישוב,1013,433,580,15,998,559,980,55,8.25%
2015-04,הדרום,1161,רהט,יישוב,3051,1326,1725,9,3042,2556,3027,31,14.88%
2015-04,הדרום,1286,שגב-שלום,יישוב,549,216,333,0,549,445,544,1,18.38%
2015-04,הדרום,1031,שדרות,יישוב,986,466,520,50,936,592,945,13,6.99%
2015-04,הדרום,1054,תל שבע,יישוב,1118,542,576,2,1116,1012,1107,6,21.30%
2015-04,המרכז,1066,"בני עי""ש",יישוב,183,91,92,30,153,65,181,4,4.49%
2015-04,המרכז,182,אבן יהודה,יישוב,148,71,77,29,119,14,148,0,2.15%
2015-04,המרכז,41,אליכין,יישוב,65,35,30,9,56,21,63,1,3.25%
2015-04,המרכז,1309,אלעד,יישוב,381,168,213,10,371,59,374,1,2.88%
2015-04,המרכז,2530,באר יעקב,יישוב,237,99,138,40,197,43,232,3,2.32%
2015-04,המרכז,466,בית דגן,יישוב,97,52,45,4,93,31,97,0,2.61%
2015-04,המרכז,681,גבעת שמואל,יישוב,245,115,130,42,203,58,239,2,1.97%
2015-04,המרכז,2550,גדרה,יישוב,341,145,196,82,259,102,333,6,2.67%
2015-04,המרכז,627,ג'לג'וליה,יישוב,95,47,48,3,92,59,91,0,2.41%
2015-04,המרכז,166,גן יבנה,יישוב,359,141,218,46,313,79,355,3,2.92%
2015-04,המרכז,229,גני תקווה,יישוב,188,76,112,67,121,24,188,1,2.08%
2015-04,המרכז,9700,הוד השרון,יישוב,559,239,320,147,412,50,556,8,1.80%
2015-04,המרכז,1290,זמר,יישוב,154,51,103,1,153,105,153,9,5.13%
2015-04,המרכז,2730,טייבה,יישוב,1520,679,841,26,1494,1259,1393,27,7.80%
2015-04,המרכז,2720,טירה,יישוב,259,132,127,11,248,118,258,12,2.25%
2015-04,המרכז,2660,יבנה,יישוב,858,402,456,92,766,277,854,23,3.48%
2015-04,המרכז,9400,יהוד,יישוב,406,186,220,40,366,58,395,8,2.45%
2015-04,המרכז,1224,כוכב יאיר,יישוב,91,37,54,39,52,0,91,0,1.58%
2015-04,המרכז,633,כפר ברא,יישוב,27,11,16,1,26,9,26,0,1.81%
2015-04,המרכז,168,כפר יונה,יישוב,312,140,172,46,266,54,310,10,2.75%
2015-04,המרכז,6900,כפר סבא,יישוב,1222,538,684,347,875,138,1209,16,2.27%
2015-04,המרכז,634,כפר קאסם,יישוב,207,96,111,7,200,108,203,4,2.20%
2015-04,המרכז,7000,לוד,יישוב,1930,912,1018,134,1796,1055,1905,21,5.35%
2015-04,המרכז,28,מ.א. ברנר,מועצה איזורית,68,36,32,21,47,5,68,0,1.67%
2015-04,המרכז,32,מ.א. גדרות,מועצה איזורית,40,14,26,16,24,4,40,1,1.63%
2015-04,המרכז,30,מ.א. גזר,מועצה איזורית,240,109,131,86,154,26,236,0,1.79%
2015-04,המרכז,27,מ.א. גן רווה,מועצה איזורית,55,23,32,13,42,4,55,0,1.88%
2015-04,המרכז,20,מ.א. דרום השרון,מועצה איזורית,291,123,168,91,200,13,288,0,1.84%
2015-04,המרכז,29,מ.א. חבל יבנה,מועצה איזורית,30,14,16,10,20,5,30,0,1.21%
2015-04,המרכז,25,מ.א. חבל מודיעין,מועצה איזורית,229,89,140,73,156,13,229,0,2.13%
2015-04,המרכז,19,מ.א. חוף השרון,מועצה איזורית,98,48,50,27,71,6,98,0,1.75%
2015-04,המרכז,18,מ.א. לב השרון,מועצה איזורית,228,99,129,41,187,29,228,0,2.07%
2015-04,המרכז,31,מ.א. נחל שורק,מועצה איזורית,50,25,25,6,44,4,50,30,1.17%
2015-04,המרכז,16,מ.א. עמק חפר,מועצה איזורית,366,153,213,85,281,24,364,0,1.85%
2015-04,המרכז,40,מ.א. עמק לוד,מועצה איזורית,115,51,64,23,92,16,115,0,1.86%
2015-04,המרכז,1200,מודיעין-מכבים-רעות*,יישוב,881,371,510,305,576,55,874,10,1.94%
2015-04,המרכז,28,מזכרת בתיה,יישוב,159,74,85,40,119,29,159,0,2.12%
2015-04,המרכז,7200,נס ציונה,יישוב,585,279,306,144,441,169,582,2,2.43%
2015-04,המרכז,7400,נתניה,יישוב,4032,1880,2152,322,3710,1382,3964,96,3.75%
2015-04,המרכז,587,סביון*,יישוב,15,4,11,6,9,0,15,0,0.76%
2015-04,המרכז,171,פרדסייה,יישוב,74,32,42,12,62,8,74,0,1.95%
2015-04,המרכז,7900,פתח תקווה,יישוב,3824,1702,2122,770,3054,976,3765,33,2.99%
2015-04,המרכז,195,קדימה-צורן,יישוב,272,109,163,45,227,36,270,3,2.42%
2015-04,המרכז,638,קלנסווה,יישוב,591,255,336,7,584,491,551,7,6.18%
2015-04,המרכז,469,קריית עקרון,יישוב,235,117,118,9,226,114,234,5,3.88%
2015-04,המרכז,2640,ראש העין,יישוב,687,315,372,79,608,145,682,20,2.70%
2015-04,המרכז,8300,ראשון לציון,יישוב,4120,1804,2316,523,3597,1202,4099,64,2.94%
2015-04,המרכז,8400,רחובות,יישוב,2321,1055,1266,470,1851,895,2269,38,3.29%
2015-04,המרכז,8500,רמלה,יישוב,1603,757,846,89,1514,697,1555,37,4.11%
2015-04,המרכז,8700,רעננה,יישוב,712,326,386,225,487,63,709,7,1.91%
2015-04,המרכז,1304,שוהם,יישוב,175,81,94,70,105,10,175,1,1.50%
2015-04,המרכז,154,תל מונד,יישוב,140,74,66,21,119,18,140,0,2.17%
2015-04,הצפון,473,אבו סנאן,יישוב,664,274,390,6,658,525,654,5,10.92%
2015-04,הצפון,478,אכסאל,יישוב,552,271,281,14,538,447,536,2,9.24%
2015-04,הצפון,529,אעבלין,יישוב,563,233,330,8,555,460,561,6,9.57%
2015-04,הצפון,482,בועיינה-נוג'ידאת,יישוב,435,181,254,8,427,328,424,9,10.67%
2015-04,הצפון,4001,בוקעאתא,יישוב,407,161,246,3,404,334,388,0,13.92%
2015-04,הצפון,998,ביר אל-מכסור,יישוב,423,163,260,1,422,324,418,0,10.65%
2015-04,הצפון,480,בית ג'ן,יישוב,393,129,264,4,389,278,385,1,6.82%
2015-04,הצפון,9200,בית שאן,יישוב,784,353,431,20,764,392,766,44,7.44%
2015-04,הצפון,944,בסמת טבעון,יישוב,213,102,111,3,210,157,210,3,6.35%
2015-04,הצפון,483,בענה,יישוב,347,154,193,7,340,278,342,11,9.89%
2015-04,הצפון,1292,ג'דיידה-מכר,יישוב,1308,569,739,3,1305,1089,1285,18,13.49%
2015-04,הצפון,485,ג'ולס,יישוב,210,65,145,2,208,156,207,5,6.66%
2015-04,הצפון,487,ג'ש (גוש חלב),יישוב,64,31,33,5,59,36,62,0,3.74%
2015-04,הצפון,489,דבורייה,יישוב,366,168,198,21,345,258,365,2,8.39%
2015-04,הצפון,490,דייר אל-אסד,יישוב,352,154,198,5,347,284,352,5,6.71%
2015-04,הצפון,492,דייר חנא,יישוב,664,292,372,8,656,511,657,0,13.30%
2015-04,הצפון,975,זרזיר,יישוב,259,116,143,3,256,187,256,3,7.74%
2015-04,הצפון,496,חורפיש,יישוב,112,49,63,5,107,68,110,1,3.84%
2015-04,הצפון,2034,חצור הגלילית,יישוב,284,128,156,14,270,132,278,11,5.65%
2015-04,הצפון,6700,טבריה,יישוב,1536,732,804,64,1472,911,1368,49,6.24%
2015-04,הצפון,962,טובא-זנגרייה,יישוב,374,171,203,6,368,246,367,2,11.96%
2015-04,הצפון,498,טורעאן,יישוב,499,200,299,11,488,426,473,7,8.19%
2015-04,הצפון,8900,טמרה,יישוב,1913,830,1083,11,1902,1673,1895,17,12.94%
2015-04,הצפון,1295,יאנוח-ג'ת,יישוב,170,63,107,10,160,93,170,4,5.73%
2015-04,הצפון,46,יבנאל,יישוב,115,66,49,5,110,95,92,0,5.81%
2015-04,הצפון,29,יסוד המעלה,יישוב,13,3,10,2,11,2,13,0,1.52%
2015-04,הצפון,499,יפיע,יישוב,644,285,359,21,623,504,626,2,7.81%
2015-04,הצפון,240,יקנעם עילית,יישוב,434,175,259,58,376,134,428,22,3.52%
2015-04,הצפון,502,ירכא,יישוב,600,240,360,1,599,459,596,3,9.10%
2015-04,הצפון,504,כאבול,יישוב,652,278,374,6,646,556,649,3,12.78%
2015-04,הצפון,505,כאוכב אבו אל-היג'א,יישוב,216,92,124,7,209,184,214,0,12.27%
2015-04,הצפון,1296,כסרא-סמיע,יישוב,209,90,119,7,202,140,203,1,5.76%
2015-04,הצפון,978,כעביה-טבאש-חג'אג'רה,יישוב,194,74,120,5,189,133,191,1,8.02%
2015-04,הצפון,1263,כפר ורדים,יישוב,54,27,27,22,32,7,54,0,1.76%
2015-04,הצפון,507,כפר יאסיף,יישוב,430,201,229,1,429,340,418,6,8.15%
2015-04,הצפון,508,כפר כמא,יישוב,54,25,29,2,52,24,52,0,3.08%
2015-04,הצפון,509,כפר כנא,יישוב,1108,484,624,26,1082,921,1054,15,11.78%
2015-04,הצפון,510,כפר מנדא,יישוב,1003,466,537,8,995,734,963,17,12.89%
2015-04,הצפון,47,כפר תבור,יישוב,54,19,35,17,37,2,52,0,2.26%
2015-04,הצפון,1139,כרמיאל,יישוב,1504,622,882,204,1300,742,1451,35,5.55%
2015-04,הצפון,65,מ.א. אל-בטוף,מועצה איזורית,376,143,233,6,370,312,364,0,12.51%
2015-04,הצפון,66,מ.א. בוסתן אל-מרג',מועצה איזורית,43,15,28,1,42,35,43,1,1.40%
2015-04,הצפון,71,מ.א. גולן,מועצה איזורית,166,76,90,26,140,15,164,0,1.91%
2015-04,הצפון,8,מ.א. הגלבוע,מועצה איזורית,751,303,448,57,694,466,744,0,5.16%
2015-04,הצפון,1,מ.א. הגליל העליון,מועצה איזורית,172,89,83,25,147,32,170,0,1.93%
2015-04,הצפון,3,מ.א. הגליל התחתון,מועצה איזורית,111,38,73,25,86,10,108,0,1.85%
2015-04,הצפון,55,מ.א. מבואות החרמון,מועצה איזורית,101,39,62,10,91,12,101,0,2.53%
2015-04,הצפון,13,מ.א. מגידו,מועצה איזורית,106,40,66,31,75,7,106,0,1.87%
2015-04,הצפון,4,מ.א. מטה אשר,מועצה איזורית,451,204,247,47,404,192,448,0,3.27%
2015-04,הצפון,52,מ.א. מעלה יוסף,מועצה איזורית,156,79,77,27,129,55,155,0,2.81%
2015-04,הצפון,2,מ.א. מרום הגליל,מועצה איזורית,256,132,124,18,238,124,251,0,3.68%
2015-04,הצפון,56,מ.א. משגב,מועצה איזורית,481,192,289,66,415,262,478,0,3.68%
2015-04,הצפון,6,מ.א. עמק הירדן,מועצה איזורית,153,64,89,29,124,32,142,0,2.10%
2015-04,הצפון,7,מ.א. עמק המעיינות,מועצה איזורית,172,74,98,26,146,39,168,0,2.59%
2015-04,הצפון,9,מ.א. עמק יזרעאל,מועצה איזורית,324,121,203,124,200,39,320,0,1.65%
2015-04,הצפון,481,מגאר,יישוב,1481,602,879,11,1470,1267,1463,12,14.58%
2015-04,הצפון,516,מג'ד אל-כרום,יישוב,488,221,267,7,481,370,482,13,7.22%
2015-04,הצפון,65,מגדל,יישוב,44,16,28,5,39,14,40,0,4.20%
2015-04,הצפון,874,מגדל העמק,יישוב,837,386,451,50,787,347,802,55,5.88%
2015-04,הצפון,4201,מג'דל שמס,יישוב,466,175,291,8,458,369,447,4,9.04%
2015-04,הצפון,517,מזרעה,יישוב,176,67,109,2,174,139,170,0,8.48%
2015-04,הצפון,43,מטולה,יישוב,27,17,10,3,24,6,27,0,2.57%
2015-04,הצפון,4203,מסעדה,יישוב,212,87,125,4,208,171,207,1,12.06%
2015-04,הצפון,518,מעיליא,יישוב,53,26,27,7,46,24,53,1,3.27%
2015-04,הצפון,1063,מעלות-תרשיחא,יישוב,782,361,421,85,697,455,769,19,6.50%
2015-04,הצפון,520,משהד,יישוב,281,114,167,8,273,223,269,3,8.22%
2015-04,הצפון,9100,נהרייה,יישוב,1827,853,974,142,1685,1056,1788,72,5.76%
2015-04,הצפון,522,נחף,יישוב,397,183,214,9,388,315,394,7,7.71%
2015-04,הצפון,7300,נצרת,יישוב,3275,1495,1780,99,3176,2574,3187,14,9.14%
2015-04,הצפון,1061,נצרת עילית,יישוב,1637,742,895,127,1510,882,1493,65,6.39%
2015-04,הצפון,525,סאג'ור,יישוב,110,35,75,4,106,69,110,0,5.56%
2015-04,הצפון,7500,סח'נין,יישוב,2105,876,1229,14,2091,1792,2094,8,14.67%
2015-04,הצפון,4501,ע'ג'ר,יישוב,100,43,57,0,100,55,99,1,9.27%
2015-04,הצפון,530,עיילבון,יישוב,163,67,96,1,162,118,161,2,5.82%
2015-04,הצפון,511,עילוט,יישוב,344,148,196,5,339,272,334,1,11.49%
2015-04,הצפון,532,עין מאהל,יישוב,491,240,251,7,484,412,473,3,8.89%
2015-04,הצפון,4502,עין קנייא,יישוב,151,64,87,1,150,126,145,0,14.00%
2015-04,הצפון,7600,עכו,יישוב,2921,1371,1550,114,2807,2201,2862,46,10.74%
2015-04,הצפון,7700,עפולה,יישוב,1541,659,882,122,1419,679,1503,47,5.86%
2015-04,הצפון,531,עראבה,יישוב,1572,660,912,26,1546,1338,1561,3,15.01%
2015-04,הצפון,535,פסוטה,יישוב,104,48,56,5,99,63,104,1,5.99%
2015-04,הצפון,536,פקיעין (בוקייעה),יישוב,116,69,47,7,109,75,114,1,4.06%
2015-04,הצפון,8000,צפת,יישוב,1334,724,610,53,1281,963,1274,22,9.32%
2015-04,הצפון,4100,קצרין,יישוב,187,86,101,16,171,83,183,3,4.55%
2015-04,הצפון,2800,קריית שמונה,יישוב,697,317,380,37,660,329,673,40,5.14%
2015-04,הצפון,543,ראמה,יישוב,289,121,168,12,277,215,286,1,7.25%
2015-04,הצפון,26,ראש פינה,יישוב,39,14,25,5,34,15,39,1,2.44%
2015-04,הצפון,542,ריינה,יישוב,631,271,360,8,623,500,600,4,8.67%
2015-04,הצפון,122,רמת ישי,יישוב,107,48,59,24,83,17,105,2,2.51%
2015-04,הצפון,913,שבלי - אום אל-גנם,יישוב,211,93,118,6,205,142,210,1,7.88%
2015-04,הצפון,812,שלומי,יישוב,205,90,115,12,193,104,202,6,5.61%
2015-04,הצפון,538,שעב,יישוב,530,214,316,2,528,476,526,1,16.86%
2015-04,הצפון,8800,שפרעם,יישוב,1920,767,1153,20,1900,1554,1897,34,10.27%
2015-04,חיפה,1326,"בסמ""ה",יישוב,408,185,223,4,404,308,407,2,9.96%
2015-04,חיפה,2710,אום אל-פחם,יישוב,3582,1497,2085,26,3556,3052,3507,25,16.14%
2015-04,חיפה,1020,אור עקיבא,יישוב,524,248,276,36,488,184,505,17,4.93%
2015-04,חיפה,6000,באקה אל-גרביה,יישוב,635,303,332,5,630,371,632,18,5.35%
2015-04,חיפה,9800,בנימינה-גבעת עדה*,יישוב,205,96,109,54,151,57,204,1,2.79%
2015-04,חיפה,541,ג'סר א-זרקא,יישוב,435,227,208,0,435,315,433,3,7.10%
2015-04,חיפה,628,ג'ת,יישוב,222,115,107,7,215,132,221,6,4.17%
2015-04,חיפה,494,דאלית אל-כרמל,יישוב,503,212,291,11,492,266,489,5,5.87%
2015-04,חיפה,9300,זכרון יעקב,יישוב,250,109,141,63,187,51,250,1,2.24%
2015-04,חיפה,6500,חדרה,יישוב,2169,935,1234,237,1932,816,2074,49,4.13%
2015-04,חיפה,4000,חיפה,יישוב,5983,2935,3048,1049,4934,3212,5745,110,4.10%
2015-04,חיפה,1247,חריש,יישוב,30,17,13,5,25,7,30,0,1.87%
2015-04,חיפה,2100,טירת כרמל,יישוב,733,353,380,24,709,397,720,18,6.34%
2015-04,חיפה,654,כפר קרע,יישוב,390,163,227,3,387,246,386,9,4.50%
2015-04,חיפה,45,מ.א. אלונה,מועצה איזורית,20,6,14,5,15,4,20,0,1.87%
2015-04,חיפה,12,מ.א. זבולון,מועצה איזורית,256,126,130,23,233,178,255,0,4.58%
2015-04,חיפה,15,מ.א. חוף הכרמל,מועצה איזורית,288,120,168,62,226,59,286,0,2.02%
2015-04,חיפה,14,מ.א. מנשה,מועצה איזורית,248,105,143,56,192,71,246,0,3.07%
2015-04,חיפה,1327,מעלה עירון,יישוב,913,356,557,9,904,758,900,10,14.84%
2015-04,חיפה,2500,נשר,יישוב,450,227,223,79,371,186,439,6,3.42%
2015-04,חיפה,534,עספיא,יישוב,328,144,184,9,319,168,315,6,5.52%
2015-04,חיפה,637,ערערה,יישוב,598,263,335,2,596,379,588,7,7.16%
2015-04,חיפה,537,פוריידיס,יישוב,395,199,196,4,391,268,392,2,6.87%
2015-04,חיפה,7800,פרדס חנה-כרכור,יישוב,836,399,437,130,706,254,826,13,4.05%
2015-04,חיפה,6800,קריית אתא,יישוב,1486,682,804,134,1352,821,1465,29,4.81%
2015-04,חיפה,9500,קריית ביאליק,יישוב,947,393,554,111,836,476,936,21,4.36%
2015-04,חיפה,2300,קריית טבעון,יישוב,165,85,80,53,112,37,160,1,1.92%
2015-04,חיפה,9600,קריית ים,יישוב,1412,664,748,127,1285,816,1385,19,6.44%
2015-04,חיפה,8200,קריית מוצקין,יישוב,949,398,551,127,822,461,929,13,4.03%
2015-04,חיפה,922,רכסים,יישוב,140,64,76,7,133,74,130,0,3.66%
2015-04,ירושלים,472,אבו גוש,יישוב,277,131,146,3,274,201,276,1,8.81%
2015-04,ירושלים,2610,בית שמש,יישוב,1114,498,616,40,1074,478,1083,19,3.21%
2015-04,ירושלים,3000,ירושלים,יישוב,12060,5501,6559,1220,10840,7528,11863,100,3.98%
2015-04,ירושלים,26,מ.א. מטה יהודה,מועצה איזורית,540,256,284,98,442,117,534,1,2.23%
2015-04,ירושלים,1015,מבשרת ציון,יישוב,370,185,185,66,304,142,366,4,2.81%
2015-04,ירושלים,1137,קריית יערים,יישוב,32,12,20,1,31,17,32,0,2.27%
2015-04,תל אביב,2400,אור יהודה,יישוב,707,339,368,40,667,215,677,16,3.55%
2015-04,תל אביב,565,אזור,יישוב,145,77,68,15,130,26,144,1,2.20%
2015-04,תל אביב,6100,בני ברק,יישוב,1964,957,1007,58,1906,961,1874,17,3.26%
2015-04,תל אביב,6200,בת ים,יישוב,2888,1345,1543,349,2539,1063,2794,55,3.96%
2015-04,תל אביב,6300,גבעתיים,יישוב,694,303,391,284,410,94,691,6,2.24%
2015-04,תל אביב,6400,הרצלייה,יישוב,985,442,543,274,711,28,978,15,2.00%
2015-04,תל אביב,6600,חולון,יישוב,2763,1297,1466,307,2456,684,2733,64,2.75%
2015-04,תל אביב,267,כפר שמריהו,יישוב,14,5,9,6,8,0,14,0,1.65%
2015-04,תל אביב,2620,קריית אונו,יישוב,344,156,188,97,247,42,343,0,1.79%
2015-04,תל אביב,8600,רמת גן,יישוב,1929,884,1045,600,1329,402,1903,10,2.42%
2015-04,תל אביב,2650,רמת השרון,יישוב,372,133,239,133,239,7,370,5,1.66%
2015-04,תל אביב,5000,תל אביב -יפו,יישוב,6896,3351,3545,2129,4767,1931,6801,70,2.68%
2015-05,אזור יהודה והשומרון,3760,אורנית,יישוב,108,51,57,39,69,3,108,2,2.21%
2015-05,אזור יהודה והשומרון,3750,אלפי מנשה,יישוב,100,49,51,33,67,1,100,3,2.26%
2015-05,אזור יהודה והשומרון,3560,אלקנה,יישוב,24,11,13,9,15,1,24,0,1.27%
2015-05,אזור יהודה והשומרון,3650,אפרת,יישוב,53,30,23,17,36,3,53,2,1.23%
2015-05,אזור יהודה והשומרון,3570,אריאל,יישוב,310,148,162,72,238,61,310,15,2.87%
2015-05,אזור יהודה והשומרון,3574,בית אל,יישוב,49,21,28,17,32,15,49,0,2.01%
2015-05,אזור יהודה והשומרון,3652,בית אריה,יישוב,48,21,27,12,36,2,48,0,1.80%
2015-05,אזור יהודה והשומרון,3780,ביתר עילית,יישוב,577,292,285,6,571,292,573,15,4.29%
2015-05,אזור יהודה והשומרון,3730,גבעת זאב,יישוב,194,97,97,36,158,43,193,2,2.48%
2015-05,אזור יהודה והשומרון,3769,הר אדר,יישוב,32,14,18,20,12,4,32,0,1.51%
2015-05,אזור יהודה והשומרון,76,מ.א. גוש עציון,מועצה איזורית,157,89,68,57,100,21,156,0,1.62%
2015-05,אזור יהודה והשומרון,78,מ.א. הר חברון,מועצה איזורית,66,33,33,25,41,3,65,0,1.85%
2015-05,אזור יהודה והשומרון,74,מ.א. מגילות ים המלח,מועצה איזורית,16,9,7,5,11,2,16,0,2.00%
2015-05,אזור יהודה והשומרון,73,מ.א. מטה בנימין,מועצה איזורית,618,314,304,183,435,137,612,0,2.44%
2015-05,אזור יהודה והשומרון,75,מ.א. ערבות הירדן,מועצה איזורית,53,23,30,15,38,4,53,0,2.18%
2015-05,אזור יהודה והשומרון,72,מ.א. שומרון,מועצה איזורית,363,192,171,94,269,45,361,0,2.14%
2015-05,אזור יהודה והשומרון,3797,מודיעין עילית,יישוב,383,128,255,23,360,59,381,3,2.71%
2015-05,אזור יהודה והשומרון,3616,מעלה אדומים,יישוב,642,276,366,89,553,178,637,17,3.10%
2015-05,אזור יהודה והשומרון,3608,מעלה אפרים,יישוב,32,14,18,3,29,9,32,2,3.86%
2015-05,אזור יהודה והשומרון,3660,עמנואל,יישוב,54,34,20,2,52,40,53,0,4.52%
2015-05,אזור יהודה והשומרון,3557,קדומים,יישוב,37,16,21,17,20,6,37,1,1.97%
2015-05,אזור יהודה והשומרון,3611,קריית ארבע,יישוב,119,61,58,17,102,66,116,5,3.52%
2015-05,אזור יהודה והשומרון,3640,קרני שומרון,יישוב,69,38,31,17,52,11,69,1,1.83%
2015-05,הדרום,31,אופקים,יישוב,1108,487,621,55,1053,671,1096,42,8.09%
2015-05,הדרום,2600,אילת,יישוב,1212,576,636,67,1145,510,1179,58,3.48%
2015-05,הדרום,70,אשדוד,יישוב,6024,2566,3458,724,5300,2968,5853,206,5.30%
2015-05,הדרום,7100,אשקלון,יישוב,4084,1744,2340,440,3644,2044,3720,127,5.21%
2015-05,הדרום,9000,באר שבע,יישוב,6684,3082,3602,855,5829,3769,6499,199,6.07%
2015-05,הדרום,2200,דימונה,יישוב,1955,903,1052,102,1853,1277,1897,76,9.98%
2015-05,הדרום,1303,חורה,יישוב,762,330,432,4,758,681,758,3,17.66%
2015-05,הדרום,831,ירוחם,יישוב,398,205,193,18,380,240,386,31,7.97%
2015-05,הדרום,1059,כסיפה,יישוב,1007,404,603,1,1006,925,1006,1,20.98%
2015-05,הדרום,1271,להבים,יישוב,38,20,18,17,21,5,37,0,1.02%
2015-05,הדרום,1060,לקיה,יישוב,886,407,479,4,882,810,879,4,19.62%
2015-05,הדרום,69,מ.א. אל קסום,מועצה איזורית,748,322,426,5,743,674,742,0,46.06%
2015-05,הדרום,38,מ.א. אשכול,מועצה איזורית,126,61,65,21,105,17,126,0,1.85%
2015-05,הדרום,33,מ.א. באר טוביה,מועצה איזורית,265,109,156,59,206,56,264,0,2.41%
2015-05,הדרום,41,מ.א. בני שמעון,מועצה איזורית,75,37,38,24,51,11,73,1,1.67%
2015-05,הדרום,54,מ.א. הערבה התיכונה,מועצה איזורית,38,16,22,9,29,2,38,0,2.09%
2015-05,הדרום,53,מ.א. חבל אילות,מועצה איזורית,17,10,7,4,13,0,17,1,0.72%
2015-05,הדרום,36,מ.א. חוף אשקלון,מועצה איזורית,203,88,115,22,181,51,197,1,2.38%
2015-05,הדרום,35,מ.א. יואב,מועצה איזורית,93,34,59,27,66,19,93,0,2.34%
2015-05,הדרום,50,מ.א. לכיש,מועצה איזורית,192,90,102,24,168,57,190,0,3.78%
2015-05,הדרום,42,מ.א. מרחבים,מועצה איזורית,171,74,97,30,141,45,170,0,2.88%
2015-05,הדרום,68,מ.א. נווה מדבר,מועצה איזורית,106,40,66,0,106,83,105,0,10.89%
2015-05,הדרום,48,מ.א. רמת נגב,מועצה איזורית,253,127,126,19,234,190,253,1,7.99%
2015-05,הדרום,39,מ.א. שדות נגב,מועצה איזורית,126,54,72,15,111,29,122,0,2.70%
2015-05,הדרום,37,מ.א. שער הנגב,מועצה איזורית,108,55,53,30,78,28,105,1,2.70%
2015-05,הדרום,34,מ.א. שפיר,מועצה איזורית,169,88,81,9,160,65,167,0,3.56%
2015-05,הדרום,51,מ.א. תמר,מועצה איזורית,14,7,7,4,10,4,14,0,2.21%
2015-05,הדרום,1268,מיתר,יישוב,65,27,38,20,45,9,65,1,1.46%
2015-05,הדרום,99,מצפה רמון,יישוב,268,112,156,21,247,176,261,14,9.41%
2015-05,הדרום,246,נתיבות,יישוב,978,428,550,45,933,498,952,51,6.41%
2015-05,הדרום,666,עומר,יישוב,56,19,37,22,34,5,56,1,1.33%
2015-05,הדרום,2560,ערד,יישוב,815,362,453,81,734,399,795,53,6.39%
2015-05,הדרום,1192,ערערה-בנגב,יישוב,1097,467,630,5,1092,995,1086,0,24.66%
2015-05,הדרום,2630,קריית גת,יישוב,1995,833,1162,127,1868,1032,1938,64,6.75%
2015-05,הדרום,1034,קריית מלאכי,יישוב,1055,456,599,20,1035,559,1021,72,8.57%
2015-05,הדרום,1161,רהט,יישוב,3085,1292,1793,14,3071,2564,3065,76,15.04%
2015-05,הדרום,1286,שגב-שלום,יישוב,569,210,359,1,568,449,565,1,18.96%
2015-05,הדרום,1031,שדרות,יישוב,1027,485,542,45,982,595,983,25,7.26%
2015-05,הדרום,1054,תל שבע,יישוב,1131,539,592,1,1130,1015,1122,11,21.53%
2015-05,המרכז,1066,"בני עי""ש",יישוב,182,91,91,28,154,66,180,4,4.46%
2015-05,המרכז,182,אבן יהודה,יישוב,139,63,76,34,105,16,139,1,2.02%
2015-05,המרכז,41,אליכין,יישוב,63,36,27,7,56,21,61,1,3.15%
2015-05,המרכז,1309,אלעד,יישוב,376,177,199,20,356,63,368,4,2.83%
2015-05,המרכז,2530,באר יעקב,יישוב,237,94,143,42,195,52,233,5,2.33%
2015-05,המרכז,466,בית דגן,יישוב,98,54,44,6,92,33,98,5,2.64%
2015-05,המרכז,681,גבעת שמואל,יישוב,249,120,129,84,165,58,242,2,2.00%
2015-05,המרכז,2550,גדרה,יישוב,329,138,191,84,245,101,326,4,2.61%
2015-05,המרכז,627,ג'לג'וליה,יישוב,94,43,51,4,90,60,92,2,2.43%
2015-05,המרכז,166,גן יבנה,יישוב,350,141,209,47,303,77,344,9,2.83%
2015-05,המרכז,229,גני תקווה,יישוב,186,69,117,69,117,24,186,0,2.06%
2015-05,המרכז,9700,הוד השרון,יישוב,572,250,322,225,347,48,569,9,1.84%
2015-05,המרכז,1290,זמר,יישוב,146,45,101,1,145,102,145,8,4.88%
2015-05,המרכז,2730,טייבה,יישוב,1489,654,835,26,1463,1228,1365,39,7.66%
2015-05,המרכז,2720,טירה,יישוב,265,124,141,12,253,122,258,8,2.25%
2015-05,המרכז,2660,יבנה,יישוב,875,410,465,118,757,276,873,47,3.55%
2015-05,המרכז,9400,יהוד,יישוב,392,190,202,52,340,54,388,12,2.41%
2015-05,המרכז,1224,כוכב יאיר,יישוב,89,39,50,49,40,0,89,2,1.54%
2015-05,המרכז,633,כפר ברא,יישוב,27,10,17,2,25,8,27,1,1.88%
2015-05,המרכז,168,כפר יונה,יישוב,288,126,162,50,238,47,287,4,2.55%
2015-05,המרכז,6900,כפר סבא,יישוב,1225,549,676,421,804,137,1214,26,2.28%
2015-05,המרכז,634,כפר קאסם,יישוב,222,107,115,5,217,115,217,3,2.35%
2015-05,המרכז,7000,לוד,יישוב,1953,933,1020,153,1800,1071,1926,57,5.40%
2015-05,המרכז,28,מ.א. ברנר,מועצה איזורית,66,36,30,23,43,4,66,4,1.62%
2015-05,המרכז,32,מ.א. גדרות,מועצה איזורית,44,14,30,18,26,5,44,0,1.80%
2015-05,המרכז,30,מ.א. גזר,מועצה איזורית,250,114,136,92,158,30,246,0,1.87%
2015-05,המרכז,27,מ.א. גן רווה,מועצה איזורית,49,24,25,15,34,2,49,0,1.67%
2015-05,המרכז,20,מ.א. דרום השרון,מועצה איזורית,298,134,164,113,185,16,296,0,1.89%
2015-05,המרכז,29,מ.א. חבל יבנה,מועצה איזורית,28,13,15,12,16,3,28,0,1.12%
2015-05,המרכז,25,מ.א. חבל מודיעין,מועצה איזורית,248,102,146,83,165,17,248,0,2.31%
2015-05,המרכז,19,מ.א. חוף השרון,מועצה איזורית,103,47,56,43,60,4,103,0,1.84%
2015-05,המרכז,18,מ.א. לב השרון,מועצה איזורית,249,120,129,60,189,37,248,0,2.25%
2015-05,המרכז,31,מ.א. נחל שורק,מועצה איזורית,50,22,28,8,42,5,49,42,1.14%
2015-05,המרכז,16,מ.א. עמק חפר,מועצה איזורית,364,156,208,108,256,24,362,0,1.84%
2015-05,המרכז,40,מ.א. עמק לוד,מועצה איזורית,128,58,70,34,94,17,127,0,2.06%
2015-05,המרכז,1200,מודיעין-מכבים-רעות*,יישוב,913,381,532,349,564,62,907,25,2.01%
2015-05,המרכז,28,מזכרת בתיה,יישוב,164,82,82,45,119,30,164,4,2.18%
2015-05,המרכז,7200,נס ציונה,יישוב,591,284,307,159,432,179,588,7,2.46%
2015-05,המרכז,7400,נתניה,יישוב,4144,1921,2223,498,3646,1399,4073,123,3.85%
2015-05,המרכז,587,סביון*,יישוב,16,5,11,9,7,0,16,0,0.81%
2015-05,המרכז,171,פרדסייה,יישוב,75,32,43,13,62,7,75,0,1.97%
2015-05,המרכז,7900,פתח תקווה,יישוב,3907,1740,2167,856,3051,1008,3846,51,3.05%
2015-05,המרכז,195,קדימה-צורן,יישוב,281,104,177,66,215,38,276,6,2.48%
2015-05,המרכז,638,קלנסווה,יישוב,576,254,322,6,570,476,530,11,5.96%
2015-05,המרכז,469,קריית עקרון,יישוב,244,122,122,12,232,114,243,6,4.03%
2015-05,המרכז,2640,ראש העין,יישוב,691,304,387,76,615,148,686,25,2.71%
2015-05,המרכז,8300,ראשון לציון,יישוב,4237,1872,2365,818,3419,1224,4219,92,3.02%
2015-05,המרכז,8400,רחובות,יישוב,2354,1099,1255,513,1841,883,2315,50,3.35%
2015-05,המרכז,8500,רמלה,יישוב,1652,787,865,105,1547,698,1617,63,4.27%
2015-05,המרכז,8700,רעננה,יישוב,752,345,407,294,458,74,745,14,2.01%
2015-05,המרכז,1304,שוהם,יישוב,180,79,101,79,101,8,180,2,1.55%
2015-05,המרכז,154,תל מונד,יישוב,152,82,70,39,113,21,152,3,2.36%
2015-05,הצפון,473,אבו סנאן,יישוב,656,272,384,5,651,512,647,14,10.82%
2015-05,הצפון,478,אכסאל,יישוב,560,268,292,13,547,458,546,3,9.40%
2015-05,הצפון,529,אעבלין,יישוב,577,244,333,10,567,469,576,8,9.80%
2015-05,הצפון,482,בועיינה-נוג'ידאת,יישוב,403,167,236,10,393,314,398,9,10.08%
2015-05,הצפון,4001,בוקעאתא,יישוב,428,169,259,5,423,340,405,4,14.44%
2015-05,הצפון,998,ביר אל-מכסור,יישוב,420,162,258,3,417,328,417,2,10.62%
2015-05,הצפון,480,בית ג'ן,יישוב,412,132,280,7,405,288,407,2,7.19%
2015-05,הצפון,9200,בית שאן,יישוב,772,341,431,19,753,389,756,59,7.35%
2015-05,הצפון,944,בסמת טבעון,יישוב,215,102,113,2,213,158,210,3,6.35%
2015-05,הצפון,483,בענה,יישוב,339,150,189,9,330,273,337,6,9.76%
2015-05,הצפון,1292,ג'דיידה-מכר,יישוב,1305,566,739,4,1301,1073,1286,36,13.50%
2015-05,הצפון,485,ג'ולס,יישוב,210,67,143,2,208,159,207,4,6.66%
2015-05,הצפון,487,ג'ש (גוש חלב),יישוב,77,34,43,5,72,38,75,1,4.49%
2015-05,הצפון,489,דבורייה,יישוב,374,168,206,24,350,260,374,5,8.58%
2015-05,הצפון,490,דייר אל-אסד,יישוב,369,163,206,6,363,290,368,10,6.99%
2015-05,הצפון,492,דייר חנא,יישוב,654,287,367,11,643,511,647,6,13.12%
2015-05,הצפון,975,זרזיר,יישוב,258,113,145,2,256,187,256,6,7.74%
2015-05,הצפון,496,חורפיש,יישוב,108,44,64,8,100,67,107,2,3.74%
2015-05,הצפון,2034,חצור הגלילית,יישוב,274,116,158,16,258,135,267,13,5.44%
2015-05,הצפון,6700,טבריה,יישוב,1549,720,829,73,1476,901,1367,69,6.23%
2015-05,הצפון,962,טובא-זנגרייה,יישוב,401,172,229,5,396,243,398,3,12.84%
2015-05,הצפון,498,טורעאן,יישוב,492,197,295,12,480,420,473,3,8.19%
2015-05,הצפון,8900,טמרה,יישוב,1856,808,1048,16,1840,1616,1846,26,12.65%
2015-05,הצפון,1295,יאנוח-ג'ת,יישוב,172,62,110,8,164,95,169,5,5.70%
2015-05,הצפון,46,יבנאל,יישוב,102,62,40,3,99,83,79,1,5.03%
2015-05,הצפון,29,יסוד המעלה,יישוב,19,6,13,5,14,2,19,0,2.21%
2015-05,הצפון,499,יפיע,יישוב,625,276,349,22,603,490,615,7,7.69%
2015-05,הצפון,240,יקנעם עילית,יישוב,427,176,251,64,363,133,424,30,3.49%
2015-05,הצפון,502,ירכא,יישוב,596,244,352,1,595,456,590,2,9.02%
2015-05,הצפון,504,כאבול,יישוב,656,282,374,9,647,556,653,3,12.85%
2015-05,הצפון,505,כאוכב אבו אל-היג'א,יישוב,220,94,126,9,211,186,218,1,12.47%
2015-05,הצפון,1296,כסרא-סמיע,יישוב,236,100,136,7,229,153,235,4,6.61%
2015-05,הצפון,978,כעביה-טבאש-חג'אג'רה,יישוב,195,78,117,6,189,136,191,4,8.02%
2015-05,הצפון,1263,כפר ורדים,יישוב,56,26,30,27,29,7,56,2,1.82%
2015-05,הצפון,507,כפר יאסיף,יישוב,433,197,236,2,431,326,428,13,8.33%
2015-05,הצפון,508,כפר כמא,יישוב,58,28,30,1,57,27,56,0,3.31%
2015-05,הצפון,509,כפר כנא,יישוב,1093,468,625,28,1065,907,1046,13,11.70%
2015-05,הצפון,510,כפר מנדא,יישוב,964,434,530,7,957,682,948,16,12.72%
2015-05,הצפון,47,כפר תבור,יישוב,43,18,25,13,30,1,42,0,1.83%
2015-05,הצפון,1139,כרמיאל,יישוב,1512,638,874,249,1263,752,1458,59,5.58%
2015-05,הצפון,65,מ.א. אל-בטוף,מועצה איזורית,376,139,237,6,370,303,365,0,12.54%
2015-05,הצפון,66,מ.א. בוסתן אל-מרג',מועצה איזורית,47,19,28,2,45,36,47,0,1.53%
2015-05,הצפון,71,מ.א. גולן,מועצה איזורית,146,65,81,30,116,15,143,0,1.66%
2015-05,הצפון,8,מ.א. הגלבוע,מועצה איזורית,751,295,456,72,679,457,748,0,5.19%
2015-05,הצפון,1,מ.א. הגליל העליון,מועצה איזורית,164,88,76,38,126,25,164,0,1.86%
2015-05,הצפון,3,מ.א. הגליל התחתון,מועצה איזורית,115,41,74,26,89,13,110,0,1.88%
2015-05,הצפון,55,מ.א. מבואות החרמון,מועצה איזורית,92,36,56,14,78,15,91,0,2.28%
2015-05,הצפון,13,מ.א. מגידו,מועצה איזורית,104,40,64,35,69,8,104,0,1.83%
2015-05,הצפון,4,מ.א. מטה אשר,מועצה איזורית,419,184,235,54,365,177,418,0,3.05%
2015-05,הצפון,52,מ.א. מעלה יוסף,מועצה איזורית,159,76,83,24,135,51,159,0,2.88%
2015-05,הצפון,2,מ.א. מרום הגליל,מועצה איזורית,289,141,148,24,265,128,283,0,4.14%
2015-05,הצפון,56,מ.א. משגב,מועצה איזורית,485,195,290,78,407,267,481,0,3.70%
2015-05,הצפון,6,מ.א. עמק הירדן,מועצה איזורית,142,54,88,28,114,33,132,0,1.95%
2015-05,הצפון,7,מ.א. עמק המעיינות,מועצה איזורית,160,67,93,25,135,39,159,0,2.46%
2015-05,הצפון,9,מ.א. עמק יזרעאל,מועצה איזורית,319,117,202,139,180,37,318,0,1.64%
2015-05,הצפון,481,מגאר,יישוב,1465,593,872,14,1451,1248,1451,16,14.47%
2015-05,הצפון,516,מג'ד אל-כרום,יישוב,504,224,280,9,495,370,500,8,7.46%
2015-05,הצפון,65,מגדל,יישוב,43,13,30,5,38,13,41,0,4.30%
2015-05,הצפון,874,מגדל העמק,יישוב,868,401,467,66,802,347,845,81,6.18%
2015-05,הצפון,4201,מג'דל שמס,יישוב,485,175,310,10,475,369,457,7,9.22%
2015-05,הצפון,517,מזרעה,יישוב,183,72,111,2,181,140,177,5,8.80%
2015-05,הצפון,43,מטולה,יישוב,29,16,13,8,21,7,29,0,2.76%
2015-05,הצפון,4203,מסעדה,יישוב,217,88,129,5,212,171,208,4,12.11%
2015-05,הצפון,518,מעיליא,יישוב,48,27,21,6,42,21,48,5,2.97%
2015-05,הצפון,1063,מעלות-תרשיחא,יישוב,812,390,422,105,707,453,809,29,6.81%
2015-05,הצפון,520,משהד,יישוב,275,107,168,7,268,215,270,4,8.25%
2015-05,הצפון,9100,נהרייה,יישוב,1798,833,965,180,1618,1046,1769,72,5.70%
2015-05,הצפון,522,נחף,יישוב,392,178,214,13,379,311,389,11,7.62%
2015-05,הצפון,7300,נצרת,יישוב,3234,1464,1770,110,3124,2545,3169,27,9.09%
2015-05,הצפון,1061,נצרת עילית,יישוב,1668,762,906,145,1523,872,1535,133,6.56%
2015-05,הצפון,525,סאג'ור,יישוב,111,36,75,4,107,71,111,1,5.60%
2015-05,הצפון,7500,סח'נין,יישוב,2124,888,1236,14,2110,1806,2111,14,14.77%
2015-05,הצפון,4501,ע'ג'ר,יישוב,110,41,69,1,109,60,110,0,10.19%
2015-05,הצפון,530,עיילבון,יישוב,167,68,99,4,163,122,166,2,5.99%
2015-05,הצפון,511,עילוט,יישוב,337,146,191,7,330,265,335,1,11.52%
2015-05,הצפון,532,עין מאהל,יישוב,484,238,246,7,477,402,469,4,8.82%
2015-05,הצפון,4502,עין קנייא,יישוב,146,60,86,2,144,122,141,0,13.66%
2015-05,הצפון,7600,עכו,יישוב,3029,1402,1627,114,2915,2233,2974,62,11.12%
2015-05,הצפון,7700,עפולה,יישוב,1574,673,901,162,1412,693,1548,92,6.03%
2015-05,הצפון,531,עראבה,יישוב,1577,654,923,27,1550,1344,1560,17,15.01%
2015-05,הצפון,535,פסוטה,יישוב,113,49,64,7,106,73,112,0,6.43%
2015-05,הצפון,536,פקיעין (בוקייעה),יישוב,122,71,51,8,114,77,121,1,4.30%
2015-05,הצפון,8000,צפת,יישוב,1354,754,600,74,1280,988,1301,32,9.50%
2015-05,הצפון,4100,קצרין,יישוב,178,80,98,29,149,83,174,3,4.33%
2015-05,הצפון,2800,קריית שמונה,יישוב,689,322,367,52,637,318,669,53,5.11%
2015-05,הצפון,543,ראמה,יישוב,291,121,170,13,278,211,289,4,7.32%
2015-05,הצפון,26,ראש פינה,יישוב,42,17,25,10,32,16,42,1,2.63%
2015-05,הצפון,542,ריינה,יישוב,635,265,370,11,624,504,615,10,8.86%
2015-05,הצפון,122,רמת ישי,יישוב,100,46,54,31,69,14,99,6,2.37%
2015-05,הצפון,913,שבלי - אום אל-גנם,יישוב,213,100,113,6,207,148,212,2,7.95%
2015-05,הצפון,812,שלומי,יישוב,209,94,115,16,193,106,207,5,5.74%
2015-05,הצפון,538,שעב,יישוב,540,220,320,4,536,476,534,2,17.08%
2015-05,הצפון,8800,שפרעם,יישוב,1921,759,1162,27,1894,1551,1908,48,10.32%
2015-05,חיפה,1326,"בסמ""ה",יישוב,411,184,227,4,407,308,409,7,10.00%
2015-05,חיפה,2710,אום אל-פחם,יישוב,3612,1514,2098,26,3586,3048,3545,51,16.28%
2015-05,חיפה,1020,אור עקיבא,יישוב,509,238,271,46,463,188,494,24,4.83%
2015-05,חיפה,6000,באקה אל-גרביה,יישוב,648,299,349,10,638,367,645,45,5.45%
2015-05,חיפה,9800,בנימינה-גבעת עדה*,יישוב,194,95,99,56,138,59,194,3,2.66%
2015-05,חיפה,541,ג'סר א-זרקא,יישוב,491,252,239,1,490,321,490,5,7.96%
2015-05,חיפה,628,ג'ת,יישוב,210,107,103,8,202,135,210,8,3.97%
2015-05,חיפה,494,דאלית אל-כרמל,יישוב,501,198,303,12,489,275,488,5,5.86%
2015-05,חיפה,9300,זכרון יעקב,יישוב,258,119,139,82,176,50,257,6,2.31%
2015-05,חיפה,6500,חדרה,יישוב,2236,930,1306,268,1968,810,2144,61,4.26%
2015-05,חיפה,4000,חיפה,יישוב,6115,2995,3120,1190,4925,3223,5884,152,4.20%
2015-05,חיפה,1247,חריש,יישוב,28,16,12,6,22,10,28,1,1.75%
2015-05,חיפה,2100,טירת כרמל,יישוב,748,381,367,31,717,404,735,23,6.46%
2015-05,חיפה,654,כפר קרע,יישוב,405,165,240,7,398,246,401,13,4.67%
2015-05,חיפה,45,מ.א. אלונה,מועצה איזורית,20,6,14,5,15,4,20,0,1.87%
2015-05,חיפה,12,מ.א. זבולון,מועצה איזורית,259,124,135,29,230,175,256,0,4.60%
2015-05,חיפה,15,מ.א. חוף הכרמל,מועצה איזורית,285,125,160,74,211,60,283,0,2.00%
2015-05,חיפה,14,מ.א. מנשה,מועצה איזורית,257,110,147,59,198,72,256,0,3.19%
2015-05,חיפה,1327,מעלה עירון,יישוב,893,350,543,10,883,734,882,12,14.59%
2015-05,חיפה,2500,נשר,יישוב,460,235,225,88,372,184,450,11,3.50%
2015-05,חיפה,534,עספיא,יישוב,329,151,178,13,316,167,317,9,5.56%
2015-05,חיפה,637,ערערה,יישוב,603,262,341,4,599,373,594,10,7.23%
2015-05,חיפה,537,פוריידיס,יישוב,398,187,211,4,394,267,395,3,6.92%
2015-05,חיפה,7800,פרדס חנה-כרכור,יישוב,847,405,442,154,693,245,841,12,4.12%
2015-05,חיפה,6800,קריית אתא,יישוב,1499,706,793,149,1350,809,1481,41,4.86%
2015-05,חיפה,9500,קריית ביאליק,יישוב,967,421,546,119,848,486,958,32,4.46%
2015-05,חיפה,2300,קריית טבעון,יישוב,178,89,89,63,115,37,175,0,2.09%
2015-05,חיפה,9600,קריית ים,יישוב,1391,649,742,141,1250,800,1370,39,6.37%
2015-05,חיפה,8200,קריית מוצקין,יישוב,977,407,570,145,832,447,956,30,4.14%
2015-05,חיפה,922,רכסים,יישוב,134,60,74,10,124,71,124,1,3.49%
2015-05,ירושלים,472,אבו גוש,יישוב,289,142,147,4,285,202,287,2,9.13%
2015-05,ירושלים,2610,בית שמש,יישוב,1222,556,666,77,1145,486,1189,67,3.52%
2015-05,ירושלים,3000,ירושלים,יישוב,12207,5576,6631,1368,10839,7537,12045,175,4.04%
2015-05,ירושלים,26,מ.א. מטה יהודה,מועצה איזורית,551,261,290,112,439,121,544,1,2.28%
2015-05,ירושלים,1015,מבשרת ציון,יישוב,372,184,188,76,296,137,368,8,2.82%
2015-05,ירושלים,1137,קריית יערים,יישוב,35,13,22,2,33,16,35,0,2.48%
2015-05,תל אביב,2400,אור יהודה,יישוב,736,366,370,57,679,201,711,42,3.72%
2015-05,תל אביב,565,אזור,יישוב,151,78,73,21,130,31,149,5,2.27%
2015-05,תל אביב,6100,בני ברק,יישוב,1934,961,973,83,1851,963,1844,34,3.21%
2015-05,תל אביב,6200,בת ים,יישוב,2903,1328,1575,393,2510,1060,2808,85,3.97%
2015-05,תל אביב,6300,גבעתיים,יישוב,718,302,416,323,395,86,716,9,2.32%
2015-05,תל אביב,6400,הרצלייה,יישוב,993,433,560,349,644,27,988,34,2.02%
2015-05,תל אביב,6600,חולון,יישוב,2818,1298,1520,445,2373,678,2785,61,2.81%
2015-05,תל אביב,267,כפר שמריהו,יישוב,11,5,6,6,5,0,11,0,1.30%
2015-05,תל אביב,2620,קריית אונו,יישוב,359,174,185,149,210,38,356,2,1.86%
2015-05,תל אביב,8600,רמת גן,יישוב,2060,953,1107,692,1368,421,2033,27,2.59%
2015-05,תל אביב,2650,רמת השרון,יישוב,364,125,239,168,196,8,363,9,1.63%
2015-05,תל אביב,5000,תל אביב -יפו,יישוב,7198,3539,3659,2429,4769,1943,7120,132,2.80%
2015-06,אזור יהודה והשומרון,3760,אורנית,יישוב,94,44,50,35,59,4,94,0,1.93%
2015-06,אזור יהודה והשומרון,3750,אלפי מנשה,יישוב,88,46,42,26,62,1,88,1,2.00%
2015-06,אזור יהודה והשומרון,3560,אלקנה,יישוב,31,18,13,10,21,1,31,0,1.64%
2015-06,אזור יהודה והשומרון,3650,אפרת,יישוב,53,29,24,19,34,2,53,2,1.23%
2015-06,אזור יהודה והשומרון,3570,אריאל,יישוב,299,143,156,67,232,55,299,10,2.77%
2015-06,אזור יהודה והשומרון,3574,בית אל,יישוב,53,28,25,14,39,16,53,0,2.18%
2015-06,אזור יהודה והשומרון,3652,בית אריה,יישוב,52,23,29,13,39,2,51,1,1.91%
2015-06,אזור יהודה והשומרון,3780,ביתר עילית,יישוב,601,292,309,10,591,298,596,5,4.45%
2015-06,אזור יהודה והשומרון,3730,גבעת זאב,יישוב,195,90,105,41,154,39,192,4,2.47%
2015-06,אזור יהודה והשומרון,3769,הר אדר,יישוב,30,13,17,18,12,5,30,0,1.42%
2015-06,אזור יהודה והשומרון,76,מ.א. גוש עציון,מועצה איזורית,152,86,66,59,93,18,151,0,1.57%
2015-06,אזור יהודה והשומרון,78,מ.א. הר חברון,מועצה איזורית,70,36,34,23,47,4,70,0,2.00%
2015-06,אזור יהודה והשומרון,74,מ.א. מגילות ים המלח,מועצה איזורית,15,7,8,5,10,2,15,0,1.88%
2015-06,אזור יהודה והשומרון,73,מ.א. מטה בנימין,מועצה איזורית,620,307,313,176,444,135,615,0,2.45%
2015-06,אזור יהודה והשומרון,75,מ.א. ערבות הירדן,מועצה איזורית,48,19,29,15,33,3,48,0,1.97%
2015-06,אזור יהודה והשומרון,72,מ.א. שומרון,מועצה איזורית,386,199,187,105,281,46,384,0,2.28%
2015-06,אזור יהודה והשומרון,3797,מודיעין עילית,יישוב,441,150,291,24,417,62,434,5,3.08%
2015-06,אזור יהודה והשומרון,3616,מעלה אדומים,יישוב,679,298,381,95,584,171,677,15,3.29%
2015-06,אזור יהודה והשומרון,3608,מעלה אפרים,יישוב,26,12,14,3,23,7,25,2,3.05%
2015-06,אזור יהודה והשומרון,3660,עמנואל,יישוב,57,35,22,2,55,41,56,1,4.76%
2015-06,אזור יהודה והשומרון,3557,קדומים,יישוב,31,16,15,15,16,6,31,1,1.65%
2015-06,אזור יהודה והשומרון,3611,קריית ארבע,יישוב,110,58,52,13,97,60,110,3,3.35%
2015-06,אזור יהודה והשומרון,3640,קרני שומרון,יישוב,70,36,34,17,53,11,70,2,1.85%
2015-06,הדרום,31,אופקים,יישוב,1141,492,649,58,1083,664,1125,37,8.29%
2015-06,הדרום,2600,אילת,יישוב,1205,560,645,63,1142,493,1166,55,3.44%
2015-06,הדרום,70,אשדוד,יישוב,6065,2596,3469,753,5312,2951,5895,173,5.34%
2015-06,הדרום,7100,אשקלון,יישוב,4081,1721,2360,438,3643,2037,3670,115,5.14%
2015-06,הדרום,9000,באר שבע,יישוב,6633,3014,3619,839,5794,3776,6438,172,6.01%
2015-06,הדרום,2200,דימונה,יישוב,1972,903,1069,103,1869,1286,1915,95,10.06%
2015-06,הדרום,1303,חורה,יישוב,759,330,429,2,757,677,754,1,17.58%
2015-06,הדרום,831,ירוחם,יישוב,395,204,191,19,376,237,378,30,7.81%
2015-06,הדרום,1059,כסיפה,יישוב,992,389,603,1,991,913,988,6,20.69%
2015-06,הדרום,1271,להבים,יישוב,42,21,21,20,22,4,42,2,1.16%
2015-06,הדרום,1060,לקיה,יישוב,881,411,470,5,876,805,876,3,19.57%
2015-06,הדרום,69,מ.א. אל קסום,מועצה איזורית,746,308,438,10,736,675,735,0,45.57%
2015-06,הדרום,38,מ.א. אשכול,מועצה איזורית,145,65,80,28,117,17,138,0,2.03%
2015-06,הדרום,33,מ.א. באר טוביה,מועצה איזורית,265,105,160,53,212,53,262,0,2.39%
2015-06,הדרום,41,מ.א. בני שמעון,מועצה איזורית,70,34,36,15,55,11,68,1,1.56%
2015-06,הדרום,54,מ.א. הערבה התיכונה,מועצה איזורית,44,21,23,9,35,3,44,0,2.43%
2015-06,הדרום,53,מ.א. חבל אילות,מועצה איזורית,14,9,5,3,11,0,14,1,0.59%
2015-06,הדרום,36,מ.א. חוף אשקלון,מועצה איזורית,219,98,121,27,192,53,214,0,2.59%
2015-06,הדרום,35,מ.א. יואב,מועצה איזורית,79,27,52,21,58,15,79,0,1.98%
2015-06,הדרום,50,מ.א. לכיש,מועצה איזורית,174,82,92,21,153,54,173,0,3.44%
2015-06,הדרום,42,מ.א. מרחבים,מועצה איזורית,174,77,97,30,144,44,173,0,2.93%
2015-06,הדרום,68,מ.א. נווה מדבר,מועצה איזורית,119,48,71,0,119,92,117,0,12.14%
2015-06,הדרום,48,מ.א. רמת נגב,מועצה איזורית,247,132,115,15,232,187,246,0,7.77%
2015-06,הדרום,39,מ.א. שדות נגב,מועצה איזורית,134,57,77,14,120,35,131,0,2.90%
2015-06,הדרום,37,מ.א. שער הנגב,מועצה איזורית,101,48,53,27,74,27,98,1,2.52%
2015-06,הדרום,34,מ.א. שפיר,מועצה איזורית,183,95,88,9,174,63,182,0,3.88%
2015-06,הדרום,51,מ.א. תמר,מועצה איזורית,16,8,8,3,13,3,16,0,2.53%
2015-06,הדרום,1268,מיתר,יישוב,73,33,40,27,46,8,73,1,1.63%
2015-06,הדרום,99,מצפה רמון,יישוב,277,116,161,12,265,179,270,18,9.70%
2015-06,הדרום,246,נתיבות,יישוב,995,439,556,45,950,487,961,49,6.46%
2015-06,הדרום,666,עומר,יישוב,50,13,37,21,29,4,49,0,1.16%
2015-06,הדרום,2560,ערד,יישוב,840,374,466,85,755,418,817,54,6.56%
2015-06,הדרום,1192,ערערה-בנגב,יישוב,1087,463,624,3,1084,994,1069,0,24.37%
2015-06,הדרום,2630,קריית גת,יישוב,1991,827,1164,122,1869,1045,1930,75,6.72%
2015-06,הדרום,1034,קריית מלאכי,יישוב,1054,472,582,21,1033,558,1022,82,8.57%
2015-06,הדרום,1161,רהט,יישוב,3127,1343,1784,6,3121,2552,3095,63,15.17%
2015-06,הדרום,1286,שגב-שלום,יישוב,549,200,349,1,548,431,545,4,18.41%
2015-06,הדרום,1031,שדרות,יישוב,1070,501,569,47,1023,597,1022,36,7.52%
2015-06,הדרום,1054,תל שבע,יישוב,1079,514,565,2,1077,985,1073,6,20.79%
2015-06,המרכז,1066,"בני עי""ש",יישוב,164,79,85,24,140,64,161,3,4.01%
2015-06,המרכז,182,אבן יהודה,יישוב,144,62,82,33,111,14,144,1,2.09%
2015-06,המרכז,41,אליכין,יישוב,65,36,29,7,58,17,64,1,3.30%
2015-06,המרכז,1309,אלעד,יישוב,371,179,192,18,353,59,364,4,2.80%
2015-06,המרכז,2530,באר יעקב,יישוב,241,98,143,43,198,55,236,7,2.36%
2015-06,המרכז,466,בית דגן,יישוב,101,57,44,10,91,35,100,0,2.69%
2015-06,המרכז,681,גבעת שמואל,יישוב,262,129,133,93,169,59,253,5,2.09%
2015-06,המרכז,2550,גדרה,יישוב,348,151,197,83,265,94,343,9,2.74%
2015-06,המרכז,627,ג'לג'וליה,יישוב,92,39,53,3,89,59,91,1,2.41%
2015-06,המרכז,166,גן יבנה,יישוב,346,140,206,51,295,79,341,4,2.81%
2015-06,המרכז,229,גני תקווה,יישוב,193,73,120,67,126,29,193,1,2.14%
2015-06,המרכז,9700,הוד השרון,יישוב,581,264,317,228,353,47,573,10,1.85%
2015-06,המרכז,1290,זמר,יישוב,143,44,99,1,142,101,142,4,4.78%
2015-06,המרכז,2730,טייבה,יישוב,1440,636,804,26,1414,1186,1320,43,7.42%
2015-06,המרכז,2720,טירה,יישוב,254,116,138,13,241,120,247,15,2.15%
2015-06,המרכז,2660,יבנה,יישוב,885,420,465,120,765,273,880,35,3.58%
2015-06,המרכז,9400,יהוד,יישוב,379,173,206,54,325,56,372,10,2.31%
2015-06,המרכז,1224,כוכב יאיר,יישוב,94,42,52,49,45,0,94,0,1.63%
2015-06,המרכז,633,כפר ברא,יישוב,34,15,19,1,33,16,33,1,2.29%
2015-06,המרכז,168,כפר יונה,יישוב,294,132,162,46,248,48,294,4,2.61%
2015-06,המרכז,6900,כפר סבא,יישוב,1145,530,615,389,756,144,1130,26,2.13%
2015-06,המרכז,634,כפר קאסם,יישוב,212,94,118,5,207,112,206,2,2.24%
2015-06,המרכז,7000,לוד,יישוב,1942,942,1000,159,1783,1073,1915,68,5.38%
2015-06,המרכז,28,מ.א. ברנר,מועצה איזורית,68,38,30,23,45,5,67,6,1.65%
2015-06,המרכז,32,מ.א. גדרות,מועצה איזורית,45,16,29,18,27,4,45,0,1.84%
2015-06,המרכז,30,מ.א. גזר,מועצה איזורית,236,104,132,93,143,25,234,0,1.77%
2015-06,המרכז,27,מ.א. גן רווה,מועצה איזורית,50,25,25,16,34,4,50,1,1.71%
2015-06,המרכז,20,מ.א. דרום השרון,מועצה איזורית,301,138,163,114,187,16,300,0,1.91%
2015-06,המרכז,29,מ.א. חבל יבנה,מועצה איזורית,37,19,18,13,24,3,37,0,1.49%
2015-06,המרכז,25,מ.א. חבל מודיעין,מועצה איזורית,265,115,150,84,181,15,263,0,2.45%
2015-06,המרכז,19,מ.א. חוף השרון,מועצה איזורית,100,52,48,42,58,4,100,0,1.78%
2015-06,המרכז,18,מ.א. לב השרון,מועצה איזורית,240,123,117,54,186,29,240,1,2.18%
2015-06,המרכז,31,מ.א. נחל שורק,מועצה איזורית,53,27,26,9,44,3,53,37,1.23%
2015-06,המרכז,16,מ.א. עמק חפר,מועצה איזורית,370,165,205,113,257,19,369,0,1.88%
2015-06,המרכז,40,מ.א. עמק לוד,מועצה איזורית,137,63,74,34,103,19,136,0,2.20%
2015-06,המרכז,1200,מודיעין-מכבים-רעות*,יישוב,910,385,525,345,565,64,902,19,2.00%
2015-06,המרכז,28,מזכרת בתיה,יישוב,162,80,82,46,116,31,162,6,2.15%
2015-06,המרכז,7200,נס ציונה,יישוב,598,279,319,161,437,177,593,4,2.48%
2015-06,המרכז,7400,נתניה,יישוב,4113,1910,2203,469,3644,1372,4037,122,3.82%
2015-06,המרכז,587,סביון*,יישוב,15,6,9,7,8,0,15,0,0.76%
2015-06,המרכז,171,פרדסייה,יישוב,78,33,45,8,70,7,78,1,2.05%
2015-06,המרכז,7900,פתח תקווה,יישוב,3859,1707,2152,837,3022,993,3799,47,3.01%
2015-06,המרכז,195,קדימה-צורן,יישוב,268,97,171,55,213,37,265,4,2.38%
2015-06,המרכז,638,קלנסווה,יישוב,569,254,315,5,564,465,535,15,6.01%
2015-06,המרכז,469,קריית עקרון,יישוב,246,123,123,12,234,115,245,8,4.06%
2015-06,המרכז,2640,ראש העין,יישוב,701,324,377,69,632,150,697,23,2.75%
2015-06,המרכז,8300,ראשון לציון,יישוב,4254,1874,2380,798,3456,1248,4217,78,3.02%
2015-06,המרכז,8400,רחובות,יישוב,2349,1092,1257,496,1853,886,2305,59,3.34%
2015-06,המרכז,8500,רמלה,יישוב,1625,751,874,108,1517,687,1577,62,4.17%
2015-06,המרכז,8700,רעננה,יישוב,744,348,396,289,455,63,738,7,1.99%
2015-06,המרכז,1304,שוהם,יישוב,178,81,97,78,100,7,178,1,1.53%
2015-06,המרכז,154,תל מונד,יישוב,143,78,65,37,106,21,143,1,2.22%
2015-06,הצפון,473,אבו סנאן,יישוב,646,268,378,8,638,486,638,17,10.68%
2015-06,הצפון,478,אכסאל,יישוב,551,263,288,12,539,460,536,3,9.24%
2015-06,הצפון,529,אעבלין,יישוב,562,234,328,10,552,468,560,9,9.55%
2015-06,הצפון,482,בועיינה-נוג'ידאת,יישוב,398,170,228,8,390,316,385,11,9.78%
2015-06,הצפון,4001,בוקעאתא,יישוב,419,164,255,5,414,325,391,3,14.01%
2015-06,הצפון,998,ביר אל-מכסור,יישוב,421,157,264,3,418,322,416,7,10.60%
2015-06,הצפון,480,בית ג'ן,יישוב,402,123,279,9,393,283,396,4,7.01%
2015-06,הצפון,9200,בית שאן,יישוב,805,358,447,18,787,388,789,48,7.64%
2015-06,הצפון,944,בסמת טבעון,יישוב,223,104,119,2,221,159,215,0,6.49%
2015-06,הצפון,483,בענה,יישוב,339,146,193,10,329,280,336,9,9.74%
2015-06,הצפון,1292,ג'דיידה-מכר,יישוב,1281,560,721,4,1277,1021,1267,37,13.33%
2015-06,הצפון,485,ג'ולס,יישוב,206,67,139,2,204,150,205,4,6.60%
2015-06,הצפון,487,ג'ש (גוש חלב),יישוב,78,36,42,3,75,43,75,4,4.49%
2015-06,הצפון,489,דבורייה,יישוב,380,170,210,24,356,260,379,5,8.69%
2015-06,הצפון,490,דייר אל-אסד,יישוב,369,164,205,7,362,299,365,5,6.94%
2015-06,הצפון,492,דייר חנא,יישוב,653,286,367,8,645,516,646,4,13.10%
2015-06,הצפון,975,זרזיר,יישוב,272,125,147,2,270,185,268,2,8.07%
2015-06,הצפון,496,חורפיש,יישוב,115,49,66,7,108,67,114,1,3.97%
2015-06,הצפון,2034,חצור הגלילית,יישוב,270,111,159,15,255,127,262,14,5.34%
2015-06,הצפון,6700,טבריה,יישוב,1588,748,840,75,1513,890,1402,59,6.38%
2015-06,הצפון,962,טובא-זנגרייה,יישוב,393,176,217,6,387,246,387,4,12.53%
2015-06,הצפון,498,טורעאן,יישוב,496,204,292,11,485,414,470,8,8.14%
2015-06,הצפון,8900,טמרה,יישוב,1850,816,1034,18,1832,1582,1836,13,12.59%
2015-06,הצפון,1295,יאנוח-ג'ת,יישוב,160,58,102,7,153,95,156,4,5.29%
2015-06,הצפון,46,יבנאל,יישוב,103,62,41,4,99,80,79,1,5.03%
2015-06,הצפון,29,יסוד המעלה,יישוב,20,6,14,5,15,3,19,0,2.21%
2015-06,הצפון,499,יפיע,יישוב,646,287,359,24,622,508,626,4,7.81%
2015-06,הצפון,240,יקנעם עילית,יישוב,424,176,248,60,364,133,420,27,3.46%
2015-06,הצפון,502,ירכא,יישוב,585,246,339,0,585,435,579,6,8.86%
2015-06,הצפון,504,כאבול,יישוב,647,283,364,10,637,551,644,2,12.69%
2015-06,הצפון,505,כאוכב אבו אל-היג'א,יישוב,223,94,129,8,215,184,222,3,12.67%
2015-06,הצפון,1296,כסרא-סמיע,יישוב,227,96,131,8,219,144,217,5,6.13%
2015-06,הצפון,978,כעביה-טבאש-חג'אג'רה,יישוב,196,77,119,5,191,131,192,1,8.06%
2015-06,הצפון,1263,כפר ורדים,יישוב,54,26,28,25,29,7,54,0,1.76%
2015-06,הצפון,507,כפר יאסיף,יישוב,423,194,229,3,420,313,416,11,8.11%
2015-06,הצפון,508,כפר כמא,יישוב,54,24,30,2,52,26,52,0,3.08%
2015-06,הצפון,509,כפר כנא,יישוב,1119,479,640,22,1097,922,1057,21,11.81%
2015-06,הצפון,510,כפר מנדא,יישוב,995,469,526,8,987,717,958,3,12.83%
2015-06,הצפון,47,כפר תבור,יישוב,47,16,31,16,31,1,47,0,2.05%
2015-06,הצפון,1139,כרמיאל,יישוב,1515,640,875,252,1263,763,1459,53,5.58%
2015-06,הצפון,65,מ.א. אל-בטוף,מועצה איזורית,359,146,213,6,353,289,345,1,11.86%
2015-06,הצפון,66,מ.א. בוסתן אל-מרג',מועצה איזורית,45,16,29,2,43,35,44,0,1.43%
2015-06,הצפון,71,מ.א. גולן,מועצה איזורית,152,63,89,25,127,15,150,0,1.74%
2015-06,הצפון,8,מ.א. הגלבוע,מועצה איזורית,803,323,480,69,734,474,795,0,5.51%
2015-06,הצפון,1,מ.א. הגליל העליון,מועצה איזורית,155,78,77,38,117,19,155,0,1.76%
2015-06,הצפון,3,מ.א. הגליל התחתון,מועצה איזורית,110,41,69,25,85,14,104,0,1.78%
2015-06,הצפון,55,מ.א. מבואות החרמון,מועצה איזורית,86,35,51,15,71,14,86,0,2.15%
2015-06,הצפון,13,מ.א. מגידו,מועצה איזורית,95,34,61,33,62,5,94,0,1.66%
2015-06,הצפון,4,מ.א. מטה אשר,מועצה איזורית,418,176,242,60,358,169,416,0,3.03%
2015-06,הצפון,52,מ.א. מעלה יוסף,מועצה איזורית,142,64,78,19,123,51,140,0,2.54%
2015-06,הצפון,2,מ.א. מרום הגליל,מועצה איזורית,275,127,148,25,250,121,271,0,3.97%
2015-06,הצפון,56,מ.א. משגב,מועצה איזורית,494,201,293,77,417,273,485,0,3.73%
2015-06,הצפון,6,מ.א. עמק הירדן,מועצה איזורית,145,53,92,29,116,32,135,0,2.00%
2015-06,הצפון,7,מ.א. עמק המעיינות,מועצה איזורית,155,66,89,26,129,40,153,1,2.36%
2015-06,הצפון,9,מ.א. עמק יזרעאל,מועצה איזורית,333,130,203,146,187,36,332,0,1.72%
2015-06,הצפון,481,מגאר,יישוב,1489,601,888,17,1472,1257,1467,15,14.61%
2015-06,הצפון,516,מג'ד אל-כרום,יישוב,522,234,288,10,512,370,519,15,7.73%
2015-06,הצפון,65,מגדל,יישוב,43,13,30,6,37,14,40,1,4.20%
2015-06,הצפון,874,מגדל העמק,יישוב,872,410,462,68,804,345,846,87,6.18%
2015-06,הצפון,4201,מג'דל שמס,יישוב,476,167,309,11,465,360,445,7,9.00%
2015-06,הצפון,517,מזרעה,יישוב,178,68,110,1,177,138,172,10,8.57%
2015-06,הצפון,43,מטולה,יישוב,25,16,9,5,20,6,25,1,2.39%
2015-06,הצפון,4203,מסעדה,יישוב,220,88,132,5,215,160,213,11,12.37%
2015-06,הצפון,518,מעיליא,יישוב,42,23,19,5,37,20,42,1,2.61%
2015-06,הצפון,1063,מעלות-תרשיחא,יישוב,786,384,402,96,690,433,773,33,6.53%
2015-06,הצפון,520,משהד,יישוב,280,110,170,4,276,220,270,3,8.25%
2015-06,הצפון,9100,נהרייה,יישוב,1817,848,969,187,1630,1043,1776,68,5.72%
2015-06,הצפון,522,נחף,יישוב,389,184,205,12,377,308,386,11,7.57%
2015-06,הצפון,7300,נצרת,יישוב,3293,1499,1794,107,3186,2565,3192,38,9.15%
2015-06,הצפון,1061,נצרת עילית,יישוב,1682,747,935,143,1539,887,1542,106,6.59%
2015-06,הצפון,525,סאג'ור,יישוב,111,33,78,4,107,70,110,0,5.56%
2015-06,הצפון,7500,סח'נין,יישוב,2139,907,1232,17,2122,1825,2123,10,14.84%
2015-06,הצפון,4501,ע'ג'ר,יישוב,110,38,72,1,109,59,110,0,10.19%
2015-06,הצפון,530,עיילבון,יישוב,168,70,98,5,163,122,168,2,6.05%
2015-06,הצפון,511,עילוט,יישוב,335,142,193,7,328,265,327,1,11.27%
2015-06,הצפון,532,עין מאהל,יישוב,489,233,256,4,485,407,474,4,8.91%
2015-06,הצפון,4502,עין קנייא,יישוב,151,62,89,2,149,125,145,3,14.00%
2015-06,הצפון,7600,עכו,יישוב,3082,1405,1677,113,2969,2260,3012,76,11.24%
2015-06,הצפון,7700,עפולה,יישוב,1562,675,887,155,1407,693,1532,94,5.97%
2015-06,הצפון,531,עראבה,יישוב,1575,660,915,28,1547,1354,1556,10,14.97%
2015-06,הצפון,535,פסוטה,יישוב,108,49,59,6,102,66,106,1,6.10%
2015-06,הצפון,536,פקיעין (בוקייעה),יישוב,124,71,53,7,117,77,123,3,4.36%
2015-06,הצפון,8000,צפת,יישוב,1351,752,599,84,1267,1001,1288,29,9.41%
2015-06,הצפון,4100,קצרין,יישוב,181,86,95,27,154,81,177,4,4.41%
2015-06,הצפון,2800,קריית שמונה,יישוב,686,323,363,51,635,310,664,47,5.08%
2015-06,הצפון,543,ראמה,יישוב,278,115,163,13,265,204,274,5,6.97%
2015-06,הצפון,26,ראש פינה,יישוב,39,15,24,9,30,14,39,3,2.44%
2015-06,הצפון,542,ריינה,יישוב,632,271,361,14,618,495,609,8,8.78%
2015-06,הצפון,122,רמת ישי,יישוב,100,46,54,32,68,14,99,2,2.37%
2015-06,הצפון,913,שבלי - אום אל-גנם,יישוב,215,101,114,6,209,142,213,2,7.98%
2015-06,הצפון,812,שלומי,יישוב,213,91,122,12,201,109,207,8,5.74%
2015-06,הצפון,538,שעב,יישוב,530,211,319,4,526,469,526,5,16.86%
2015-06,הצפון,8800,שפרעם,יישוב,1922,763,1159,26,1896,1533,1913,54,10.34%
2015-06,חיפה,1326,"בסמ""ה",יישוב,411,185,226,3,408,315,407,5,9.96%
2015-06,חיפה,2710,אום אל-פחם,יישוב,3581,1501,2080,24,3557,2992,3515,41,16.17%
2015-06,חיפה,1020,אור עקיבא,יישוב,513,229,284,45,468,182,496,20,4.85%
2015-06,חיפה,6000,באקה אל-גרביה,יישוב,621,295,326,12,609,354,617,23,5.23%
2015-06,חיפה,9800,בנימינה-גבעת עדה*,יישוב,188,91,97,49,139,63,188,1,2.58%
2015-06,חיפה,541,ג'סר א-זרקא,יישוב,487,243,244,2,485,306,487,7,7.92%
2015-06,חיפה,628,ג'ת,יישוב,203,100,103,6,197,124,203,4,3.84%
2015-06,חיפה,494,דאלית אל-כרמל,יישוב,479,197,282,12,467,269,463,7,5.57%
2015-06,חיפה,9300,זכרון יעקב,יישוב,246,116,130,77,169,48,246,6,2.21%
2015-06,חיפה,6500,חדרה,יישוב,2294,940,1354,285,2009,829,2178,79,4.32%
2015-06,חיפה,4000,חיפה,יישוב,6235,3043,3192,1209,5026,3288,5946,178,4.24%
2015-06,חיפה,1247,חריש,יישוב,29,18,11,5,24,10,27,0,1.69%
2015-06,חיפה,2100,טירת כרמל,יישוב,729,371,358,32,697,410,706,25,6.22%
2015-06,חיפה,654,כפר קרע,יישוב,404,169,235,7,397,245,400,9,4.66%
2015-06,חיפה,45,מ.א. אלונה,מועצה איזורית,22,8,14,8,14,4,22,0,2.06%
2015-06,חיפה,12,מ.א. זבולון,מועצה איזורית,261,120,141,27,234,180,257,0,4.61%
2015-06,חיפה,15,מ.א. חוף הכרמל,מועצה איזורית,290,128,162,72,218,69,282,0,1.99%
2015-06,חיפה,14,מ.א. מנשה,מועצה איזורית,263,112,151,60,203,71,260,0,3.24%
2015-06,חיפה,1327,מעלה עירון,יישוב,893,349,544,6,887,736,879,11,14.54%
2015-06,חיפה,2500,נשר,יישוב,473,244,229,86,387,183,461,14,3.58%
2015-06,חיפה,534,עספיא,יישוב,322,152,170,10,312,167,313,7,5.49%
2015-06,חיפה,637,ערערה,יישוב,594,257,337,3,591,377,582,4,7.09%
2015-06,חיפה,537,פוריידיס,יישוב,404,184,220,8,396,268,399,0,6.98%
2015-06,חיפה,7800,פרדס חנה-כרכור,יישוב,835,395,440,158,677,243,827,25,4.05%
2015-06,חיפה,6800,קריית אתא,יישוב,1552,716,836,135,1417,840,1509,52,4.94%
2015-06,חיפה,9500,קריית ביאליק,יישוב,1013,424,589,129,884,488,999,35,4.64%
2015-06,חיפה,2300,קריית טבעון,יישוב,180,90,90,67,113,40,177,1,2.12%
2015-06,חיפה,9600,קריית ים,יישוב,1477,674,803,153,1324,845,1422,43,6.60%
2015-06,חיפה,8200,קריית מוצקין,יישוב,995,424,571,150,845,470,968,25,4.19%
2015-06,חיפה,922,רכסים,יישוב,152,68,84,9,143,84,135,1,3.79%
2015-06,ירושלים,472,אבו גוש,יישוב,271,137,134,5,266,190,271,5,8.66%
2015-06,ירושלים,2610,בית שמש,יישוב,1227,559,668,86,1141,496,1182,49,3.50%
2015-06,ירושלים,3000,ירושלים,יישוב,12223,5565,6658,1363,10860,7578,12048,150,4.04%
2015-06,ירושלים,26,מ.א. מטה יהודה,מועצה איזורית,580,285,295,107,473,123,569,3,2.38%
2015-06,ירושלים,1015,מבשרת ציון,יישוב,365,178,187,82,283,139,359,5,2.76%
2015-06,ירושלים,1137,קריית יערים,יישוב,34,12,22,3,31,14,34,0,2.41%
2015-06,תל אביב,2400,אור יהודה,יישוב,729,377,352,46,683,209,706,36,3.70%
2015-06,תל אביב,565,אזור,יישוב,170,85,85,20,150,30,170,6,2.59%
2015-06,תל אביב,6100,בני ברק,יישוב,1904,933,971,88,1816,927,1815,31,3.16%
2015-06,תל אביב,6200,בת ים,יישוב,2846,1338,1508,383,2463,1048,2743,88,3.89%
2015-06,תל אביב,6300,גבעתיים,יישוב,700,307,393,303,397,89,697,4,2.26%
2015-06,תל אביב,6400,הרצלייה,יישוב,986,409,577,358,628,35,979,47,2.00%
2015-06,תל אביב,6600,חולון,יישוב,2910,1339,1571,441,2469,695,2852,72,2.87%
2015-06,תל אביב,267,כפר שמריהו,יישוב,9,4,5,5,4,0,9,0,1.07%
2015-06,תל אביב,2620,קריית אונו,יישוב,361,162,199,158,203,39,359,6,1.88%
2015-06,תל אביב,8600,רמת גן,יישוב,2018,938,1080,703,1315,409,1992,35,2.53%
2015-06,תל אביב,2650,רמת השרון,יישוב,345,127,218,158,187,8,341,4,1.53%
2015-06,תל אביב,5000,תל אביב -יפו,יישוב,7174,3561,3613,2336,4838,1978,7091,125,2.79%
2015-07,אזור יהודה והשומרון,3760,אורנית,יישוב,98,43,55,35,63,4,98,0,2.01%
2015-07,אזור יהודה והשומרון,3750,אלפי מנשה,יישוב,92,39,53,28,64,1,92,1,2.09%
2015-07,אזור יהודה והשומרון,3560,אלקנה,יישוב,30,17,13,9,21,1,30,0,1.58%
2015-07,אזור יהודה והשומרון,3650,אפרת,יישוב,54,31,23,20,34,2,52,2,1.21%
2015-07,אזור יהודה והשומרון,3570,אריאל,יישוב,317,150,167,76,241,57,316,2,2.92%
2015-07,אזור יהודה והשומרון,3574,בית אל,יישוב,66,38,28,15,51,16,66,0,2.69%
2015-07,אזור יהודה והשומרון,3652,בית אריה,יישוב,59,22,37,15,44,2,58,1,2.16%
2015-07,אזור יהודה והשומרון,3780,ביתר עילית,יישוב,803,328,475,15,788,306,797,5,5.86%
2015-07,אזור יהודה והשומרון,3730,גבעת זאב,יישוב,217,93,124,48,169,44,211,1,2.71%
2015-07,אזור יהודה והשומרון,3769,הר אדר,יישוב,35,16,19,20,15,5,35,0,1.65%
2015-07,אזור יהודה והשומרון,76,מ.א. גוש עציון,מועצה איזורית,156,85,71,62,94,17,155,0,1.61%
2015-07,אזור יהודה והשומרון,78,מ.א. הר חברון,מועצה איזורית,76,37,39,23,53,4,76,0,2.17%
2015-07,אזור יהודה והשומרון,74,מ.א. מגילות ים המלח,מועצה איזורית,14,6,8,4,10,1,14,0,1.75%
2015-07,אזור יהודה והשומרון,73,מ.א. מטה בנימין,מועצה איזורית,680,322,358,176,504,145,670,0,2.67%
2015-07,אזור יהודה והשומרון,75,מ.א. ערבות הירדן,מועצה איזורית,47,20,27,11,36,5,47,0,1.93%
2015-07,אזור יהודה והשומרון,72,מ.א. שומרון,מועצה איזורית,401,205,196,117,284,52,395,0,2.34%
2015-07,אזור יהודה והשומרון,3797,מודיעין עילית,יישוב,754,161,593,24,730,62,749,1,5.20%
2015-07,אזור יהודה והשומרון,3616,מעלה אדומים,יישוב,737,299,438,95,642,176,731,21,3.54%
2015-07,אזור יהודה והשומרון,3608,מעלה אפרים,יישוב,22,9,13,3,19,8,22,0,2.69%
2015-07,אזור יהודה והשומרון,3660,עמנואל,יישוב,81,48,33,3,78,42,81,0,6.74%
2015-07,אזור יהודה והשומרון,3557,קדומים,יישוב,43,28,15,18,25,5,43,0,2.28%
2015-07,אזור יהודה והשומרון,3611,קריית ארבע,יישוב,119,65,54,12,107,58,119,1,3.61%
2015-07,אזור יהודה והשומרון,3640,קרני שומרון,יישוב,76,40,36,21,55,11,75,0,1.98%
2015-07,הדרום,31,אופקים,יישוב,1278,519,759,61,1217,655,1246,30,9.10%
2015-07,הדרום,2600,אילת,יישוב,1253,576,677,68,1185,490,1216,57,3.58%
2015-07,הדרום,70,אשדוד,יישוב,6564,2655,3909,783,5781,2878,6379,186,5.75%
2015-07,הדרום,7100,אשקלון,יישוב,4336,1771,2565,443,3893,2061,3895,116,5.44%
2015-07,הדרום,9000,באר שבע,יישוב,6772,3001,3771,852,5920,3706,6543,166,6.10%
2015-07,הדרום,2200,דימונה,יישוב,2070,887,1183,107,1963,1321,1998,61,10.45%
2015-07,הדרום,1303,חורה,יישוב,750,322,428,2,748,666,744,1,17.39%
2015-07,הדרום,831,ירוחם,יישוב,430,207,223,18,412,242,406,21,8.34%
2015-07,הדרום,1059,כסיפה,יישוב,1006,386,620,1,1005,905,1001,4,20.90%
2015-07,הדרום,1271,להבים,יישוב,39,22,17,18,21,4,39,0,1.08%
2015-07,הדרום,1060,לקיה,יישוב,868,393,475,3,865,778,862,1,19.31%
2015-07,הדרום,69,מ.א. אל קסום,מועצה איזורית,763,309,454,9,754,670,759,0,47.06%
2015-07,הדרום,38,מ.א. אשכול,מועצה איזורית,141,59,82,32,109,14,139,0,2.04%
2015-07,הדרום,33,מ.א. באר טוביה,מועצה איזורית,308,109,199,53,255,53,306,0,2.79%
2015-07,הדרום,41,מ.א. בני שמעון,מועצה איזורית,80,33,47,23,57,14,78,3,1.78%
2015-07,הדרום,54,מ.א. הערבה התיכונה,מועצה איזורית,36,15,21,6,30,3,35,0,1.93%
2015-07,הדרום,53,מ.א. חבל אילות,מועצה איזורית,16,10,6,4,12,0,16,1,0.68%
2015-07,הדרום,36,מ.א. חוף אשקלון,מועצה איזורית,254,101,153,33,221,55,247,0,2.98%
2015-07,הדרום,35,מ.א. יואב,מועצה איזורית,78,28,50,25,53,14,78,0,1.96%
2015-07,הדרום,50,מ.א. לכיש,מועצה איזורית,196,85,111,22,174,56,193,0,3.84%
2015-07,הדרום,42,מ.א. מרחבים,מועצה איזורית,211,82,129,32,179,44,209,0,3.54%
2015-07,הדרום,68,מ.א. נווה מדבר,מועצה איזורית,121,51,70,1,120,94,119,0,12.34%
2015-07,הדרום,48,מ.א. רמת נגב,מועצה איזורית,256,134,122,12,244,195,255,0,8.06%
2015-07,הדרום,39,מ.א. שדות נגב,מועצה איזורית,152,58,94,21,131,32,146,0,3.23%
2015-07,הדרום,37,מ.א. שער הנגב,מועצה איזורית,130,59,71,34,96,33,124,0,3.19%
2015-07,הדרום,34,מ.א. שפיר,מועצה איזורית,207,106,101,13,194,64,203,0,4.32%
2015-07,הדרום,51,מ.א. תמר,מועצה איזורית,13,5,8,2,11,3,13,0,2.05%
2015-07,הדרום,1268,מיתר,יישוב,77,30,47,28,49,9,76,1,1.70%
2015-07,הדרום,99,מצפה רמון,יישוב,283,115,168,15,268,169,273,15,9.80%
2015-07,הדרום,246,נתיבות,יישוב,1208,480,728,58,1150,501,1170,48,7.76%
2015-07,הדרום,666,עומר,יישוב,57,16,41,23,34,4,56,0,1.33%
2015-07,הדרום,2560,ערד,יישוב,842,360,482,88,754,409,820,50,6.58%
2015-07,הדרום,1192,ערערה-בנגב,יישוב,1077,454,623,3,1074,994,1061,1,24.23%
2015-07,הדרום,2630,קריית גת,יישוב,2087,854,1233,117,1970,1047,2019,60,7.01%
2015-07,הדרום,1034,קריית מלאכי,יישוב,1081,486,595,25,1056,542,1050,74,8.79%
2015-07,הדרום,1161,רהט,יישוב,3082,1292,1790,12,3070,2515,3046,45,14.96%
2015-07,הדרום,1286,שגב-שלום,יישוב,529,190,339,1,528,429,522,2,17.77%
2015-07,הדרום,1031,שדרות,יישוב,1127,506,621,55,1072,593,1076,38,7.89%
2015-07,הדרום,1054,תל שבע,יישוב,1088,500,588,4,1084,986,1080,5,20.89%
2015-07,המרכז,1066,"בני עי""ש",יישוב,156,68,88,25,131,66,154,1,3.84%
2015-07,המרכז,182,אבן יהודה,יישוב,154,69,85,39,115,16,153,0,2.22%
2015-07,המרכז,41,אליכין,יישוב,83,42,41,8,75,15,82,3,4.19%
2015-07,המרכז,1309,אלעד,יישוב,560,224,336,19,541,58,555,2,4.21%
2015-07,המרכז,2530,באר יעקב,יישוב,233,104,129,43,190,46,230,6,2.30%
2015-07,המרכז,466,בית דגן,יישוב,108,69,39,11,97,33,107,2,2.87%
2015-07,המרכז,681,גבעת שמואל,יישוב,281,135,146,94,187,56,277,1,2.28%
2015-07,המרכז,2550,גדרה,יישוב,365,148,217,76,289,98,361,15,2.88%
2015-07,המרכז,627,ג'לג'וליה,יישוב,101,43,58,1,100,60,99,0,2.61%
2015-07,המרכז,166,גן יבנה,יישוב,383,144,239,67,316,77,377,4,3.10%
2015-07,המרכז,229,גני תקווה,יישוב,208,84,124,70,138,28,207,0,2.29%
2015-07,המרכז,9700,הוד השרון,יישוב,640,282,358,236,404,47,636,6,2.05%
2015-07,המרכז,1290,זמר,יישוב,136,44,92,1,135,93,135,0,4.56%
2015-07,המרכז,2730,טייבה,יישוב,1409,625,784,27,1382,1143,1266,38,7.14%
2015-07,המרכז,2720,טירה,יישוב,253,121,132,13,240,114,247,9,2.15%
2015-07,המרכז,2660,יבנה,יישוב,941,431,510,140,801,280,932,23,3.78%
2015-07,המרכז,9400,יהוד,יישוב,412,197,215,60,352,60,403,5,2.50%
2015-07,המרכז,1224,כוכב יאיר,יישוב,95,41,54,45,50,1,95,2,1.65%
2015-07,המרכז,633,כפר ברא,יישוב,34,18,16,0,34,15,34,0,2.36%
2015-07,המרכז,168,כפר יונה,יישוב,340,147,193,46,294,53,337,3,2.98%
2015-07,המרכז,6900,כפר סבא,יישוב,1215,552,663,402,813,141,1201,18,2.26%
2015-07,המרכז,634,כפר קאסם,יישוב,238,106,132,4,234,119,234,2,2.53%
2015-07,המרכז,7000,לוד,יישוב,2040,936,1104,177,1863,1051,2003,55,5.61%
2015-07,המרכז,28,מ.א. ברנר,מועצה איזורית,80,41,39,29,51,5,79,1,1.94%
2015-07,המרכז,32,מ.א. גדרות,מועצה איזורית,42,15,27,19,23,5,42,0,1.71%
2015-07,המרכז,30,מ.א. גזר,מועצה איזורית,264,111,153,91,173,23,261,0,1.98%
2015-07,המרכז,27,מ.א. גן רווה,מועצה איזורית,56,32,24,19,37,3,56,1,1.91%
2015-07,המרכז,20,מ.א. דרום השרון,מועצה איזורית,319,136,183,125,194,15,317,0,2.02%
2015-07,המרכז,29,מ.א. חבל יבנה,מועצה איזורית,45,18,27,16,29,4,45,1,1.81%
2015-07,המרכז,25,מ.א. חבל מודיעין,מועצה איזורית,261,113,148,81,180,17,260,0,2.42%
2015-07,המרכז,19,מ.א. חוף השרון,מועצה איזורית,114,55,59,44,70,7,114,0,2.03%
2015-07,המרכז,18,מ.א. לב השרון,מועצה איזורית,258,121,137,49,209,31,258,0,2.34%
2015-07,המרכז,31,מ.א. נחל שורק,מועצה איזורית,47,23,24,7,40,5,47,30,1.06%
2015-07,המרכז,16,מ.א. עמק חפר,מועצה איזורית,383,152,231,116,267,15,382,0,1.94%
2015-07,המרכז,40,מ.א. עמק לוד,מועצה איזורית,132,59,73,34,98,17,132,0,2.14%
2015-07,המרכז,1200,מודיעין-מכבים-רעות*,יישוב,974,392,582,333,641,65,966,18,2.14%
2015-07,המרכז,28,מזכרת בתיה,יישוב,178,78,100,43,135,35,176,1,2.34%
2015-07,המרכז,7200,נס ציונה,יישוב,654,293,361,161,493,178,648,12,2.70%
2015-07,המרכז,7400,נתניה,יישוב,4444,1951,2493,483,3961,1377,4344,89,4.10%
2015-07,המרכז,587,סביון*,יישוב,17,10,7,8,9,0,17,0,0.86%
2015-07,המרכז,171,פרדסייה,יישוב,73,30,43,11,62,6,73,0,1.92%
2015-07,המרכז,7900,פתח תקווה,יישוב,4109,1782,2327,845,3264,1011,4030,51,3.19%
2015-07,המרכז,195,קדימה-צורן,יישוב,297,100,197,67,230,36,293,2,2.62%
2015-07,המרכז,638,קלנסווה,יישוב,545,252,293,4,541,444,500,14,5.64%
2015-07,המרכז,469,קריית עקרון,יישוב,282,135,147,12,270,121,276,6,4.55%
2015-07,המרכז,2640,ראש העין,יישוב,768,351,417,74,694,145,764,27,3.01%
2015-07,המרכז,8300,ראשון לציון,יישוב,4492,1933,2559,829,3663,1218,4457,94,3.19%
2015-07,המרכז,8400,רחובות,יישוב,2630,1120,1510,537,2093,882,2578,50,3.72%
2015-07,המרכז,8500,רמלה,יישוב,1786,809,977,116,1670,691,1715,56,4.52%
2015-07,המרכז,8700,רעננה,יישוב,778,333,445,287,491,59,771,8,2.08%
2015-07,המרכז,1304,שוהם,יישוב,191,81,110,83,108,8,190,1,1.63%
2015-07,המרכז,154,תל מונד,יישוב,155,79,76,43,112,21,153,0,2.37%
2015-07,הצפון,473,אבו סנאן,יישוב,641,260,381,9,632,486,630,17,10.56%
2015-07,הצפון,478,אכסאל,יישוב,551,252,299,11,540,454,538,8,9.27%
2015-07,הצפון,529,אעבלין,יישוב,560,225,335,12,548,460,555,14,9.48%
2015-07,הצפון,482,בועיינה-נוג'ידאת,יישוב,388,170,218,8,380,317,375,14,9.55%
2015-07,הצפון,4001,בוקעאתא,יישוב,380,141,239,3,377,317,360,0,13.04%
2015-07,הצפון,998,ביר אל-מכסור,יישוב,406,155,251,3,403,318,404,0,10.33%
2015-07,הצפון,480,בית ג'ן,יישוב,397,127,270,10,387,291,386,6,6.84%
2015-07,הצפון,9200,בית שאן,יישוב,895,400,495,17,878,409,876,50,8.41%
2015-07,הצפון,944,בסמת טבעון,יישוב,218,97,121,3,215,157,211,3,6.38%
2015-07,הצפון,483,בענה,יישוב,364,149,215,10,354,297,355,10,10.23%
2015-07,הצפון,1292,ג'דיידה-מכר,יישוב,1275,543,732,6,1269,1004,1263,34,13.29%
2015-07,הצפון,485,ג'ולס,יישוב,208,65,143,1,207,150,206,5,6.63%
2015-07,הצפון,487,ג'ש (גוש חלב),יישוב,70,33,37,4,66,41,67,4,4.03%
2015-07,הצפון,489,דבורייה,יישוב,386,170,216,28,358,253,386,3,8.83%
2015-07,הצפון,490,דייר אל-אסד,יישוב,389,165,224,11,378,300,385,3,7.29%
2015-07,הצפון,492,דייר חנא,יישוב,648,285,363,7,641,509,642,4,13.03%
2015-07,הצפון,975,זרזיר,יישוב,283,131,152,2,281,190,275,6,8.27%
2015-07,הצפון,496,חורפיש,יישוב,104,43,61,5,99,62,101,6,3.54%
2015-07,הצפון,2034,חצור הגלילית,יישוב,279,123,156,14,265,128,264,11,5.38%
2015-07,הצפון,6700,טבריה,יישוב,1683,749,934,82,1601,900,1495,59,6.78%
2015-07,הצפון,962,טובא-זנגרייה,יישוב,381,173,208,6,375,239,374,2,12.16%
2015-07,הצפון,498,טורעאן,יישוב,552,213,339,15,537,427,511,9,8.79%
2015-07,הצפון,8900,טמרה,יישוב,1855,812,1043,30,1825,1535,1843,9,12.63%
2015-07,הצפון,1295,יאנוח-ג'ת,יישוב,142,49,93,4,138,98,139,2,4.74%
2015-07,הצפון,46,יבנאל,יישוב,110,64,46,4,106,86,81,3,5.15%
2015-07,הצפון,29,יסוד המעלה,יישוב,19,4,15,4,15,2,19,1,2.21%
2015-07,הצפון,499,יפיע,יישוב,630,289,341,25,605,489,614,6,7.68%
2015-07,הצפון,240,יקנעם עילית,יישוב,498,194,304,70,428,129,489,29,4.00%
2015-07,הצפון,502,ירכא,יישוב,578,245,333,0,578,430,572,9,8.77%
2015-07,הצפון,504,כאבול,יישוב,642,274,368,10,632,542,639,4,12.61%
2015-07,הצפון,505,כאוכב אבו אל-היג'א,יישוב,224,88,136,8,216,192,217,2,12.42%
2015-07,הצפון,1296,כסרא-סמיע,יישוב,227,90,137,9,218,144,224,2,6.32%
2015-07,הצפון,978,כעביה-טבאש-חג'אג'רה,יישוב,191,77,114,4,187,126,188,2,7.91%
2015-07,הצפון,1263,כפר ורדים,יישוב,60,24,36,30,30,7,60,0,1.95%
2015-07,הצפון,507,כפר יאסיף,יישוב,419,184,235,3,416,304,414,11,8.08%
2015-07,הצפון,508,כפר כמא,יישוב,55,25,30,3,52,24,53,1,3.14%
2015-07,הצפון,509,כפר כנא,יישוב,1169,509,660,27,1142,955,1090,18,12.13%
2015-07,הצפון,510,כפר מנדא,יישוב,977,446,531,8,969,691,956,22,12.81%
2015-07,הצפון,47,כפר תבור,יישוב,47,14,33,20,27,1,47,0,2.05%
2015-07,הצפון,1139,כרמיאל,יישוב,1507,622,885,255,1252,760,1444,51,5.53%
2015-07,הצפון,65,מ.א. אל-בטוף,מועצה איזורית,364,152,212,6,358,290,349,2,12.00%
2015-07,הצפון,66,מ.א. בוסתן אל-מרג',מועצה איזורית,43,17,26,1,42,34,42,0,1.37%
2015-07,הצפון,71,מ.א. גולן,מועצה איזורית,164,78,86,23,141,17,162,0,1.88%
2015-07,הצפון,8,מ.א. הגלבוע,מועצה איזורית,807,322,485,75,732,462,799,0,5.54%
2015-07,הצפון,1,מ.א. הגליל העליון,מועצה איזורית,171,84,87,43,128,18,170,0,1.93%
2015-07,הצפון,3,מ.א. הגליל התחתון,מועצה איזורית,129,44,85,36,93,17,122,0,2.09%
2015-07,הצפון,55,מ.א. מבואות החרמון,מועצה איזורית,91,35,56,21,70,14,90,0,2.25%
2015-07,הצפון,13,מ.א. מגידו,מועצה איזורית,99,43,56,33,66,5,99,0,1.74%
2015-07,הצפון,4,מ.א. מטה אשר,מועצה איזורית,397,160,237,59,338,172,395,0,2.88%
2015-07,הצפון,52,מ.א. מעלה יוסף,מועצה איזורית,173,80,93,26,147,52,171,0,3.10%
2015-07,הצפון,2,מ.א. מרום הגליל,מועצה איזורית,304,138,166,25,279,127,293,0,4.29%
2015-07,הצפון,56,מ.א. משגב,מועצה איזורית,522,204,318,90,432,279,511,0,3.93%
2015-07,הצפון,6,מ.א. עמק הירדן,מועצה איזורית,160,61,99,33,127,31,147,0,2.18%
2015-07,הצפון,7,מ.א. עמק המעיינות,מועצה איזורית,161,66,95,26,135,37,157,0,2.42%
2015-07,הצפון,9,מ.א. עמק יזרעאל,מועצה איזורית,362,144,218,153,209,37,359,0,1.86%
2015-07,הצפון,481,מגאר,יישוב,1475,595,880,21,1454,1246,1450,23,14.47%
2015-07,הצפון,516,מג'ד אל-כרום,יישוב,553,238,315,11,542,381,542,20,8.04%
2015-07,הצפון,65,מגדל,יישוב,42,15,27,5,37,14,40,2,4.20%
2015-07,הצפון,874,מגדל העמק,יישוב,953,417,536,84,869,372,898,73,6.54%
2015-07,הצפון,4201,מג'דל שמס,יישוב,458,170,288,12,446,353,438,7,8.87%
2015-07,הצפון,517,מזרעה,יישוב,170,69,101,1,169,128,165,6,8.25%
2015-07,הצפון,43,מטולה,יישוב,25,16,9,5,20,6,25,1,2.39%
2015-07,הצפון,4203,מסעדה,יישוב,203,78,125,4,199,158,197,0,11.55%
2015-07,הצפון,518,מעיליא,יישוב,43,27,16,11,32,17,43,1,2.67%
2015-07,הצפון,1063,מעלות-תרשיחא,יישוב,830,387,443,105,725,432,813,32,6.84%
2015-07,הצפון,520,משהד,יישוב,283,112,171,5,278,222,271,5,8.28%
2015-07,הצפון,9100,נהרייה,יישוב,1828,845,983,204,1624,995,1766,68,5.69%
2015-07,הצפון,522,נחף,יישוב,403,191,212,15,388,319,394,9,7.71%
2015-07,הצפון,7300,נצרת,יישוב,3284,1465,1819,121,3163,2516,3216,14,9.21%
2015-07,הצפון,1061,נצרת עילית,יישוב,1772,763,1009,151,1621,891,1602,92,6.83%
2015-07,הצפון,525,סאג'ור,יישוב,109,37,72,4,105,70,108,0,5.46%
2015-07,הצפון,7500,סח'נין,יישוב,2196,924,1272,26,2170,1840,2181,8,15.18%
2015-07,הצפון,4501,ע'ג'ר,יישוב,110,42,68,0,110,64,109,1,10.11%
2015-07,הצפון,530,עיילבון,יישוב,166,64,102,5,161,114,164,0,5.92%
2015-07,הצפון,511,עילוט,יישוב,347,139,208,6,341,261,344,0,11.79%
2015-07,הצפון,532,עין מאהל,יישוב,498,243,255,11,487,407,480,1,9.01%
2015-07,הצפון,4502,עין קנייא,יישוב,154,61,93,2,152,128,146,3,14.08%
2015-07,הצפון,7600,עכו,יישוב,3174,1405,1769,117,3057,2251,3096,84,11.52%
2015-07,הצפון,7700,עפולה,יישוב,1723,727,996,171,1552,694,1679,70,6.50%
2015-07,הצפון,531,עראבה,יישוב,1599,669,930,30,1569,1367,1582,4,15.19%
2015-07,הצפון,535,פסוטה,יישוב,121,48,73,6,115,65,120,0,6.85%
2015-07,הצפון,536,פקיעין (בוקייעה),יישוב,132,75,57,9,123,77,127,2,4.50%
2015-07,הצפון,8000,צפת,יישוב,1447,761,686,87,1360,979,1381,32,10.02%
2015-07,הצפון,4100,קצרין,יישוב,197,87,110,33,164,83,193,1,4.78%
2015-07,הצפון,2800,קריית שמונה,יישוב,741,346,395,57,684,309,720,22,5.48%
2015-07,הצפון,543,ראמה,יישוב,288,121,167,14,274,204,283,5,7.18%
2015-07,הצפון,26,ראש פינה,יישוב,40,16,24,7,33,14,40,0,2.50%
2015-07,הצפון,542,ריינה,יישוב,655,273,382,17,638,500,635,11,9.12%
2015-07,הצפון,122,רמת ישי,יישוב,116,52,64,41,75,15,114,1,2.72%
2015-07,הצפון,913,שבלי - אום אל-גנם,יישוב,221,105,116,6,215,147,217,3,8.12%
2015-07,הצפון,812,שלומי,יישוב,211,89,122,10,201,97,205,8,5.69%
2015-07,הצפון,538,שעב,יישוב,551,226,325,4,547,482,543,0,17.32%
2015-07,הצפון,8800,שפרעם,יישוב,1915,752,1163,26,1889,1516,1895,39,10.26%
2015-07,חיפה,1326,"בסמ""ה",יישוב,417,189,228,3,414,312,410,5,10.02%
2015-07,חיפה,2710,אום אל-פחם,יישוב,3579,1477,2102,30,3549,2985,3514,29,16.16%
2015-07,חיפה,1020,אור עקיבא,יישוב,531,238,293,42,489,183,516,22,5.03%
2015-07,חיפה,6000,באקה אל-גרביה,יישוב,631,290,341,14,617,354,625,12,5.29%
2015-07,חיפה,9800,בנימינה-גבעת עדה*,יישוב,177,86,91,45,132,60,177,3,2.43%
2015-07,חיפה,541,ג'סר א-זרקא,יישוב,493,243,250,5,488,314,487,8,7.92%
2015-07,חיפה,628,ג'ת,יישוב,211,105,106,7,204,119,209,2,3.95%
2015-07,חיפה,494,דאלית אל-כרמל,יישוב,488,189,299,10,478,269,464,6,5.58%
2015-07,חיפה,9300,זכרון יעקב,יישוב,260,118,142,87,173,46,259,1,2.32%
2015-07,חיפה,6500,חדרה,יישוב,2363,984,1379,296,2067,816,2237,65,4.44%
2015-07,חיפה,4000,חיפה,יישוב,6267,3014,3253,1199,5068,3174,5965,160,4.25%
2015-07,חיפה,1247,חריש,יישוב,22,15,7,3,19,9,22,1,1.38%
2015-07,חיפה,2100,טירת כרמל,יישוב,733,360,373,35,698,408,716,20,6.30%
2015-07,חיפה,654,כפר קרע,יישוב,399,176,223,13,386,238,395,4,4.60%
2015-07,חיפה,45,מ.א. אלונה,מועצה איזורית,18,5,13,7,11,4,18,0,1.69%
2015-07,חיפה,12,מ.א. זבולון,מועצה איזורית,278,122,156,29,249,185,272,0,4.88%
2015-07,חיפה,15,מ.א. חוף הכרמל,מועצה איזורית,293,138,155,71,222,61,291,0,2.06%
2015-07,חיפה,14,מ.א. מנשה,מועצה איזורית,256,111,145,59,197,72,254,0,3.17%
2015-07,חיפה,1327,מעלה עירון,יישוב,890,340,550,5,885,724,879,4,14.54%
2015-07,חיפה,2500,נשר,יישוב,462,241,221,88,374,179,454,15,3.53%
2015-07,חיפה,534,עספיא,יישוב,322,150,172,13,309,155,310,6,5.44%
2015-07,חיפה,637,ערערה,יישוב,579,250,329,5,574,360,570,8,6.96%
2015-07,חיפה,537,פוריידיס,יישוב,417,194,223,11,406,255,413,1,7.21%
2015-07,חיפה,7800,פרדס חנה-כרכור,יישוב,851,388,463,141,710,255,837,26,4.10%
2015-07,חיפה,6800,קריית אתא,יישוב,1665,724,941,134,1531,829,1624,43,5.30%
2015-07,חיפה,9500,קריית ביאליק,יישוב,1028,416,612,124,904,487,1006,23,4.67%
2015-07,חיפה,2300,קריית טבעון,יישוב,171,81,90,69,102,34,170,0,2.03%
2015-07,חיפה,9600,קריית ים,יישוב,1466,683,783,149,1317,820,1419,38,6.59%
2015-07,חיפה,8200,קריית מוצקין,יישוב,1001,425,576,145,856,436,977,26,4.23%
2015-07,חיפה,922,רכסים,יישוב,232,72,160,11,221,86,216,1,5.93%
2015-07,ירושלים,472,אבו גוש,יישוב,278,147,131,7,271,189,276,2,8.81%
2015-07,ירושלים,2610,בית שמש,יישוב,1566,643,923,105,1461,511,1517,27,4.44%
2015-07,ירושלים,3000,ירושלים,יישוב,13075,5627,7448,1415,11660,7568,12828,138,4.29%
2015-07,ירושלים,26,מ.א. מטה יהודה,מועצה איזורית,672,300,372,122,550,130,660,0,2.76%
2015-07,ירושלים,1015,מבשרת ציון,יישוב,384,184,200,82,302,142,379,7,2.90%
2015-07,ירושלים,1137,קריית יערים,יישוב,45,15,30,5,40,14,45,0,3.16%
2015-07,תל אביב,2400,אור יהודה,יישוב,807,369,438,45,762,191,783,38,4.08%
2015-07,תל אביב,565,אזור,יישוב,183,85,98,20,163,31,181,5,2.75%
2015-07,תל אביב,6100,בני ברק,יישוב,2572,969,1603,94,2478,929,2481,33,4.27%
2015-07,תל אביב,6200,בת ים,יישוב,2998,1364,1634,409,2589,1031,2873,91,4.06%
2015-07,תל אביב,6300,גבעתיים,יישוב,747,313,434,319,428,86,743,5,2.40%
2015-07,תל אביב,6400,הרצלייה,יישוב,1065,447,618,368,697,37,1060,33,2.17%
2015-07,תל אביב,6600,חולון,יישוב,3082,1373,1709,481,2601,711,3028,60,3.04%
2015-07,תל אביב,267,כפר שמריהו,יישוב,10,4,6,5,5,0,10,0,1.19%
2015-07,תל אביב,2620,קריית אונו,יישוב,382,167,215,155,227,38,380,2,1.98%
2015-07,תל אביב,8600,רמת גן,יישוב,2123,922,1201,692,1431,407,2098,23,2.67%
2015-07,תל אביב,2650,רמת השרון,יישוב,368,127,241,160,208,9,365,3,1.63%
2015-07,תל אביב,5000,תל אביב -יפו,יישוב,7221,3568,3653,2390,4831,1907,7122,117,2.80%
2015-08,אזור יהודה והשומרון,3760,אורנית,יישוב,100,43,57,38,62,4,100,0,2.05%
2015-08,אזור יהודה והשומרון,3750,אלפי מנשה,יישוב,92,40,52,27,65,1,91,0,2.06%
2015-08,אזור יהודה והשומרון,3560,אלקנה,יישוב,29,16,13,12,17,1,29,0,1.53%
2015-08,אזור יהודה והשומרון,3650,אפרת,יישוב,64,34,30,29,35,2,64,0,1.48%
2015-08,אזור יהודה והשומרון,3570,אריאל,יישוב,334,160,174,82,252,60,332,7,3.06%
2015-08,אזור יהודה והשומרון,3574,בית אל,יישוב,61,38,23,11,50,16,60,0,2.46%
2015-08,אזור יהודה והשומרון,3652,בית אריה,יישוב,63,22,41,17,46,2,63,1,2.34%
2015-08,אזור יהודה והשומרון,3780,ביתר עילית,יישוב,850,337,513,11,839,301,845,2,6.20%
2015-08,אזור יהודה והשומרון,3730,גבעת זאב,יישוב,215,94,121,48,167,44,213,1,2.73%
2015-08,אזור יהודה והשומרון,3769,הר אדר,יישוב,36,17,19,19,17,5,36,0,1.69%
2015-08,אזור יהודה והשומרון,76,מ.א. גוש עציון,מועצה איזורית,177,94,83,68,109,16,175,0,1.82%
2015-08,אזור יהודה והשומרון,78,מ.א. הר חברון,מועצה איזורית,79,40,39,26,53,5,79,0,2.25%
2015-08,אזור יהודה והשומרון,74,מ.א. מגילות ים המלח,מועצה איזורית,15,6,9,4,11,1,15,0,1.87%
2015-08,אזור יהודה והשומרון,73,מ.א. מטה בנימין,מועצה איזורית,698,334,364,167,531,146,690,0,2.75%
2015-08,אזור יהודה והשומרון,75,מ.א. ערבות הירדן,מועצה איזורית,51,26,25,15,36,6,51,0,2.10%
2015-08,אזור יהודה והשומרון,72,מ.א. שומרון,מועצה איזורית,416,220,196,118,298,46,412,0,2.44%
2015-08,אזור יהודה והשומרון,3797,מודיעין עילית,יישוב,847,163,684,18,829,64,843,5,5.81%
2015-08,אזור יהודה והשומרון,3616,מעלה אדומים,יישוב,754,317,437,96,658,181,743,21,3.60%
2015-08,אזור יהודה והשומרון,3608,מעלה אפרים,יישוב,25,13,12,2,23,9,25,2,3.05%
2015-08,אזור יהודה והשומרון,3660,עמנואל,יישוב,86,50,36,3,83,40,85,0,7.05%
2015-08,אזור יהודה והשומרון,3557,קדומים,יישוב,47,29,18,21,26,6,47,0,2.49%
2015-08,אזור יהודה והשומרון,3611,קריית ארבע,יישוב,130,67,63,15,115,60,127,3,3.84%
2015-08,אזור יהודה והשומרון,3640,קרני שומרון,יישוב,82,44,38,19,63,8,80,2,2.11%
2015-08,הדרום,31,אופקים,יישוב,1303,507,796,75,1228,639,1279,34,9.31%
2015-08,הדרום,2600,אילת,יישוב,1212,527,685,74,1138,476,1171,55,3.45%
2015-08,הדרום,70,אשדוד,יישוב,6657,2610,4047,772,5885,2851,6465,189,5.82%
2015-08,הדרום,7100,אשקלון,יישוב,4368,1762,2606,456,3912,2057,3933,121,5.49%
2015-08,הדרום,9000,באר שבע,יישוב,6818,2977,3841,859,5959,3649,6605,125,6.16%
2015-08,הדרום,2200,דימונה,יישוב,2099,888,1211,111,1988,1306,2022,62,10.56%
2015-08,הדרום,1303,חורה,יישוב,762,323,439,2,760,673,753,4,17.56%
2015-08,הדרום,831,ירוחם,יישוב,459,211,248,21,438,238,433,28,8.85%
2015-08,הדרום,1059,כסיפה,יישוב,1021,391,630,1,1020,917,1015,2,21.13%
2015-08,הדרום,1271,להבים,יישוב,43,25,18,17,26,4,42,0,1.16%
2015-08,הדרום,1060,לקיה,יישוב,859,378,481,3,856,779,850,2,19.10%
2015-08,הדרום,69,מ.א. אל קסום,מועצה איזורית,752,308,444,9,743,656,748,0,46.37%
2015-08,הדרום,38,מ.א. אשכול,מועצה איזורית,147,68,79,31,116,15,147,0,2.16%
2015-08,הדרום,33,מ.א. באר טוביה,מועצה איזורית,323,124,199,61,262,57,318,0,2.90%
2015-08,הדרום,41,מ.א. בני שמעון,מועצה איזורית,85,30,55,25,60,14,83,4,1.89%
2015-08,הדרום,54,מ.א. הערבה התיכונה,מועצה איזורית,36,13,23,5,31,5,35,0,1.93%
2015-08,הדרום,53,מ.א. חבל אילות,מועצה איזורית,18,13,5,4,14,0,18,4,0.76%
2015-08,הדרום,36,מ.א. חוף אשקלון,מועצה איזורית,259,100,159,38,221,58,251,1,3.03%
2015-08,הדרום,35,מ.א. יואב,מועצה איזורית,89,28,61,33,56,11,89,0,2.24%
2015-08,הדרום,50,מ.א. לכיש,מועצה איזורית,193,77,116,21,172,53,190,0,3.78%
2015-08,הדרום,42,מ.א. מרחבים,מועצה איזורית,210,72,138,29,181,42,208,0,3.52%
2015-08,הדרום,68,מ.א. נווה מדבר,מועצה איזורית,119,51,68,2,117,85,115,0,11.93%
2015-08,הדרום,48,מ.א. רמת נגב,מועצה איזורית,250,131,119,14,236,195,250,0,7.89%
2015-08,הדרום,39,מ.א. שדות נגב,מועצה איזורית,155,60,95,19,136,33,149,0,3.30%
2015-08,הדרום,37,מ.א. שער הנגב,מועצה איזורית,116,50,66,34,82,26,113,0,2.91%
2015-08,הדרום,34,מ.א. שפיר,מועצה איזורית,212,100,112,17,195,64,208,0,4.43%
2015-08,הדרום,51,מ.א. תמר,מועצה איזורית,14,4,10,2,12,3,14,0,2.21%
2015-08,הדרום,1268,מיתר,יישוב,80,32,48,32,48,10,80,0,1.79%
2015-08,הדרום,99,מצפה רמון,יישוב,279,113,166,19,260,174,272,13,9.76%
2015-08,הדרום,246,נתיבות,יישוב,1212,482,730,59,1153,493,1178,59,7.81%
2015-08,הדרום,666,עומר,יישוב,58,15,43,24,34,3,57,0,1.35%
2015-08,הדרום,2560,ערד,יישוב,806,342,464,77,729,392,779,47,6.27%
2015-08,הדרום,1192,ערערה-בנגב,יישוב,1082,452,630,3,1079,1000,1067,1,24.33%
2015-08,הדרום,2630,קריית גת,יישוב,2023,806,1217,115,1908,1012,1968,59,6.84%
2015-08,הדרום,1034,קריית מלאכי,יישוב,1057,450,607,29,1028,537,1024,59,8.59%
2015-08,הדרום,1161,רהט,יישוב,3048,1317,1731,13,3035,2499,3015,46,14.83%
2015-08,הדרום,1286,שגב-שלום,יישוב,527,186,341,1,526,428,520,3,17.72%
2015-08,הדרום,1031,שדרות,יישוב,1129,491,638,62,1067,586,1075,33,7.88%
2015-08,הדרום,1054,תל שבע,יישוב,1100,498,602,6,1094,989,1089,5,21.03%
2015-08,המרכז,1066,"בני עי""ש",יישוב,175,75,100,25,150,66,172,3,4.27%
2015-08,המרכז,182,אבן יהודה,יישוב,152,71,81,38,114,18,152,0,2.21%
2015-08,המרכז,41,אליכין,יישוב,86,46,40,7,79,15,84,4,4.29%
2015-08,המרכז,1309,אלעד,יישוב,623,235,388,15,608,64,614,2,4.64%
2015-08,המרכז,2530,באר יעקב,יישוב,244,105,139,41,203,45,242,6,2.42%
2015-08,המרכז,466,בית דגן,יישוב,113,65,48,11,102,34,112,1,3.00%
2015-08,המרכז,681,גבעת שמואל,יישוב,270,136,134,91,179,51,265,2,2.19%
2015-08,המרכז,2550,גדרה,יישוב,352,144,208,79,273,96,348,3,2.78%
2015-08,המרכז,627,ג'לג'וליה,יישוב,105,46,59,2,103,60,104,1,2.74%
2015-08,המרכז,166,גן יבנה,יישוב,398,145,253,64,334,77,393,16,3.23%
2015-08,המרכז,229,גני תקווה,יישוב,236,87,149,80,156,29,234,0,2.58%
2015-08,המרכז,9700,הוד השרון,יישוב,685,279,406,232,453,54,679,8,2.18%
2015-08,המרכז,1290,זמר,יישוב,157,47,110,3,154,96,156,2,5.23%
2015-08,המרכז,2730,טייבה,יישוב,1395,601,794,26,1369,1110,1230,37,6.95%
2015-08,המרכז,2720,טירה,יישוב,280,118,162,18,262,113,273,6,2.38%
2015-08,המרכז,2660,יבנה,יישוב,959,422,537,140,819,271,949,29,3.85%
2015-08,המרכז,9400,יהוד,יישוב,431,204,227,70,361,56,421,9,2.61%
2015-08,המרכז,1224,כוכב יאיר,יישוב,90,41,49,42,48,1,90,0,1.56%
2015-08,המרכז,633,כפר ברא,יישוב,41,25,16,0,41,15,40,0,2.76%
2015-08,המרכז,168,כפר יונה,יישוב,341,143,198,47,294,58,339,2,3.00%
2015-08,המרכז,6900,כפר סבא,יישוב,1240,535,705,409,831,129,1225,27,2.30%
2015-08,המרכז,634,כפר קאסם,יישוב,257,114,143,9,248,127,249,7,2.69%
2015-08,המרכז,7000,לוד,יישוב,2120,960,1160,168,1952,1051,2088,46,5.83%
2015-08,המרכז,28,מ.א. ברנר,מועצה איזורית,87,44,43,33,54,5,87,0,2.13%
2015-08,המרכז,32,מ.א. גדרות,מועצה איזורית,47,19,28,20,27,6,46,0,1.88%
2015-08,המרכז,30,מ.א. גזר,מועצה איזורית,297,114,183,89,208,23,294,0,2.23%
2015-08,המרכז,27,מ.א. גן רווה,מועצה איזורית,52,27,25,19,33,4,52,0,1.78%
2015-08,המרכז,20,מ.א. דרום השרון,מועצה איזורית,347,147,200,130,217,13,344,0,2.20%
2015-08,המרכז,29,מ.א. חבל יבנה,מועצה איזורית,46,19,27,15,31,4,46,0,1.85%
2015-08,המרכז,25,מ.א. חבל מודיעין,מועצה איזורית,249,108,141,75,174,14,247,0,2.30%
2015-08,המרכז,19,מ.א. חוף השרון,מועצה איזורית,109,46,63,44,65,7,109,0,1.94%
2015-08,המרכז,18,מ.א. לב השרון,מועצה איזורית,255,114,141,49,206,31,255,0,2.32%
2015-08,המרכז,31,מ.א. נחל שורק,מועצה איזורית,58,28,30,9,49,4,57,34,1.27%
2015-08,המרכז,16,מ.א. עמק חפר,מועצה איזורית,399,160,239,110,289,18,399,0,2.03%
2015-08,המרכז,40,מ.א. עמק לוד,מועצה איזורית,141,62,79,38,103,13,141,0,2.29%
2015-08,המרכז,1200,מודיעין-מכבים-רעות*,יישוב,998,392,606,316,682,55,989,12,2.19%
2015-08,המרכז,28,מזכרת בתיה,יישוב,187,75,112,47,140,33,186,0,2.47%
2015-08,המרכז,7200,נס ציונה,יישוב,695,307,388,171,524,176,689,10,2.87%
2015-08,המרכז,7400,נתניה,יישוב,4669,1950,2719,479,4190,1386,4574,75,4.30%
2015-08,המרכז,587,סביון*,יישוב,18,10,8,10,8,0,18,0,0.92%
2015-08,המרכז,171,פרדסייה,יישוב,79,32,47,14,65,7,78,0,2.05%
2015-08,המרכז,7900,פתח תקווה,יישוב,4217,1749,2468,868,3349,1026,4155,57,3.29%
2015-08,המרכז,195,קדימה-צורן,יישוב,294,108,186,71,223,33,291,3,2.61%
2015-08,המרכז,638,קלנסווה,יישוב,545,252,293,4,541,426,497,12,5.61%
2015-08,המרכז,469,קריית עקרון,יישוב,296,143,153,14,282,118,291,8,4.78%
2015-08,המרכז,2640,ראש העין,יישוב,885,380,505,92,793,160,876,19,3.44%
2015-08,המרכז,8300,ראשון לציון,יישוב,4425,1868,2557,830,3595,1237,4393,73,3.14%
2015-08,המרכז,8400,רחובות,יישוב,2710,1101,1609,552,2158,863,2655,60,3.83%
2015-08,המרכז,8500,רמלה,יישוב,1811,826,985,109,1702,682,1749,66,4.60%
2015-08,המרכז,8700,רעננה,יישוב,780,330,450,281,499,57,774,7,2.08%
2015-08,המרכז,1304,שוהם,יישוב,195,84,111,79,116,9,195,0,1.67%
2015-08,המרכז,154,תל מונד,יישוב,156,68,88,48,108,21,156,1,2.42%
2015-08,הצפון,473,אבו סנאן,יישוב,617,257,360,8,609,475,610,11,10.26%
2015-08,הצפון,478,אכסאל,יישוב,537,246,291,8,529,449,525,3,9.07%
2015-08,הצפון,529,אעבלין,יישוב,561,222,339,12,549,462,555,11,9.48%
2015-08,הצפון,482,בועיינה-נוג'ידאת,יישוב,354,161,193,6,348,296,338,8,8.69%
2015-08,הצפון,4001,בוקעאתא,יישוב,379,142,237,5,374,314,362,1,13.11%
2015-08,הצפון,998,ביר אל-מכסור,יישוב,405,155,250,3,402,319,403,1,10.30%
2015-08,הצפון,480,בית ג'ן,יישוב,381,123,258,9,372,273,373,8,6.63%
2015-08,הצפון,9200,בית שאן,יישוב,882,373,509,17,865,410,864,59,8.31%
2015-08,הצפון,944,בסמת טבעון,יישוב,224,99,125,3,221,162,216,3,6.52%
2015-08,הצפון,483,בענה,יישוב,353,147,206,9,344,286,349,8,10.08%
2015-08,הצפון,1292,ג'דיידה-מכר,יישוב,1249,538,711,5,1244,983,1238,34,13.06%
2015-08,הצפון,485,ג'ולס,יישוב,201,58,143,1,200,146,201,6,6.48%
2015-08,הצפון,487,ג'ש (גוש חלב),יישוב,68,28,40,3,65,38,65,4,3.92%
2015-08,הצפון,489,דבורייה,יישוב,398,176,222,28,370,257,397,8,9.06%
2015-08,הצפון,490,דייר אל-אסד,יישוב,401,171,230,12,389,304,395,10,7.47%
2015-08,הצפון,492,דייר חנא,יישוב,636,274,362,7,629,505,628,3,12.79%
2015-08,הצפון,975,זרזיר,יישוב,279,126,153,6,273,180,274,8,8.24%
2015-08,הצפון,496,חורפיש,יישוב,99,43,56,5,94,59,97,7,3.40%
2015-08,הצפון,2034,חצור הגלילית,יישוב,277,107,170,16,261,131,265,6,5.40%
2015-08,הצפון,6700,טבריה,יישוב,1664,734,930,87,1577,881,1491,54,6.76%
2015-08,הצפון,962,טובא-זנגרייה,יישוב,377,171,206,7,370,245,369,2,12.02%
2015-08,הצפון,498,טורעאן,יישוב,541,200,341,15,526,418,507,11,8.72%
2015-08,הצפון,8900,טמרה,יישוב,1830,811,1019,30,1800,1519,1816,14,12.47%
2015-08,הצפון,1295,יאנוח-ג'ת,יישוב,142,55,87,2,140,92,140,3,4.77%
2015-08,הצפון,46,יבנאל,יישוב,119,71,48,4,115,79,94,1,5.93%
2015-08,הצפון,29,יסוד המעלה,יישוב,17,3,14,3,14,2,17,0,1.98%
2015-08,הצפון,499,יפיע,יישוב,629,293,336,24,605,474,614,6,7.68%
2015-08,הצפון,240,יקנעם עילית,יישוב,520,200,320,79,441,131,507,30,4.15%
2015-08,הצפון,502,ירכא,יישוב,567,239,328,1,566,420,560,13,8.60%
2015-08,הצפון,504,כאבול,יישוב,642,278,364,6,636,545,638,7,12.59%
2015-08,הצפון,505,כאוכב אבו אל-היג'א,יישוב,218,87,131,6,212,189,214,0,12.27%
2015-08,הצפון,1296,כסרא-סמיע,יישוב,215,78,137,6,209,139,210,3,5.95%
2015-08,הצפון,978,כעביה-טבאש-חג'אג'רה,יישוב,189,80,109,5,184,128,183,6,7.71%
2015-08,הצפון,1263,כפר ורדים,יישוב,61,27,34,27,34,8,61,1,1.98%
2015-08,הצפון,507,כפר יאסיף,יישוב,408,182,226,3,405,292,401,9,7.84%
2015-08,הצפון,508,כפר כמא,יישוב,63,30,33,3,60,28,62,2,3.65%
2015-08,הצפון,509,כפר כנא,יישוב,1162,491,671,27,1135,953,1079,20,12.02%
2015-08,הצפון,510,כפר מנדא,יישוב,958,429,529,7,951,681,936,11,12.58%
2015-08,הצפון,47,כפר תבור,יישוב,50,12,38,22,28,1,50,0,2.17%
2015-08,הצפון,1139,כרמיאל,יישוב,1524,621,903,267,1257,740,1453,51,5.56%
2015-08,הצפון,65,מ.א. אל-בטוף,מועצה איזורית,360,160,200,6,354,292,337,1,11.62%
2015-08,הצפון,66,מ.א. בוסתן אל-מרג',מועצה איזורית,40,14,26,1,39,34,40,0,1.30%
2015-08,הצפון,71,מ.א. גולן,מועצה איזורית,180,79,101,25,155,22,178,0,2.07%
2015-08,הצפון,8,מ.א. הגלבוע,מועצה איזורית,846,335,511,74,772,468,836,0,5.80%
2015-08,הצפון,1,מ.א. הגליל העליון,מועצה איזורית,185,79,106,52,133,27,183,0,2.07%
2015-08,הצפון,3,מ.א. הגליל התחתון,מועצה איזורית,120,39,81,35,85,14,116,0,1.98%
2015-08,הצפון,55,מ.א. מבואות החרמון,מועצה איזורית,95,37,58,24,71,16,94,0,2.35%
2015-08,הצפון,13,מ.א. מגידו,מועצה איזורית,95,44,51,33,62,6,95,0,1.67%
2015-08,הצפון,4,מ.א. מטה אשר,מועצה איזורית,406,178,228,52,354,167,403,0,2.94%
2015-08,הצפון,52,מ.א. מעלה יוסף,מועצה איזורית,176,80,96,24,152,50,174,2,3.15%
2015-08,הצפון,2,מ.א. מרום הגליל,מועצה איזורית,287,131,156,23,264,125,280,0,4.10%
2015-08,הצפון,56,מ.א. משגב,מועצה איזורית,547,207,340,98,449,288,531,0,4.09%
2015-08,הצפון,6,מ.א. עמק הירדן,מועצה איזורית,150,59,91,34,116,28,142,0,2.10%
2015-08,הצפון,7,מ.א. עמק המעיינות,מועצה איזורית,178,77,101,32,146,38,174,0,2.69%
2015-08,הצפון,9,מ.א. עמק יזרעאל,מועצה איזורית,377,148,229,163,214,38,374,0,1.93%
2015-08,הצפון,481,מגאר,יישוב,1395,560,835,25,1370,1187,1375,11,13.82%
2015-08,הצפון,516,מג'ד אל-כרום,יישוב,550,227,323,11,539,371,538,14,7.99%
2015-08,הצפון,65,מגדל,יישוב,33,10,23,3,30,10,31,1,3.29%
2015-08,הצפון,874,מגדל העמק,יישוב,953,405,548,86,867,367,895,77,6.52%
2015-08,הצפון,4201,מג'דל שמס,יישוב,450,165,285,11,439,349,433,6,8.78%
2015-08,הצפון,517,מזרעה,יישוב,171,69,102,0,171,129,164,2,8.21%
2015-08,הצפון,43,מטולה,יישוב,23,15,8,4,19,6,23,0,2.20%
2015-08,הצפון,4203,מסעדה,יישוב,201,79,122,5,196,162,195,3,11.44%
2015-08,הצפון,518,מעיליא,יישוב,47,23,24,12,35,22,47,0,2.91%
2015-08,הצפון,1063,מעלות-תרשיחא,יישוב,856,373,483,110,746,452,839,33,7.05%
2015-08,הצפון,520,משהד,יישוב,281,110,171,3,278,227,270,5,8.25%
2015-08,הצפון,9100,נהרייה,יישוב,1833,843,990,196,1637,1003,1760,71,5.67%
2015-08,הצפון,522,נחף,יישוב,395,188,207,11,384,315,388,8,7.61%
2015-08,הצפון,7300,נצרת,יישוב,3292,1446,1846,112,3180,2537,3212,16,9.20%
2015-08,הצפון,1061,נצרת עילית,יישוב,1801,775,1026,168,1633,884,1631,98,6.94%
2015-08,הצפון,525,סאג'ור,יישוב,98,34,64,5,93,68,97,2,4.93%
2015-08,הצפון,7500,סח'נין,יישוב,2183,932,1251,29,2154,1831,2163,5,15.08%
2015-08,הצפון,4501,ע'ג'ר,יישוב,107,42,65,1,106,64,106,0,9.86%
2015-08,הצפון,530,עיילבון,יישוב,162,66,96,7,155,108,161,3,5.82%
2015-08,הצפון,511,עילוט,יישוב,357,144,213,6,351,274,352,0,12.03%
2015-08,הצפון,532,עין מאהל,יישוב,504,243,261,8,496,414,484,3,9.08%
2015-08,הצפון,4502,עין קנייא,יישוב,157,60,97,2,155,125,149,2,14.33%
2015-08,הצפון,7600,עכו,יישוב,3183,1403,1780,122,3061,2243,3114,77,11.58%
2015-08,הצפון,7700,עפולה,יישוב,1730,712,1018,163,1567,693,1681,101,6.51%
2015-08,הצפון,531,עראבה,יישוב,1609,674,935,32,1577,1390,1587,11,15.23%
2015-08,הצפון,535,פסוטה,יישוב,118,44,74,8,110,66,118,0,6.75%
2015-08,הצפון,536,פקיעין (בוקייעה),יישוב,130,72,58,8,122,79,125,4,4.43%
2015-08,הצפון,8000,צפת,יישוב,1496,780,716,84,1412,978,1424,30,10.30%
2015-08,הצפון,4100,קצרין,יישוב,207,94,113,31,176,91,206,3,5.09%
2015-08,הצפון,2800,קריית שמונה,יישוב,744,333,411,62,682,301,717,35,5.46%
2015-08,הצפון,543,ראמה,יישוב,288,120,168,15,273,207,283,1,7.18%
2015-08,הצפון,26,ראש פינה,יישוב,45,14,31,8,37,16,45,2,2.81%
2015-08,הצפון,542,ריינה,יישוב,645,268,377,14,631,498,615,7,8.86%
2015-08,הצפון,122,רמת ישי,יישוב,104,47,57,35,69,17,102,1,2.44%
2015-08,הצפון,913,שבלי - אום אל-גנם,יישוב,234,105,129,7,227,145,229,6,8.53%
2015-08,הצפון,812,שלומי,יישוב,222,94,128,9,213,98,216,3,5.98%
2015-08,הצפון,538,שעב,יישוב,545,220,325,3,542,474,540,1,17.24%
2015-08,הצפון,8800,שפרעם,יישוב,1893,739,1154,31,1862,1515,1872,17,10.15%
2015-08,חיפה,1326,"בסמ""ה",יישוב,416,185,231,3,413,313,411,5,10.05%
2015-08,חיפה,2710,אום אל-פחם,יישוב,3591,1491,2100,32,3559,2981,3525,23,16.21%
2015-08,חיפה,1020,אור עקיבא,יישוב,536,244,292,40,496,177,514,23,5.01%
2015-08,חיפה,6000,באקה אל-גרביה,יישוב,650,303,347,15,635,353,644,20,5.45%
2015-08,חיפה,9800,בנימינה-גבעת עדה*,יישוב,185,91,94,48,137,62,185,0,2.54%
2015-08,חיפה,541,ג'סר א-זרקא,יישוב,482,244,238,3,479,316,480,3,7.82%
2015-08,חיפה,628,ג'ת,יישוב,215,106,109,6,209,126,214,2,4.04%
2015-08,חיפה,494,דאלית אל-כרמל,יישוב,471,188,283,10,461,260,455,6,5.48%
2015-08,חיפה,9300,זכרון יעקב,יישוב,256,120,136,80,176,46,255,1,2.29%
2015-08,חיפה,6500,חדרה,יישוב,2438,982,1456,305,2133,824,2299,65,4.55%
2015-08,חיפה,4000,חיפה,יישוב,6254,2960,3294,1175,5079,3144,5958,130,4.25%
2015-08,חיפה,1247,חריש,יישוב,25,16,9,5,20,7,24,2,1.50%
2015-08,חיפה,2100,טירת כרמל,יישוב,728,347,381,35,693,390,714,21,6.29%
2015-08,חיפה,654,כפר קרע,יישוב,410,183,227,11,399,242,407,10,4.74%
2015-08,חיפה,45,מ.א. אלונה,מועצה איזורית,20,7,13,5,15,5,19,0,1.78%
2015-08,חיפה,12,מ.א. זבולון,מועצה איזורית,281,129,152,30,251,178,278,0,4.99%
2015-08,חיפה,15,מ.א. חוף הכרמל,מועצה איזורית,305,143,162,84,221,66,300,0,2.12%
2015-08,חיפה,14,מ.א. מנשה,מועצה איזורית,256,111,145,64,192,75,252,0,3.14%
2015-08,חיפה,1327,מעלה עירון,יישוב,887,327,560,6,881,731,872,3,14.44%
2015-08,חיפה,2500,נשר,יישוב,457,231,226,93,364,174,448,9,3.48%
2015-08,חיפה,534,עספיא,יישוב,318,143,175,9,309,169,299,6,5.26%
2015-08,חיפה,637,ערערה,יישוב,587,254,333,7,580,360,579,10,7.06%
2015-08,חיפה,537,פוריידיס,יישוב,429,198,231,11,418,257,426,2,7.42%
2015-08,חיפה,7800,פרדס חנה-כרכור,יישוב,796,347,449,144,652,243,784,16,3.85%
2015-08,חיפה,6800,קריית אתא,יישוב,1705,720,985,125,1580,831,1665,63,5.43%
2015-08,חיפה,9500,קריית ביאליק,יישוב,1019,416,603,131,888,484,1001,31,4.65%
2015-08,חיפה,2300,קריית טבעון,יישוב,175,75,100,79,96,34,173,1,2.07%
2015-08,חיפה,9600,קריית ים,יישוב,1474,682,792,140,1334,802,1436,43,6.66%
2015-08,חיפה,8200,קריית מוצקין,יישוב,1026,437,589,145,881,446,1001,29,4.33%
2015-08,חיפה,922,רכסים,יישוב,246,81,165,14,232,82,229,2,6.27%
2015-08,ירושלים,472,אבו גוש,יישוב,280,145,135,8,272,185,277,4,8.84%
2015-08,ירושלים,2610,בית שמש,יישוב,1612,625,987,106,1506,508,1572,33,4.60%
2015-08,ירושלים,3000,ירושלים,יישוב,13556,5762,7794,1428,12128,7639,13278,131,4.43%
2015-08,ירושלים,26,מ.א. מטה יהודה,מועצה איזורית,655,288,367,120,535,131,647,2,2.71%
2015-08,ירושלים,1015,מבשרת ציון,יישוב,398,189,209,80,318,141,390,6,2.99%
2015-08,ירושלים,1137,קריית יערים,יישוב,50,17,33,9,41,15,50,0,3.50%
2015-08,תל אביב,2400,אור יהודה,יישוב,868,368,500,49,819,195,834,39,4.34%
2015-08,תל אביב,565,אזור,יישוב,178,80,98,19,159,27,178,2,2.71%
2015-08,תל אביב,6100,בני ברק,יישוב,2790,958,1832,95,2695,893,2705,20,4.64%
2015-08,תל אביב,6200,בת ים,יישוב,2975,1348,1627,411,2564,1011,2858,84,4.04%
2015-08,תל אביב,6300,גבעתיים,יישוב,752,317,435,321,431,85,750,7,2.43%
2015-08,תל אביב,6400,הרצלייה,יישוב,1157,456,701,364,793,41,1153,30,2.35%
2015-08,תל אביב,6600,חולון,יישוב,3062,1356,1706,477,2585,688,2993,58,3.01%
2015-08,תל אביב,267,כפר שמריהו,יישוב,6,2,4,3,3,0,6,0,0.72%
2015-08,תל אביב,2620,קריית אונו,יישוב,406,166,240,162,244,36,403,1,2.10%
2015-08,תל אביב,8600,רמת גן,יישוב,2125,918,1207,671,1454,391,2091,22,2.66%
2015-08,תל אביב,2650,רמת השרון,יישוב,397,125,272,169,228,8,396,6,1.77%
2015-08,תל אביב,5000,תל אביב -יפו,יישוב,7255,3563,3692,2392,4863,1894,7131,104,2.80%
2015-09,אזור יהודה והשומרון,3760,אורנית,יישוב,103,48,55,40,63,4,103,0,2.11%
2015-09,אזור יהודה והשומרון,3750,אלפי מנשה,יישוב,78,37,41,24,54,0,78,1,1.77%
2015-09,אזור יהודה והשומרון,3560,אלקנה,יישוב,30,14,16,13,17,1,30,0,1.58%
2015-09,אזור יהודה והשומרון,3650,אפרת,יישוב,56,28,28,28,28,2,56,1,1.30%
2015-09,אזור יהודה והשומרון,3570,אריאל,יישוב,313,142,171,82,231,52,313,4,2.89%
2015-09,אזור יהודה והשומרון,3574,בית אל,יישוב,55,36,19,10,45,13,54,1,2.22%
2015-09,אזור יהודה והשומרון,3652,בית אריה,יישוב,56,19,37,14,42,2,56,0,2.09%
2015-09,אזור יהודה והשומרון,3780,ביתר עילית,יישוב,621,278,343,11,610,270,618,2,4.61%
2015-09,אזור יהודה והשומרון,3730,גבעת זאב,יישוב,194,95,99,35,159,39,192,1,2.47%
2015-09,אזור יהודה והשומרון,3769,הר אדר,יישוב,28,11,17,17,11,2,28,0,1.32%
2015-09,אזור יהודה והשומרון,76,מ.א. גוש עציון,מועצה איזורית,156,86,70,70,86,13,155,0,1.61%
2015-09,אזור יהודה והשומרון,78,מ.א. הר חברון,מועצה איזורית,65,30,35,19,46,7,64,0,1.83%
2015-09,אזור יהודה והשומרון,74,מ.א. מגילות ים המלח,מועצה איזורית,15,8,7,4,11,1,15,0,1.87%
2015-09,אזור יהודה והשומרון,73,מ.א. מטה בנימין,מועצה איזורית,618,299,319,169,449,130,612,0,2.44%
2015-09,אזור יהודה והשומרון,75,מ.א. ערבות הירדן,מועצה איזורית,44,22,22,13,31,4,43,0,1.77%
2015-09,אזור יהודה והשומרון,72,מ.א. שומרון,מועצה איזורית,401,210,191,122,279,49,397,0,2.35%
2015-09,אזור יהודה והשומרון,3797,מודיעין עילית,יישוב,430,127,303,13,417,41,430,4,3.05%
2015-09,אזור יהודה והשומרון,3616,מעלה אדומים,יישוב,644,288,356,96,548,170,635,11,3.09%
2015-09,אזור יהודה והשומרון,3608,מעלה אפרים,יישוב,29,13,16,2,27,10,29,2,3.52%
2015-09,אזור יהודה והשומרון,3660,עמנואל,יישוב,70,38,32,2,68,37,70,3,5.88%
2015-09,אזור יהודה והשומרון,3557,קדומים,יישוב,42,28,14,14,28,6,41,0,2.18%
2015-09,אזור יהודה והשומרון,3611,קריית ארבע,יישוב,114,55,59,10,104,55,114,3,3.46%
2015-09,אזור יהודה והשומרון,3640,קרני שומרון,יישוב,75,42,33,17,58,7,74,0,1.96%
2015-09,הדרום,31,אופקים,יישוב,1111,443,668,55,1056,619,1086,15,8.02%
2015-09,הדרום,2600,אילת,יישוב,1103,490,613,56,1047,467,1069,30,3.16%
2015-09,הדרום,70,אשדוד,יישוב,5575,2292,3283,691,4884,2710,5393,124,4.90%
2015-09,הדרום,7100,אשקלון,יישוב,3923,1579,2344,419,3504,1973,3490,78,4.90%
2015-09,הדרום,9000,באר שבע,יישוב,6184,2718,3466,807,5377,3451,5985,128,5.61%
2015-09,הדרום,2200,דימונה,יישוב,1858,810,1048,104,1754,1224,1799,43,9.51%
2015-09,הדרום,1303,חורה,יישוב,715,298,417,1,714,639,708,3,16.69%
2015-09,הדרום,831,ירוחם,יישוב,402,199,203,18,384,215,388,17,8.00%
2015-09,הדרום,1059,כסיפה,יישוב,969,367,602,0,969,896,961,1,20.24%
2015-09,הדרום,1271,להבים,יישוב,48,25,23,18,30,5,47,1,1.30%
2015-09,הדרום,1060,לקיה,יישוב,792,343,449,3,789,736,787,1,17.94%
2015-09,הדרום,69,מ.א. אל קסום,מועצה איזורית,709,284,425,9,700,642,702,0,43.47%
2015-09,הדרום,38,מ.א. אשכול,מועצה איזורית,141,63,78,28,113,16,140,0,2.06%
2015-09,הדרום,33,מ.א. באר טוביה,מועצה איזורית,279,110,169,61,218,51,277,0,2.53%
2015-09,הדרום,41,מ.א. בני שמעון,מועצה איזורית,72,25,47,27,45,12,71,0,1.62%
2015-09,הדרום,54,מ.א. הערבה התיכונה,מועצה איזורית,29,11,18,6,23,1,29,0,1.60%
2015-09,הדרום,53,מ.א. חבל אילות,מועצה איזורית,20,11,9,5,15,0,20,3,0.85%
2015-09,הדרום,36,מ.א. חוף אשקלון,מועצה איזורית,212,85,127,32,180,56,207,2,2.50%
2015-09,הדרום,35,מ.א. יואב,מועצה איזורית,88,33,55,31,57,13,88,0,2.21%
2015-09,הדרום,50,מ.א. לכיש,מועצה איזורית,161,66,95,19,142,50,159,0,3.16%
2015-09,הדרום,42,מ.א. מרחבים,מועצה איזורית,179,66,113,23,156,46,176,0,2.98%
2015-09,הדרום,68,מ.א. נווה מדבר,מועצה איזורית,105,43,62,0,105,84,102,0,10.58%
2015-09,הדרום,48,מ.א. רמת נגב,מועצה איזורית,237,124,113,14,223,191,237,0,7.48%
2015-09,הדרום,39,מ.א. שדות נגב,מועצה איזורית,135,58,77,18,117,30,130,0,2.88%
2015-09,הדרום,37,מ.א. שער הנגב,מועצה איזורית,101,41,60,34,67,22,98,0,2.52%
2015-09,הדרום,34,מ.א. שפיר,מועצה איזורית,183,80,103,19,164,62,181,0,3.85%
2015-09,הדרום,51,מ.א. תמר,מועצה איזורית,10,3,7,2,8,2,10,0,1.58%
2015-09,הדרום,1268,מיתר,יישוב,68,27,41,28,40,7,67,1,1.50%
2015-09,הדרום,99,מצפה רמון,יישוב,270,109,161,22,248,167,261,9,9.41%
2015-09,הדרום,246,נתיבות,יישוב,1038,429,609,49,989,482,995,50,6.68%
2015-09,הדרום,666,עומר,יישוב,58,15,43,28,30,3,58,0,1.37%
2015-09,הדרום,2560,ערד,יישוב,708,303,405,71,637,382,688,25,5.58%
2015-09,הדרום,1192,ערערה-בנגב,יישוב,1059,434,625,3,1056,988,1049,0,24.02%
2015-09,הדרום,2630,קריית גת,יישוב,1817,722,1095,112,1705,973,1766,36,6.19%
2015-09,הדרום,1034,קריית מלאכי,יישוב,952,388,564,26,926,511,918,42,7.77%
2015-09,הדרום,1161,רהט,יישוב,2772,1170,1602,11,2761,2368,2750,69,13.71%
2015-09,הדרום,1286,שגב-שלום,יישוב,491,176,315,0,491,407,485,1,16.72%
2015-09,הדרום,1031,שדרות,יישוב,1034,437,597,59,975,571,974,26,7.19%
2015-09,הדרום,1054,תל שבע,יישוב,1025,458,567,6,1019,943,1013,10,19.85%
2015-09,המרכז,1066,"בני עי""ש",יישוב,161,74,87,28,133,62,157,3,3.91%
2015-09,המרכז,182,אבן יהודה,יישוב,137,68,69,40,97,16,137,1,1.99%
2015-09,המרכז,41,אליכין,יישוב,72,40,32,8,64,17,70,0,3.60%
2015-09,המרכז,1309,אלעד,יישוב,412,179,233,15,397,52,406,3,3.12%
2015-09,המרכז,2530,באר יעקב,יישוב,206,85,121,39,167,39,204,2,2.05%
2015-09,המרכז,466,בית דגן,יישוב,92,53,39,10,82,34,90,3,2.43%
2015-09,המרכז,681,גבעת שמואל,יישוב,246,117,129,79,167,48,240,0,1.98%
2015-09,המרכז,2550,גדרה,יישוב,327,130,197,77,250,86,320,3,2.57%
2015-09,המרכז,627,ג'לג'וליה,יישוב,88,37,51,1,87,57,86,0,2.28%
2015-09,המרכז,166,גן יבנה,יישוב,343,129,214,61,282,72,334,4,2.75%
2015-09,המרכז,229,גני תקווה,יישוב,203,83,120,70,133,24,203,0,2.25%
2015-09,המרכז,9700,הוד השרון,יישוב,582,242,340,222,360,50,576,6,1.86%
2015-09,המרכז,1290,זמר,יישוב,139,39,100,2,137,98,138,2,4.65%
2015-09,המרכז,2730,טייבה,יישוב,1337,574,763,21,1316,1078,1201,19,6.80%
2015-09,המרכז,2720,טירה,יישוב,229,103,126,15,214,100,222,10,1.94%
2015-09,המרכז,2660,יבנה,יישוב,811,363,448,139,672,258,806,28,3.29%
2015-09,המרכז,9400,יהוד,יישוב,369,172,197,72,297,49,364,3,2.27%
2015-09,המרכז,1224,כוכב יאיר,יישוב,76,39,37,40,36,1,76,0,1.32%
2015-09,המרכז,633,כפר ברא,יישוב,34,18,16,0,34,15,33,0,2.29%
2015-09,המרכז,168,כפר יונה,יישוב,300,127,173,41,259,45,299,2,2.65%
2015-09,המרכז,6900,כפר סבא,יישוב,1080,494,586,367,713,129,1065,18,2.01%
2015-09,המרכז,634,כפר קאסם,יישוב,203,95,108,6,197,112,200,2,2.17%
2015-09,המרכז,7000,לוד,יישוב,1860,847,1013,155,1705,991,1837,30,5.17%
2015-09,המרכז,28,מ.א. ברנר,מועצה איזורית,77,38,39,33,44,4,77,4,1.89%
2015-09,המרכז,32,מ.א. גדרות,מועצה איזורית,42,14,28,17,25,6,42,0,1.72%
2015-09,המרכז,30,מ.א. גזר,מועצה איזורית,262,114,148,90,172,23,259,0,1.96%
2015-09,המרכז,27,מ.א. גן רווה,מועצה איזורית,44,20,24,13,31,4,44,0,1.50%
2015-09,המרכז,20,מ.א. דרום השרון,מועצה איזורית,291,137,154,123,168,15,288,0,1.84%
2015-09,המרכז,29,מ.א. חבל יבנה,מועצה איזורית,35,12,23,14,21,3,35,0,1.41%
2015-09,המרכז,25,מ.א. חבל מודיעין,מועצה איזורית,210,100,110,63,147,14,209,0,1.95%
2015-09,המרכז,19,מ.א. חוף השרון,מועצה איזורית,95,40,55,34,61,7,95,0,1.69%
2015-09,המרכז,18,מ.א. לב השרון,מועצה איזורית,241,111,130,48,193,30,239,0,2.17%
2015-09,המרכז,31,מ.א. נחל שורק,מועצה איזורית,51,28,23,13,38,6,49,15,1.14%
2015-09,המרכז,16,מ.א. עמק חפר,מועצה איזורית,353,143,210,96,257,18,349,0,1.78%
2015-09,המרכז,40,מ.א. עמק לוד,מועצה איזורית,134,58,76,41,93,14,132,0,2.14%
2015-09,המרכז,1200,מודיעין-מכבים-רעות*,יישוב,852,338,514,314,538,63,846,6,1.88%
2015-09,המרכז,28,מזכרת בתיה,יישוב,161,66,95,44,117,30,161,4,2.14%
2015-09,המרכז,7200,נס ציונה,יישוב,600,267,333,159,441,170,596,4,2.49%
2015-09,המרכז,7400,נתניה,יישוב,4080,1785,2295,393,3687,1315,4002,43,3.78%
2015-09,המרכז,587,סביון*,יישוב,14,7,7,8,6,0,14,0,0.71%
2015-09,המרכז,171,פרדסייה,יישוב,71,30,41,12,59,6,71,0,1.87%
2015-09,המרכז,7900,פתח תקווה,יישוב,3724,1609,2115,781,2943,1002,3653,27,2.90%
2015-09,המרכז,195,קדימה-צורן,יישוב,263,102,161,58,205,34,261,0,2.34%
2015-09,המרכז,638,קלנסווה,יישוב,524,239,285,5,519,406,484,8,5.47%
2015-09,המרכז,469,קריית עקרון,יישוב,248,130,118,15,233,110,244,5,4.04%
2015-09,המרכז,2640,ראש העין,יישוב,687,319,368,87,600,139,684,14,2.70%
2015-09,המרכז,8300,ראשון לציון,יישוב,4063,1721,2342,752,3311,1170,4036,56,2.89%
2015-09,המרכז,8400,רחובות,יישוב,2263,998,1265,505,1758,810,2223,46,3.22%
2015-09,המרכז,8500,רמלה,יישוב,1543,686,857,100,1443,626,1491,55,3.95%
2015-09,המרכז,8700,רעננה,יישוב,694,308,386,263,431,61,682,5,1.84%
2015-09,המרכז,1304,שוהם,יישוב,185,89,96,84,101,10,185,0,1.59%
2015-09,המרכז,154,תל מונד,יישוב,140,63,77,41,99,21,139,0,2.16%
2015-09,הצפון,473,אבו סנאן,יישוב,581,241,340,8,573,457,576,4,9.74%
2015-09,הצפון,478,אכסאל,יישוב,511,225,286,6,505,444,501,0,8.69%
2015-09,הצפון,529,אעבלין,יישוב,536,207,329,8,528,451,528,8,9.06%
2015-09,הצפון,482,בועיינה-נוג'ידאת,יישוב,335,150,185,6,329,283,324,2,8.36%
2015-09,הצפון,4001,בוקעאתא,יישוב,362,131,231,6,356,307,349,1,12.70%
2015-09,הצפון,998,ביר אל-מכסור,יישוב,402,151,251,3,399,320,400,1,10.24%
2015-09,הצפון,480,בית ג'ן,יישוב,348,102,246,11,337,261,340,1,6.07%
2015-09,הצפון,9200,בית שאן,יישוב,797,343,453,21,776,400,778,43,7.54%
2015-09,הצפון,944,בסמת טבעון,יישוב,196,86,110,2,194,147,190,2,5.78%
2015-09,הצפון,483,בענה,יישוב,328,143,185,6,322,284,325,6,9.45%
2015-09,הצפון,1292,ג'דיידה-מכר,יישוב,1182,524,658,6,1176,968,1170,21,12.43%
2015-09,הצפון,485,ג'ולס,יישוב,193,48,145,0,193,139,191,5,6.18%
2015-09,הצפון,487,ג'ש (גוש חלב),יישוב,66,29,37,4,62,36,64,0,3.86%
2015-09,הצפון,489,דבורייה,יישוב,357,156,201,22,335,254,357,0,8.22%
2015-09,הצפון,490,דייר אל-אסד,יישוב,346,152,194,9,337,283,346,4,6.60%
2015-09,הצפון,492,דייר חנא,יישוב,625,270,355,6,619,508,615,0,12.55%
2015-09,הצפון,975,זרזיר,יישוב,246,107,139,6,240,175,240,5,7.29%
2015-09,הצפון,496,חורפיש,יישוב,89,37,52,3,86,59,87,2,3.06%
2015-09,הצפון,2034,חצור הגלילית,יישוב,262,102,160,14,248,133,248,6,5.07%
2015-09,הצפון,6700,טבריה,יישוב,1557,695,862,88,1469,889,1377,43,6.28%
2015-09,הצפון,962,טובא-זנגרייה,יישוב,350,158,192,6,344,235,342,0,11.24%
2015-09,הצפון,498,טורעאן,יישוב,480,183,297,10,470,392,462,0,8.01%
2015-09,הצפון,8900,טמרה,יישוב,1741,772,969,31,1710,1483,1720,30,11.89%
2015-09,הצפון,1295,יאנוח-ג'ת,יישוב,128,44,84,3,125,87,127,0,4.35%
2015-09,הצפון,46,יבנאל,יישוב,102,63,39,5,97,77,81,1,5.15%
2015-09,הצפון,29,יסוד המעלה,יישוב,14,4,10,2,12,2,14,0,1.64%
2015-09,הצפון,499,יפיע,יישוב,592,262,330,30,562,457,580,4,7.28%
2015-09,הצפון,240,יקנעם עילית,יישוב,444,169,275,80,364,127,435,18,3.58%
2015-09,הצפון,502,ירכא,יישוב,527,224,303,1,526,401,522,9,8.06%
2015-09,הצפון,504,כאבול,יישוב,622,266,356,10,612,533,616,10,12.21%
2015-09,הצפון,505,כאוכב אבו אל-היג'א,יישוב,215,83,132,5,210,186,210,0,12.07%
2015-09,הצפון,1296,כסרא-סמיע,יישוב,180,67,113,4,176,124,177,4,5.06%
2015-09,הצפון,978,כעביה-טבאש-חג'אג'רה,יישוב,184,70,114,5,179,130,178,0,7.52%
2015-09,הצפון,1263,כפר ורדים,יישוב,66,29,37,29,37,8,65,1,2.11%
2015-09,הצפון,507,כפר יאסיף,יישוב,379,165,214,3,376,281,373,7,7.34%
2015-09,הצפון,508,כפר כמא,יישוב,56,25,31,6,50,25,56,1,3.31%
2015-09,הצפון,509,כפר כנא,יישוב,1077,458,619,26,1051,916,1000,12,11.24%
2015-09,הצפון,510,כפר מנדא,יישוב,918,426,492,6,912,671,882,1,11.94%
2015-09,הצפון,47,כפר תבור,יישוב,43,12,31,19,24,2,43,0,1.88%
2015-09,הצפון,1139,כרמיאל,יישוב,1415,571,844,259,1156,712,1362,24,5.23%
2015-09,הצפון,65,מ.א. אל-בטוף,מועצה איזורית,325,137,188,7,318,265,316,0,10.92%
2015-09,הצפון,66,מ.א. בוסתן אל-מרג',מועצה איזורית,43,17,26,1,42,35,42,0,1.37%
2015-09,הצפון,71,מ.א. גולן,מועצה איזורית,178,81,97,29,149,17,177,1,2.06%
2015-09,הצפון,8,מ.א. הגלבוע,מועצה איזורית,780,285,495,69,711,452,771,0,5.35%
2015-09,הצפון,1,מ.א. הגליל העליון,מועצה איזורית,176,78,98,53,123,26,174,0,1.97%
2015-09,הצפון,3,מ.א. הגליל התחתון,מועצה איזורית,127,43,84,41,86,16,121,0,2.07%
2015-09,הצפון,55,מ.א. מבואות החרמון,מועצה איזורית,100,39,61,26,74,15,98,0,2.46%
2015-09,הצפון,13,מ.א. מגידו,מועצה איזורית,93,41,52,32,61,5,93,0,1.64%
2015-09,הצפון,4,מ.א. מטה אשר,מועצה איזורית,377,164,213,53,324,164,368,0,2.68%
2015-09,הצפון,52,מ.א. מעלה יוסף,מועצה איזורית,162,79,83,23,139,51,160,0,2.90%
2015-09,הצפון,2,מ.א. מרום הגליל,מועצה איזורית,272,123,149,23,249,124,262,0,3.84%
2015-09,הצפון,56,מ.א. משגב,מועצה איזורית,524,205,319,96,428,275,507,0,3.90%
2015-09,הצפון,6,מ.א. עמק הירדן,מועצה איזורית,147,54,93,35,112,26,139,0,2.06%
2015-09,הצפון,7,מ.א. עמק המעיינות,מועצה איזורית,181,80,101,34,147,38,177,0,2.73%
2015-09,הצפון,9,מ.א. עמק יזרעאל,מועצה איזורית,371,134,237,165,206,32,370,0,1.91%
2015-09,הצפון,481,מגאר,יישוב,1316,527,789,20,1296,1142,1293,1,13.10%
2015-09,הצפון,516,מג'ד אל-כרום,יישוב,491,217,274,12,479,369,481,5,7.20%
2015-09,הצפון,65,מגדל,יישוב,28,10,18,2,26,11,24,0,2.56%
2015-09,הצפון,874,מגדל העמק,יישוב,818,341,477,79,739,313,773,51,5.68%
2015-09,הצפון,4201,מג'דל שמס,יישוב,448,162,286,11,437,351,428,3,8.69%
2015-09,הצפון,517,מזרעה,יישוב,156,67,89,0,156,119,151,5,7.61%
2015-09,הצפון,43,מטולה,יישוב,21,16,5,5,16,6,21,0,2.01%
2015-09,הצפון,4203,מסעדה,יישוב,196,70,126,6,190,166,190,0,11.18%
2015-09,הצפון,518,מעיליא,יישוב,42,24,18,11,31,17,42,0,2.61%
2015-09,הצפון,1063,מעלות-תרשיחא,יישוב,771,334,437,99,672,414,756,27,6.39%
2015-09,הצפון,520,משהד,יישוב,256,106,150,4,252,211,243,1,7.49%
2015-09,הצפון,9100,נהרייה,יישוב,1730,787,943,185,1545,984,1668,54,5.39%
2015-09,הצפון,522,נחף,יישוב,368,169,199,15,353,306,361,6,7.11%
2015-09,הצפון,7300,נצרת,יישוב,3151,1369,1782,108,3043,2451,3079,12,8.85%
2015-09,הצפון,1061,נצרת עילית,יישוב,1664,714,950,148,1516,848,1503,74,6.43%
2015-09,הצפון,525,סאג'ור,יישוב,93,35,58,4,89,67,91,1,4.64%
2015-09,הצפון,7500,סח'נין,יישוב,2145,914,1231,28,2117,1832,2112,1,14.77%
2015-09,הצפון,4501,ע'ג'ר,יישוב,87,31,56,1,86,60,87,0,8.24%
2015-09,הצפון,530,עיילבון,יישוב,161,64,97,9,152,112,161,0,5.82%
2015-09,הצפון,511,עילוט,יישוב,326,136,190,6,320,260,322,2,11.12%
2015-09,הצפון,532,עין מאהל,יישוב,468,222,246,9,459,379,457,0,8.61%
2015-09,הצפון,4502,עין קנייא,יישוב,148,55,93,1,147,124,139,2,13.50%
2015-09,הצפון,7600,עכו,יישוב,2886,1289,1597,117,2769,2139,2824,48,10.62%
2015-09,הצפון,7700,עפולה,יישוב,1532,621,911,156,1376,671,1486,50,5.80%
2015-09,הצפון,531,עראבה,יישוב,1572,667,905,34,1538,1381,1550,1,14.92%
2015-09,הצפון,535,פסוטה,יישוב,101,37,64,7,94,63,100,0,5.78%
2015-09,הצפון,536,פקיעין (בוקייעה),יישוב,100,54,46,4,96,66,98,1,3.51%
2015-09,הצפון,8000,צפת,יישוב,1314,700,614,76,1238,931,1242,33,9.11%
2015-09,הצפון,4100,קצרין,יישוב,191,81,110,29,162,84,188,2,4.67%
2015-09,הצפון,2800,קריית שמונה,יישוב,684,310,374,65,619,309,653,19,5.00%
2015-09,הצפון,543,ראמה,יישוב,253,104,149,11,242,190,248,3,6.35%
2015-09,הצפון,26,ראש פינה,יישוב,43,11,32,9,34,13,41,1,2.56%
2015-09,הצפון,542,ריינה,יישוב,590,248,342,13,577,474,562,6,8.16%
2015-09,הצפון,122,רמת ישי,יישוב,86,33,53,28,58,14,85,1,2.04%
2015-09,הצפון,913,שבלי - אום אל-גנם,יישוב,186,84,102,7,179,133,184,0,6.97%
2015-09,הצפון,812,שלומי,יישוב,213,91,122,11,202,97,209,4,5.79%
2015-09,הצפון,538,שעב,יישוב,532,216,316,4,528,466,529,1,16.94%
2015-09,הצפון,8800,שפרעם,יישוב,1835,717,1118,31,1804,1511,1808,19,9.83%
2015-09,חיפה,1326,"בסמ""ה",יישוב,394,173,221,2,392,310,391,1,9.60%
2015-09,חיפה,2710,אום אל-פחם,יישוב,3425,1417,2008,30,3395,2895,3369,31,15.60%
2015-09,חיפה,1020,אור עקיבא,יישוב,475,214,261,41,434,173,451,14,4.43%
2015-09,חיפה,6000,באקה אל-גרביה,יישוב,601,279,322,11,590,348,595,11,5.05%
2015-09,חיפה,9800,בנימינה-גבעת עדה*,יישוב,181,87,94,47,134,60,181,1,2.48%
2015-09,חיפה,541,ג'סר א-זרקא,יישוב,428,222,206,2,426,289,427,5,7.01%
2015-09,חיפה,628,ג'ת,יישוב,209,103,106,5,204,122,207,5,3.91%
2015-09,חיפה,494,דאלית אל-כרמל,יישוב,448,165,283,13,435,256,429,4,5.18%
2015-09,חיפה,9300,זכרון יעקב,יישוב,241,104,137,76,165,51,239,1,2.15%
2015-09,חיפה,6500,חדרה,יישוב,2223,882,1341,294,1929,771,2090,42,4.16%
2015-09,חיפה,4000,חיפה,יישוב,5759,2762,2997,1105,4654,2967,5512,89,3.94%
2015-09,חיפה,1247,חריש,יישוב,25,15,10,4,21,9,23,0,1.44%
2015-09,חיפה,2100,טירת כרמל,יישוב,679,318,361,37,642,378,666,17,5.89%
2015-09,חיפה,654,כפר קרע,יישוב,390,171,219,7,383,236,386,0,4.50%
2015-09,חיפה,45,מ.א. אלונה,מועצה איזורית,20,7,13,6,14,5,19,0,1.78%
2015-09,חיפה,12,מ.א. זבולון,מועצה איזורית,253,114,139,23,230,165,250,0,4.49%
2015-09,חיפה,15,מ.א. חוף הכרמל,מועצה איזורית,285,131,154,82,203,64,284,0,2.01%
2015-09,חיפה,14,מ.א. מנשה,מועצה איזורית,236,109,127,56,180,70,234,0,2.92%
2015-09,חיפה,1327,מעלה עירון,יישוב,837,305,532,6,831,704,829,3,13.83%
2015-09,חיפה,2500,נשר,יישוב,425,205,220,88,337,160,415,8,3.24%
2015-09,חיפה,534,עספיא,יישוב,286,116,170,12,274,154,275,3,4.86%
2015-09,חיפה,637,ערערה,יישוב,559,232,327,8,551,344,549,4,6.72%
2015-09,חיפה,537,פוריידיס,יישוב,404,195,209,10,394,258,400,1,7.00%
2015-09,חיפה,7800,פרדס חנה-כרכור,יישוב,789,330,459,144,645,242,777,17,3.81%
2015-09,חיפה,6800,קריית אתא,יישוב,1462,660,802,131,1331,795,1425,32,4.68%
2015-09,חיפה,9500,קריית ביאליק,יישוב,953,395,558,123,830,460,937,18,4.37%
2015-09,חיפה,2300,קריית טבעון,יישוב,160,64,96,64,96,33,158,1,1.89%
2015-09,חיפה,9600,קריית ים,יישוב,1392,630,762,134,1258,785,1357,21,6.32%
2015-09,חיפה,8200,קריית מוצקין,יישוב,970,410,560,139,831,438,948,14,4.11%
2015-09,חיפה,922,רכסים,יישוב,167,68,99,14,153,77,150,1,4.20%
2015-09,ירושלים,472,אבו גוש,יישוב,254,128,126,8,246,176,252,3,8.10%
2015-09,ירושלים,2610,בית שמש,יישוב,1347,534,813,100,1247,469,1309,23,3.86%
2015-09,ירושלים,3000,ירושלים,יישוב,12130,5348,6782,1287,10843,7443,11877,118,3.98%
2015-09,ירושלים,26,מ.א. מטה יהודה,מועצה איזורית,539,241,298,107,432,126,526,1,2.20%
2015-09,ירושלים,1015,מבשרת ציון,יישוב,343,183,160,67,276,130,337,2,2.59%
2015-09,ירושלים,1137,קריית יערים,יישוב,43,14,29,10,33,13,43,0,3.02%
2015-09,תל אביב,2400,אור יהודה,יישוב,641,299,342,42,599,168,624,24,3.28%
2015-09,תל אביב,565,אזור,יישוב,166,77,89,19,147,27,165,0,2.51%
2015-09,תל אביב,6100,בני ברק,יישוב,2028,874,1154,93,1935,871,1947,10,3.38%
2015-09,תל אביב,6200,בת ים,יישוב,2583,1185,1398,361,2222,950,2489,63,3.54%
2015-09,תל אביב,6300,גבעתיים,יישוב,664,297,367,280,384,80,659,3,2.14%
2015-09,תל אביב,6400,הרצלייה,יישוב,976,385,591,345,631,37,967,27,1.98%
2015-09,תל אביב,6600,חולון,יישוב,2771,1267,1504,456,2315,650,2721,24,2.74%
2015-09,תל אביב,267,כפר שמריהו,יישוב,8,3,5,5,3,0,8,0,0.95%
2015-09,תל אביב,2620,קריית אונו,יישוב,367,156,211,155,212,32,367,2,1.92%
2015-09,תל אביב,8600,רמת גן,יישוב,1858,848,1010,609,1249,393,1835,21,2.34%
2015-09,תל אביב,2650,רמת השרון,יישוב,338,107,231,153,185,9,335,4,1.50%
2015-09,תל אביב,5000,תל אביב -יפו,יישוב,6498,3157,3341,2133,4365,1787,6401,82,2.52%
2015-10,אזור יהודה והשומרון,3760,אורנית,יישוב,106,51,55,42,64,4,106,1,2.17%
2015-10,אזור יהודה והשומרון,3750,אלפי מנשה,יישוב,95,44,51,29,66,2,94,0,2.13%
2015-10,אזור יהודה והשומרון,3560,אלקנה,יישוב,40,18,22,15,25,0,40,0,2.10%
2015-10,אזור יהודה והשומרון,3650,אפרת,יישוב,56,26,30,27,29,4,56,2,1.30%
2015-10,אזור יהודה והשומרון,3570,אריאל,יישוב,348,145,203,86,262,52,346,11,3.19%
2015-10,אזור יהודה והשומרון,3574,בית אל,יישוב,56,35,21,13,43,19,55,1,2.26%
2015-10,אזור יהודה והשומרון,3652,בית אריה,יישוב,56,23,33,16,40,2,56,0,2.09%
2015-10,אזור יהודה והשומרון,3780,ביתר עילית,יישוב,618,300,318,12,606,283,614,1,4.58%
2015-10,אזור יהודה והשומרון,3730,גבעת זאב,יישוב,210,92,118,41,169,44,208,3,2.67%
2015-10,אזור יהודה והשומרון,3769,הר אדר,יישוב,40,17,23,20,20,4,40,0,1.88%
2015-10,אזור יהודה והשומרון,76,מ.א. גוש עציון,מועצה איזורית,167,87,80,75,92,15,165,0,1.71%
2015-10,אזור יהודה והשומרון,78,מ.א. הר חברון,מועצה איזורית,74,32,42,22,52,7,73,0,2.08%
2015-10,אזור יהודה והשומרון,74,מ.א. מגילות ים המלח,מועצה איזורית,15,7,8,4,11,1,15,0,1.88%
2015-10,אזור יהודה והשומרון,73,מ.א. מטה בנימין,מועצה איזורית,653,313,340,188,465,135,645,0,2.57%
2015-10,אזור יהודה והשומרון,75,מ.א. ערבות הירדן,מועצה איזורית,46,22,24,13,33,4,46,0,1.89%
2015-10,אזור יהודה והשומרון,72,מ.א. שומרון,מועצה איזורית,417,227,190,129,288,39,414,0,2.45%
2015-10,אזור יהודה והשומרון,3797,מודיעין עילית,יישוב,399,142,257,15,384,48,397,5,2.82%
2015-10,אזור יהודה והשומרון,3616,מעלה אדומים,יישוב,660,283,377,93,567,182,655,19,3.18%
2015-10,אזור יהודה והשומרון,3608,מעלה אפרים,יישוב,31,13,18,3,28,8,31,0,3.75%
2015-10,אזור יהודה והשומרון,3660,עמנואל,יישוב,67,39,28,2,65,36,67,0,5.64%
2015-10,אזור יהודה והשומרון,3557,קדומים,יישוב,40,28,12,14,26,5,40,0,2.12%
2015-10,אזור יהודה והשומרון,3611,קריית ארבע,יישוב,118,59,59,12,106,55,118,4,3.58%
2015-10,אזור יהודה והשומרון,3640,קרני שומרון,יישוב,75,43,32,15,60,8,74,2,1.96%
2015-10,הדרום,31,אופקים,יישוב,1099,451,648,57,1042,610,1074,44,7.94%
2015-10,הדרום,2600,אילת,יישוב,1221,584,637,57,1164,496,1173,51,3.46%
2015-10,הדרום,70,אשדוד,יישוב,5864,2462,3402,734,5130,2768,5653,214,5.13%
2015-10,הדרום,7100,אשקלון,יישוב,4107,1673,2434,428,3679,2037,3648,114,5.11%
2015-10,הדרום,9000,באר שבע,יישוב,6393,2840,3553,827,5566,3485,6165,158,5.77%
2015-10,הדרום,2200,דימונה,יישוב,1929,851,1078,109,1820,1235,1854,61,9.77%
2015-10,הדרום,1303,חורה,יישוב,741,310,431,0,741,654,731,5,17.14%
2015-10,הדרום,831,ירוחם,יישוב,415,202,213,16,399,223,399,27,8.21%
2015-10,הדרום,1059,כסיפה,יישוב,988,381,607,0,988,916,982,16,20.59%
2015-10,הדרום,1271,להבים,יישוב,47,25,22,16,31,5,46,1,1.27%
2015-10,הדרום,1060,לקיה,יישוב,788,330,458,1,787,735,779,8,17.79%
2015-10,הדרום,69,מ.א. אל קסום,מועצה איזורית,722,281,441,12,710,652,709,0,43.90%
2015-10,הדרום,38,מ.א. אשכול,מועצה איזורית,155,70,85,32,123,14,154,0,2.26%
2015-10,הדרום,33,מ.א. באר טוביה,מועצה איזורית,288,116,172,56,232,50,285,0,2.60%
2015-10,הדרום,41,מ.א. בני שמעון,מועצה איזורית,68,20,48,25,43,11,67,0,1.53%
2015-10,הדרום,54,מ.א. הערבה התיכונה,מועצה איזורית,32,9,23,8,24,3,31,0,1.71%
2015-10,הדרום,53,מ.א. חבל אילות,מועצה איזורית,23,15,8,5,18,0,23,3,0.97%
2015-10,הדרום,36,מ.א. חוף אשקלון,מועצה איזורית,213,88,125,31,182,52,207,0,2.50%
2015-10,הדרום,35,מ.א. יואב,מועצה איזורית,85,40,45,28,57,13,85,0,2.14%
2015-10,הדרום,50,מ.א. לכיש,מועצה איזורית,171,68,103,19,152,49,169,0,3.36%
2015-10,הדרום,42,מ.א. מרחבים,מועצה איזורית,185,70,115,19,166,43,181,0,3.06%
2015-10,הדרום,68,מ.א. נווה מדבר,מועצה איזורית,103,39,64,0,103,82,102,0,10.58%
2015-10,הדרום,48,מ.א. רמת נגב,מועצה איזורית,251,131,120,16,235,198,251,0,7.92%
2015-10,הדרום,39,מ.א. שדות נגב,מועצה איזורית,132,57,75,16,116,34,125,0,2.77%
2015-10,הדרום,37,מ.א. שער הנגב,מועצה איזורית,112,48,64,37,75,22,109,0,2.81%
2015-10,הדרום,34,מ.א. שפיר,מועצה איזורית,184,83,101,19,165,64,182,0,3.88%
2015-10,הדרום,51,מ.א. תמר,מועצה איזורית,12,4,8,3,9,2,12,0,1.90%
2015-10,הדרום,1268,מיתר,יישוב,74,29,45,33,41,9,74,0,1.66%
2015-10,הדרום,99,מצפה רמון,יישוב,282,113,169,25,257,171,273,18,9.80%
2015-10,הדרום,246,נתיבות,יישוב,1023,428,595,39,984,485,986,51,6.62%
2015-10,הדרום,666,עומר,יישוב,65,23,42,25,40,3,64,1,1.51%
2015-10,הדרום,2560,ערד,יישוב,748,333,415,85,663,387,723,32,5.85%
2015-10,הדרום,1192,ערערה-בנגב,יישוב,1062,438,624,2,1060,989,1048,10,24.00%
2015-10,הדרום,2630,קריית גת,יישוב,1944,803,1141,115,1829,993,1880,55,6.56%
2015-10,הדרום,1034,קריית מלאכי,יישוב,1046,450,596,23,1023,512,1007,78,8.46%
2015-10,הדרום,1161,רהט,יישוב,2788,1209,1579,7,2781,2396,2745,36,13.69%
2015-10,הדרום,1286,שגב-שלום,יישוב,483,182,301,3,480,415,476,8,16.46%
2015-10,הדרום,1031,שדרות,יישוב,1075,478,597,60,1015,565,1013,46,7.46%
2015-10,הדרום,1054,תל שבע,יישוב,1024,461,563,7,1017,940,1015,23,19.89%
2015-10,המרכז,1066,"בני עי""ש",יישוב,156,73,83,26,130,58,153,1,3.82%
2015-10,המרכז,182,אבן יהודה,יישוב,145,73,72,43,102,19,145,1,2.11%
2015-10,המרכז,41,אליכין,יישוב,72,39,33,8,64,17,71,0,3.65%
2015-10,המרכז,1309,אלעד,יישוב,395,175,220,16,379,53,389,3,2.99%
2015-10,המרכז,2530,באר יעקב,יישוב,224,87,137,51,173,44,222,1,2.22%
2015-10,המרכז,466,בית דגן,יישוב,87,53,34,10,77,34,86,2,2.32%
2015-10,המרכז,681,גבעת שמואל,יישוב,266,136,130,83,183,53,260,2,2.14%
2015-10,המרכז,2550,גדרה,יישוב,333,132,201,69,264,94,326,9,2.61%
2015-10,המרכז,627,ג'לג'וליה,יישוב,91,36,55,2,89,58,86,2,2.28%
2015-10,המרכז,166,גן יבנה,יישוב,334,126,208,60,274,74,326,7,2.69%
2015-10,המרכז,229,גני תקווה,יישוב,199,85,114,66,133,28,196,1,2.17%
2015-10,המרכז,9700,הוד השרון,יישוב,634,259,375,245,389,52,623,13,2.01%
2015-10,המרכז,1290,זמר,יישוב,144,44,100,2,142,99,143,1,4.81%
2015-10,המרכז,2730,טייבה,יישוב,1240,555,685,17,1223,1017,1112,17,6.33%
2015-10,המרכז,2720,טירה,יישוב,216,101,115,12,204,100,211,6,1.85%
2015-10,המרכז,2660,יבנה,יישוב,809,397,412,126,683,256,800,39,3.26%
2015-10,המרכז,9400,יהוד,יישוב,388,180,208,88,300,52,381,9,2.37%
2015-10,המרכז,1224,כוכב יאיר,יישוב,76,37,39,38,38,0,76,0,1.32%
2015-10,המרכז,633,כפר ברא,יישוב,32,19,13,0,32,11,31,0,2.16%
2015-10,המרכז,168,כפר יונה,יישוב,318,132,186,50,268,45,317,1,2.81%
2015-10,המרכז,6900,כפר סבא,יישוב,1183,533,650,401,782,129,1167,25,2.20%
2015-10,המרכז,634,כפר קאסם,יישוב,204,96,108,6,198,118,199,2,2.16%
2015-10,המרכז,7000,לוד,יישוב,1936,896,1040,152,1784,1025,1908,50,5.36%
2015-10,המרכז,28,מ.א. ברנר,מועצה איזורית,81,38,43,34,47,3,81,0,1.99%
2015-10,המרכז,32,מ.א. גדרות,מועצה איזורית,46,17,29,16,30,5,46,0,1.88%
2015-10,המרכז,30,מ.א. גזר,מועצה איזורית,278,125,153,100,178,22,277,0,2.10%
2015-10,המרכז,27,מ.א. גן רווה,מועצה איזורית,46,24,22,14,32,4,46,0,1.57%
2015-10,המרכז,20,מ.א. דרום השרון,מועצה איזורית,298,138,160,123,175,17,294,0,1.88%
2015-10,המרכז,29,מ.א. חבל יבנה,מועצה איזורית,37,17,20,15,22,3,37,0,1.49%
2015-10,המרכז,25,מ.א. חבל מודיעין,מועצה איזורית,223,109,114,67,156,16,221,0,2.06%
2015-10,המרכז,19,מ.א. חוף השרון,מועצה איזורית,93,40,53,36,57,5,93,0,1.66%
2015-10,המרכז,18,מ.א. לב השרון,מועצה איזורית,262,121,141,46,216,29,261,1,2.37%
2015-10,המרכז,31,מ.א. נחל שורק,מועצה איזורית,58,29,29,12,46,8,56,44,1.31%
2015-10,המרכז,16,מ.א. עמק חפר,מועצה איזורית,379,156,223,101,278,19,377,0,1.92%
2015-10,המרכז,40,מ.א. עמק לוד,מועצה איזורית,133,57,76,37,96,17,132,0,2.14%
2015-10,המרכז,1200,מודיעין-מכבים-רעות*,יישוב,908,378,530,345,563,62,898,15,1.99%
2015-10,המרכז,28,מזכרת בתיה,יישוב,168,71,97,48,120,29,168,0,2.23%
2015-10,המרכז,7200,נס ציונה,יישוב,657,296,361,170,487,176,651,10,2.72%
2015-10,המרכז,7400,נתניה,יישוב,4380,1945,2435,416,3964,1394,4281,53,4.04%
2015-10,המרכז,587,סביון*,יישוב,16,7,9,8,8,0,16,0,0.81%
2015-10,המרכז,171,פרדסייה,יישוב,75,37,38,14,61,7,74,0,1.95%
2015-10,המרכז,7900,פתח תקווה,יישוב,3857,1692,2165,797,3060,1001,3784,51,3.00%
2015-10,המרכז,195,קדימה-צורן,יישוב,274,113,161,58,216,36,272,0,2.44%
2015-10,המרכז,638,קלנסווה,יישוב,515,234,281,5,510,399,472,9,5.34%
2015-10,המרכז,469,קריית עקרון,יישוב,268,145,123,12,256,114,264,10,4.36%
2015-10,המרכז,2640,ראש העין,יישוב,774,363,411,95,679,145,765,21,3.01%
2015-10,המרכז,8300,ראשון לציון,יישוב,4252,1842,2410,792,3460,1194,4219,71,3.02%
2015-10,המרכז,8400,רחובות,יישוב,2379,1059,1320,525,1854,819,2333,67,3.38%
2015-10,המרכז,8500,רמלה,יישוב,1646,757,889,104,1542,673,1577,52,4.17%
2015-10,המרכז,8700,רעננה,יישוב,711,322,389,260,451,55,706,7,1.90%
2015-10,המרכז,1304,שוהם,יישוב,189,81,108,84,105,11,189,0,1.62%
2015-10,המרכז,154,תל מונד,יישוב,152,70,82,40,112,21,152,0,2.36%
2015-10,הצפון,473,אבו סנאן,יישוב,595,258,337,9,586,464,588,15,9.93%
2015-10,הצפון,478,אכסאל,יישוב,515,227,288,8,507,448,506,2,8.77%
2015-10,הצפון,529,אעבלין,יישוב,540,206,334,8,532,452,535,9,9.17%
2015-10,הצפון,482,בועיינה-נוג'ידאת,יישוב,350,149,201,7,343,297,339,3,8.72%
2015-10,הצפון,4001,בוקעאתא,יישוב,363,135,228,4,359,302,347,4,12.63%
2015-10,הצפון,998,ביר אל-מכסור,יישוב,394,153,241,2,392,314,390,4,10.01%
2015-10,הצפון,480,בית ג'ן,יישוב,367,114,253,8,359,271,358,0,6.38%
2015-10,הצפון,9200,בית שאן,יישוב,849,374,475,28,821,408,833,56,8.04%
2015-10,הצפון,944,בסמת טבעון,יישוב,204,92,112,2,202,160,193,3,5.86%
2015-10,הצפון,483,בענה,יישוב,338,146,192,6,332,294,334,7,9.68%
2015-10,הצפון,1292,ג'דיידה-מכר,יישוב,1212,541,671,8,1204,991,1195,27,12.67%
2015-10,הצפון,485,ג'ולס,יישוב,196,51,145,0,196,137,194,4,6.27%
2015-10,הצפון,487,ג'ש (גוש חלב),יישוב,62,27,35,2,60,33,60,2,3.63%
2015-10,הצפון,489,דבורייה,יישוב,344,154,190,19,325,249,343,2,7.93%
2015-10,הצפון,490,דייר אל-אסד,יישוב,352,147,205,8,344,293,351,9,6.69%
2015-10,הצפון,492,דייר חנא,יישוב,628,268,360,8,620,498,619,0,12.62%
2015-10,הצפון,975,זרזיר,יישוב,249,113,136,6,243,171,243,9,7.37%
2015-10,הצפון,496,חורפיש,יישוב,98,39,59,10,88,59,94,0,3.30%
2015-10,הצפון,2034,חצור הגלילית,יישוב,298,116,182,12,286,136,281,7,5.71%
2015-10,הצפון,6700,טבריה,יישוב,1633,747,886,96,1537,913,1436,63,6.53%
2015-10,הצפון,962,טובא-זנגרייה,יישוב,354,158,196,4,350,241,345,2,11.32%
2015-10,הצפון,498,טורעאן,יישוב,487,197,290,11,476,386,462,5,8.01%
2015-10,הצפון,8900,טמרה,יישוב,1680,761,919,27,1653,1432,1663,18,11.54%
2015-10,הצפון,1295,יאנוח-ג'ת,יישוב,143,52,91,1,142,93,142,2,4.83%
2015-10,הצפון,46,יבנאל,יישוב,112,65,47,6,106,80,90,0,5.69%
2015-10,הצפון,29,יסוד המעלה,יישוב,12,4,8,2,10,2,12,0,1.41%
2015-10,הצפון,499,יפיע,יישוב,606,276,330,26,580,469,590,3,7.40%
2015-10,הצפון,240,יקנעם עילית,יישוב,465,183,282,76,389,115,458,24,3.76%
2015-10,הצפון,502,ירכא,יישוב,542,230,312,1,541,404,537,14,8.27%
2015-10,הצפון,504,כאבול,יישוב,616,267,349,9,607,525,612,7,12.14%
2015-10,הצפון,505,כאוכב אבו אל-היג'א,יישוב,208,82,126,3,205,183,208,0,11.97%
2015-10,הצפון,1296,כסרא-סמיע,יישוב,195,78,117,4,191,135,188,1,5.36%
2015-10,הצפון,978,כעביה-טבאש-חג'אג'רה,יישוב,187,73,114,5,182,137,181,1,7.63%
2015-10,הצפון,1263,כפר ורדים,יישוב,70,30,40,25,45,10,69,0,2.24%
2015-10,הצפון,507,כפר יאסיף,יישוב,398,181,217,3,395,290,393,10,7.70%
2015-10,הצפון,508,כפר כמא,יישוב,62,25,37,6,56,28,60,0,3.54%
2015-10,הצפון,509,כפר כנא,יישוב,1074,446,628,28,1046,917,1015,25,11.39%
2015-10,הצפון,510,כפר מנדא,יישוב,872,408,464,6,866,665,846,2,11.51%
2015-10,הצפון,47,כפר תבור,יישוב,47,13,34,20,27,1,47,0,2.05%
2015-10,הצפון,1139,כרמיאל,יישוב,1518,613,905,258,1260,720,1440,46,5.51%
2015-10,הצפון,65,מ.א. אל-בטוף,מועצה איזורית,343,145,198,9,334,277,331,1,11.42%
2015-10,הצפון,66,מ.א. בוסתן אל-מרג',מועצה איזורית,40,14,26,0,40,33,39,0,1.27%
2015-10,הצפון,71,מ.א. גולן,מועצה איזורית,185,79,106,29,156,21,184,0,2.14%
2015-10,הצפון,8,מ.א. הגלבוע,מועצה איזורית,784,298,486,76,708,447,778,0,5.40%
2015-10,הצפון,1,מ.א. הגליל העליון,מועצה איזורית,198,81,117,53,145,29,197,0,2.23%
2015-10,הצפון,3,מ.א. הגליל התחתון,מועצה איזורית,117,41,76,42,75,14,111,0,1.90%
2015-10,הצפון,55,מ.א. מבואות החרמון,מועצה איזורית,98,37,61,22,76,17,95,0,2.38%
2015-10,הצפון,13,מ.א. מגידו,מועצה איזורית,105,46,59,35,70,2,105,0,1.85%
2015-10,הצפון,4,מ.א. מטה אשר,מועצה איזורית,418,186,232,62,356,168,410,0,2.99%
2015-10,הצפון,52,מ.א. מעלה יוסף,מועצה איזורית,182,82,100,28,154,52,178,0,3.22%
2015-10,הצפון,2,מ.א. מרום הגליל,מועצה איזורית,279,134,145,22,257,125,270,0,3.95%
2015-10,הצפון,56,מ.א. משגב,מועצה איזורית,564,221,343,95,469,290,549,0,4.23%
2015-10,הצפון,6,מ.א. עמק הירדן,מועצה איזורית,158,65,93,31,127,32,150,0,2.22%
2015-10,הצפון,7,מ.א. עמק המעיינות,מועצה איזורית,194,83,111,38,156,39,191,0,2.95%
2015-10,הצפון,9,מ.א. עמק יזרעאל,מועצה איזורית,410,160,250,186,224,30,406,0,2.10%
2015-10,הצפון,481,מגאר,יישוב,1307,524,783,20,1287,1128,1288,3,13.06%
2015-10,הצפון,516,מג'ד אל-כרום,יישוב,510,225,285,14,496,380,504,16,7.52%
2015-10,הצפון,65,מגדל,יישוב,33,11,22,3,30,12,30,1,3.18%
2015-10,הצפון,874,מגדל העמק,יישוב,906,368,538,86,820,333,849,63,6.20%
2015-10,הצפון,4201,מג'דל שמס,יישוב,455,166,289,9,446,354,424,5,8.61%
2015-10,הצפון,517,מזרעה,יישוב,158,67,91,0,158,122,147,5,7.42%
2015-10,הצפון,43,מטולה,יישוב,24,15,9,7,17,6,24,0,2.29%
2015-10,הצפון,4203,מסעדה,יישוב,197,73,124,4,193,162,189,0,11.13%
2015-10,הצפון,518,מעיליא,יישוב,46,29,17,11,35,18,45,1,2.79%
2015-10,הצפון,1063,מעלות-תרשיחא,יישוב,874,405,469,109,765,435,857,29,7.19%
2015-10,הצפון,520,משהד,יישוב,256,111,145,4,252,218,243,2,7.49%
2015-10,הצפון,9100,נהרייה,יישוב,1889,868,1021,210,1679,1042,1824,78,5.87%
2015-10,הצפון,522,נחף,יישוב,374,177,197,17,357,303,371,8,7.30%
2015-10,הצפון,7300,נצרת,יישוב,3171,1397,1774,117,3054,2470,3102,24,8.91%
2015-10,הצפון,1061,נצרת עילית,יישוב,1745,781,964,150,1595,865,1580,107,6.74%
2015-10,הצפון,525,סאג'ור,יישוב,101,37,64,4,97,67,99,3,5.03%
2015-10,הצפון,7500,סח'נין,יישוב,2149,910,1239,29,2120,1823,2126,6,14.86%
2015-10,הצפון,4501,ע'ג'ר,יישוב,87,33,54,1,86,60,87,0,8.24%
2015-10,הצפון,530,עיילבון,יישוב,161,66,95,8,153,109,161,0,5.82%
2015-10,הצפון,511,עילוט,יישוב,327,135,192,5,322,261,322,3,11.12%
2015-10,הצפון,532,עין מאהל,יישוב,477,231,246,10,467,381,466,4,8.77%
2015-10,הצפון,4502,עין קנייא,יישוב,148,55,93,1,147,123,138,0,13.41%
2015-10,הצפון,7600,עכו,יישוב,3014,1347,1667,120,2894,2181,2954,65,11.05%
2015-10,הצפון,7700,עפולה,יישוב,1637,670,967,174,1463,710,1566,104,6.09%
2015-10,הצפון,531,עראבה,יישוב,1589,679,910,31,1558,1397,1566,3,15.05%
2015-10,הצפון,535,פסוטה,יישוב,97,40,57,5,92,65,95,3,5.50%
2015-10,הצפון,536,פקיעין (בוקייעה),יישוב,123,64,59,5,118,77,118,2,4.19%
2015-10,הצפון,8000,צפת,יישוב,1374,739,635,71,1303,928,1296,24,9.47%
2015-10,הצפון,4100,קצרין,יישוב,209,82,127,31,178,86,204,1,5.04%
2015-10,הצפון,2800,קריית שמונה,יישוב,721,329,392,75,646,302,690,31,5.26%
2015-10,הצפון,543,ראמה,יישוב,272,106,166,13,259,203,266,3,6.78%
2015-10,הצפון,26,ראש פינה,יישוב,53,15,38,14,39,14,51,2,3.17%
2015-10,הצפון,542,ריינה,יישוב,611,262,349,14,597,487,586,10,8.48%
2015-10,הצפון,122,רמת ישי,יישוב,86,35,51,27,59,13,85,2,2.04%
2015-10,הצפון,913,שבלי - אום אל-גנם,יישוב,202,86,116,8,194,144,199,0,7.50%
2015-10,הצפון,812,שלומי,יישוב,227,95,132,13,214,102,221,5,6.10%
2015-10,הצפון,538,שעב,יישוב,535,218,317,4,531,466,529,1,16.94%
2015-10,הצפון,8800,שפרעם,יישוב,1806,727,1079,27,1779,1477,1781,21,9.70%
2015-10,חיפה,1326,"בסמ""ה",יישוב,397,176,221,4,393,312,394,2,9.67%
2015-10,חיפה,2710,אום אל-פחם,יישוב,3470,1429,2041,35,3435,2919,3420,32,15.80%
2015-10,חיפה,1020,אור עקיבא,יישוב,511,235,276,50,461,170,491,13,4.80%
2015-10,חיפה,6000,באקה אל-גרביה,יישוב,636,303,333,10,626,365,632,16,5.35%
2015-10,חיפה,9800,בנימינה-גבעת עדה*,יישוב,178,77,101,56,122,59,177,1,2.43%
2015-10,חיפה,541,ג'סר א-זרקא,יישוב,445,224,221,3,442,306,443,3,7.26%
2015-10,חיפה,628,ג'ת,יישוב,217,111,106,5,212,129,217,5,4.10%
2015-10,חיפה,494,דאלית אל-כרמל,יישוב,464,185,279,14,450,260,441,6,5.32%
2015-10,חיפה,9300,זכרון יעקב,יישוב,259,116,143,86,173,48,257,1,2.31%
2015-10,חיפה,6500,חדרה,יישוב,2350,972,1378,296,2054,796,2206,54,4.38%
2015-10,חיפה,4000,חיפה,יישוב,6082,2935,3147,1158,4924,3065,5807,125,4.14%
2015-10,חיפה,1247,חריש,יישוב,23,13,10,4,19,10,20,0,1.26%
2015-10,חיפה,2100,טירת כרמל,יישוב,701,326,375,42,659,376,682,16,6.02%
2015-10,חיפה,654,כפר קרע,יישוב,387,172,215,10,377,232,384,5,4.48%
2015-10,חיפה,45,מ.א. אלונה,מועצה איזורית,18,7,11,6,12,4,17,0,1.59%
2015-10,חיפה,12,מ.א. זבולון,מועצה איזורית,261,124,137,24,237,164,254,0,4.56%
2015-10,חיפה,15,מ.א. חוף הכרמל,מועצה איזורית,305,134,171,83,222,65,300,0,2.12%
2015-10,חיפה,14,מ.א. מנשה,מועצה איזורית,234,103,131,54,180,70,233,0,2.91%
2015-10,חיפה,1327,מעלה עירון,יישוב,841,307,534,6,835,705,831,2,13.86%
2015-10,חיפה,2500,נשר,יישוב,438,214,224,82,356,161,429,8,3.34%
2015-10,חיפה,534,עספיא,יישוב,297,124,173,14,283,161,283,10,4.99%
2015-10,חיפה,637,ערערה,יישוב,546,234,312,7,539,333,536,5,6.57%
2015-10,חיפה,537,פוריידיס,יישוב,400,202,198,10,390,262,395,2,6.92%
2015-10,חיפה,7800,פרדס חנה-כרכור,יישוב,835,362,473,158,677,234,819,25,4.01%
2015-10,חיפה,6800,קריית אתא,יישוב,1553,713,840,132,1421,795,1515,45,4.96%
2015-10,חיפה,9500,קריית ביאליק,יישוב,984,403,581,119,865,464,967,29,4.50%
2015-10,חיפה,2300,קריית טבעון,יישוב,182,73,109,66,116,34,179,1,2.14%
2015-10,חיפה,9600,קריית ים,יישוב,1461,671,790,132,1329,812,1421,32,6.59%
2015-10,חיפה,8200,קריית מוצקין,יישוב,1009,426,583,141,868,447,977,36,4.23%
2015-10,חיפה,922,רכסים,יישוב,168,68,100,12,156,76,153,0,4.28%
2015-10,ירושלים,472,אבו גוש,יישוב,247,126,121,6,241,174,247,5,7.95%
2015-10,ירושלים,2610,בית שמש,יישוב,1371,576,795,105,1266,471,1336,52,3.93%
2015-10,ירושלים,3000,ירושלים,יישוב,12385,5548,6837,1369,11016,7546,12133,154,4.06%
2015-10,ירושלים,26,מ.א. מטה יהודה,מועצה איזורית,539,257,282,116,423,125,530,2,2.22%
2015-10,ירושלים,1015,מבשרת ציון,יישוב,360,185,175,76,284,138,349,5,2.68%
2015-10,ירושלים,1137,קריית יערים,יישוב,38,15,23,8,30,16,38,0,2.68%
2015-10,תל אביב,2400,אור יהודה,יישוב,722,343,379,50,672,182,693,37,3.63%
2015-10,תל אביב,565,אזור,יישוב,183,89,94,21,162,31,182,2,2.76%
2015-10,תל אביב,6100,בני ברק,יישוב,2015,934,1081,92,1923,898,1923,19,3.34%
2015-10,תל אביב,6200,בת ים,יישוב,2758,1290,1468,368,2390,996,2641,57,3.75%
2015-10,תל אביב,6300,גבעתיים,יישוב,687,313,374,289,398,80,682,7,2.21%
2015-10,תל אביב,6400,הרצלייה,יישוב,1047,432,615,349,698,36,1037,37,2.12%
2015-10,תל אביב,6600,חולון,יישוב,3029,1375,1654,478,2551,686,2977,65,2.99%
2015-10,תל אביב,267,כפר שמריהו,יישוב,5,3,2,3,2,0,5,0,0.60%
2015-10,תל אביב,2620,קריית אונו,יישוב,379,166,213,158,221,36,377,5,1.97%
2015-10,תל אביב,8600,רמת גן,יישוב,1963,892,1071,648,1315,409,1936,28,2.46%
2015-10,תל אביב,2650,רמת השרון,יישוב,365,137,228,176,189,9,363,3,1.63%
2015-10,תל אביב,5000,תל אביב -יפו,יישוב,6919,3400,3519,2255,4664,1865,6824,97,2.69%
2015-11,אזור יהודה והשומרון,3760,אורנית,יישוב,109,56,53,38,71,4,109,0,2.23%
2015-11,אזור יהודה והשומרון,3750,אלפי מנשה,יישוב,93,42,51,28,65,0,93,3,2.11%
2015-11,אזור יהודה והשומרון,3560,אלקנה,יישוב,39,19,20,13,26,0,39,0,2.05%
2015-11,אזור יהודה והשומרון,3650,אפרת,יישוב,50,28,22,25,25,2,50,2,1.16%
2015-11,אזור יהודה והשומרון,3570,אריאל,יישוב,335,159,176,87,248,47,333,14,3.07%
2015-11,אזור יהודה והשומרון,3574,בית אל,יישוב,56,34,22,14,42,18,55,1,2.26%
2015-11,אזור יהודה והשומרון,3652,בית אריה,יישוב,52,24,28,12,40,2,52,0,1.94%
2015-11,אזור יהודה והשומרון,3780,ביתר עילית,יישוב,623,318,305,10,613,280,617,10,4.60%
2015-11,אזור יהודה והשומרון,3730,גבעת זאב,יישוב,206,95,111,42,164,46,205,0,2.63%
2015-11,אזור יהודה והשומרון,3769,הר אדר,יישוב,41,16,25,22,19,4,41,0,1.93%
2015-11,אזור יהודה והשומרון,76,מ.א. גוש עציון,מועצה איזורית,166,81,85,69,97,13,163,0,1.69%
2015-11,אזור יהודה והשומרון,78,מ.א. הר חברון,מועצה איזורית,73,35,38,20,53,5,72,0,2.05%
2015-11,אזור יהודה והשומרון,74,מ.א. מגילות ים המלח,מועצה איזורית,11,6,5,2,9,0,11,0,1.38%
2015-11,אזור יהודה והשומרון,73,מ.א. מטה בנימין,מועצה איזורית,648,311,337,195,453,133,634,0,2.53%
2015-11,אזור יהודה והשומרון,75,מ.א. ערבות הירדן,מועצה איזורית,38,18,20,10,28,5,37,0,1.52%
2015-11,אזור יהודה והשומרון,72,מ.א. שומרון,מועצה איזורית,421,219,202,127,294,46,417,0,2.47%
2015-11,אזור יהודה והשומרון,3797,מודיעין עילית,יישוב,356,128,228,15,341,49,348,6,2.48%
2015-11,אזור יהודה והשומרון,3616,מעלה אדומים,יישוב,670,293,377,105,565,187,663,14,3.22%
2015-11,אזור יהודה והשומרון,3608,מעלה אפרים,יישוב,28,14,14,3,25,9,28,2,3.40%
2015-11,אזור יהודה והשומרון,3660,עמנואל,יישוב,68,35,33,3,65,37,67,1,5.64%
2015-11,אזור יהודה והשומרון,3557,קדומים,יישוב,36,24,12,15,21,5,36,0,1.92%
2015-11,אזור יהודה והשומרון,3611,קריית ארבע,יישוב,124,64,60,11,113,56,124,7,3.76%
2015-11,אזור יהודה והשומרון,3640,קרני שומרון,יישוב,81,48,33,24,57,6,80,3,2.11%
2015-11,הדרום,31,אופקים,יישוב,1056,449,607,57,999,600,1030,42,7.64%
2015-11,הדרום,2600,אילת,יישוב,1288,629,659,61,1227,490,1239,53,3.65%
2015-11,הדרום,70,אשדוד,יישוב,5809,2475,3334,695,5114,2772,5590,203,5.07%
2015-11,הדרום,7100,אשקלון,יישוב,3950,1634,2316,402,3548,2003,3485,116,4.90%
2015-11,הדרום,9000,באר שבע,יישוב,6403,2833,3570,817,5586,3468,6158,187,5.77%
2015-11,הדרום,2200,דימונה,יישוב,1894,859,1035,100,1794,1237,1817,43,9.59%
2015-11,הדרום,1303,חורה,יישוב,734,298,436,2,732,648,725,7,17.02%
2015-11,הדרום,831,ירוחם,יישוב,397,207,190,15,382,224,383,39,7.91%
2015-11,הדרום,1059,כסיפה,יישוב,987,388,599,1,986,905,981,7,20.57%
2015-11,הדרום,1271,להבים,יישוב,43,23,20,16,27,5,41,1,1.13%
2015-11,הדרום,1060,לקיה,יישוב,789,340,449,1,788,735,777,11,17.75%
2015-11,הדרום,69,מ.א. אל קסום,מועצה איזורית,727,281,446,5,722,654,716,0,44.33%
2015-11,הדרום,38,מ.א. אשכול,מועצה איזורית,145,67,78,31,114,15,142,0,2.09%
2015-11,הדרום,33,מ.א. באר טוביה,מועצה איזורית,267,111,156,51,216,50,264,0,2.41%
2015-11,הדרום,41,מ.א. בני שמעון,מועצה איזורית,65,23,42,19,46,12,63,0,1.44%
2015-11,הדרום,54,מ.א. הערבה התיכונה,מועצה איזורית,29,12,17,7,22,1,29,0,1.60%
2015-11,הדרום,53,מ.א. חבל אילות,מועצה איזורית,26,12,14,7,19,0,26,3,1.10%
2015-11,הדרום,36,מ.א. חוף אשקלון,מועצה איזורית,220,92,128,33,187,47,213,1,2.57%
2015-11,הדרום,35,מ.א. יואב,מועצה איזורית,82,37,45,30,52,15,79,0,1.98%
2015-11,הדרום,50,מ.א. לכיש,מועצה איזורית,172,69,103,19,153,53,169,0,3.36%
2015-11,הדרום,42,מ.א. מרחבים,מועצה איזורית,183,66,117,22,161,42,178,0,3.01%
2015-11,הדרום,68,מ.א. נווה מדבר,מועצה איזורית,101,37,64,1,100,82,100,0,10.37%
2015-11,הדרום,48,מ.א. רמת נגב,מועצה איזורית,247,130,117,16,231,191,247,1,7.79%
2015-11,הדרום,39,מ.א. שדות נגב,מועצה איזורית,118,61,57,19,99,31,115,0,2.55%
2015-11,הדרום,37,מ.א. שער הנגב,מועצה איזורית,109,46,63,30,79,23,107,1,2.76%
2015-11,הדרום,34,מ.א. שפיר,מועצה איזורית,181,79,102,17,164,61,174,0,3.71%
2015-11,הדרום,51,מ.א. תמר,מועצה איזורית,15,2,13,4,11,2,15,0,2.37%
2015-11,הדרום,1268,מיתר,יישוב,72,29,43,32,40,10,71,3,1.59%
2015-11,הדרום,99,מצפה רמון,יישוב,280,117,163,21,259,175,268,15,9.63%
2015-11,הדרום,246,נתיבות,יישוב,963,438,525,39,924,472,916,48,6.18%
2015-11,הדרום,666,עומר,יישוב,60,19,41,27,33,3,59,0,1.40%
2015-11,הדרום,2560,ערד,יישוב,753,346,407,95,658,385,729,44,5.89%
2015-11,הדרום,1192,ערערה-בנגב,יישוב,1069,443,626,3,1066,991,1053,24,24.09%
2015-11,הדרום,2630,קריית גת,יישוב,1920,824,1096,116,1804,960,1838,49,6.42%
2015-11,הדרום,1034,קריית מלאכי,יישוב,966,435,531,19,947,487,939,70,7.93%
2015-11,הדרום,1161,רהט,יישוב,2822,1245,1577,5,2817,2377,2784,75,13.85%
2015-11,הדרום,1286,שגב-שלום,יישוב,473,177,296,3,470,408,468,8,16.23%
2015-11,הדרום,1031,שדרות,יישוב,1004,452,552,53,951,561,940,31,6.96%
2015-11,הדרום,1054,תל שבע,יישוב,1032,462,570,6,1026,938,1023,25,20.01%
2015-11,המרכז,1066,"בני עי""ש",יישוב,163,72,91,25,138,60,160,7,3.99%
2015-11,המרכז,182,אבן יהודה,יישוב,143,73,70,35,108,19,143,0,2.08%
2015-11,המרכז,41,אליכין,יישוב,69,40,29,8,61,18,68,0,3.50%
2015-11,המרכז,1309,אלעד,יישוב,388,172,216,17,371,60,376,1,2.89%
2015-11,המרכז,2530,באר יעקב,יישוב,226,92,134,52,174,45,221,1,2.21%
2015-11,המרכז,466,בית דגן,יישוב,101,55,46,11,90,34,100,0,2.69%
2015-11,המרכז,681,גבעת שמואל,יישוב,260,134,126,83,177,52,255,0,2.10%
2015-11,המרכז,2550,גדרה,יישוב,311,128,183,64,247,92,302,6,2.42%
2015-11,המרכז,627,ג'לג'וליה,יישוב,92,33,59,2,90,61,87,1,2.31%
2015-11,המרכז,166,גן יבנה,יישוב,322,142,180,54,268,70,311,13,2.57%
2015-11,המרכז,229,גני תקווה,יישוב,204,83,121,70,134,25,202,0,2.23%
2015-11,המרכז,9700,הוד השרון,יישוב,662,259,403,267,395,59,656,10,2.11%
2015-11,המרכז,1290,זמר,יישוב,152,49,103,3,149,102,151,4,5.07%
2015-11,המרכז,2730,טייבה,יישוב,1234,546,688,14,1220,999,1084,22,6.18%
2015-11,המרכז,2720,טירה,יישוב,256,117,139,16,240,108,249,8,2.17%
2015-11,המרכז,2660,יבנה,יישוב,783,395,388,114,669,247,777,39,3.17%
2015-11,המרכז,9400,יהוד,יישוב,383,193,190,91,292,51,377,11,2.34%
2015-11,המרכז,1224,כוכב יאיר,יישוב,85,42,43,40,45,1,85,0,1.48%
2015-11,המרכז,633,כפר ברא,יישוב,30,17,13,0,30,11,30,2,2.09%
2015-11,המרכז,168,כפר יונה,יישוב,303,133,170,46,257,45,302,5,2.68%
2015-11,המרכז,6900,כפר סבא,יישוב,1226,550,676,420,806,138,1206,27,2.27%
2015-11,המרכז,634,כפר קאסם,יישוב,218,102,116,9,209,123,211,3,2.29%
2015-11,המרכז,7000,לוד,יישוב,2005,942,1063,150,1855,1051,1968,69,5.52%
2015-11,המרכז,28,מ.א. ברנר,מועצה איזורית,80,35,45,39,41,2,80,4,1.97%
2015-11,המרכז,32,מ.א. גדרות,מועצה איזורית,50,19,31,16,34,5,50,1,2.04%
2015-11,המרכז,30,מ.א. גזר,מועצה איזורית,285,127,158,107,178,22,281,0,2.13%
2015-11,המרכז,27,מ.א. גן רווה,מועצה איזורית,53,23,30,20,33,3,53,0,1.81%
2015-11,המרכז,20,מ.א. דרום השרון,מועצה איזורית,302,145,157,119,183,19,298,0,1.90%
2015-11,המרכז,29,מ.א. חבל יבנה,מועצה איזורית,34,15,19,15,19,3,34,0,1.37%
2015-11,המרכז,25,מ.א. חבל מודיעין,מועצה איזורית,239,125,114,82,157,17,237,0,2.21%
2015-11,המרכז,19,מ.א. חוף השרון,מועצה איזורית,90,37,53,38,52,7,90,0,1.61%
2015-11,המרכז,18,מ.א. לב השרון,מועצה איזורית,280,128,152,50,230,30,278,0,2.53%
2015-11,המרכז,31,מ.א. נחל שורק,מועצה איזורית,61,33,28,12,49,5,60,42,1.42%
2015-11,המרכז,16,מ.א. עמק חפר,מועצה איזורית,372,161,211,93,279,17,370,0,1.88%
2015-11,המרכז,40,מ.א. עמק לוד,מועצה איזורית,128,61,67,36,92,14,127,0,2.06%
2015-11,המרכז,1200,מודיעין-מכבים-רעות*,יישוב,910,391,519,365,545,59,899,17,2.00%
2015-11,המרכז,28,מזכרת בתיה,יישוב,158,74,84,44,114,27,156,4,2.08%
2015-11,המרכז,7200,נס ציונה,יישוב,655,310,345,167,488,178,647,12,2.70%
2015-11,המרכז,7400,נתניה,יישוב,4373,1997,2376,403,3970,1418,4280,131,4.04%
2015-11,המרכז,587,סביון*,יישוב,14,5,9,6,8,0,14,0,0.71%
2015-11,המרכז,171,פרדסייה,יישוב,80,35,45,11,69,7,80,0,2.10%
2015-11,המרכז,7900,פתח תקווה,יישוב,3902,1741,2161,844,3058,1001,3833,81,3.04%
2015-11,המרכז,195,קדימה-צורן,יישוב,255,109,146,46,209,39,252,2,2.27%
2015-11,המרכז,638,קלנסווה,יישוב,511,229,282,3,508,382,458,12,5.19%
2015-11,המרכז,469,קריית עקרון,יישוב,257,138,119,14,243,117,253,10,4.18%
2015-11,המרכז,2640,ראש העין,יישוב,761,352,409,96,665,145,752,14,2.97%
2015-11,המרכז,8300,ראשון לציון,יישוב,4244,1879,2365,782,3462,1245,4210,80,3.01%
2015-11,המרכז,8400,רחובות,יישוב,2294,1064,1230,503,1791,786,2248,84,3.26%
2015-11,המרכז,8500,רמלה,יישוב,1659,773,886,107,1552,688,1588,81,4.20%
2015-11,המרכז,8700,רעננה,יישוב,721,332,389,278,443,58,714,10,1.93%
2015-11,המרכז,1304,שוהם,יישוב,181,84,97,78,103,11,181,2,1.55%
2015-11,המרכז,154,תל מונד,יישוב,144,70,74,38,106,19,144,1,2.23%
2015-11,הצפון,473,אבו סנאן,יישוב,604,258,346,11,593,470,600,13,10.11%
2015-11,הצפון,478,אכסאל,יישוב,512,233,279,10,502,446,499,5,8.66%
2015-11,הצפון,529,אעבלין,יישוב,540,207,333,9,531,451,533,7,9.14%
2015-11,הצפון,482,בועיינה-נוג'ידאת,יישוב,353,152,201,8,345,294,341,3,8.76%
2015-11,הצפון,4001,בוקעאתא,יישוב,357,136,221,3,354,303,337,0,12.31%
2015-11,הצפון,998,ביר אל-מכסור,יישוב,400,162,238,1,399,323,396,2,10.14%
2015-11,הצפון,480,בית ג'ן,יישוב,379,130,249,7,372,267,370,5,6.58%
2015-11,הצפון,9200,בית שאן,יישוב,823,384,439,22,801,410,806,70,7.79%
2015-11,הצפון,944,בסמת טבעון,יישוב,198,91,107,2,196,149,192,1,5.84%
2015-11,הצפון,483,בענה,יישוב,348,150,198,6,342,295,345,8,9.97%
2015-11,הצפון,1292,ג'דיידה-מכר,יישוב,1220,541,679,11,1209,984,1201,29,12.72%
2015-11,הצפון,485,ג'ולס,יישוב,204,54,150,0,204,139,202,3,6.51%
2015-11,הצפון,487,ג'ש (גוש חלב),יישוב,67,29,38,3,64,35,64,0,3.86%
2015-11,הצפון,489,דבורייה,יישוב,360,159,201,19,341,256,354,5,8.16%
2015-11,הצפון,490,דייר אל-אסד,יישוב,360,150,210,10,350,293,359,6,6.83%
2015-11,הצפון,492,דייר חנא,יישוב,613,261,352,6,607,493,604,3,12.36%
2015-11,הצפון,975,זרזיר,יישוב,268,121,147,5,263,184,261,2,7.88%
2015-11,הצפון,496,חורפיש,יישוב,105,45,60,12,93,57,101,2,3.54%
2015-11,הצפון,2034,חצור הגלילית,יישוב,271,112,159,11,260,128,258,13,5.27%
2015-11,הצפון,6700,טבריה,יישוב,1644,789,855,88,1556,887,1463,80,6.64%
2015-11,הצפון,962,טובא-זנגרייה,יישוב,349,158,191,4,345,240,339,2,11.15%
2015-11,הצפון,498,טורעאן,יישוב,504,204,300,13,491,399,475,7,8.22%
2015-11,הצפון,8900,טמרה,יישוב,1660,750,910,23,1637,1426,1646,15,11.44%
2015-11,הצפון,1295,יאנוח-ג'ת,יישוב,155,51,104,2,153,95,152,1,5.16%
2015-11,הצפון,46,יבנאל,יישוב,122,73,49,6,116,87,97,2,6.10%
2015-11,הצפון,29,יסוד המעלה,יישוב,16,6,10,4,12,2,16,0,1.86%
2015-11,הצפון,499,יפיע,יישוב,607,268,339,24,583,464,595,9,7.46%
2015-11,הצפון,240,יקנעם עילית,יישוב,478,198,280,77,401,123,473,27,3.88%
2015-11,הצפון,502,ירכא,יישוב,539,227,312,0,539,402,529,13,8.16%
2015-11,הצפון,504,כאבול,יישוב,604,261,343,9,595,512,597,9,11.88%
2015-11,הצפון,505,כאוכב אבו אל-היג'א,יישוב,220,89,131,3,217,185,220,0,12.57%
2015-11,הצפון,1296,כסרא-סמיע,יישוב,198,87,111,3,195,133,193,7,5.49%
2015-11,הצפון,978,כעביה-טבאש-חג'אג'רה,יישוב,198,82,116,5,193,133,193,3,8.10%
2015-11,הצפון,1263,כפר ורדים,יישוב,67,31,36,26,41,11,67,0,2.17%
2015-11,הצפון,507,כפר יאסיף,יישוב,414,185,229,4,410,303,406,10,7.93%
2015-11,הצפון,508,כפר כמא,יישוב,66,29,37,7,59,28,64,2,3.77%
2015-11,הצפון,509,כפר כנא,יישוב,1060,444,616,22,1038,913,1006,20,11.30%
2015-11,הצפון,510,כפר מנדא,יישוב,835,388,447,6,829,643,819,5,11.18%
2015-11,הצפון,47,כפר תבור,יישוב,44,15,29,21,23,2,44,0,1.92%
2015-11,הצפון,1139,כרמיאל,יישוב,1534,623,911,257,1277,731,1452,51,5.56%
2015-11,הצפון,65,מ.א. אל-בטוף,מועצה איזורית,361,152,209,9,352,285,346,1,11.91%
2015-11,הצפון,66,מ.א. בוסתן אל-מרג',מועצה איזורית,40,13,27,0,40,35,39,1,1.27%
2015-11,הצפון,71,מ.א. גולן,מועצה איזורית,186,85,101,36,150,21,186,1,2.16%
2015-11,הצפון,8,מ.א. הגלבוע,מועצה איזורית,777,302,475,82,695,448,768,0,5.33%
2015-11,הצפון,1,מ.א. הגליל העליון,מועצה איזורית,213,92,121,58,155,26,210,0,2.38%
2015-11,הצפון,3,מ.א. הגליל התחתון,מועצה איזורית,114,43,71,36,78,18,108,0,1.85%
2015-11,הצפון,55,מ.א. מבואות החרמון,מועצה איזורית,93,37,56,20,73,18,91,0,2.28%
2015-11,הצפון,13,מ.א. מגידו,מועצה איזורית,100,46,54,34,66,5,100,0,1.76%
2015-11,הצפון,4,מ.א. מטה אשר,מועצה איזורית,433,196,237,60,373,175,427,0,3.11%
2015-11,הצפון,52,מ.א. מעלה יוסף,מועצה איזורית,180,86,94,25,155,48,179,1,3.24%
2015-11,הצפון,2,מ.א. מרום הגליל,מועצה איזורית,284,131,153,24,260,126,278,0,4.07%
2015-11,הצפון,56,מ.א. משגב,מועצה איזורית,560,223,337,97,463,292,545,0,4.20%
2015-11,הצפון,6,מ.א. עמק הירדן,מועצה איזורית,160,68,92,30,130,33,145,0,2.15%
2015-11,הצפון,7,מ.א. עמק המעיינות,מועצה איזורית,198,90,108,34,164,40,194,1,3.00%
2015-11,הצפון,9,מ.א. עמק יזרעאל,מועצה איזורית,408,162,246,185,223,30,407,0,2.10%
2015-11,הצפון,481,מגאר,יישוב,1336,538,798,19,1317,1133,1315,12,13.30%
2015-11,הצפון,516,מג'ד אל-כרום,יישוב,499,232,267,14,485,373,491,15,7.34%
2015-11,הצפון,65,מגדל,יישוב,39,17,22,3,36,13,37,1,3.90%
2015-11,הצפון,874,מגדל העמק,יישוב,903,367,536,82,821,331,854,95,6.24%
2015-11,הצפון,4201,מג'דל שמס,יישוב,463,179,284,12,451,360,436,5,8.84%
2015-11,הצפון,517,מזרעה,יישוב,161,66,95,1,160,122,154,1,7.75%
2015-11,הצפון,43,מטולה,יישוב,33,18,15,7,26,6,32,0,3.03%
2015-11,הצפון,4203,מסעדה,יישוב,197,71,126,5,192,169,190,2,11.18%
2015-11,הצפון,518,מעיליא,יישוב,45,26,19,6,39,23,45,0,2.79%
2015-11,הצפון,1063,מעלות-תרשיחא,יישוב,857,408,449,105,752,435,842,31,7.07%
2015-11,הצפון,520,משהד,יישוב,277,120,157,8,269,223,263,5,8.06%
2015-11,הצפון,9100,נהרייה,יישוב,1921,905,1016,200,1721,1035,1856,79,5.96%
2015-11,הצפון,522,נחף,יישוב,377,179,198,20,357,302,373,12,7.33%
2015-11,הצפון,7300,נצרת,יישוב,3147,1389,1758,126,3021,2468,3071,35,8.83%
2015-11,הצפון,1061,נצרת עילית,יישוב,1738,763,975,159,1579,866,1562,117,6.67%
2015-11,הצפון,525,סאג'ור,יישוב,107,42,65,5,102,68,105,0,5.32%
2015-11,הצפון,7500,סח'נין,יישוב,2173,915,1258,38,2135,1815,2151,24,15.01%
2015-11,הצפון,4501,ע'ג'ר,יישוב,93,36,57,1,92,59,93,0,8.76%
2015-11,הצפון,530,עיילבון,יישוב,170,78,92,8,162,116,170,2,6.12%
2015-11,הצפון,511,עילוט,יישוב,323,131,192,4,319,256,319,2,11.03%
2015-11,הצפון,532,עין מאהל,יישוב,497,237,260,12,485,398,485,2,9.09%
2015-11,הצפון,4502,עין קנייא,יישוב,148,56,92,1,147,119,142,0,13.75%
2015-11,הצפון,7600,עכו,יישוב,3081,1390,1691,132,2949,2219,3015,68,11.25%
2015-11,הצפון,7700,עפולה,יישוב,1650,698,952,160,1490,693,1565,100,6.09%
2015-11,הצפון,531,עראבה,יישוב,1576,676,900,32,1544,1375,1562,21,15.02%
2015-11,הצפון,535,פסוטה,יישוב,91,37,54,4,87,63,90,0,5.23%
2015-11,הצפון,536,פקיעין (בוקייעה),יישוב,125,68,57,2,123,74,120,4,4.26%
2015-11,הצפון,8000,צפת,יישוב,1358,743,615,65,1293,927,1289,25,9.42%
2015-11,הצפון,4100,קצרין,יישוב,217,83,134,31,186,87,214,4,5.28%
2015-11,הצפון,2800,קריית שמונה,יישוב,728,325,403,68,660,316,695,37,5.30%
2015-11,הצפון,543,ראמה,יישוב,271,117,154,10,261,207,263,2,6.71%
2015-11,הצפון,26,ראש פינה,יישוב,49,16,33,12,37,13,48,0,2.99%
2015-11,הצפון,542,ריינה,יישוב,609,252,357,11,598,488,579,9,8.39%
2015-11,הצפון,122,רמת ישי,יישוב,83,37,46,27,56,10,82,0,1.97%
2015-11,הצפון,913,שבלי - אום אל-גנם,יישוב,200,80,120,8,192,137,196,4,7.39%
2015-11,הצפון,812,שלומי,יישוב,231,98,133,11,220,103,225,5,6.21%
2015-11,הצפון,538,שעב,יישוב,540,222,318,5,535,472,534,0,17.08%
2015-11,הצפון,8800,שפרעם,יישוב,1817,734,1083,31,1786,1459,1802,24,9.80%
2015-11,חיפה,1326,"בסמ""ה",יישוב,410,190,220,6,404,313,406,4,9.94%
2015-11,חיפה,2710,אום אל-פחם,יישוב,3462,1461,2001,43,3419,2873,3415,18,15.78%
2015-11,חיפה,1020,אור עקיבא,יישוב,517,245,272,52,465,172,493,21,4.82%
2015-11,חיפה,6000,באקה אל-גרביה,יישוב,627,300,327,8,619,365,623,29,5.28%
2015-11,חיפה,9800,בנימינה-גבעת עדה*,יישוב,181,79,102,57,124,58,181,2,2.48%
2015-11,חיפה,541,ג'סר א-זרקא,יישוב,439,227,212,5,434,312,438,3,7.18%
2015-11,חיפה,628,ג'ת,יישוב,215,110,105,6,209,126,213,4,4.02%
2015-11,חיפה,494,דאלית אל-כרמל,יישוב,461,186,275,13,448,259,444,8,5.36%
2015-11,חיפה,9300,זכרון יעקב,יישוב,258,120,138,80,178,49,255,3,2.29%
2015-11,חיפה,6500,חדרה,יישוב,2335,1003,1332,293,2042,832,2196,65,4.36%
2015-11,חיפה,4000,חיפה,יישוב,6221,3023,3198,1149,5072,3106,5932,177,4.23%
2015-11,חיפה,1247,חריש,יישוב,21,11,10,1,20,11,19,1,1.19%
2015-11,חיפה,2100,טירת כרמל,יישוב,705,338,367,48,657,363,693,14,6.11%
2015-11,חיפה,654,כפר קרע,יישוב,403,185,218,10,393,230,397,4,4.63%
2015-11,חיפה,45,מ.א. אלונה,מועצה איזורית,24,9,15,5,19,4,24,0,2.25%
2015-11,חיפה,12,מ.א. זבולון,מועצה איזורית,259,119,140,26,233,164,256,0,4.60%
2015-11,חיפה,15,מ.א. חוף הכרמל,מועצה איזורית,303,136,167,96,207,62,300,0,2.12%
2015-11,חיפה,14,מ.א. מנשה,מועצה איזורית,226,98,128,48,178,74,224,0,2.80%
2015-11,חיפה,1327,מעלה עירון,יישוב,850,318,532,11,839,700,840,14,13.99%
2015-11,חיפה,2500,נשר,יישוב,424,212,212,79,345,161,417,12,3.25%
2015-11,חיפה,534,עספיא,יישוב,309,132,177,17,292,172,291,7,5.13%
2015-11,חיפה,637,ערערה,יישוב,562,250,312,7,555,350,552,20,6.75%
2015-11,חיפה,537,פוריידיס,יישוב,415,210,205,12,403,259,410,3,7.16%
2015-11,חיפה,7800,פרדס חנה-כרכור,יישוב,850,375,475,163,687,259,839,22,4.11%
2015-11,חיפה,6800,קריית אתא,יישוב,1530,679,851,120,1410,808,1479,48,4.85%
2015-11,חיפה,9500,קריית ביאליק,יישוב,995,413,582,116,879,463,975,28,4.54%
2015-11,חיפה,2300,קריית טבעון,יישוב,189,75,114,69,120,39,186,0,2.22%
2015-11,חיפה,9600,קריית ים,יישוב,1458,688,770,134,1324,805,1417,51,6.58%
2015-11,חיפה,8200,קריית מוצקין,יישוב,1036,448,588,143,893,464,1002,26,4.33%
2015-11,חיפה,922,רכסים,יישוב,167,71,96,12,155,83,153,1,4.28%
2015-11,ירושלים,472,אבו גוש,יישוב,244,119,125,7,237,178,244,5,7.87%
2015-11,ירושלים,2610,בית שמש,יישוב,1328,592,736,96,1232,484,1294,55,3.82%
2015-11,ירושלים,3000,ירושלים,יישוב,12362,5575,6787,1341,11021,7570,12095,166,4.05%
2015-11,ירושלים,26,מ.א. מטה יהודה,מועצה איזורית,537,251,286,120,417,128,525,0,2.20%
2015-11,ירושלים,1015,מבשרת ציון,יישוב,369,192,177,77,292,135,360,4,2.76%
2015-11,ירושלים,1137,קריית יערים,יישוב,35,14,21,6,29,18,35,0,2.48%
2015-11,תל אביב,2400,אור יהודה,יישוב,720,366,354,50,670,165,689,42,3.61%
2015-11,תל אביב,565,אזור,יישוב,191,87,104,27,164,32,189,2,2.87%
2015-11,תל אביב,6100,בני ברק,יישוב,1968,930,1038,86,1882,911,1867,26,3.25%
2015-11,תל אביב,6200,בת ים,יישוב,2868,1347,1521,400,2468,996,2746,85,3.89%
2015-11,תל אביב,6300,גבעתיים,יישוב,736,325,411,325,411,81,731,5,2.37%
2015-11,תל אביב,6400,הרצלייה,יישוב,1067,457,610,355,712,36,1054,39,2.16%
2015-11,תל אביב,6600,חולון,יישוב,3085,1385,1700,487,2598,684,3029,68,3.04%
2015-11,תל אביב,267,כפר שמריהו,יישוב,7,5,2,3,4,0,7,0,0.83%
2015-11,תל אביב,2620,קריית אונו,יישוב,377,153,224,159,218,38,370,5,1.93%
2015-11,תל אביב,8600,רמת גן,יישוב,1927,903,1024,657,1270,403,1895,30,2.41%
2015-11,תל אביב,2650,רמת השרון,יישוב,369,153,216,171,198,9,366,9,1.64%
2015-11,תל אביב,5000,תל אביב -יפו,יישוב,7122,3514,3608,2392,4730,1874,7007,105,2.76%
2015-12,אזור יהודה והשומרון,3760,אורנית,יישוב,105,58,47,36,69,4,105,1,2.15%
2015-12,אזור יהודה והשומרון,3750,אלפי מנשה,יישוב,87,43,44,22,65,0,87,1,1.98%
2015-12,אזור יהודה והשומרון,3560,אלקנה,יישוב,40,19,21,16,24,0,40,0,2.10%
2015-12,אזור יהודה והשומרון,3650,אפרת,יישוב,43,25,18,20,23,1,42,2,0.98%
2015-12,אזור יהודה והשומרון,3570,אריאל,יישוב,321,155,166,79,242,44,319,11,2.95%
2015-12,אזור יהודה והשומרון,3574,בית אל,יישוב,56,34,22,14,42,19,55,1,2.26%
2015-12,אזור יהודה והשומרון,3652,בית אריה,יישוב,52,19,33,15,37,2,52,0,1.94%
2015-12,אזור יהודה והשומרון,3780,ביתר עילית,יישוב,571,281,290,8,563,260,568,3,4.25%
2015-12,אזור יהודה והשומרון,3730,גבעת זאב,יישוב,210,92,118,41,169,42,205,5,2.63%
2015-12,אזור יהודה והשומרון,3769,הר אדר,יישוב,40,15,25,23,17,4,40,0,1.88%
2015-12,אזור יהודה והשומרון,76,מ.א. גוש עציון,מועצה איזורית,178,86,92,80,98,15,174,0,1.81%
2015-12,אזור יהודה והשומרון,78,מ.א. הר חברון,מועצה איזורית,58,28,30,15,43,7,57,0,1.62%
2015-12,אזור יהודה והשומרון,74,מ.א. מגילות ים המלח,מועצה איזורית,8,4,4,1,7,0,8,0,1.00%
2015-12,אזור יהודה והשומרון,73,מ.א. מטה בנימין,מועצה איזורית,630,308,322,191,439,130,620,0,2.47%
2015-12,אזור יהודה והשומרון,75,מ.א. ערבות הירדן,מועצה איזורית,47,22,25,8,39,6,47,0,1.93%
2015-12,אזור יהודה והשומרון,72,מ.א. שומרון,מועצה איזורית,410,203,207,129,281,47,403,0,2.39%
2015-12,אזור יהודה והשומרון,3797,מודיעין עילית,יישוב,352,132,220,15,337,48,348,6,2.48%
2015-12,אזור יהודה והשומרון,3616,מעלה אדומים,יישוב,667,299,368,83,584,186,657,20,3.19%
2015-12,אזור יהודה והשומרון,3608,מעלה אפרים,יישוב,26,12,14,3,23,8,26,0,3.16%
2015-12,אזור יהודה והשומרון,3660,עמנואל,יישוב,71,39,32,3,68,38,70,1,5.88%
2015-12,אזור יהודה והשומרון,3557,קדומים,יישוב,41,25,16,15,26,5,40,0,2.12%
2015-12,אזור יהודה והשומרון,3611,קריית ארבע,יישוב,108,58,50,12,96,52,107,3,3.26%
2015-12,אזור יהודה והשומרון,3640,קרני שומרון,יישוב,79,44,35,23,56,5,79,2,2.08%
2015-12,הדרום,31,אופקים,יישוב,1002,418,584,50,952,585,977,33,7.28%
2015-12,הדרום,2600,אילת,יישוב,1323,649,674,61,1262,478,1265,56,3.72%
2015-12,הדרום,70,אשדוד,יישוב,5623,2410,3213,656,4967,2744,5398,178,4.91%
2015-12,הדרום,7100,אשקלון,יישוב,3851,1643,2208,400,3451,1981,3371,125,4.74%
2015-12,הדרום,9000,באר שבע,יישוב,6307,2791,3516,800,5507,3459,6013,151,5.64%
2015-12,הדרום,2200,דימונה,יישוב,1892,849,1043,96,1796,1249,1809,49,9.56%
2015-12,הדרום,1303,חורה,יישוב,710,295,415,2,708,626,695,5,16.43%
2015-12,הדרום,831,ירוחם,יישוב,390,214,176,13,377,220,373,17,7.72%
2015-12,הדרום,1059,כסיפה,יישוב,985,394,591,0,985,893,978,4,20.52%
2015-12,הדרום,1271,להבים,יישוב,43,22,21,19,24,5,42,0,1.16%
2015-12,הדרום,1060,לקיה,יישוב,781,345,436,1,780,723,767,10,17.56%
2015-12,הדרום,69,מ.א. אל קסום,מועצה איזורית,709,280,429,4,705,640,695,0,43.03%
2015-12,הדרום,38,מ.א. אשכול,מועצה איזורית,143,68,75,31,112,14,141,0,2.07%
2015-12,הדרום,33,מ.א. באר טוביה,מועצה איזורית,273,112,161,48,225,54,270,0,2.47%
2015-12,הדרום,41,מ.א. בני שמעון,מועצה איזורית,59,19,40,15,44,10,58,3,1.33%
2015-12,הדרום,54,מ.א. הערבה התיכונה,מועצה איזורית,27,11,16,8,19,1,27,0,1.49%
2015-12,הדרום,53,מ.א. חבל אילות,מועצה איזורית,26,11,15,8,18,0,26,1,1.10%
2015-12,הדרום,36,מ.א. חוף אשקלון,מועצה איזורית,219,89,130,35,184,50,210,0,2.54%
2015-12,הדרום,35,מ.א. יואב,מועצה איזורית,83,39,44,30,53,15,82,0,2.06%
2015-12,הדרום,50,מ.א. לכיש,מועצה איזורית,166,71,95,22,144,50,164,0,3.26%
2015-12,הדרום,42,מ.א. מרחבים,מועצה איזורית,175,62,113,22,153,31,169,0,2.86%
2015-12,הדרום,68,מ.א. נווה מדבר,מועצה איזורית,100,36,64,1,99,83,99,0,10.27%
2015-12,הדרום,48,מ.א. רמת נגב,מועצה איזורית,254,128,126,18,236,195,254,0,8.01%
2015-12,הדרום,39,מ.א. שדות נגב,מועצה איזורית,112,59,53,21,91,30,111,0,2.46%
2015-12,הדרום,37,מ.א. שער הנגב,מועצה איזורית,104,44,60,29,75,21,100,0,2.58%
2015-12,הדרום,34,מ.א. שפיר,מועצה איזורית,161,73,88,15,146,61,158,0,3.36%
2015-12,הדרום,51,מ.א. תמר,מועצה איזורית,15,1,14,4,11,1,15,0,2.37%
2015-12,הדרום,1268,מיתר,יישוב,65,30,35,26,39,8,65,1,1.46%
2015-12,הדרום,99,מצפה רמון,יישוב,273,118,155,23,250,165,262,12,9.44%
2015-12,הדרום,246,נתיבות,יישוב,955,422,533,42,913,478,904,45,6.10%
2015-12,הדרום,666,עומר,יישוב,52,19,33,28,24,2,52,0,1.23%
2015-12,הדרום,2560,ערד,יישוב,752,356,396,93,659,363,730,39,5.90%
2015-12,הדרום,1192,ערערה-בנגב,יישוב,1054,439,615,3,1051,970,1037,3,23.81%
2015-12,הדרום,2630,קריית גת,יישוב,1862,795,1067,112,1750,944,1793,47,6.27%
2015-12,הדרום,1034,קריית מלאכי,יישוב,935,428,507,22,913,466,898,79,7.61%
2015-12,הדרום,1161,רהט,יישוב,2785,1185,1600,4,2781,2312,2742,64,13.67%
2015-12,הדרום,1286,שגב-שלום,יישוב,454,169,285,3,451,386,446,6,15.59%
2015-12,הדרום,1031,שדרות,יישוב,973,447,526,47,926,562,904,26,6.71%
2015-12,הדרום,1054,תל שבע,יישוב,984,447,537,4,980,893,971,20,19.19%
2015-12,המרכז,1066,"בני עי""ש",יישוב,160,66,94,26,134,63,154,4,3.84%
2015-12,המרכז,182,אבן יהודה,יישוב,136,62,74,34,102,18,134,3,1.95%
2015-12,המרכז,41,אליכין,יישוב,78,45,33,11,67,18,76,3,3.90%
2015-12,המרכז,1309,אלעד,יישוב,364,167,197,18,346,59,353,3,2.72%
2015-12,המרכז,2530,באר יעקב,יישוב,231,95,136,55,176,44,225,5,2.25%
2015-12,המרכז,466,בית דגן,יישוב,91,53,38,8,83,33,89,2,2.40%
2015-12,המרכז,681,גבעת שמואל,יישוב,262,136,126,81,181,54,258,2,2.13%
2015-12,המרכז,2550,גדרה,יישוב,316,130,186,61,255,93,307,16,2.46%
2015-12,המרכז,627,ג'לג'וליה,יישוב,87,32,55,4,83,58,83,2,2.20%
2015-12,המרכז,166,גן יבנה,יישוב,308,131,177,51,257,74,298,11,2.46%
2015-12,המרכז,229,גני תקווה,יישוב,185,76,109,60,125,27,183,1,2.03%
2015-12,המרכז,9700,הוד השרון,יישוב,636,262,374,264,372,57,629,14,2.03%
2015-12,המרכז,1290,זמר,יישוב,143,43,100,3,140,101,142,0,4.78%
2015-12,המרכז,2730,טייבה,יישוב,1238,547,691,15,1223,975,1108,29,6.31%
2015-12,המרכז,2720,טירה,יישוב,234,112,122,13,221,102,228,8,1.99%
2015-12,המרכז,2660,יבנה,יישוב,735,370,365,117,618,243,728,35,2.98%
2015-12,המרכז,9400,יהוד,יישוב,401,197,204,95,306,52,393,15,2.44%
2015-12,המרכז,1224,כוכב יאיר,יישוב,86,45,41,43,43,3,85,0,1.48%
2015-12,המרכז,633,כפר ברא,יישוב,30,15,15,1,29,12,29,2,2.02%
2015-12,המרכז,168,כפר יונה,יישוב,318,142,176,49,269,44,317,8,2.81%
2015-12,המרכז,6900,כפר סבא,יישוב,1218,577,641,419,799,137,1190,24,2.24%
2015-12,המרכז,634,כפר קאסם,יישוב,238,110,128,7,231,131,232,0,2.51%
2015-12,המרכז,7000,לוד,יישוב,1917,894,1023,130,1787,1017,1882,54,5.29%
2015-12,המרכז,28,מ.א. ברנר,מועצה איזורית,74,32,42,38,36,3,74,3,1.82%
2015-12,המרכז,32,מ.א. גדרות,מועצה איזורית,47,19,28,16,31,4,47,0,1.92%
2015-12,המרכז,30,מ.א. גזר,מועצה איזורית,296,132,164,120,176,24,294,0,2.23%
2015-12,המרכז,27,מ.א. גן רווה,מועצה איזורית,46,23,23,22,24,2,46,0,1.57%
2015-12,המרכז,20,מ.א. דרום השרון,מועצה איזורית,309,156,153,122,187,22,304,0,1.94%
2015-12,המרכז,29,מ.א. חבל יבנה,מועצה איזורית,37,14,23,14,23,4,37,0,1.49%
2015-12,המרכז,25,מ.א. חבל מודיעין,מועצה איזורית,240,129,111,83,157,21,236,0,2.20%
2015-12,המרכז,19,מ.א. חוף השרון,מועצה איזורית,86,37,49,32,54,5,86,0,1.53%
2015-12,המרכז,18,מ.א. לב השרון,מועצה איזורית,272,129,143,39,233,32,268,0,2.44%
2015-12,המרכז,31,מ.א. נחל שורק,מועצה איזורית,52,27,25,11,41,4,52,33,1.25%
2015-12,המרכז,16,מ.א. עמק חפר,מועצה איזורית,354,160,194,90,264,14,351,0,1.79%
2015-12,המרכז,40,מ.א. עמק לוד,מועצה איזורית,133,61,72,34,99,15,133,0,2.16%
2015-12,המרכז,1200,מודיעין-מכבים-רעות*,יישוב,918,390,528,378,540,59,911,27,2.02%
2015-12,המרכז,28,מזכרת בתיה,יישוב,156,70,86,47,109,29,155,3,2.06%
2015-12,המרכז,7200,נס ציונה,יישוב,653,315,338,176,477,176,642,18,2.68%
2015-12,המרכז,7400,נתניה,יישוב,4203,1951,2252,403,3800,1398,4098,124,3.87%
2015-12,המרכז,587,סביון*,יישוב,15,7,8,8,7,0,15,0,0.76%
2015-12,המרכז,171,פרדסייה,יישוב,82,38,44,12,70,7,82,0,2.15%
2015-12,המרכז,7900,פתח תקווה,יישוב,3816,1707,2109,850,2966,1005,3731,60,2.96%
2015-12,המרכז,195,קדימה-צורן,יישוב,244,100,144,46,198,37,241,3,2.17%
2015-12,המרכז,638,קלנסווה,יישוב,512,239,273,4,508,375,467,13,5.29%
2015-12,המרכז,469,קריית עקרון,יישוב,245,130,115,19,226,114,237,9,3.93%
2015-12,המרכז,2640,ראש העין,יישוב,706,349,357,107,599,143,697,23,2.75%
2015-12,המרכז,8300,ראשון לציון,יישוב,4180,1843,2337,736,3444,1248,4137,93,2.96%
2015-12,המרכז,8400,רחובות,יישוב,2231,1031,1200,480,1751,799,2173,68,3.15%
2015-12,המרכז,8500,רמלה,יישוב,1575,764,811,100,1475,673,1516,63,4.01%
2015-12,המרכז,8700,רעננה,יישוב,709,328,381,280,429,55,694,6,1.87%
2015-12,המרכז,1304,שוהם,יישוב,170,88,82,76,94,12,169,0,1.45%
2015-12,המרכז,154,תל מונד,יישוב,151,78,73,43,108,21,150,1,2.32%
2015-12,הצפון,473,אבו סנאן,יישוב,612,263,349,8,604,482,606,13,10.20%
2015-12,הצפון,478,אכסאל,יישוב,515,234,281,9,506,447,505,2,8.76%
2015-12,הצפון,529,אעבלין,יישוב,536,213,323,7,529,452,527,2,9.04%
2015-12,הצפון,482,בועיינה-נוג'ידאת,יישוב,343,147,196,9,334,285,329,8,8.48%
2015-12,הצפון,4001,בוקעאתא,יישוב,370,139,231,4,366,312,349,0,12.70%
2015-12,הצפון,998,ביר אל-מכסור,יישוב,401,168,233,1,400,320,393,1,10.07%
2015-12,הצפון,480,בית ג'ן,יישוב,380,123,257,3,377,266,375,3,6.66%
2015-12,הצפון,9200,בית שאן,יישוב,808,358,450,19,789,394,791,57,7.66%
2015-12,הצפון,944,בסמת טבעון,יישוב,203,97,106,2,201,151,195,2,5.92%
2015-12,הצפון,483,בענה,יישוב,358,156,202,5,353,303,354,12,10.20%
2015-12,הצפון,1292,ג'דיידה-מכר,יישוב,1191,530,661,11,1180,975,1179,25,12.52%
2015-12,הצפון,485,ג'ולס,יישוב,245,70,175,0,245,141,243,7,7.73%
2015-12,הצפון,487,ג'ש (גוש חלב),יישוב,68,27,41,5,63,33,65,1,3.92%
2015-12,הצפון,489,דבורייה,יישוב,346,151,195,16,330,257,342,1,7.91%
2015-12,הצפון,490,דייר אל-אסד,יישוב,353,146,207,10,343,292,352,10,6.71%
2015-12,הצפון,492,דייר חנא,יישוב,634,272,362,7,627,489,625,7,12.73%
2015-12,הצפון,975,זרזיר,יישוב,280,128,152,3,277,190,274,12,8.24%
2015-12,הצפון,496,חורפיש,יישוב,115,49,66,10,105,60,107,1,3.74%
2015-12,הצפון,2034,חצור הגלילית,יישוב,269,114,155,10,259,128,255,4,5.21%
2015-12,הצפון,6700,טבריה,יישוב,1646,799,847,85,1561,882,1466,65,6.65%
2015-12,הצפון,962,טובא-זנגרייה,יישוב,361,166,195,5,356,243,351,0,11.50%
2015-12,הצפון,498,טורעאן,יישוב,500,204,296,18,482,387,475,3,8.22%
2015-12,הצפון,8900,טמרה,יישוב,1659,764,895,20,1639,1431,1624,16,11.30%
2015-12,הצפון,1295,יאנוח-ג'ת,יישוב,143,49,94,2,141,93,139,3,4.74%
2015-12,הצפון,46,יבנאל,יישוב,128,77,51,6,122,87,105,3,6.57%
2015-12,הצפון,29,יסוד המעלה,יישוב,19,5,14,4,15,3,19,0,2.21%
2015-12,הצפון,499,יפיע,יישוב,599,259,340,16,583,458,587,8,7.36%
2015-12,הצפון,240,יקנעם עילית,יישוב,461,195,266,71,390,111,455,27,3.74%
2015-12,הצפון,502,ירכא,יישוב,528,210,318,0,528,409,516,12,7.98%
2015-12,הצפון,504,כאבול,יישוב,596,261,335,8,588,512,585,3,11.67%
2015-12,הצפון,505,כאוכב אבו אל-היג'א,יישוב,224,93,131,2,222,190,222,1,12.67%
2015-12,הצפון,1296,כסרא-סמיע,יישוב,221,84,137,5,216,153,205,7,5.81%
2015-12,הצפון,978,כעביה-טבאש-חג'אג'רה,יישוב,194,82,112,7,187,130,190,2,7.98%
2015-12,הצפון,1263,כפר ורדים,יישוב,63,27,36,26,37,7,61,0,1.98%
2015-12,הצפון,507,כפר יאסיף,יישוב,412,179,233,6,406,300,402,9,7.86%
2015-12,הצפון,508,כפר כמא,יישוב,65,28,37,7,58,28,62,0,3.65%
2015-12,הצפון,509,כפר כנא,יישוב,1104,468,636,22,1082,918,1042,12,11.66%
2015-12,הצפון,510,כפר מנדא,יישוב,816,391,425,6,810,648,791,1,10.84%
2015-12,הצפון,47,כפר תבור,יישוב,34,14,20,16,18,1,34,0,1.49%
2015-12,הצפון,1139,כרמיאל,יישוב,1497,610,887,241,1256,712,1429,57,5.48%
2015-12,הצפון,65,מ.א. אל-בטוף,מועצה איזורית,353,142,211,11,342,278,342,1,11.78%
2015-12,הצפון,66,מ.א. בוסתן אל-מרג',מועצה איזורית,42,14,28,1,41,33,41,0,1.33%
2015-12,הצפון,71,מ.א. גולן,מועצה איזורית,181,87,94,41,140,18,179,0,2.08%
2015-12,הצפון,8,מ.א. הגלבוע,מועצה איזורית,751,303,448,75,676,434,741,0,5.14%
2015-12,הצפון,1,מ.א. הגליל העליון,מועצה איזורית,215,92,123,55,160,26,212,0,2.40%
2015-12,הצפון,3,מ.א. הגליל התחתון,מועצה איזורית,110,40,70,34,76,16,105,0,1.79%
2015-12,הצפון,55,מ.א. מבואות החרמון,מועצה איזורית,113,50,63,22,91,22,108,0,2.70%
2015-12,הצפון,13,מ.א. מגידו,מועצה איזורית,102,42,60,35,67,3,102,0,1.80%
2015-12,הצפון,4,מ.א. מטה אשר,מועצה איזורית,442,200,242,66,376,168,439,0,3.20%
2015-12,הצפון,52,מ.א. מעלה יוסף,מועצה איזורית,195,96,99,28,167,51,192,0,3.48%
2015-12,הצפון,2,מ.א. מרום הגליל,מועצה איזורית,282,134,148,24,258,125,274,0,4.01%
2015-12,הצפון,56,מ.א. משגב,מועצה איזורית,562,225,337,96,466,297,550,0,4.23%
2015-12,הצפון,6,מ.א. עמק הירדן,מועצה איזורית,168,77,91,28,140,31,158,0,2.34%
2015-12,הצפון,7,מ.א. עמק המעיינות,מועצה איזורית,193,87,106,33,160,36,191,0,2.95%
2015-12,הצפון,9,מ.א. עמק יזרעאל,מועצה איזורית,397,149,248,178,219,32,393,0,2.03%
2015-12,הצפון,481,מגאר,יישוב,1366,555,811,19,1347,1146,1311,6,13.26%
2015-12,הצפון,516,מג'ד אל-כרום,יישוב,489,234,255,13,476,370,483,7,7.23%
2015-12,הצפון,65,מגדל,יישוב,37,15,22,3,34,14,33,1,3.49%
2015-12,הצפון,874,מגדל העמק,יישוב,851,367,484,85,766,315,799,73,5.86%
2015-12,הצפון,4201,מג'דל שמס,יישוב,452,175,277,11,441,354,431,5,8.74%
2015-12,הצפון,517,מזרעה,יישוב,156,63,93,1,155,126,150,1,7.56%
2015-12,הצפון,43,מטולה,יישוב,32,16,16,7,25,7,32,1,3.03%
2015-12,הצפון,4203,מסעדה,יישוב,207,76,131,5,202,174,195,3,11.44%
2015-12,הצפון,518,מעיליא,יישוב,47,26,21,6,41,22,47,2,2.91%
2015-12,הצפון,1063,מעלות-תרשיחא,יישוב,849,404,445,106,743,439,819,30,6.89%
2015-12,הצפון,520,משהד,יישוב,266,117,149,6,260,213,257,6,7.89%
2015-12,הצפון,9100,נהרייה,יישוב,1922,916,1006,206,1716,1035,1850,85,5.95%
2015-12,הצפון,522,נחף,יישוב,379,174,205,15,364,307,375,8,7.37%
2015-12,הצפון,7300,נצרת,יישוב,3079,1376,1703,119,2960,2399,3006,28,8.66%
2015-12,הצפון,1061,נצרת עילית,יישוב,1657,724,933,161,1496,874,1482,87,6.35%
2015-12,הצפון,525,סאג'ור,יישוב,109,41,68,6,103,68,106,5,5.36%
2015-12,הצפון,7500,סח'נין,יישוב,2146,930,1216,36,2110,1785,2111,15,14.77%
2015-12,הצפון,4501,ע'ג'ר,יישוב,89,37,52,3,86,59,89,0,8.41%
2015-12,הצפון,530,עיילבון,יישוב,165,78,87,6,159,115,160,3,5.78%
2015-12,הצפון,511,עילוט,יישוב,324,130,194,4,320,265,314,1,10.87%
2015-12,הצפון,532,עין מאהל,יישוב,521,245,276,13,508,394,508,3,9.48%
2015-12,הצפון,4502,עין קנייא,יישוב,152,60,92,1,151,118,145,0,14.00%
2015-12,הצפון,7600,עכו,יישוב,3084,1404,1680,119,2965,2205,3001,59,11.21%
2015-12,הצפון,7700,עפולה,יישוב,1605,666,939,156,1449,667,1517,99,5.91%
2015-12,הצפון,531,עראבה,יישוב,1572,683,889,36,1536,1336,1547,16,14.90%
2015-12,הצפון,535,פסוטה,יישוב,102,41,61,4,98,59,98,1,5.67%
2015-12,הצפון,536,פקיעין (בוקייעה),יישוב,124,63,61,3,121,75,117,1,4.16%
2015-12,הצפון,8000,צפת,יישוב,1363,758,605,67,1296,941,1294,20,9.45%
2015-12,הצפון,4100,קצרין,יישוב,220,80,140,34,186,93,216,2,5.32%
2015-12,הצפון,2800,קריית שמונה,יישוב,735,333,402,69,666,306,707,30,5.39%
2015-12,הצפון,543,ראמה,יישוב,273,114,159,12,261,207,266,4,6.78%
2015-12,הצפון,26,ראש פינה,יישוב,50,19,31,9,41,17,49,1,3.05%
2015-12,הצפון,542,ריינה,יישוב,591,257,334,12,579,468,563,14,8.17%
2015-12,הצפון,122,רמת ישי,יישוב,96,41,55,35,61,9,94,0,2.25%
2015-12,הצפון,913,שבלי - אום אל-גנם,יישוב,204,82,122,7,197,133,201,1,7.56%
2015-12,הצפון,812,שלומי,יישוב,225,94,131,13,212,99,218,4,6.03%
2015-12,הצפון,538,שעב,יישוב,533,219,314,4,529,467,524,2,16.81%
2015-12,הצפון,8800,שפרעם,יישוב,1796,724,1072,29,1767,1445,1760,23,9.60%
2015-12,חיפה,1326,"בסמ""ה",יישוב,400,183,217,4,396,306,398,1,9.76%
2015-12,חיפה,2710,אום אל-פחם,יישוב,3447,1476,1971,45,3402,2859,3392,32,15.69%
2015-12,חיפה,1020,אור עקיבא,יישוב,499,224,275,49,450,168,476,19,4.66%
2015-12,חיפה,6000,באקה אל-גרביה,יישוב,643,318,325,11,632,370,638,22,5.40%
2015-12,חיפה,9800,בנימינה-גבעת עדה*,יישוב,179,79,100,55,124,58,179,0,2.46%
2015-12,חיפה,541,ג'סר א-זרקא,יישוב,462,244,218,5,457,324,460,7,7.51%
2015-12,חיפה,628,ג'ת,יישוב,214,110,104,7,207,124,212,6,4.00%
2015-12,חיפה,494,דאלית אל-כרמל,יישוב,482,194,288,14,468,253,462,8,5.56%
2015-12,חיפה,9300,זכרון יעקב,יישוב,268,120,148,89,179,50,261,1,2.34%
2015-12,חיפה,6500,חדרה,יישוב,2321,1022,1299,280,2041,843,2170,70,4.31%
2015-12,חיפה,4000,חיפה,יישוב,6181,3033,3148,1151,5030,3172,5827,152,4.16%
2015-12,חיפה,1247,חריש,יישוב,24,12,12,0,24,11,20,1,1.26%
2015-12,חיפה,2100,טירת כרמל,יישוב,722,349,373,42,680,370,699,26,6.16%
2015-12,חיפה,654,כפר קרע,יישוב,397,191,206,9,388,228,393,8,4.58%
2015-12,חיפה,45,מ.א. אלונה,מועצה איזורית,27,11,16,6,21,4,27,0,2.53%
2015-12,חיפה,12,מ.א. זבולון,מועצה איזורית,255,122,133,29,226,156,249,0,4.47%
2015-12,חיפה,15,מ.א. חוף הכרמל,מועצה איזורית,324,146,178,105,219,58,315,0,2.23%
2015-12,חיפה,14,מ.א. מנשה,מועצה איזורית,212,94,118,47,165,77,210,0,2.62%
2015-12,חיפה,1327,מעלה עירון,יישוב,845,318,527,13,832,697,835,7,13.92%
2015-12,חיפה,2500,נשר,יישוב,419,206,213,72,347,160,407,8,3.17%
2015-12,חיפה,534,עספיא,יישוב,299,128,171,18,281,172,277,8,4.89%
2015-12,חיפה,637,ערערה,יישוב,557,242,315,3,554,343,550,22,6.73%
2015-12,חיפה,537,פוריידיס,יישוב,429,215,214,12,417,277,421,2,7.34%
2015-12,חיפה,7800,פרדס חנה-כרכור,יישוב,863,383,480,168,695,269,843,22,4.13%
2015-12,חיפה,6800,קריית אתא,יישוב,1494,657,837,119,1375,782,1448,45,4.75%
2015-12,חיפה,9500,קריית ביאליק,יישוב,992,420,572,109,883,453,975,37,4.54%
2015-12,חיפה,2300,קריית טבעון,יישוב,173,65,108,59,114,37,170,1,2.03%
2015-12,חיפה,9600,קריית ים,יישוב,1460,671,789,135,1325,800,1402,44,6.51%
2015-12,חיפה,8200,קריית מוצקין,יישוב,1026,456,570,146,880,462,994,26,4.30%
2015-12,חיפה,922,רכסים,יישוב,176,81,95,13,163,80,162,0,4.52%
2015-12,ירושלים,472,אבו גוש,יישוב,252,128,124,7,245,176,250,6,8.04%
2015-12,ירושלים,2610,בית שמש,יישוב,1241,570,671,91,1150,486,1194,31,3.53%
2015-12,ירושלים,3000,ירושלים,יישוב,12302,5625,6677,1323,10979,7597,12030,165,4.03%
2015-12,ירושלים,26,מ.א. מטה יהודה,מועצה איזורית,505,258,247,110,395,126,493,1,2.06%
2015-12,ירושלים,1015,מבשרת ציון,יישוב,371,189,182,83,288,131,362,13,2.78%
2015-12,ירושלים,1137,קריית יערים,יישוב,36,12,24,6,30,17,36,0,2.54%
2015-12,תל אביב,2400,אור יהודה,יישוב,705,365,340,45,660,177,680,41,3.57%
2015-12,תל אביב,565,אזור,יישוב,187,83,104,27,160,27,186,3,2.82%
2015-12,תל אביב,6100,בני ברק,יישוב,1898,919,979,84,1814,869,1800,18,3.13%
2015-12,תל אביב,6200,בת ים,יישוב,2826,1333,1493,379,2447,990,2689,88,3.81%
2015-12,תל אביב,6300,גבעתיים,יישוב,729,330,399,317,412,81,724,4,2.34%
2015-12,תל אביב,6400,הרצלייה,יישוב,1006,435,571,334,672,41,992,40,2.03%
2015-12,תל אביב,6600,חולון,יישוב,3037,1393,1644,477,2560,679,2994,49,3.01%
2015-12,תל אביב,267,כפר שמריהו,יישוב,6,4,2,2,4,0,6,0,0.72%
2015-12,תל אביב,2620,קריית אונו,יישוב,379,174,205,153,226,39,378,6,1.97%
2015-12,תל אביב,8600,רמת גן,יישוב,1969,942,1027,656,1313,399,1939,29,2.47%
2015-12,תל אביב,2650,רמת השרון,יישוב,351,157,194,161,190,10,347,10,1.56%
2015-12,תל אביב,5000,תל אביב -יפו,יישוב,7124,3496,3628,2380,4744,1869,6983,111,2.75%
2016-01,אזור יהודה והשומרון,3760,אורנית,יישוב,105,54,51,36,69,2,105,2,2.15%
2016-01,אזור יהודה והשומרון,3750,אלפי מנשה,יישוב,97,45,52,22,75,1,97,1,2.20%
2016-01,אזור יהודה והשומרון,3560,אלקנה,יישוב,40,22,18,14,26,0,40,0,2.10%
2016-01,אזור יהודה והשומרון,3650,אפרת,יישוב,41,21,20,21,20,1,41,0,0.95%
2016-01,אזור יהודה והשומרון,3570,אריאל,יישוב,302,134,168,79,223,42,301,8,2.79%
2016-01,אזור יהודה והשומרון,3574,בית אל,יישוב,49,31,18,12,37,21,47,1,1.93%
2016-01,אזור יהודה והשומרון,3652,בית אריה,יישוב,60,23,37,16,44,3,60,0,2.23%
2016-01,אזור יהודה והשומרון,3780,ביתר עילית,יישוב,552,269,283,8,544,254,549,5,4.11%
2016-01,אזור יהודה והשומרון,3730,גבעת זאב,יישוב,204,95,109,35,169,41,200,7,2.57%
2016-01,אזור יהודה והשומרון,3769,הר אדר,יישוב,41,17,24,23,18,4,41,0,1.93%
2016-01,אזור יהודה והשומרון,76,מ.א. גוש עציון,מועצה איזורית,167,79,88,71,96,12,163,0,1.69%
2016-01,אזור יהודה והשומרון,78,מ.א. הר חברון,מועצה איזורית,70,36,34,25,45,5,69,0,1.97%
2016-01,אזור יהודה והשומרון,74,מ.א. מגילות ים המלח,מועצה איזורית,11,5,6,3,8,0,11,0,1.38%
2016-01,אזור יהודה והשומרון,73,מ.א. מטה בנימין,מועצה איזורית,607,294,313,200,407,125,596,0,2.38%
2016-01,אזור יהודה והשומרון,75,מ.א. ערבות הירדן,מועצה איזורית,47,25,22,12,35,5,47,0,1.93%
2016-01,אזור יהודה והשומרון,72,מ.א. שומרון,מועצה איזורית,388,181,207,134,254,39,386,0,2.29%
2016-01,אזור יהודה והשומרון,3797,מודיעין עילית,יישוב,360,131,229,17,343,46,354,4,2.53%
2016-01,אזור יהודה והשומרון,3616,מעלה אדומים,יישוב,646,281,365,90,556,174,635,21,3.09%
2016-01,אזור יהודה והשומרון,3608,מעלה אפרים,יישוב,27,12,15,3,24,10,27,2,3.28%
2016-01,אזור יהודה והשומרון,3660,עמנואל,יישוב,59,36,23,2,57,33,59,3,5.00%
2016-01,אזור יהודה והשומרון,3557,קדומים,יישוב,41,25,16,15,26,5,41,0,2.18%
2016-01,אזור יהודה והשומרון,3611,קריית ארבע,יישוב,100,55,45,10,90,53,98,4,2.99%
2016-01,אזור יהודה והשומרון,3640,קרני שומרון,יישוב,73,37,36,22,51,7,71,4,1.88%
2016-01,הדרום,31,אופקים,יישוב,1021,419,602,51,970,592,988,49,7.35%
2016-01,הדרום,2600,אילת,יישוב,1481,721,760,71,1410,489,1420,46,4.16%
2016-01,הדרום,70,אשדוד,יישוב,5657,2379,3278,668,4989,2733,5410,173,4.92%
2016-01,הדרום,7100,אשקלון,יישוב,3768,1606,2162,394,3374,1958,3287,135,4.63%
2016-01,הדרום,9000,באר שבע,יישוב,6219,2773,3446,793,5426,3417,5920,170,5.56%
2016-01,הדרום,2200,דימונה,יישוב,1909,827,1082,101,1808,1249,1819,62,9.60%
2016-01,הדרום,1303,חורה,יישוב,692,286,406,1,691,610,678,17,16.10%
2016-01,הדרום,831,ירוחם,יישוב,372,198,174,14,358,217,356,43,7.39%
2016-01,הדרום,1059,כסיפה,יישוב,1025,420,605,0,1025,905,1017,18,21.17%
2016-01,הדרום,1271,להבים,יישוב,41,26,15,19,22,4,41,0,1.13%
2016-01,הדרום,1060,לקיה,יישוב,752,331,421,2,750,693,738,14,17.01%
2016-01,הדרום,69,מ.א. אל קסום,מועצה איזורית,719,283,436,3,716,648,704,0,43.62%
2016-01,הדרום,38,מ.א. אשכול,מועצה איזורית,127,53,74,27,100,16,127,0,1.87%
2016-01,הדרום,33,מ.א. באר טוביה,מועצה איזורית,260,115,145,43,217,47,257,0,2.35%
2016-01,הדרום,41,מ.א. בני שמעון,מועצה איזורית,61,17,44,17,44,12,60,3,1.37%
2016-01,הדרום,54,מ.א. הערבה התיכונה,מועצה איזורית,28,10,18,7,21,4,27,0,1.49%
2016-01,הדרום,53,מ.א. חבל אילות,מועצה איזורית,24,9,15,7,17,0,24,3,1.02%
2016-01,הדרום,36,מ.א. חוף אשקלון,מועצה איזורית,226,96,130,44,182,51,218,0,2.64%
2016-01,הדרום,35,מ.א. יואב,מועצה איזורית,87,38,49,29,58,19,84,0,2.11%
2016-01,הדרום,50,מ.א. לכיש,מועצה איזורית,150,70,80,20,130,45,148,0,2.94%
2016-01,הדרום,42,מ.א. מרחבים,מועצה איזורית,188,71,117,23,165,32,184,0,3.11%
2016-01,הדרום,68,מ.א. נווה מדבר,מועצה איזורית,106,43,63,3,103,86,103,0,10.68%
2016-01,הדרום,48,מ.א. רמת נגב,מועצה איזורית,248,124,124,17,231,189,247,0,7.79%
2016-01,הדרום,39,מ.א. שדות נגב,מועצה איזורית,117,55,62,19,98,28,113,0,2.50%
2016-01,הדרום,37,מ.א. שער הנגב,מועצה איזורית,111,48,63,29,82,24,107,0,2.76%
2016-01,הדרום,34,מ.א. שפיר,מועצה איזורית,149,74,75,15,134,59,145,0,3.09%
2016-01,הדרום,51,מ.א. תמר,מועצה איזורית,15,2,13,4,11,1,15,0,2.37%
2016-01,הדרום,1268,מיתר,יישוב,67,32,35,27,40,7,66,2,1.48%
2016-01,הדרום,99,מצפה רמון,יישוב,265,117,148,23,242,163,257,11,9.27%
2016-01,הדרום,246,נתיבות,יישוב,916,409,507,40,876,463,868,59,5.87%
2016-01,הדרום,666,עומר,יישוב,59,22,37,31,28,2,59,1,1.40%
2016-01,הדרום,2560,ערד,יישוב,763,358,405,94,669,377,731,41,5.91%
2016-01,הדרום,1192,ערערה-בנגב,יישוב,1075,450,625,4,1071,984,1052,21,24.07%
2016-01,הדרום,2630,קריית גת,יישוב,1867,783,1084,112,1755,914,1803,72,6.31%
2016-01,הדרום,1034,קריית מלאכי,יישוב,897,411,486,19,878,463,860,81,7.31%
2016-01,הדרום,1161,רהט,יישוב,2768,1176,1592,4,2764,2286,2724,55,13.60%
2016-01,הדרום,1286,שגב-שלום,יישוב,446,167,279,3,443,377,437,18,15.32%
2016-01,הדרום,1031,שדרות,יישוב,932,426,506,50,882,547,865,26,6.44%
2016-01,הדרום,1054,תל שבע,יישוב,960,425,535,4,956,871,943,27,18.74%
2016-01,המרכז,1066,"בני עי""ש",יישוב,161,75,86,28,133,55,157,3,3.91%
2016-01,המרכז,182,אבן יהודה,יישוב,159,69,90,40,119,18,157,2,2.28%
2016-01,המרכז,41,אליכין,יישוב,75,43,32,10,65,19,72,3,3.70%
2016-01,המרכז,1309,אלעד,יישוב,375,175,200,23,352,55,366,3,2.82%
2016-01,המרכז,2530,באר יעקב,יישוב,226,105,121,59,167,44,220,3,2.20%
2016-01,המרכז,466,בית דגן,יישוב,85,52,33,8,77,31,84,1,2.27%
2016-01,המרכז,681,גבעת שמואל,יישוב,262,139,123,84,178,49,257,0,2.12%
2016-01,המרכז,2550,גדרה,יישוב,306,133,173,66,240,89,297,14,2.39%
2016-01,המרכז,627,ג'לג'וליה,יישוב,91,37,54,2,89,58,89,2,2.36%
2016-01,המרכז,166,גן יבנה,יישוב,307,125,182,54,253,72,299,12,2.47%
2016-01,המרכז,229,גני תקווה,יישוב,187,84,103,67,120,29,184,0,2.04%
2016-01,המרכז,9700,הוד השרון,יישוב,638,278,360,261,377,58,630,10,2.03%
2016-01,המרכז,1290,זמר,יישוב,137,43,94,3,134,97,136,7,4.59%
2016-01,המרכז,2730,טייבה,יישוב,1246,547,699,10,1236,976,1108,41,6.31%
2016-01,המרכז,2720,טירה,יישוב,213,103,110,14,199,98,207,17,1.81%
2016-01,המרכז,2660,יבנה,יישוב,736,364,372,119,617,239,729,27,2.98%
2016-01,המרכז,9400,יהוד,יישוב,403,201,202,98,305,49,398,12,2.47%
2016-01,המרכז,1224,כוכב יאיר,יישוב,98,47,51,46,52,2,98,1,1.70%
2016-01,המרכז,633,כפר ברא,יישוב,26,13,13,1,25,12,25,1,1.75%
2016-01,המרכז,168,כפר יונה,יישוב,310,137,173,49,261,43,309,10,2.74%
2016-01,המרכז,6900,כפר סבא,יישוב,1210,551,659,397,813,118,1185,23,2.23%
2016-01,המרכז,634,כפר קאסם,יישוב,234,108,126,7,227,132,228,2,2.47%
2016-01,המרכז,7000,לוד,יישוב,1966,921,1045,140,1826,1029,1920,57,5.39%
2016-01,המרכז,28,מ.א. ברנר,מועצה איזורית,75,36,39,36,39,2,75,4,1.85%
2016-01,המרכז,32,מ.א. גדרות,מועצה איזורית,43,19,24,20,23,3,43,0,1.76%
2016-01,המרכז,30,מ.א. גזר,מועצה איזורית,313,144,169,128,185,19,312,0,2.37%
2016-01,המרכז,27,מ.א. גן רווה,מועצה איזורית,51,26,25,24,27,5,51,0,1.74%
2016-01,המרכז,20,מ.א. דרום השרון,מועצה איזורית,326,165,161,133,193,21,323,0,2.06%
2016-01,המרכז,29,מ.א. חבל יבנה,מועצה איזורית,37,11,26,14,23,2,37,0,1.49%
2016-01,המרכז,25,מ.א. חבל מודיעין,מועצה איזורית,231,119,112,75,156,18,228,0,2.12%
2016-01,המרכז,19,מ.א. חוף השרון,מועצה איזורית,97,38,59,38,59,5,97,0,1.73%
2016-01,המרכז,18,מ.א. לב השרון,מועצה איזורית,272,128,144,43,229,28,270,0,2.45%
2016-01,המרכז,31,מ.א. נחל שורק,מועצה איזורית,51,27,24,13,38,4,51,49,1.22%
2016-01,המרכז,16,מ.א. עמק חפר,מועצה איזורית,365,181,184,90,275,13,363,0,1.85%
2016-01,המרכז,40,מ.א. עמק לוד,מועצה איזורית,150,71,79,39,111,18,149,0,2.42%
2016-01,המרכז,1200,מודיעין-מכבים-רעות*,יישוב,920,400,520,371,549,67,906,20,2.01%
2016-01,המרכז,28,מזכרת בתיה,יישוב,146,60,86,45,101,28,145,4,1.93%
2016-01,המרכז,7200,נס ציונה,יישוב,667,302,365,182,485,169,655,18,2.73%
2016-01,המרכז,7400,נתניה,יישוב,4180,1940,2240,412,3768,1386,4065,79,3.84%
2016-01,המרכז,587,סביון*,יישוב,13,5,8,7,6,0,13,0,0.66%
2016-01,המרכז,171,פרדסייה,יישוב,80,36,44,15,65,4,80,0,2.10%
2016-01,המרכז,7900,פתח תקווה,יישוב,3720,1667,2053,810,2910,991,3637,57,2.89%
2016-01,המרכז,195,קדימה-צורן,יישוב,240,94,146,39,201,43,235,0,2.12%
2016-01,המרכז,638,קלנסווה,יישוב,506,240,266,5,501,370,471,13,5.33%
2016-01,המרכז,469,קריית עקרון,יישוב,232,126,106,18,214,103,228,11,3.79%
2016-01,המרכז,2640,ראש העין,יישוב,727,357,370,103,624,139,718,32,2.83%
2016-01,המרכז,8300,ראשון לציון,יישוב,4199,1852,2347,768,3431,1226,4156,96,2.98%
2016-01,המרכז,8400,רחובות,יישוב,2177,1040,1137,498,1679,776,2124,89,3.09%
2016-01,המרכז,8500,רמלה,יישוב,1594,771,823,103,1491,676,1530,57,4.05%
2016-01,המרכז,8700,רעננה,יישוב,699,325,374,273,426,57,685,7,1.85%
2016-01,המרכז,1304,שוהם,יישוב,176,87,89,73,103,10,175,0,1.50%
2016-01,המרכז,154,תל מונד,יישוב,144,69,75,40,104,20,144,1,2.23%
2016-01,הצפון,473,אבו סנאן,יישוב,608,259,349,6,602,489,601,8,10.12%
2016-01,הצפון,478,אכסאל,יישוב,522,242,280,7,515,447,511,3,8.85%
2016-01,הצפון,529,אעבלין,יישוב,524,209,315,5,519,443,512,11,8.81%
2016-01,הצפון,482,בועיינה-נוג'ידאת,יישוב,377,162,215,9,368,293,361,5,9.23%
2016-01,הצפון,4001,בוקעאתא,יישוב,365,136,229,4,361,307,352,0,12.79%
2016-01,הצפון,998,ביר אל-מכסור,יישוב,393,161,232,2,391,312,389,2,9.98%
2016-01,הצפון,480,בית ג'ן,יישוב,396,139,257,4,392,275,386,5,6.84%
2016-01,הצפון,9200,בית שאן,יישוב,798,366,432,20,778,391,777,52,7.54%
2016-01,הצפון,944,בסמת טבעון,יישוב,196,92,104,4,192,149,187,0,5.69%
2016-01,הצפון,483,בענה,יישוב,357,152,205,3,354,316,345,9,9.97%
2016-01,הצפון,1292,ג'דיידה-מכר,יישוב,1214,538,676,10,1204,999,1190,29,12.62%
2016-01,הצפון,485,ג'ולס,יישוב,244,72,172,0,244,145,241,3,7.67%
2016-01,הצפון,487,ג'ש (גוש חלב),יישוב,71,27,44,4,67,32,67,1,4.03%
2016-01,הצפון,489,דבורייה,יישוב,351,153,198,14,337,260,344,3,7.95%
2016-01,הצפון,490,דייר אל-אסד,יישוב,358,152,206,9,349,299,350,5,6.67%
2016-01,הצפון,492,דייר חנא,יישוב,635,280,355,6,629,496,623,3,12.70%
2016-01,הצפון,975,זרזיר,יישוב,273,117,156,2,271,182,267,14,8.04%
2016-01,הצפון,496,חורפיש,יישוב,104,49,55,10,94,56,101,0,3.54%
2016-01,הצפון,2034,חצור הגלילית,יישוב,267,120,147,7,260,127,250,2,5.11%
2016-01,הצפון,6700,טבריה,יישוב,1672,810,862,87,1585,874,1469,75,6.67%
2016-01,הצפון,962,טובא-זנגרייה,יישוב,384,180,204,4,380,256,373,0,12.13%
2016-01,הצפון,498,טורעאן,יישוב,517,223,294,20,497,396,484,8,8.36%
2016-01,הצפון,8900,טמרה,יישוב,1651,778,873,21,1630,1413,1607,21,11.20%
2016-01,הצפון,1295,יאנוח-ג'ת,יישוב,144,51,93,5,139,95,143,1,4.87%
2016-01,הצפון,46,יבנאל,יישוב,136,87,49,5,131,88,109,3,6.81%
2016-01,הצפון,29,יסוד המעלה,יישוב,16,5,11,3,13,3,16,0,1.86%
2016-01,הצפון,499,יפיע,יישוב,605,273,332,14,591,459,595,7,7.46%
2016-01,הצפון,240,יקנעם עילית,יישוב,446,186,260,81,365,115,440,28,3.62%
2016-01,הצפון,502,ירכא,יישוב,548,226,322,1,547,420,539,19,8.30%
2016-01,הצפון,504,כאבול,יישוב,580,261,319,8,572,494,568,7,11.37%
2016-01,הצפון,505,כאוכב אבו אל-היג'א,יישוב,225,93,132,3,222,191,217,1,12.42%
2016-01,הצפון,1296,כסרא-סמיע,יישוב,197,83,114,6,191,135,191,4,5.44%
2016-01,הצפון,978,כעביה-טבאש-חג'אג'רה,יישוב,201,88,113,8,193,126,193,3,8.10%
2016-01,הצפון,1263,כפר ורדים,יישוב,73,33,40,29,44,5,72,2,2.33%
2016-01,הצפון,507,כפר יאסיף,יישוב,427,192,235,3,424,317,418,8,8.15%
2016-01,הצפון,508,כפר כמא,יישוב,69,32,37,6,63,27,69,1,4.05%
2016-01,הצפון,509,כפר כנא,יישוב,1126,488,638,19,1107,935,1044,31,11.68%
2016-01,הצפון,510,כפר מנדא,יישוב,817,393,424,7,810,658,783,7,10.74%
2016-01,הצפון,47,כפר תבור,יישוב,40,18,22,20,20,1,40,0,1.75%
2016-01,הצפון,1139,כרמיאל,יישוב,1492,615,877,254,1238,698,1437,49,5.50%
2016-01,הצפון,65,מ.א. אל-בטוף,מועצה איזורית,370,149,221,11,359,287,348,2,11.99%
2016-01,הצפון,66,מ.א. בוסתן אל-מרג',מועצה איזורית,40,12,28,1,39,33,39,0,1.27%
2016-01,הצפון,71,מ.א. גולן,מועצה איזורית,185,88,97,43,142,19,183,0,2.13%
2016-01,הצפון,8,מ.א. הגלבוע,מועצה איזורית,749,313,436,66,683,434,741,0,5.14%
2016-01,הצפון,1,מ.א. הגליל העליון,מועצה איזורית,218,92,126,62,156,22,212,0,2.40%
2016-01,הצפון,3,מ.א. הגליל התחתון,מועצה איזורית,115,45,70,34,81,15,108,0,1.85%
2016-01,הצפון,55,מ.א. מבואות החרמון,מועצה איזורית,113,50,63,19,94,21,110,0,2.75%
2016-01,הצפון,13,מ.א. מגידו,מועצה איזורית,104,44,60,35,69,3,104,0,1.83%
2016-01,הצפון,4,מ.א. מטה אשר,מועצה איזורית,431,191,240,69,362,172,428,0,3.12%
2016-01,הצפון,52,מ.א. מעלה יוסף,מועצה איזורית,190,90,100,30,160,48,187,0,3.39%
2016-01,הצפון,2,מ.א. מרום הגליל,מועצה איזורית,271,123,148,29,242,119,261,0,3.82%
2016-01,הצפון,56,מ.א. משגב,מועצה איזורית,556,216,340,95,461,294,545,0,4.20%
2016-01,הצפון,6,מ.א. עמק הירדן,מועצה איזורית,169,78,91,32,137,31,159,0,2.35%
2016-01,הצפון,7,מ.א. עמק המעיינות,מועצה איזורית,186,77,109,27,159,36,183,0,2.83%
2016-01,הצפון,9,מ.א. עמק יזרעאל,מועצה איזורית,393,164,229,172,221,30,390,0,2.02%
2016-01,הצפון,481,מגאר,יישוב,1381,576,805,22,1359,1158,1321,17,13.35%
2016-01,הצפון,516,מג'ד אל-כרום,יישוב,489,235,254,10,479,373,477,13,7.15%
2016-01,הצפון,65,מגדל,יישוב,37,14,23,4,33,13,33,2,3.49%
2016-01,הצפון,874,מגדל העמק,יישוב,860,384,476,80,780,309,803,76,5.89%
2016-01,הצפון,4201,מג'דל שמס,יישוב,445,167,278,11,434,351,426,11,8.65%
2016-01,הצפון,517,מזרעה,יישוב,154,66,88,2,152,118,148,3,7.47%
2016-01,הצפון,43,מטולה,יישוב,33,18,15,7,26,6,33,0,3.13%
2016-01,הצפון,4203,מסעדה,יישוב,210,77,133,5,205,177,200,4,11.70%
2016-01,הצפון,518,מעיליא,יישוב,41,24,17,7,34,20,41,0,2.55%
2016-01,הצפון,1063,מעלות-תרשיחא,יישוב,824,398,426,99,725,423,807,35,6.80%
2016-01,הצפון,520,משהד,יישוב,267,114,153,7,260,215,253,9,7.77%
2016-01,הצפון,9100,נהרייה,יישוב,1921,928,993,220,1701,1002,1849,75,5.94%
2016-01,הצפון,522,נחף,יישוב,401,181,220,18,383,317,389,10,7.62%
2016-01,הצפון,7300,נצרת,יישוב,3062,1360,1702,121,2941,2399,2982,33,8.60%
2016-01,הצפון,1061,נצרת עילית,יישוב,1699,750,949,179,1520,877,1510,104,6.46%
2016-01,הצפון,525,סאג'ור,יישוב,114,41,73,4,110,74,112,3,5.65%
2016-01,הצפון,7500,סח'נין,יישוב,2164,959,1205,32,2132,1811,2126,17,14.86%
2016-01,הצפון,4501,ע'ג'ר,יישוב,95,38,57,2,93,60,94,0,8.84%
2016-01,הצפון,530,עיילבון,יישוב,173,81,92,5,168,122,167,1,6.02%
2016-01,הצפון,511,עילוט,יישוב,314,123,191,4,310,264,309,4,10.72%
2016-01,הצפון,532,עין מאהל,יישוב,513,251,262,10,503,391,495,2,9.26%
2016-01,הצפון,4502,עין קנייא,יישוב,157,62,95,1,156,120,151,1,14.49%
2016-01,הצפון,7600,עכו,יישוב,3136,1421,1715,130,3006,2224,3047,61,11.36%
2016-01,הצפון,7700,עפולה,יישוב,1609,699,910,153,1456,651,1528,84,5.95%
2016-01,הצפון,531,עראבה,יישוב,1558,676,882,30,1528,1341,1528,5,14.74%
2016-01,הצפון,535,פסוטה,יישוב,103,43,60,3,100,55,100,3,5.78%
2016-01,הצפון,536,פקיעין (בוקייעה),יישוב,123,61,62,7,116,72,120,1,4.26%
2016-01,הצפון,8000,צפת,יישוב,1345,730,615,77,1268,963,1263,12,9.25%
2016-01,הצפון,4100,קצרין,יישוב,218,81,137,34,184,90,214,8,5.28%
2016-01,הצפון,2800,קריית שמונה,יישוב,778,371,407,66,712,313,747,30,5.67%
2016-01,הצפון,543,ראמה,יישוב,265,108,157,10,255,200,261,5,6.66%
2016-01,הצפון,26,ראש פינה,יישוב,52,20,32,10,42,19,52,1,3.23%
2016-01,הצפון,542,ריינה,יישוב,597,263,334,11,586,468,560,6,8.13%
2016-01,הצפון,122,רמת ישי,יישוב,94,43,51,34,60,7,92,0,2.21%
2016-01,הצפון,913,שבלי - אום אל-גנם,יישוב,215,92,123,6,209,142,210,2,7.88%
2016-01,הצפון,812,שלומי,יישוב,232,99,133,13,219,100,227,7,6.26%
2016-01,הצפון,538,שעב,יישוב,536,224,312,4,532,474,525,3,16.84%
2016-01,הצפון,8800,שפרעם,יישוב,1793,718,1075,33,1760,1439,1755,37,9.57%
2016-01,חיפה,1326,"בסמ""ה",יישוב,404,183,221,5,399,306,401,6,9.83%
2016-01,חיפה,2710,אום אל-פחם,יישוב,3356,1430,1926,43,3313,2789,3304,55,15.35%
2016-01,חיפה,1020,אור עקיבא,יישוב,501,224,277,53,448,160,485,20,4.74%
2016-01,חיפה,6000,באקה אל-גרביה,יישוב,614,313,301,12,602,355,607,24,5.15%
2016-01,חיפה,9800,בנימינה-גבעת עדה*,יישוב,185,78,107,58,127,60,185,2,2.54%
2016-01,חיפה,541,ג'סר א-זרקא,יישוב,456,237,219,5,451,327,451,5,7.38%
2016-01,חיפה,628,ג'ת,יישוב,209,110,99,9,200,117,207,6,3.91%
2016-01,חיפה,494,דאלית אל-כרמל,יישוב,472,187,285,20,452,257,447,11,5.39%
2016-01,חיפה,9300,זכרון יעקב,יישוב,267,122,145,86,181,48,260,1,2.33%
2016-01,חיפה,6500,חדרה,יישוב,2332,1040,1292,268,2064,834,2183,74,4.33%
2016-01,חיפה,4000,חיפה,יישוב,6141,3022,3119,1161,4980,3100,5803,160,4.14%
2016-01,חיפה,1247,חריש,יישוב,30,16,14,0,30,13,27,2,1.69%
2016-01,חיפה,2100,טירת כרמל,יישוב,677,338,339,39,638,361,659,19,5.83%
2016-01,חיפה,654,כפר קרע,יישוב,386,182,204,15,371,229,381,11,4.45%
2016-01,חיפה,45,מ.א. אלונה,מועצה איזורית,29,12,17,6,23,4,29,0,2.72%
2016-01,חיפה,12,מ.א. זבולון,מועצה איזורית,245,120,125,28,217,154,241,0,4.33%
2016-01,חיפה,15,מ.א. חוף הכרמל,מועצה איזורית,325,149,176,108,217,60,318,1,2.25%
2016-01,חיפה,14,מ.א. מנשה,מועצה איזורית,232,104,128,47,185,77,230,0,2.87%
2016-01,חיפה,1327,מעלה עירון,יישוב,831,314,517,10,821,680,821,17,13.72%
2016-01,חיפה,2500,נשר,יישוב,409,199,210,74,335,151,396,4,3.09%
2016-01,חיפה,534,עספיא,יישוב,292,131,161,15,277,168,272,5,4.81%
2016-01,חיפה,637,ערערה,יישוב,550,239,311,2,548,346,543,19,6.65%
2016-01,חיפה,537,פוריידיס,יישוב,425,216,209,13,412,274,418,2,7.29%
2016-01,חיפה,7800,פרדס חנה-כרכור,יישוב,836,364,472,175,661,261,819,15,4.01%
2016-01,חיפה,6800,קריית אתא,יישוב,1517,694,823,116,1401,764,1481,48,4.86%
2016-01,חיפה,9500,קריית ביאליק,יישוב,989,404,585,116,873,455,969,34,4.51%
2016-01,חיפה,2300,קריית טבעון,יישוב,179,72,107,66,113,38,176,3,2.10%
2016-01,חיפה,9600,קריית ים,יישוב,1416,661,755,127,1289,796,1376,41,6.40%
2016-01,חיפה,8200,קריית מוצקין,יישוב,1008,445,563,142,866,448,972,28,4.21%
2016-01,חיפה,922,רכסים,יישוב,162,77,85,12,150,77,151,0,4.22%
2016-01,ירושלים,472,אבו גוש,יישוב,255,129,126,7,248,179,254,2,8.16%
2016-01,ירושלים,2610,בית שמש,יישוב,1222,544,678,90,1132,472,1184,48,3.50%
2016-01,ירושלים,3000,ירושלים,יישוב,12243,5578,6665,1337,10906,7572,11943,195,4.00%
2016-01,ירושלים,26,מ.א. מטה יהודה,מועצה איזורית,512,265,247,121,391,127,499,1,2.09%
2016-01,ירושלים,1015,מבשרת ציון,יישוב,368,183,185,80,288,127,357,5,2.74%
2016-01,ירושלים,1137,קריית יערים,יישוב,38,14,24,7,31,16,38,0,2.68%
2016-01,תל אביב,2400,אור יהודה,יישוב,732,361,371,42,690,174,710,33,3.72%
2016-01,תל אביב,565,אזור,יישוב,201,90,111,30,171,27,201,2,3.04%
2016-01,תל אביב,6100,בני ברק,יישוב,1876,925,951,82,1794,854,1771,24,3.08%
2016-01,תל אביב,6200,בת ים,יישוב,2852,1342,1510,375,2477,977,2726,61,3.86%
2016-01,תל אביב,6300,גבעתיים,יישוב,718,313,405,311,407,76,713,5,2.31%
2016-01,תל אביב,6400,הרצלייה,יישוב,990,438,552,312,678,29,979,33,2.00%
2016-01,תל אביב,6600,חולון,יישוב,2998,1387,1611,466,2532,682,2933,62,2.95%
2016-01,תל אביב,267,כפר שמריהו,יישוב,7,4,3,3,4,0,7,1,0.83%
2016-01,תל אביב,2620,קריית אונו,יישוב,397,179,218,151,246,37,395,2,2.06%
2016-01,תל אביב,8600,רמת גן,יישוב,1958,930,1028,685,1273,376,1925,45,2.45%
2016-01,תל אביב,2650,רמת השרון,יישוב,370,152,218,160,210,13,363,10,1.63%
2016-01,תל אביב,5000,תל אביב -יפו,יישוב,7160,3503,3657,2353,4807,1876,7016,108,2.76%
2016-02,אזור יהודה והשומרון,3760,אורנית,יישוב,105,51,54,35,70,3,105,0,2.15%
2016-02,אזור יהודה והשומרון,3750,אלפי מנשה,יישוב,100,48,52,23,77,2,99,0,2.24%
2016-02,אזור יהודה והשומרון,3560,אלקנה,יישוב,39,17,22,15,24,0,38,1,2.00%
2016-02,אזור יהודה והשומרון,3650,אפרת,יישוב,36,18,18,20,16,1,36,1,0.84%
2016-02,אזור יהודה והשומרון,3570,אריאל,יישוב,297,131,166,76,221,41,296,10,2.74%
2016-02,אזור יהודה והשומרון,3574,בית אל,יישוב,50,27,23,13,37,17,49,1,2.01%
2016-02,אזור יהודה והשומרון,3652,בית אריה,יישוב,56,18,38,14,42,2,56,0,2.09%
2016-02,אזור יהודה והשומרון,3780,ביתר עילית,יישוב,516,250,266,7,509,230,513,6,3.86%
2016-02,אזור יהודה והשומרון,3730,גבעת זאב,יישוב,203,99,104,39,164,38,202,3,2.59%
2016-02,אזור יהודה והשומרון,3769,הר אדר,יישוב,42,17,25,23,19,4,42,0,1.97%
2016-02,אזור יהודה והשומרון,76,מ.א. גוש עציון,מועצה איזורית,169,80,89,70,99,17,164,0,1.70%
2016-02,אזור יהודה והשומרון,78,מ.א. הר חברון,מועצה איזורית,55,26,29,17,38,6,55,0,1.57%
2016-02,אזור יהודה והשומרון,74,מ.א. מגילות ים המלח,מועצה איזורית,9,3,6,2,7,0,9,0,1.13%
2016-02,אזור יהודה והשומרון,73,מ.א. מטה בנימין,מועצה איזורית,619,296,323,196,423,130,611,0,2.44%
2016-02,אזור יהודה והשומרון,75,מ.א. ערבות הירדן,מועצה איזורית,49,24,25,13,36,4,49,0,2.01%
2016-02,אזור יהודה והשומרון,72,מ.א. שומרון,מועצה איזורית,399,194,205,142,257,34,392,0,2.32%
2016-02,אזור יהודה והשומרון,3797,מודיעין עילית,יישוב,362,116,246,24,338,40,361,4,2.57%
2016-02,אזור יהודה והשומרון,3616,מעלה אדומים,יישוב,618,265,353,91,527,170,611,17,2.98%
2016-02,אזור יהודה והשומרון,3608,מעלה אפרים,יישוב,30,15,15,2,28,10,30,0,3.63%
2016-02,אזור יהודה והשומרון,3660,עמנואל,יישוב,58,29,29,0,58,32,55,1,4.68%
2016-02,אזור יהודה והשומרון,3557,קדומים,יישוב,36,22,14,11,25,4,36,0,1.92%
2016-02,אזור יהודה והשומרון,3611,קריית ארבע,יישוב,105,53,52,11,94,52,104,6,3.17%
2016-02,אזור יהודה והשומרון,3640,קרני שומרון,יישוב,72,37,35,20,52,5,72,0,1.90%
2016-02,הדרום,31,אופקים,יישוב,976,409,567,53,923,565,946,49,7.06%
2016-02,הדרום,2600,אילת,יישוב,1455,721,734,72,1383,484,1400,41,4.10%
2016-02,הדרום,70,אשדוד,יישוב,5591,2373,3218,685,4906,2676,5360,139,4.88%
2016-02,הדרום,7100,אשקלון,יישוב,3757,1580,2177,394,3363,1918,3243,125,4.57%
2016-02,הדרום,9000,באר שבע,יישוב,6102,2711,3391,796,5306,3317,5812,172,5.46%
2016-02,הדרום,2200,דימונה,יישוב,1854,810,1044,97,1757,1218,1764,48,9.34%
2016-02,הדרום,1303,חורה,יישוב,670,275,395,1,669,596,658,8,15.70%
2016-02,הדרום,831,ירוחם,יישוב,374,209,165,15,359,218,359,35,7.45%
2016-02,הדרום,1059,כסיפה,יישוב,1049,433,616,3,1046,924,1036,9,21.48%
2016-02,הדרום,1271,להבים,יישוב,42,23,19,22,20,3,41,1,1.13%
2016-02,הדרום,1060,לקיה,יישוב,728,315,413,2,726,661,714,6,16.55%
2016-02,הדרום,69,מ.א. אל קסום,מועצה איזורית,716,284,432,7,709,639,707,0,43.80%
2016-02,הדרום,38,מ.א. אשכול,מועצה איזורית,125,57,68,25,100,14,121,0,1.78%
2016-02,הדרום,33,מ.א. באר טוביה,מועצה איזורית,258,113,145,50,208,42,253,0,2.31%
2016-02,הדרום,41,מ.א. בני שמעון,מועצה איזורית,67,18,49,17,50,14,65,2,1.49%
2016-02,הדרום,54,מ.א. הערבה התיכונה,מועצה איזורית,26,9,17,8,18,2,26,0,1.43%
2016-02,הדרום,53,מ.א. חבל אילות,מועצה איזורית,29,11,18,7,22,0,29,2,1.23%
2016-02,הדרום,36,מ.א. חוף אשקלון,מועצה איזורית,219,89,130,43,176,49,213,0,2.58%
2016-02,הדרום,35,מ.א. יואב,מועצה איזורית,82,36,46,29,53,12,81,0,2.03%
2016-02,הדרום,50,מ.א. לכיש,מועצה איזורית,145,66,79,16,129,46,143,0,2.84%
2016-02,הדרום,42,מ.א. מרחבים,מועצה איזורית,185,73,112,31,154,31,180,0,3.05%
2016-02,הדרום,68,מ.א. נווה מדבר,מועצה איזורית,108,43,65,3,105,86,106,0,11.00%
2016-02,הדרום,48,מ.א. רמת נגב,מועצה איזורית,263,136,127,19,244,196,263,0,8.28%
2016-02,הדרום,39,מ.א. שדות נגב,מועצה איזורית,106,56,50,18,88,28,105,1,2.33%
2016-02,הדרום,37,מ.א. שער הנגב,מועצה איזורית,100,42,58,27,73,22,97,0,2.50%
2016-02,הדרום,34,מ.א. שפיר,מועצה איזורית,151,74,77,12,139,55,150,0,3.19%
2016-02,הדרום,51,מ.א. תמר,מועצה איזורית,17,2,15,6,11,1,17,0,2.69%
2016-02,הדרום,1268,מיתר,יישוב,65,27,38,25,40,8,63,1,1.41%
2016-02,הדרום,99,מצפה רמון,יישוב,264,116,148,24,240,155,254,17,9.18%
2016-02,הדרום,246,נתיבות,יישוב,918,421,497,36,882,472,873,65,5.91%
2016-02,הדרום,666,עומר,יישוב,53,19,34,30,23,2,53,1,1.26%
2016-02,הדרום,2560,ערד,יישוב,728,338,390,80,648,361,696,47,5.64%
2016-02,הדרום,1192,ערערה-בנגב,יישוב,1067,441,626,5,1062,984,1052,2,24.07%
2016-02,הדרום,2630,קריית גת,יישוב,1896,765,1131,116,1780,925,1814,47,6.34%
2016-02,הדרום,1034,קריית מלאכי,יישוב,904,406,498,23,881,445,864,77,7.35%
2016-02,הדרום,1161,רהט,יישוב,2663,1137,1526,7,2656,2246,2623,82,13.16%
2016-02,הדרום,1286,שגב-שלום,יישוב,427,156,271,3,424,362,417,5,14.72%
2016-02,הדרום,1031,שדרות,יישוב,929,436,493,56,873,529,861,22,6.41%
2016-02,הדרום,1054,תל שבע,יישוב,921,407,514,4,917,844,899,15,18.02%
2016-02,המרכז,1066,"בני עי""ש",יישוב,159,72,87,33,126,50,158,6,3.94%
2016-02,המרכז,182,אבן יהודה,יישוב,150,64,86,41,109,15,150,1,2.18%
2016-02,המרכז,41,אליכין,יישוב,70,40,30,7,63,20,67,2,3.45%
2016-02,המרכז,1309,אלעד,יישוב,356,177,179,24,332,48,350,4,2.70%
2016-02,המרכז,2530,באר יעקב,יישוב,234,92,142,59,175,42,231,5,2.31%
2016-02,המרכז,466,בית דגן,יישוב,81,51,30,4,77,33,79,4,2.14%
2016-02,המרכז,681,גבעת שמואל,יישוב,240,129,111,74,166,48,234,1,1.93%
2016-02,המרכז,2550,גדרה,יישוב,317,134,183,64,253,80,310,11,2.49%
2016-02,המרכז,627,ג'לג'וליה,יישוב,91,38,53,3,88,60,86,2,2.28%
2016-02,המרכז,166,גן יבנה,יישוב,293,133,160,50,243,69,283,9,2.34%
2016-02,המרכז,229,גני תקווה,יישוב,181,86,95,65,116,26,181,1,2.01%
2016-02,המרכז,9700,הוד השרון,יישוב,623,266,357,252,371,53,614,13,1.98%
2016-02,המרכז,1290,זמר,יישוב,144,49,95,3,141,89,143,7,4.81%
2016-02,המרכז,2730,טייבה,יישוב,1267,549,718,12,1255,973,1107,40,6.30%
2016-02,המרכז,2720,טירה,יישוב,224,113,111,11,213,93,219,9,1.91%
2016-02,המרכז,2660,יבנה,יישוב,738,365,373,116,622,234,733,27,3.00%
2016-02,המרכז,9400,יהוד,יישוב,378,175,203,93,285,44,372,7,2.31%
2016-02,המרכז,1224,כוכב יאיר,יישוב,90,40,50,44,46,2,90,1,1.56%
2016-02,המרכז,633,כפר ברא,יישוב,23,12,11,1,22,11,22,0,1.54%
2016-02,המרכז,168,כפר יונה,יישוב,313,144,169,54,259,41,310,2,2.75%
2016-02,המרכז,6900,כפר סבא,יישוב,1215,567,648,398,817,124,1195,24,2.25%
2016-02,המרכז,634,כפר קאסם,יישוב,244,107,137,12,232,135,233,2,2.52%
2016-02,המרכז,7000,לוד,יישוב,1946,915,1031,136,1810,1013,1910,61,5.36%
2016-02,המרכז,28,מ.א. ברנר,מועצה איזורית,74,37,37,33,41,2,74,2,1.83%
2016-02,המרכז,32,מ.א. גדרות,מועצה איזורית,46,23,23,19,27,2,46,1,1.88%
2016-02,המרכז,30,מ.א. גזר,מועצה איזורית,296,137,159,123,173,22,294,0,2.23%
2016-02,המרכז,27,מ.א. גן רווה,מועצה איזורית,50,26,24,25,25,4,50,0,1.71%
2016-02,המרכז,20,מ.א. דרום השרון,מועצה איזורית,325,157,168,128,197,22,322,0,2.06%
2016-02,המרכז,29,מ.א. חבל יבנה,מועצה איזורית,37,16,21,17,20,3,36,2,1.45%
2016-02,המרכז,25,מ.א. חבל מודיעין,מועצה איזורית,221,108,113,83,138,17,219,0,2.04%
2016-02,המרכז,19,מ.א. חוף השרון,מועצה איזורית,109,45,64,45,64,4,109,0,1.94%
2016-02,המרכז,18,מ.א. לב השרון,מועצה איזורית,259,125,134,43,216,28,257,0,2.34%
2016-02,המרכז,31,מ.א. נחל שורק,מועצה איזורית,53,28,25,13,40,5,52,49,1.25%
2016-02,המרכז,16,מ.א. עמק חפר,מועצה איזורית,365,176,189,92,273,11,362,0,1.84%
2016-02,המרכז,40,מ.א. עמק לוד,מועצה איזורית,141,67,74,37,104,16,141,0,2.29%
2016-02,המרכז,1200,מודיעין-מכבים-רעות*,יישוב,935,400,535,357,578,65,920,18,2.04%
2016-02,המרכז,28,מזכרת בתיה,יישוב,141,56,85,41,100,26,141,2,1.88%
2016-02,המרכז,7200,נס ציונה,יישוב,638,291,347,179,459,156,633,13,2.64%
2016-02,המרכז,7400,נתניה,יישוב,4152,1970,2182,440,3712,1372,4061,100,3.84%
2016-02,המרכז,587,סביון*,יישוב,15,2,13,9,6,0,15,0,0.76%
2016-02,המרכז,171,פרדסייה,יישוב,85,36,49,16,69,7,85,0,2.23%
2016-02,המרכז,7900,פתח תקווה,יישוב,3701,1651,2050,801,2900,963,3591,53,2.85%
2016-02,המרכז,195,קדימה-צורן,יישוב,225,89,136,47,178,34,224,0,2.02%
2016-02,המרכז,638,קלנסווה,יישוב,511,243,268,6,505,376,468,16,5.30%
2016-02,המרכז,469,קריית עקרון,יישוב,226,127,99,22,204,92,223,10,3.71%
2016-02,המרכז,2640,ראש העין,יישוב,697,345,352,87,610,137,688,23,2.72%
2016-02,המרכז,8300,ראשון לציון,יישוב,4155,1834,2321,792,3363,1192,4118,98,2.95%
2016-02,המרכז,8400,רחובות,יישוב,2124,987,1137,500,1624,731,2068,84,3.01%
2016-02,המרכז,8500,רמלה,יישוב,1554,763,791,104,1450,656,1490,63,3.95%
2016-02,המרכז,8700,רעננה,יישוב,666,307,359,257,409,51,660,16,1.78%
2016-02,המרכז,1304,שוהם,יישוב,179,87,92,80,99,9,178,1,1.53%
2016-02,המרכז,154,תל מונד,יישוב,138,63,75,40,98,18,137,0,2.13%
2016-02,הצפון,473,אבו סנאן,יישוב,618,268,350,6,612,495,611,9,10.28%
2016-02,הצפון,478,אכסאל,יישוב,529,254,275,7,522,445,519,6,8.98%
2016-02,הצפון,529,אעבלין,יישוב,533,225,308,8,525,446,521,13,8.95%
2016-02,הצפון,482,בועיינה-נוג'ידאת,יישוב,353,155,198,11,342,284,338,4,8.69%
2016-02,הצפון,4001,בוקעאתא,יישוב,370,135,235,3,367,307,360,3,13.04%
2016-02,הצפון,998,ביר אל-מכסור,יישוב,383,155,228,3,380,303,379,1,9.75%
2016-02,הצפון,480,בית ג'ן,יישוב,403,129,274,6,397,273,390,2,6.91%
2016-02,הצפון,9200,בית שאן,יישוב,819,371,448,23,796,381,796,61,7.71%
2016-02,הצפון,944,בסמת טבעון,יישוב,195,94,101,4,191,142,188,2,5.72%
2016-02,הצפון,483,בענה,יישוב,355,148,207,7,348,306,350,19,10.10%
2016-02,הצפון,1292,ג'דיידה-מכר,יישוב,1212,532,680,8,1204,995,1188,20,12.60%
2016-02,הצפון,485,ג'ולס,יישוב,240,78,162,0,240,145,237,8,7.55%
2016-02,הצפון,487,ג'ש (גוש חלב),יישוב,66,27,39,4,62,31,63,1,3.80%
2016-02,הצפון,489,דבורייה,יישוב,356,158,198,15,341,256,352,4,8.12%
2016-02,הצפון,490,דייר אל-אסד,יישוב,363,153,210,10,353,289,357,6,6.80%
2016-02,הצפון,492,דייר חנא,יישוב,636,280,356,6,630,496,626,2,12.75%
2016-02,הצפון,975,זרזיר,יישוב,269,115,154,2,267,184,261,10,7.88%
2016-02,הצפון,496,חורפיש,יישוב,111,57,54,9,102,59,107,3,3.74%
2016-02,הצפון,2034,חצור הגלילית,יישוב,271,119,152,10,261,137,250,4,5.11%
2016-02,הצפון,6700,טבריה,יישוב,1636,773,863,82,1554,831,1438,61,6.54%
2016-02,הצפון,962,טובא-זנגרייה,יישוב,378,176,202,4,374,262,368,1,11.99%
2016-02,הצפון,498,טורעאן,יישוב,494,220,274,14,480,386,470,10,8.14%
2016-02,הצפון,8900,טמרה,יישוב,1621,761,860,21,1600,1390,1583,16,11.05%
2016-02,הצפון,1295,יאנוח-ג'ת,יישוב,158,55,103,6,152,94,154,5,5.22%
2016-02,הצפון,46,יבנאל,יישוב,128,82,46,6,122,73,102,1,6.40%
2016-02,הצפון,29,יסוד המעלה,יישוב,19,6,13,4,15,5,19,2,2.21%
2016-02,הצפון,499,יפיע,יישוב,622,275,347,19,603,467,609,9,7.62%
2016-02,הצפון,240,יקנעם עילית,יישוב,482,205,277,84,398,118,477,28,3.91%
2016-02,הצפון,502,ירכא,יישוב,535,219,316,2,533,420,526,8,8.12%
2016-02,הצפון,504,כאבול,יישוב,578,264,314,10,568,499,565,4,11.31%
2016-02,הצפון,505,כאוכב אבו אל-היג'א,יישוב,222,90,132,5,217,186,217,0,12.42%
2016-02,הצפון,1296,כסרא-סמיע,יישוב,201,83,118,6,195,138,193,3,5.49%
2016-02,הצפון,978,כעביה-טבאש-חג'אג'רה,יישוב,186,73,113,6,180,127,183,2,7.71%
2016-02,הצפון,1263,כפר ורדים,יישוב,67,32,35,25,42,7,65,0,2.11%
2016-02,הצפון,507,כפר יאסיף,יישוב,436,189,247,3,433,319,423,20,8.24%
2016-02,הצפון,508,כפר כמא,יישוב,59,27,32,5,54,27,59,3,3.48%
2016-02,הצפון,509,כפר כנא,יישוב,1079,482,597,25,1054,901,1003,19,11.27%
2016-02,הצפון,510,כפר מנדא,יישוב,801,391,410,9,792,656,774,6,10.63%
2016-02,הצפון,47,כפר תבור,יישוב,41,19,22,23,18,1,40,0,1.75%
2016-02,הצפון,1139,כרמיאל,יישוב,1502,610,892,243,1259,715,1435,45,5.50%
2016-02,הצפון,65,מ.א. אל-בטוף,מועצה איזורית,379,143,236,10,369,289,360,0,12.42%
2016-02,הצפון,66,מ.א. בוסתן אל-מרג',מועצה איזורית,40,12,28,1,39,34,39,1,1.27%
2016-02,הצפון,71,מ.א. גולן,מועצה איזורית,185,84,101,45,140,20,184,1,2.14%
2016-02,הצפון,8,מ.א. הגלבוע,מועצה איזורית,755,318,437,69,686,438,743,0,5.15%
2016-02,הצפון,1,מ.א. הגליל העליון,מועצה איזורית,208,86,122,55,153,19,206,0,2.33%
2016-02,הצפון,3,מ.א. הגליל התחתון,מועצה איזורית,112,43,69,38,74,12,106,0,1.81%
2016-02,הצפון,55,מ.א. מבואות החרמון,מועצה איזורית,113,51,62,17,96,21,110,0,2.75%
2016-02,הצפון,13,מ.א. מגידו,מועצה איזורית,112,39,73,38,74,6,110,0,1.94%
2016-02,הצפון,4,מ.א. מטה אשר,מועצה איזורית,448,199,249,66,382,183,442,0,3.22%
2016-02,הצפון,52,מ.א. מעלה יוסף,מועצה איזורית,207,100,107,29,178,54,202,0,3.66%
2016-02,הצפון,2,מ.א. מרום הגליל,מועצה איזורית,267,123,144,32,235,115,256,0,3.75%
2016-02,הצפון,56,מ.א. משגב,מועצה איזורית,577,225,352,106,471,304,563,0,4.33%
2016-02,הצפון,6,מ.א. עמק הירדן,מועצה איזורית,166,80,86,28,138,30,157,0,2.32%
2016-02,הצפון,7,מ.א. עמק המעיינות,מועצה איזורית,196,81,115,36,160,38,193,0,2.98%
2016-02,הצפון,9,מ.א. עמק יזרעאל,מועצה איזורית,372,158,214,167,205,32,367,0,1.90%
2016-02,הצפון,481,מגאר,יישוב,1335,550,785,22,1313,1112,1286,13,13.04%
2016-02,הצפון,516,מג'ד אל-כרום,יישוב,489,235,254,10,479,366,479,8,7.17%
2016-02,הצפון,65,מגדל,יישוב,31,12,19,2,29,10,30,0,3.18%
2016-02,הצפון,874,מגדל העמק,יישוב,897,396,501,91,806,313,848,77,6.20%
2016-02,הצפון,4201,מג'דל שמס,יישוב,445,164,281,10,435,353,422,2,8.58%
2016-02,הצפון,517,מזרעה,יישוב,163,71,92,3,160,122,155,0,7.79%
2016-02,הצפון,43,מטולה,יישוב,36,18,18,10,26,5,36,1,3.40%
2016-02,הצפון,4203,מסעדה,יישוב,208,76,132,4,204,175,197,1,11.55%
2016-02,הצפון,518,מעיליא,יישוב,41,21,20,7,34,22,41,1,2.55%
2016-02,הצפון,1063,מעלות-תרשיחא,יישוב,820,398,422,100,720,415,805,36,6.78%
2016-02,הצפון,520,משהד,יישוב,259,111,148,8,251,214,242,6,7.46%
2016-02,הצפון,9100,נהרייה,יישוב,1895,913,982,202,1693,969,1814,74,5.84%
2016-02,הצפון,522,נחף,יישוב,406,193,213,21,385,312,400,8,7.82%
2016-02,הצפון,7300,נצרת,יישוב,3087,1361,1726,115,2972,2383,3027,29,8.72%
2016-02,הצפון,1061,נצרת עילית,יישוב,1672,753,919,169,1503,862,1496,91,6.41%
2016-02,הצפון,525,סאג'ור,יישוב,116,44,72,3,113,76,115,0,5.79%
2016-02,הצפון,7500,סח'נין,יישוב,2124,930,1194,36,2088,1778,2090,4,14.64%
2016-02,הצפון,4501,ע'ג'ר,יישוב,99,43,56,3,96,61,97,1,9.10%
2016-02,הצפון,530,עיילבון,יישוב,176,83,93,6,170,113,172,0,6.19%
2016-02,הצפון,511,עילוט,יישוב,307,118,189,5,302,258,300,1,10.44%
2016-02,הצפון,532,עין מאהל,יישוב,504,248,256,12,492,380,489,3,9.16%
2016-02,הצפון,4502,עין קנייא,יישוב,152,58,94,1,151,121,148,1,14.24%
2016-02,הצפון,7600,עכו,יישוב,3059,1402,1657,123,2936,2208,2963,59,11.08%
2016-02,הצפון,7700,עפולה,יישוב,1595,680,915,156,1439,639,1509,86,5.88%
2016-02,הצפון,531,עראבה,יישוב,1581,694,887,38,1543,1355,1547,4,14.90%
2016-02,הצפון,535,פסוטה,יישוב,105,51,54,3,102,58,104,3,5.99%
2016-02,הצפון,536,פקיעין (בוקייעה),יישוב,120,62,58,6,114,74,119,1,4.23%
2016-02,הצפון,8000,צפת,יישוב,1313,703,610,78,1235,935,1219,20,8.95%
2016-02,הצפון,4100,קצרין,יישוב,226,85,141,35,191,94,221,5,5.44%
2016-02,הצפון,2800,קריית שמונה,יישוב,783,362,421,63,720,323,752,32,5.71%
2016-02,הצפון,543,ראמה,יישוב,277,117,160,11,266,201,271,1,6.90%
2016-02,הצפון,26,ראש פינה,יישוב,47,17,30,10,37,19,45,0,2.81%
2016-02,הצפון,542,ריינה,יישוב,590,252,338,9,581,464,558,8,8.11%
2016-02,הצפון,122,רמת ישי,יישוב,89,37,52,34,55,9,87,1,2.09%
2016-02,הצפון,913,שבלי - אום אל-גנם,יישוב,211,89,122,6,205,139,210,1,7.88%
2016-02,הצפון,812,שלומי,יישוב,224,94,130,13,211,96,218,10,6.03%
2016-02,הצפון,538,שעב,יישוב,523,212,311,5,518,465,518,1,16.65%
2016-02,הצפון,8800,שפרעם,יישוב,1795,725,1070,33,1762,1399,1761,34,9.60%
2016-02,חיפה,1326,"בסמ""ה",יישוב,396,179,217,6,390,302,392,4,9.63%
2016-02,חיפה,2710,אום אל-פחם,יישוב,3320,1407,1913,48,3272,2773,3268,38,15.20%
2016-02,חיפה,1020,אור עקיבא,יישוב,470,220,250,44,426,149,457,21,4.48%
2016-02,חיפה,6000,באקה אל-גרביה,יישוב,637,323,314,15,622,360,628,23,5.32%
2016-02,חיפה,9800,בנימינה-גבעת עדה*,יישוב,185,77,108,61,124,64,182,0,2.50%
2016-02,חיפה,541,ג'סר א-זרקא,יישוב,457,239,218,5,452,333,449,8,7.35%
2016-02,חיפה,628,ג'ת,יישוב,201,99,102,6,195,112,197,10,3.73%
2016-02,חיפה,494,דאלית אל-כרמל,יישוב,479,197,282,16,463,261,451,7,5.44%
2016-02,חיפה,9300,זכרון יעקב,יישוב,262,121,141,85,177,52,257,1,2.31%
2016-02,חיפה,6500,חדרה,יישוב,2313,1024,1289,266,2047,813,2174,74,4.32%
2016-02,חיפה,4000,חיפה,יישוב,6034,3019,3015,1131,4903,3029,5724,166,4.09%
2016-02,חיפה,1247,חריש,יישוב,28,15,13,0,28,11,26,1,1.63%
2016-02,חיפה,2100,טירת כרמל,יישוב,640,320,320,35,605,357,625,23,5.55%
2016-02,חיפה,654,כפר קרע,יישוב,386,186,200,17,369,237,379,14,4.43%
2016-02,חיפה,45,מ.א. אלונה,מועצה איזורית,33,13,20,7,26,4,32,0,3.00%
2016-02,חיפה,12,מ.א. זבולון,מועצה איזורית,246,113,133,26,220,152,239,0,4.29%
2016-02,חיפה,15,מ.א. חוף הכרמל,מועצה איזורית,310,143,167,101,209,52,306,0,2.16%
2016-02,חיפה,14,מ.א. מנשה,מועצה איזורית,214,91,123,50,164,73,210,0,2.62%
2016-02,חיפה,1327,מעלה עירון,יישוב,813,312,501,11,802,669,805,9,13.48%
2016-02,חיפה,2500,נשר,יישוב,413,210,203,79,334,141,399,7,3.11%
2016-02,חיפה,534,עספיא,יישוב,290,125,165,16,274,163,270,11,4.77%
2016-02,חיפה,637,ערערה,יישוב,548,241,307,6,542,355,536,15,6.57%
2016-02,חיפה,537,פוריידיס,יישוב,417,221,196,12,405,275,408,2,7.13%
2016-02,חיפה,7800,פרדס חנה-כרכור,יישוב,834,370,464,171,663,265,812,29,3.98%
2016-02,חיפה,6800,קריית אתא,יישוב,1563,711,852,123,1440,785,1515,53,4.96%
2016-02,חיפה,9500,קריית ביאליק,יישוב,989,413,576,117,872,463,969,31,4.51%
2016-02,חיפה,2300,קריית טבעון,יישוב,175,70,105,63,112,36,172,2,2.06%
2016-02,חיפה,9600,קריית ים,יישוב,1385,652,733,124,1261,772,1350,45,6.29%
2016-02,חיפה,8200,קריית מוצקין,יישוב,1018,456,562,143,875,440,982,31,4.25%
2016-02,חיפה,922,רכסים,יישוב,171,85,86,11,160,81,156,1,4.36%
2016-02,ירושלים,472,אבו גוש,יישוב,262,137,125,7,255,188,260,2,8.34%
2016-02,ירושלים,2610,בית שמש,יישוב,1187,528,659,81,1106,463,1140,39,3.38%
2016-02,ירושלים,3000,ירושלים,יישוב,12168,5555,6613,1327,10841,7519,11859,165,3.98%
2016-02,ירושלים,26,מ.א. מטה יהודה,מועצה איזורית,527,277,250,124,403,133,515,0,2.15%
2016-02,ירושלים,1015,מבשרת ציון,יישוב,362,179,183,91,271,121,353,6,2.71%
2016-02,ירושלים,1137,קריית יערים,יישוב,43,17,26,9,34,16,43,0,3.02%
2016-02,תל אביב,2400,אור יהודה,יישוב,727,356,371,47,680,165,696,35,3.65%
2016-02,תל אביב,565,אזור,יישוב,191,84,107,30,161,27,189,3,2.87%
2016-02,תל אביב,6100,בני ברק,יישוב,1850,934,916,83,1767,841,1743,25,3.04%
2016-02,תל אביב,6200,בת ים,יישוב,2819,1349,1470,380,2439,978,2703,78,3.83%
2016-02,תל אביב,6300,גבעתיים,יישוב,699,298,401,323,376,79,697,6,2.26%
2016-02,תל אביב,6400,הרצלייה,יישוב,1000,437,563,328,672,25,986,32,2.02%
2016-02,תל אביב,6600,חולון,יישוב,2924,1358,1566,438,2486,654,2855,63,2.87%
2016-02,תל אביב,267,כפר שמריהו,יישוב,7,4,3,3,4,0,7,0,0.83%
2016-02,תל אביב,2620,קריית אונו,יישוב,377,159,218,137,240,43,374,6,1.95%
2016-02,תל אביב,8600,רמת גן,יישוב,1930,899,1031,668,1262,364,1893,39,2.41%
2016-02,תל אביב,2650,רמת השרון,יישוב,362,158,204,154,208,9,358,4,1.60%
2016-02,תל אביב,5000,תל אביב -יפו,יישוב,7158,3529,3629,2392,4766,1812,7041,160,2.77%
2016-03,אזור יהודה והשומרון,3760,אורנית,יישוב,96,47,49,38,58,4,95,0,1.95%
2016-03,אזור יהודה והשומרון,3750,אלפי מנשה,יישוב,91,41,50,27,64,3,90,1,2.04%
2016-03,אזור יהודה והשומרון,3560,אלקנה,יישוב,32,12,20,11,21,0,32,0,1.69%
2016-03,אזור יהודה והשומרון,3650,אפרת,יישוב,37,18,19,19,18,1,37,1,0.86%
2016-03,אזור יהודה והשומרון,3570,אריאל,יישוב,313,134,179,73,240,41,311,11,2.88%
2016-03,אזור יהודה והשומרון,3574,בית אל,יישוב,53,27,26,16,37,20,51,0,2.10%
2016-03,אזור יהודה והשומרון,3652,בית אריה,יישוב,61,19,42,17,44,1,61,1,2.27%
2016-03,אזור יהודה והשומרון,3780,ביתר עילית,יישוב,503,229,274,8,495,223,499,7,3.75%
2016-03,אזור יהודה והשומרון,3730,גבעת זאב,יישוב,202,91,111,46,156,36,199,3,2.56%
2016-03,אזור יהודה והשומרון,3769,הר אדר,יישוב,41,14,27,21,20,3,41,0,1.93%
2016-03,אזור יהודה והשומרון,76,מ.א. גוש עציון,מועצה איזורית,156,77,79,62,94,17,151,0,1.57%
2016-03,אזור יהודה והשומרון,78,מ.א. הר חברון,מועצה איזורית,51,22,29,18,33,4,50,1,1.43%
2016-03,אזור יהודה והשומרון,74,מ.א. מגילות ים המלח,מועצה איזורית,12,6,6,3,9,0,12,0,1.50%
2016-03,אזור יהודה והשומרון,73,מ.א. מטה בנימין,מועצה איזורית,598,295,303,184,414,131,586,0,2.34%
2016-03,אזור יהודה והשומרון,75,מ.א. ערבות הירדן,מועצה איזורית,49,27,22,11,38,3,49,0,2.01%
2016-03,אזור יהודה והשומרון,72,מ.א. שומרון,מועצה איזורית,401,200,201,150,251,38,397,0,2.35%
2016-03,אזור יהודה והשומרון,3797,מודיעין עילית,יישוב,351,108,243,22,329,38,347,5,2.48%
2016-03,אזור יהודה והשומרון,3616,מעלה אדומים,יישוב,635,283,352,85,550,173,631,18,3.07%
2016-03,אזור יהודה והשומרון,3608,מעלה אפרים,יישוב,33,18,15,2,31,9,33,2,3.98%
2016-03,אזור יהודה והשומרון,3660,עמנואל,יישוב,60,32,28,0,60,33,59,2,5.00%
2016-03,אזור יהודה והשומרון,3557,קדומים,יישוב,39,24,15,9,30,5,39,0,2.07%
2016-03,אזור יהודה והשומרון,3611,קריית ארבע,יישוב,102,53,49,11,91,52,100,4,3.05%
2016-03,אזור יהודה והשומרון,3640,קרני שומרון,יישוב,68,33,35,19,49,5,68,1,1.80%
2016-03,הדרום,31,אופקים,יישוב,939,400,539,55,884,565,902,41,6.75%
2016-03,הדרום,2600,אילת,יישוב,1329,665,664,68,1261,464,1279,53,3.76%
2016-03,הדרום,70,אשדוד,יישוב,5549,2378,3171,678,4871,2595,5289,160,4.81%
2016-03,הדרום,7100,אשקלון,יישוב,3719,1540,2179,388,3331,1897,3209,135,4.53%
2016-03,הדרום,9000,באר שבע,יישוב,5993,2649,3344,783,5210,3296,5688,177,5.35%
2016-03,הדרום,2200,דימונה,יישוב,1866,817,1049,97,1769,1193,1773,73,9.38%
2016-03,הדרום,1303,חורה,יישוב,644,262,382,2,642,575,632,5,15.17%
2016-03,הדרום,831,ירוחם,יישוב,360,197,163,15,345,216,349,28,7.26%
2016-03,הדרום,1059,כסיפה,יישוב,1033,412,621,3,1030,922,1022,8,21.25%
2016-03,הדרום,1271,להבים,יישוב,38,18,20,20,18,2,38,0,1.05%
2016-03,הדרום,1060,לקיה,יישוב,735,313,422,2,733,650,725,4,16.76%
2016-03,הדרום,69,מ.א. אל קסום,מועצה איזורית,699,272,427,7,692,618,687,0,42.57%
2016-03,הדרום,38,מ.א. אשכול,מועצה איזורית,123,52,71,26,97,14,118,0,1.73%
2016-03,הדרום,33,מ.א. באר טוביה,מועצה איזורית,267,117,150,48,219,43,261,0,2.38%
2016-03,הדרום,41,מ.א. בני שמעון,מועצה איזורית,62,17,45,14,48,11,61,7,1.40%
2016-03,הדרום,54,מ.א. הערבה התיכונה,מועצה איזורית,28,11,17,7,21,2,28,0,1.54%
2016-03,הדרום,53,מ.א. חבל אילות,מועצה איזורית,26,8,18,8,18,0,26,4,1.10%
2016-03,הדרום,36,מ.א. חוף אשקלון,מועצה איזורית,220,89,131,42,178,47,212,0,2.56%
2016-03,הדרום,35,מ.א. יואב,מועצה איזורית,73,30,43,24,49,11,72,0,1.81%
2016-03,הדרום,50,מ.א. לכיש,מועצה איזורית,135,62,73,17,118,42,131,0,2.61%
2016-03,הדרום,42,מ.א. מרחבים,מועצה איזורית,172,65,107,31,141,30,165,0,2.79%
2016-03,הדרום,68,מ.א. נווה מדבר,מועצה איזורית,113,46,67,2,111,86,110,0,11.41%
2016-03,הדרום,48,מ.א. רמת נגב,מועצה איזורית,244,127,117,15,229,195,244,0,7.69%
2016-03,הדרום,39,מ.א. שדות נגב,מועצה איזורית,109,58,51,19,90,31,105,0,2.33%
2016-03,הדרום,37,מ.א. שער הנגב,מועצה איזורית,90,40,50,27,63,21,88,1,2.27%
2016-03,הדרום,34,מ.א. שפיר,מועצה איזורית,155,75,80,17,138,56,153,0,3.26%
2016-03,הדרום,51,מ.א. תמר,מועצה איזורית,14,2,12,4,10,1,13,0,2.05%
2016-03,הדרום,1268,מיתר,יישוב,65,28,37,24,41,7,64,1,1.43%
2016-03,הדרום,99,מצפה רמון,יישוב,225,91,134,20,205,149,221,12,8.08%
2016-03,הדרום,246,נתיבות,יישוב,886,408,478,32,854,469,837,64,5.68%
2016-03,הדרום,666,עומר,יישוב,61,24,37,30,31,2,60,1,1.42%
2016-03,הדרום,2560,ערד,יישוב,707,331,376,78,629,352,679,47,5.51%
2016-03,הדרום,1192,ערערה-בנגב,יישוב,1078,441,637,4,1074,969,1062,1,24.25%
2016-03,הדרום,2630,קריית גת,יישוב,1825,739,1086,118,1707,907,1753,71,6.14%
2016-03,הדרום,1034,קריית מלאכי,יישוב,826,372,454,16,810,404,788,78,6.74%
2016-03,הדרום,1161,רהט,יישוב,2655,1131,1524,11,2644,2214,2619,42,13.14%
2016-03,הדרום,1286,שגב-שלום,יישוב,426,159,267,3,423,366,416,9,14.69%
2016-03,הדרום,1031,שדרות,יישוב,915,410,505,53,862,532,840,28,6.27%
2016-03,הדרום,1054,תל שבע,יישוב,903,403,500,6,897,821,878,22,17.68%
2016-03,המרכז,1066,"בני עי""ש",יישוב,149,72,77,35,114,46,148,4,3.70%
2016-03,המרכז,182,אבן יהודה,יישוב,144,70,74,39,105,14,144,0,2.09%
2016-03,המרכז,41,אליכין,יישוב,64,32,32,8,56,18,62,7,3.20%
2016-03,המרכז,1309,אלעד,יישוב,340,170,170,24,316,50,336,3,2.59%
2016-03,המרכז,2530,באר יעקב,יישוב,233,85,148,63,170,43,232,7,2.32%
2016-03,המרכז,466,בית דגן,יישוב,87,46,41,6,81,33,85,3,2.30%
2016-03,המרכז,681,גבעת שמואל,יישוב,241,128,113,74,167,51,233,3,1.93%
2016-03,המרכז,2550,גדרה,יישוב,326,135,191,75,251,78,318,8,2.55%
2016-03,המרכז,627,ג'לג'וליה,יישוב,108,49,59,3,105,68,102,1,2.69%
2016-03,המרכז,166,גן יבנה,יישוב,284,123,161,44,240,64,275,7,2.28%
2016-03,המרכז,229,גני תקווה,יישוב,181,86,95,59,122,28,180,1,2.00%
2016-03,המרכז,9700,הוד השרון,יישוב,599,264,335,246,353,54,594,8,1.92%
2016-03,המרכז,1290,זמר,יישוב,146,45,101,4,142,91,145,6,4.88%
2016-03,המרכז,2730,טייבה,יישוב,1256,542,714,15,1241,972,1103,45,6.28%
2016-03,המרכז,2720,טירה,יישוב,230,113,117,9,221,95,224,19,1.96%
2016-03,המרכז,2660,יבנה,יישוב,694,333,361,107,587,220,688,23,2.82%
2016-03,המרכז,9400,יהוד,יישוב,384,181,203,94,290,48,380,6,2.36%
2016-03,המרכז,1224,כוכב יאיר,יישוב,86,43,43,49,37,2,86,0,1.49%
2016-03,המרכז,633,כפר ברא,יישוב,24,12,12,1,23,13,23,0,1.61%
2016-03,המרכז,168,כפר יונה,יישוב,324,145,179,55,269,43,321,6,2.84%
2016-03,המרכז,6900,כפר סבא,יישוב,1187,536,651,403,784,119,1169,31,2.20%
2016-03,המרכז,634,כפר קאסם,יישוב,228,102,126,11,217,130,221,6,2.39%
2016-03,המרכז,7000,לוד,יישוב,1888,869,1019,133,1755,991,1838,58,5.17%
2016-03,המרכז,28,מ.א. ברנר,מועצה איזורית,67,32,35,34,33,2,67,1,1.66%
2016-03,המרכז,32,מ.א. גדרות,מועצה איזורית,45,22,23,20,25,2,45,1,1.84%
2016-03,המרכז,30,מ.א. גזר,מועצה איזורית,288,127,161,121,167,21,286,0,2.17%
2016-03,המרכז,27,מ.א. גן רווה,מועצה איזורית,54,24,30,28,26,3,54,1,1.84%
2016-03,המרכז,20,מ.א. דרום השרון,מועצה איזורית,314,151,163,120,194,19,310,0,1.98%
2016-03,המרכז,29,מ.א. חבל יבנה,מועצה איזורית,33,17,16,14,19,3,33,0,1.32%
2016-03,המרכז,25,מ.א. חבל מודיעין,מועצה איזורית,230,110,120,84,146,16,228,0,2.12%
2016-03,המרכז,19,מ.א. חוף השרון,מועצה איזורית,103,42,61,38,65,4,102,0,1.82%
2016-03,המרכז,18,מ.א. לב השרון,מועצה איזורית,251,123,128,45,206,30,248,0,2.25%
2016-03,המרכז,31,מ.א. נחל שורק,מועצה איזורית,53,30,23,13,40,6,51,41,1.24%
2016-03,המרכז,16,מ.א. עמק חפר,מועצה איזורית,357,172,185,94,263,11,354,0,1.80%
2016-03,המרכז,40,מ.א. עמק לוד,מועצה איזורית,136,69,67,33,103,14,136,0,2.20%
2016-03,המרכז,1200,מודיעין-מכבים-רעות*,יישוב,913,390,523,351,562,60,902,16,2.00%
2016-03,המרכז,28,מזכרת בתיה,יישוב,134,60,74,45,89,26,132,1,1.76%
2016-03,המרכז,7200,נס ציונה,יישוב,627,283,344,177,450,161,618,15,2.58%
2016-03,המרכז,7400,נתניה,יישוב,4095,1944,2151,470,3625,1371,4004,82,3.79%
2016-03,המרכז,587,סביון*,יישוב,15,1,14,8,7,0,15,0,0.76%
2016-03,המרכז,171,פרדסייה,יישוב,78,37,41,18,60,5,77,0,2.03%
2016-03,המרכז,7900,פתח תקווה,יישוב,3651,1635,2016,780,2871,960,3562,54,2.83%
2016-03,המרכז,195,קדימה-צורן,יישוב,233,96,137,56,177,38,230,0,2.07%
2016-03,המרכז,638,קלנסווה,יישוב,495,232,263,6,489,372,453,15,5.14%
2016-03,המרכז,469,קריית עקרון,יישוב,236,131,105,24,212,87,231,12,3.83%
2016-03,המרכז,2640,ראש העין,יישוב,673,334,339,89,584,138,661,17,2.62%
2016-03,המרכז,8300,ראשון לציון,יישוב,4110,1814,2296,785,3325,1204,4070,106,2.92%
2016-03,המרכז,8400,רחובות,יישוב,2086,949,1137,474,1612,707,2033,67,2.96%
2016-03,המרכז,8500,רמלה,יישוב,1535,753,782,96,1439,659,1474,71,3.91%
2016-03,המרכז,8700,רעננה,יישוב,660,296,364,260,400,45,653,4,1.76%
2016-03,המרכז,1304,שוהם,יישוב,172,86,86,75,97,10,170,1,1.46%
2016-03,המרכז,154,תל מונד,יישוב,134,59,75,44,90,16,134,2,2.08%
2016-03,הצפון,473,אבו סנאן,יישוב,610,256,354,6,604,487,603,14,10.15%
2016-03,הצפון,478,אכסאל,יישוב,530,252,278,9,521,437,523,5,9.04%
2016-03,הצפון,529,אעבלין,יישוב,514,221,293,7,507,428,504,4,8.68%
2016-03,הצפון,482,בועיינה-נוג'ידאת,יישוב,343,144,199,10,333,262,334,3,8.60%
2016-03,הצפון,4001,בוקעאתא,יישוב,370,132,238,4,366,309,360,0,13.04%
2016-03,הצפון,998,ביר אל-מכסור,יישוב,380,154,226,5,375,296,374,0,9.63%
2016-03,הצפון,480,בית ג'ן,יישוב,403,122,281,9,394,275,391,1,6.92%
2016-03,הצפון,9200,בית שאן,יישוב,771,359,412,20,751,371,744,74,7.24%
2016-03,הצפון,944,בסמת טבעון,יישוב,197,93,104,4,193,141,189,2,5.75%
2016-03,הצפון,483,בענה,יישוב,334,140,194,9,325,285,329,12,9.55%
2016-03,הצפון,1292,ג'דיידה-מכר,יישוב,1216,529,687,5,1211,988,1195,25,12.67%
2016-03,הצפון,485,ג'ולס,יישוב,227,71,156,0,227,142,225,8,7.20%
2016-03,הצפון,487,ג'ש (גוש חלב),יישוב,67,31,36,6,61,32,64,2,3.86%
2016-03,הצפון,489,דבורייה,יישוב,349,149,200,16,333,256,345,4,7.97%
2016-03,הצפון,490,דייר אל-אסד,יישוב,351,151,200,11,340,280,347,13,6.62%
2016-03,הצפון,492,דייר חנא,יישוב,632,283,349,7,625,504,621,8,12.66%
2016-03,הצפון,975,זרזיר,יישוב,248,107,141,3,245,174,244,9,7.40%
2016-03,הצפון,496,חורפיש,יישוב,114,54,60,10,104,66,108,5,3.77%
2016-03,הצפון,2034,חצור הגלילית,יישוב,267,119,148,14,253,143,243,8,4.98%
2016-03,הצפון,6700,טבריה,יישוב,1604,768,836,84,1520,800,1425,87,6.48%
2016-03,הצפון,962,טובא-זנגרייה,יישוב,383,175,208,5,378,265,370,0,12.04%
2016-03,הצפון,498,טורעאן,יישוב,470,202,268,15,455,372,451,6,7.84%
2016-03,הצפון,8900,טמרה,יישוב,1577,736,841,20,1557,1361,1548,20,10.83%
2016-03,הצפון,1295,יאנוח-ג'ת,יישוב,167,60,107,6,161,95,164,7,5.54%
2016-03,הצפון,46,יבנאל,יישוב,118,72,46,7,111,68,94,2,5.93%
2016-03,הצפון,29,יסוד המעלה,יישוב,21,8,13,2,19,5,21,0,2.43%
2016-03,הצפון,499,יפיע,יישוב,618,281,337,19,599,456,609,8,7.62%
2016-03,הצפון,240,יקנעם עילית,יישוב,487,214,273,91,396,120,479,24,3.93%
2016-03,הצפון,502,ירכא,יישוב,536,220,316,0,536,419,529,6,8.16%
2016-03,הצפון,504,כאבול,יישוב,566,261,305,13,553,487,554,4,11.12%
2016-03,הצפון,505,כאוכב אבו אל-היג'א,יישוב,226,89,137,7,219,186,221,1,12.62%
2016-03,הצפון,1296,כסרא-סמיע,יישוב,212,91,121,5,207,148,200,3,5.68%
2016-03,הצפון,978,כעביה-טבאש-חג'אג'רה,יישוב,183,81,102,4,179,125,179,2,7.56%
2016-03,הצפון,1263,כפר ורדים,יישוב,67,30,37,28,39,5,66,1,2.14%
2016-03,הצפון,507,כפר יאסיף,יישוב,424,185,239,4,420,313,413,12,8.06%
2016-03,הצפון,508,כפר כמא,יישוב,61,30,31,4,57,28,60,0,3.54%
2016-03,הצפון,509,כפר כנא,יישוב,1024,456,568,24,1000,828,974,22,10.98%
2016-03,הצפון,510,כפר מנדא,יישוב,760,375,385,9,751,625,744,6,10.26%
2016-03,הצפון,47,כפר תבור,יישוב,43,20,23,20,23,1,42,1,1.83%
2016-03,הצפון,1139,כרמיאל,יישוב,1470,573,897,240,1230,711,1397,45,5.36%
2016-03,הצפון,65,מ.א. אל-בטוף,מועצה איזורית,350,135,215,9,341,269,337,1,11.61%
2016-03,הצפון,66,מ.א. בוסתן אל-מרג',מועצה איזורית,39,12,27,1,38,33,38,0,1.24%
2016-03,הצפון,71,מ.א. גולן,מועצה איזורית,168,73,95,42,126,19,167,0,1.94%
2016-03,הצפון,8,מ.א. הגלבוע,מועצה איזורית,733,306,427,67,666,432,721,0,5.00%
2016-03,הצפון,1,מ.א. הגליל העליון,מועצה איזורית,197,82,115,70,127,15,196,0,2.22%
2016-03,הצפון,3,מ.א. הגליל התחתון,מועצה איזורית,108,42,66,37,71,12,105,0,1.79%
2016-03,הצפון,55,מ.א. מבואות החרמון,מועצה איזורית,102,47,55,15,87,19,98,0,2.45%
2016-03,הצפון,13,מ.א. מגידו,מועצה איזורית,101,34,67,37,64,8,100,0,1.76%
2016-03,הצפון,4,מ.א. מטה אשר,מועצה איזורית,425,182,243,60,365,174,422,0,3.08%
2016-03,הצפון,52,מ.א. מעלה יוסף,מועצה איזורית,191,91,100,24,167,54,188,0,3.41%
2016-03,הצפון,2,מ.א. מרום הגליל,מועצה איזורית,263,120,143,30,233,107,251,0,3.68%
2016-03,הצפון,56,מ.א. משגב,מועצה איזורית,560,220,340,100,460,301,547,0,4.21%
2016-03,הצפון,6,מ.א. עמק הירדן,מועצה איזורית,164,81,83,33,131,31,154,0,2.28%
2016-03,הצפון,7,מ.א. עמק המעיינות,מועצה איזורית,190,79,111,36,154,38,187,0,2.89%
2016-03,הצפון,9,מ.א. עמק יזרעאל,מועצה איזורית,349,150,199,163,186,34,346,0,1.79%
2016-03,הצפון,481,מגאר,יישוב,1317,548,769,17,1300,1107,1270,10,12.90%
2016-03,הצפון,516,מג'ד אל-כרום,יישוב,481,231,250,8,473,359,469,19,7.03%
2016-03,הצפון,65,מגדל,יישוב,34,15,19,2,32,11,33,1,3.49%
2016-03,הצפון,874,מגדל העמק,יישוב,868,400,468,80,788,310,818,74,5.99%
2016-03,הצפון,4201,מג'דל שמס,יישוב,451,171,280,9,442,361,424,5,8.61%
2016-03,הצפון,517,מזרעה,יישוב,164,71,93,3,161,122,158,5,7.93%
2016-03,הצפון,43,מטולה,יישוב,31,15,16,11,20,5,31,0,2.94%
2016-03,הצפון,4203,מסעדה,יישוב,209,78,131,5,204,172,197,4,11.55%
2016-03,הצפון,518,מעיליא,יישוב,48,25,23,4,44,25,46,0,2.85%
2016-03,הצפון,1063,מעלות-תרשיחא,יישוב,814,405,409,87,727,427,790,40,6.66%
2016-03,הצפון,520,משהד,יישוב,264,109,155,7,257,202,255,5,7.83%
2016-03,הצפון,9100,נהרייה,יישוב,1828,884,944,200,1628,965,1763,75,5.68%
2016-03,הצפון,522,נחף,יישוב,395,190,205,17,378,307,387,14,7.59%
2016-03,הצפון,7300,נצרת,יישוב,3101,1379,1722,127,2974,2383,3046,35,8.77%
2016-03,הצפון,1061,נצרת עילית,יישוב,1585,724,861,166,1419,810,1416,93,6.08%
2016-03,הצפון,525,סאג'ור,יישוב,116,44,72,3,113,72,114,0,5.75%
2016-03,הצפון,7500,סח'נין,יישוב,2137,924,1213,37,2100,1797,2095,18,14.67%
2016-03,הצפון,4501,ע'ג'ר,יישוב,95,40,55,3,92,61,94,1,8.84%
2016-03,הצפון,530,עיילבון,יישוב,169,81,88,5,164,108,165,1,5.95%
2016-03,הצפון,511,עילוט,יישוב,324,125,199,5,319,266,321,0,11.09%
2016-03,הצפון,532,עין מאהל,יישוב,462,227,235,11,451,354,452,1,8.53%
2016-03,הצפון,4502,עין קנייא,יישוב,154,62,92,1,153,119,149,1,14.33%
2016-03,הצפון,7600,עכו,יישוב,3043,1408,1635,136,2907,2190,2942,70,11.01%
2016-03,הצפון,7700,עפולה,יישוב,1537,665,872,161,1376,627,1447,89,5.66%
2016-03,הצפון,531,עראבה,יישוב,1574,685,889,36,1538,1355,1542,11,14.86%
2016-03,הצפון,535,פסוטה,יישוב,110,56,54,2,108,62,108,1,6.21%
2016-03,הצפון,536,פקיעין (בוקייעה),יישוב,120,67,53,6,114,75,116,1,4.13%
2016-03,הצפון,8000,צפת,יישוב,1265,703,562,83,1182,900,1176,22,8.67%
2016-03,הצפון,4100,קצרין,יישוב,204,75,129,36,168,90,200,4,4.95%
2016-03,הצפון,2800,קריית שמונה,יישוב,772,355,417,63,709,311,739,38,5.62%
2016-03,הצפון,543,ראמה,יישוב,276,113,163,8,268,204,272,4,6.92%
2016-03,הצפון,26,ראש פינה,יישוב,46,17,29,9,37,19,45,0,2.81%
2016-03,הצפון,542,ריינה,יישוב,553,243,310,9,544,437,533,8,7.77%
2016-03,הצפון,122,רמת ישי,יישוב,100,43,57,36,64,10,97,1,2.32%
2016-03,הצפון,913,שבלי - אום אל-גנם,יישוב,209,83,126,5,204,136,207,3,7.77%
2016-03,הצפון,812,שלומי,יישוב,221,95,126,16,205,103,215,6,5.95%
2016-03,הצפון,538,שעב,יישוב,538,221,317,3,535,479,529,3,16.94%
2016-03,הצפון,8800,שפרעם,יישוב,1726,699,1027,32,1694,1345,1696,31,9.28%
2016-03,חיפה,1326,"בסמ""ה",יישוב,403,181,222,7,396,301,396,6,9.72%
2016-03,חיפה,2710,אום אל-פחם,יישוב,3236,1370,1866,46,3190,2717,3181,44,14.86%
2016-03,חיפה,1020,אור עקיבא,יישוב,477,232,245,47,430,134,462,12,4.53%
2016-03,חיפה,6000,באקה אל-גרביה,יישוב,589,291,298,17,572,353,581,30,4.94%
2016-03,חיפה,9800,בנימינה-גבעת עדה*,יישוב,175,72,103,54,121,57,174,2,2.39%
2016-03,חיפה,541,ג'סר א-זרקא,יישוב,451,233,218,5,446,322,448,12,7.33%
2016-03,חיפה,628,ג'ת,יישוב,206,101,105,9,197,112,203,4,3.84%
2016-03,חיפה,494,דאלית אל-כרמל,יישוב,471,178,293,15,456,255,439,7,5.30%
2016-03,חיפה,9300,זכרון יעקב,יישוב,264,117,147,81,183,47,260,3,2.33%
2016-03,חיפה,6500,חדרה,יישוב,2226,972,1254,239,1987,812,2079,62,4.14%
2016-03,חיפה,4000,חיפה,יישוב,5879,2938,2941,1088,4791,2974,5589,181,3.99%
2016-03,חיפה,1247,חריש,יישוב,32,18,14,1,31,12,28,1,1.75%
2016-03,חיפה,2100,טירת כרמל,יישוב,637,314,323,34,603,353,619,18,5.50%
2016-03,חיפה,654,כפר קרע,יישוב,389,183,206,17,372,245,378,9,4.41%
2016-03,חיפה,45,מ.א. אלונה,מועצה איזורית,32,16,16,9,23,4,32,0,3.00%
2016-03,חיפה,12,מ.א. זבולון,מועצה איזורית,245,112,133,28,217,152,239,0,4.29%
2016-03,חיפה,15,מ.א. חוף הכרמל,מועצה איזורית,309,143,166,101,208,51,305,1,2.15%
2016-03,חיפה,14,מ.א. מנשה,מועצה איזורית,219,93,126,60,159,69,214,0,2.67%
2016-03,חיפה,1327,מעלה עירון,יישוב,806,310,496,11,795,668,789,12,13.25%
2016-03,חיפה,2500,נשר,יישוב,424,218,206,86,338,143,407,10,3.17%
2016-03,חיפה,534,עספיא,יישוב,305,133,172,18,287,163,284,8,5.01%
2016-03,חיפה,637,ערערה,יישוב,557,246,311,9,548,364,535,12,6.56%
2016-03,חיפה,537,פוריידיס,יישוב,403,219,184,11,392,271,397,3,6.95%
2016-03,חיפה,7800,פרדס חנה-כרכור,יישוב,830,371,459,165,665,249,808,34,3.96%
2016-03,חיפה,6800,קריית אתא,יישוב,1510,695,815,111,1399,763,1472,37,4.83%
2016-03,חיפה,9500,קריית ביאליק,יישוב,987,416,571,102,885,468,965,31,4.49%
2016-03,חיפה,2300,קריית טבעון,יישוב,177,72,105,58,119,40,174,4,2.08%
2016-03,חיפה,9600,קריית ים,יישוב,1383,646,737,128,1255,804,1338,41,6.23%
2016-03,חיפה,8200,קריית מוצקין,יישוב,1012,457,555,149,863,437,979,29,4.24%
2016-03,חיפה,922,רכסים,יישוב,167,82,85,10,157,80,150,3,4.20%
2016-03,ירושלים,472,אבו גוש,יישוב,261,130,131,7,254,190,259,2,8.31%
2016-03,ירושלים,2610,בית שמש,יישוב,1156,522,634,83,1073,455,1119,34,3.32%
2016-03,ירושלים,3000,ירושלים,יישוב,12041,5478,6563,1324,10717,7511,11752,155,3.94%
2016-03,ירושלים,26,מ.א. מטה יהודה,מועצה איזורית,500,256,244,117,383,123,490,0,2.05%
2016-03,ירושלים,1015,מבשרת ציון,יישוב,366,179,187,86,280,121,360,7,2.76%
2016-03,ירושלים,1137,קריית יערים,יישוב,52,18,34,12,40,16,52,2,3.63%
2016-03,תל אביב,2400,אור יהודה,יישוב,705,353,352,55,650,173,671,40,3.52%
2016-03,תל אביב,565,אזור,יישוב,194,92,102,31,163,31,190,3,2.88%
2016-03,תל אביב,6100,בני ברק,יישוב,1818,908,910,84,1734,837,1715,21,2.99%
2016-03,תל אביב,6200,בת ים,יישוב,2789,1282,1507,373,2416,974,2667,93,3.78%
2016-03,תל אביב,6300,גבעתיים,יישוב,695,304,391,321,374,77,691,9,2.24%
2016-03,תל אביב,6400,הרצלייה,יישוב,1034,454,580,345,689,35,1021,29,2.09%
2016-03,תל אביב,6600,חולון,יישוב,2911,1351,1560,426,2485,680,2829,44,2.85%
2016-03,תל אביב,267,כפר שמריהו,יישוב,7,4,3,4,3,0,7,0,0.83%
2016-03,תל אביב,2620,קריית אונו,יישוב,373,169,204,143,230,46,369,5,1.93%
2016-03,תל אביב,8600,רמת גן,יישוב,1863,872,991,646,1217,362,1825,32,2.33%
2016-03,תל אביב,2650,רמת השרון,יישוב,377,165,212,154,223,12,371,14,1.66%
2016-03,תל אביב,5000,תל אביב -יפו,יישוב,7056,3529,3527,2322,4734,1802,6927,149,2.72%
2016-04,אזור יהודה והשומרון,3760,אורנית,יישוב,86,46,40,30,56,1,86,0,1.77%
2016-04,אזור יהודה והשומרון,3750,אלפי מנשה,יישוב,67,33,34,19,48,2,67,3,1.53%
2016-04,אזור יהודה והשומרון,3560,אלקנה,יישוב,26,8,18,12,14,0,26,0,1.38%
2016-04,אזור יהודה והשומרון,3650,אפרת,יישוב,31,13,18,17,14,1,31,1,0.72%
2016-04,אזור יהודה והשומרון,3570,אריאל,יישוב,281,120,161,74,207,39,278,10,2.58%
2016-04,אזור יהודה והשומרון,3574,בית אל,יישוב,43,22,21,10,33,17,41,0,1.69%
2016-04,אזור יהודה והשומרון,3652,בית אריה,יישוב,47,15,32,18,29,0,47,0,1.76%
2016-04,אזור יהודה והשומרון,3780,ביתר עילית,יישוב,481,219,262,9,472,220,477,1,3.59%
2016-04,אזור יהודה והשומרון,3730,גבעת זאב,יישוב,188,85,103,42,146,34,187,1,2.40%
2016-04,אזור יהודה והשומרון,3769,הר אדר,יישוב,34,11,23,15,19,3,34,0,1.60%
2016-04,אזור יהודה והשומרון,76,מ.א. גוש עציון,מועצה איזורית,139,67,72,65,74,16,136,0,1.41%
2016-04,אזור יהודה והשומרון,78,מ.א. הר חברון,מועצה איזורית,53,23,30,16,37,4,52,1,1.48%
2016-04,אזור יהודה והשומרון,74,מ.א. מגילות ים המלח,מועצה איזורית,13,6,7,3,10,0,13,0,1.63%
2016-04,אזור יהודה והשומרון,73,מ.א. מטה בנימין,מועצה איזורית,539,267,272,158,381,125,532,0,2.12%
2016-04,אזור יהודה והשומרון,75,מ.א. ערבות הירדן,מועצה איזורית,43,20,23,9,34,3,43,0,1.77%
2016-04,אזור יהודה והשומרון,72,מ.א. שומרון,מועצה איזורית,355,174,181,131,224,33,353,0,2.09%
2016-04,אזור יהודה והשומרון,3797,מודיעין עילית,יישוב,332,103,229,20,312,30,331,0,2.37%
2016-04,אזור יהודה והשומרון,3616,מעלה אדומים,יישוב,539,248,291,76,463,159,535,14,2.61%
2016-04,אזור יהודה והשומרון,3608,מעלה אפרים,יישוב,30,17,13,1,29,9,30,0,3.63%
2016-04,אזור יהודה והשומרון,3660,עמנואל,יישוב,51,29,22,0,51,31,51,0,4.36%
2016-04,אזור יהודה והשומרון,3557,קדומים,יישוב,36,23,13,7,29,5,35,1,1.86%
2016-04,אזור יהודה והשומרון,3611,קריית ארבע,יישוב,91,45,46,11,80,50,88,2,2.70%
2016-04,אזור יהודה והשומרון,3640,קרני שומרון,יישוב,63,29,34,18,45,6,63,2,1.67%
2016-04,הדרום,31,אופקים,יישוב,859,355,504,53,806,551,824,23,6.21%
2016-04,הדרום,2600,אילת,יישוב,1094,580,514,52,1042,423,1052,40,3.11%
2016-04,הדרום,70,אשדוד,יישוב,4922,2101,2821,614,4308,2395,4723,76,4.32%
2016-04,הדרום,7100,אשקלון,יישוב,3349,1404,1945,375,2974,1749,2875,92,4.07%
2016-04,הדרום,9000,באר שבע,יישוב,5349,2367,2982,743,4606,3008,5092,89,4.82%
2016-04,הדרום,2200,דימונה,יישוב,1629,709,920,96,1533,1100,1559,43,8.35%
2016-04,הדרום,1303,חורה,יישוב,597,229,368,3,594,539,585,3,14.20%
2016-04,הדרום,831,ירוחם,יישוב,332,178,154,10,322,210,322,17,6.73%
2016-04,הדרום,1059,כסיפה,יישוב,1000,391,609,2,998,901,992,7,20.75%
2016-04,הדרום,1271,להבים,יישוב,36,16,20,24,12,2,36,0,1.00%
2016-04,הדרום,1060,לקיה,יישוב,673,275,398,2,671,605,660,4,15.49%
2016-04,הדרום,69,מ.א. אל קסום,מועצה איזורית,661,245,416,9,652,586,652,0,40.42%
2016-04,הדרום,38,מ.א. אשכול,מועצה איזורית,97,38,59,20,77,10,97,0,1.43%
2016-04,הדרום,33,מ.א. באר טוביה,מועצה איזורית,227,92,135,44,183,34,223,0,2.04%
2016-04,הדרום,41,מ.א. בני שמעון,מועצה איזורית,64,21,43,22,42,11,63,1,1.45%
2016-04,הדרום,54,מ.א. הערבה התיכונה,מועצה איזורית,27,11,16,8,19,4,27,0,1.49%
2016-04,הדרום,53,מ.א. חבל אילות,מועצה איזורית,19,7,12,6,13,1,18,2,0.77%
2016-04,הדרום,36,מ.א. חוף אשקלון,מועצה איזורית,184,72,112,40,144,42,178,0,2.15%
2016-04,הדרום,35,מ.א. יואב,מועצה איזורית,63,23,40,22,41,9,62,0,1.56%
2016-04,הדרום,50,מ.א. לכיש,מועצה איזורית,123,52,71,17,106,38,121,0,2.41%
2016-04,הדרום,42,מ.א. מרחבים,מועצה איזורית,156,57,99,24,132,27,152,0,2.57%
2016-04,הדרום,68,מ.א. נווה מדבר,מועצה איזורית,114,43,71,2,112,91,112,0,11.62%
2016-04,הדרום,48,מ.א. רמת נגב,מועצה איזורית,228,113,115,11,217,186,228,1,7.20%
2016-04,הדרום,39,מ.א. שדות נגב,מועצה איזורית,105,51,54,21,84,32,98,0,2.17%
2016-04,הדרום,37,מ.א. שער הנגב,מועצה איזורית,80,33,47,27,53,19,76,0,1.96%
2016-04,הדרום,34,מ.א. שפיר,מועצה איזורית,134,69,65,14,120,57,133,0,2.83%
2016-04,הדרום,51,מ.א. תמר,מועצה איזורית,14,4,10,6,8,1,14,0,2.21%
2016-04,הדרום,1268,מיתר,יישוב,64,25,39,25,39,7,62,2,1.39%
2016-04,הדרום,99,מצפה רמון,יישוב,196,75,121,17,179,135,189,12,6.99%
2016-04,הדרום,246,נתיבות,יישוב,796,355,441,37,759,445,757,38,5.16%
2016-04,הדרום,666,עומר,יישוב,52,18,34,27,25,2,52,1,1.23%
2016-04,הדרום,2560,ערד,יישוב,631,299,332,71,560,329,603,32,4.92%
2016-04,הדרום,1192,ערערה-בנגב,יישוב,1009,402,607,1,1008,934,996,18,23.09%
2016-04,הדרום,2630,קריית גת,יישוב,1604,640,964,104,1500,849,1540,36,5.44%
2016-04,הדרום,1034,קריית מלאכי,יישוב,679,294,385,17,662,375,655,33,5.67%
2016-04,הדרום,1161,רהט,יישוב,2500,1033,1467,10,2490,2119,2473,43,12.50%
2016-04,הדרום,1286,שגב-שלום,יישוב,368,117,251,2,366,326,358,6,12.91%
2016-04,הדרום,1031,שדרות,יישוב,846,378,468,53,793,504,775,12,5.81%
2016-04,הדרום,1054,תל שבע,יישוב,799,334,465,4,795,728,778,13,15.99%
2016-04,המרכז,1066,"בני עי""ש",יישוב,149,70,79,34,115,44,148,2,3.70%
2016-04,המרכז,182,אבן יהודה,יישוב,129,64,65,39,90,11,128,0,1.86%
2016-04,המרכז,41,אליכין,יישוב,47,25,22,6,41,16,45,1,2.35%
2016-04,המרכז,1309,אלעד,יישוב,306,149,157,26,280,47,299,1,2.32%
2016-04,המרכז,2530,באר יעקב,יישוב,203,77,126,53,150,43,201,6,2.02%
2016-04,המרכז,466,בית דגן,יישוב,78,42,36,7,71,29,78,3,2.11%
2016-04,המרכז,681,גבעת שמואל,יישוב,214,113,101,72,142,43,208,0,1.72%
2016-04,המרכז,2550,גדרה,יישוב,287,115,172,67,220,73,283,4,2.28%
2016-04,המרכז,627,ג'לג'וליה,יישוב,88,38,50,3,85,55,87,1,2.31%
2016-04,המרכז,166,גן יבנה,יישוב,247,99,148,40,207,58,240,3,1.99%
2016-04,המרכז,229,גני תקווה,יישוב,149,77,72,45,104,21,149,1,1.66%
2016-04,המרכז,9700,הוד השרון,יישוב,525,229,296,230,295,46,521,10,1.68%
2016-04,המרכז,1290,זמר,יישוב,141,45,96,3,138,88,139,5,4.68%
2016-04,המרכז,2730,טייבה,יישוב,1193,522,671,16,1177,924,1012,34,5.79%
2016-04,המרכז,2720,טירה,יישוב,187,90,97,7,180,78,181,2,1.59%
2016-04,המרכז,2660,יבנה,יישוב,577,270,307,91,486,189,577,11,2.38%
2016-04,המרכז,9400,יהוד,יישוב,342,158,184,92,250,47,339,2,2.11%
2016-04,המרכז,1224,כוכב יאיר,יישוב,79,41,38,47,32,1,79,0,1.37%
2016-04,המרכז,633,כפר ברא,יישוב,25,12,13,1,24,13,23,0,1.61%
2016-04,המרכז,168,כפר יונה,יישוב,291,126,165,45,246,40,287,2,2.55%
2016-04,המרכז,6900,כפר סבא,יישוב,1076,485,591,391,685,101,1065,22,2.01%
2016-04,המרכז,634,כפר קאסם,יישוב,207,91,116,12,195,118,199,0,2.16%
2016-04,המרכז,7000,לוד,יישוב,1709,793,916,125,1584,926,1676,37,4.74%
2016-04,המרכז,28,מ.א. ברנר,מועצה איזורית,60,28,32,28,32,2,60,3,1.49%
2016-04,המרכז,32,מ.א. גדרות,מועצה איזורית,43,22,21,21,22,2,43,0,1.76%
2016-04,המרכז,30,מ.א. גזר,מועצה איזורית,273,114,159,123,150,25,269,0,2.04%
2016-04,המרכז,27,מ.א. גן רווה,מועצה איזורית,48,19,29,28,20,3,48,0,1.64%
2016-04,המרכז,20,מ.א. דרום השרון,מועצה איזורית,271,119,152,107,164,19,268,0,1.71%
2016-04,המרכז,29,מ.א. חבל יבנה,מועצה איזורית,31,12,19,16,15,3,31,0,1.25%
2016-04,המרכז,25,מ.א. חבל מודיעין,מועצה איזורית,203,100,103,74,129,13,201,0,1.87%
2016-04,המרכז,19,מ.א. חוף השרון,מועצה איזורית,88,37,51,36,52,4,88,0,1.57%
2016-04,המרכז,18,מ.א. לב השרון,מועצה איזורית,226,124,102,46,180,28,224,0,2.04%
2016-04,המרכז,31,מ.א. נחל שורק,מועצה איזורית,49,25,24,14,35,4,47,23,1.17%
2016-04,המרכז,16,מ.א. עמק חפר,מועצה איזורית,341,162,179,103,238,14,336,0,1.71%
2016-04,המרכז,40,מ.א. עמק לוד,מועצה איזורית,121,64,57,31,90,12,121,0,1.96%
2016-04,המרכז,1200,מודיעין-מכבים-רעות*,יישוב,779,360,419,298,481,57,769,17,1.71%
2016-04,המרכז,28,מזכרת בתיה,יישוב,125,58,67,48,77,23,125,3,1.67%
2016-04,המרכז,7200,נס ציונה,יישוב,588,263,325,182,406,145,578,6,2.42%
2016-04,המרכז,7400,נתניה,יישוב,3624,1705,1919,494,3130,1241,3563,50,3.38%
2016-04,המרכז,587,סביון*,יישוב,15,2,13,8,7,0,15,0,0.76%
2016-04,המרכז,171,פרדסייה,יישוב,83,37,46,21,62,4,83,0,2.18%
2016-04,המרכז,7900,פתח תקווה,יישוב,3330,1469,1861,746,2584,877,3274,21,2.61%
2016-04,המרכז,195,קדימה-צורן,יישוב,238,93,145,62,176,39,235,1,2.12%
2016-04,המרכז,638,קלנסווה,יישוב,460,220,240,5,455,344,409,9,4.66%
2016-04,המרכז,469,קריית עקרון,יישוב,212,118,94,21,191,85,206,9,3.43%
2016-04,המרכז,2640,ראש העין,יישוב,566,288,278,81,485,128,560,11,2.22%
2016-04,המרכז,8300,ראשון לציון,יישוב,3687,1649,2038,782,2905,1068,3659,54,2.63%
2016-04,המרכז,8400,רחובות,יישוב,1841,842,999,434,1407,653,1807,35,2.64%
2016-04,המרכז,8500,רמלה,יישוב,1367,659,708,95,1272,615,1306,51,3.48%
2016-04,המרכז,8700,רעננה,יישוב,578,262,316,235,343,40,571,6,1.55%
2016-04,המרכז,1304,שוהם,יישוב,162,76,86,74,88,8,162,0,1.39%
2016-04,המרכז,154,תל מונד,יישוב,121,57,64,44,77,13,121,0,1.88%
2016-04,הצפון,473,אבו סנאן,יישוב,586,240,346,3,583,481,579,9,9.79%
2016-04,הצפון,478,אכסאל,יישוב,504,240,264,7,497,424,500,2,8.68%
2016-04,הצפון,529,אעבלין,יישוב,498,219,279,9,489,417,493,5,8.51%
2016-04,הצפון,482,בועיינה-נוג'ידאת,יישוב,313,133,180,8,305,242,306,7,7.94%
2016-04,הצפון,4001,בוקעאתא,יישוב,360,131,229,2,358,302,351,0,12.76%
2016-04,הצפון,998,ביר אל-מכסור,יישוב,372,149,223,5,367,287,368,2,9.49%
2016-04,הצפון,480,בית ג'ן,יישוב,396,113,283,5,391,256,387,0,6.86%
2016-04,הצפון,9200,בית שאן,יישוב,636,280,356,19,617,348,624,42,6.14%
2016-04,הצפון,944,בסמת טבעון,יישוב,185,85,100,3,182,134,181,2,5.52%
2016-04,הצפון,483,בענה,יישוב,295,125,170,9,286,254,293,4,8.60%
2016-04,הצפון,1292,ג'דיידה-מכר,יישוב,1134,501,633,3,1131,941,1114,20,11.91%
2016-04,הצפון,485,ג'ולס,יישוב,211,65,146,0,211,138,209,6,6.72%
2016-04,הצפון,487,ג'ש (גוש חלב),יישוב,71,31,40,7,64,33,69,2,4.15%
2016-04,הצפון,489,דבורייה,יישוב,326,137,189,11,315,247,322,1,7.48%
2016-04,הצפון,490,דייר אל-אסד,יישוב,320,140,180,12,308,255,317,5,6.08%
2016-04,הצפון,492,דייר חנא,יישוב,620,274,346,7,613,494,611,1,12.48%
2016-04,הצפון,975,זרזיר,יישוב,224,96,128,4,220,149,221,2,6.75%
2016-04,הצפון,496,חורפיש,יישוב,104,46,58,13,91,65,98,2,3.44%
2016-04,הצפון,2034,חצור הגלילית,יישוב,241,105,136,10,231,134,219,8,4.51%
2016-04,הצפון,6700,טבריה,יישוב,1405,681,724,72,1333,740,1231,51,5.65%
2016-04,הצפון,962,טובא-זנגרייה,יישוב,351,159,192,5,346,245,341,4,11.21%
2016-04,הצפון,498,טורעאן,יישוב,420,177,243,11,409,334,412,5,7.21%
2016-04,הצפון,8900,טמרה,יישוב,1497,681,816,14,1483,1306,1467,11,10.32%
2016-04,הצפון,1295,יאנוח-ג'ת,יישוב,146,52,94,4,142,88,142,5,4.83%
2016-04,הצפון,46,יבנאל,יישוב,113,74,39,9,104,66,90,1,5.69%
2016-04,הצפון,29,יסוד המעלה,יישוב,11,5,6,1,10,3,11,0,1.29%
2016-04,הצפון,499,יפיע,יישוב,589,258,331,15,574,450,576,9,7.24%
2016-04,הצפון,240,יקנעם עילית,יישוב,423,178,245,95,328,98,421,26,3.47%
2016-04,הצפון,502,ירכא,יישוב,515,211,304,1,514,407,506,4,7.83%
2016-04,הצפון,504,כאבול,יישוב,522,240,282,13,509,456,515,1,10.42%
2016-04,הצפון,505,כאוכב אבו אל-היג'א,יישוב,222,91,131,5,217,185,216,1,12.37%
2016-04,הצפון,1296,כסרא-סמיע,יישוב,207,77,130,4,203,151,185,6,5.28%
2016-04,הצפון,978,כעביה-טבאש-חג'אג'רה,יישוב,159,64,95,3,156,118,157,0,6.69%
2016-04,הצפון,1263,כפר ורדים,יישוב,53,25,28,25,28,5,52,0,1.70%
2016-04,הצפון,507,כפר יאסיף,יישוב,395,169,226,4,391,293,386,11,7.57%
2016-04,הצפון,508,כפר כמא,יישוב,51,22,29,2,49,27,49,0,2.91%
2016-04,הצפון,509,כפר כנא,יישוב,927,406,521,17,910,765,890,19,10.13%
2016-04,הצפון,510,כפר מנדא,יישוב,719,344,375,8,711,594,702,1,9.74%
2016-04,הצפון,47,כפר תבור,יישוב,38,16,22,20,18,1,37,0,1.62%
2016-04,הצפון,1139,כרמיאל,יישוב,1352,518,834,228,1124,674,1288,21,4.96%
2016-04,הצפון,65,מ.א. אל-בטוף,מועצה איזורית,310,117,193,6,304,247,300,0,10.36%
2016-04,הצפון,66,מ.א. בוסתן אל-מרג',מועצה איזורית,36,11,25,1,35,29,36,0,1.17%
2016-04,הצפון,71,מ.א. גולן,מועצה איזורית,140,57,83,36,104,15,140,0,1.63%
2016-04,הצפון,8,מ.א. הגלבוע,מועצה איזורית,651,271,380,57,594,393,646,0,4.48%
2016-04,הצפון,1,מ.א. הגליל העליון,מועצה איזורית,182,78,104,73,109,17,180,0,2.04%
2016-04,הצפון,3,מ.א. הגליל התחתון,מועצה איזורית,91,38,53,33,58,11,89,0,1.52%
2016-04,הצפון,55,מ.א. מבואות החרמון,מועצה איזורית,95,45,50,11,84,15,93,0,2.33%
2016-04,הצפון,13,מ.א. מגידו,מועצה איזורית,92,29,63,34,58,7,92,0,1.62%
2016-04,הצפון,4,מ.א. מטה אשר,מועצה איזורית,387,165,222,56,331,174,382,0,2.78%
2016-04,הצפון,52,מ.א. מעלה יוסף,מועצה איזורית,169,82,87,19,150,49,165,0,2.99%
2016-04,הצפון,2,מ.א. מרום הגליל,מועצה איזורית,249,107,142,26,223,102,242,0,3.54%
2016-04,הצפון,56,מ.א. משגב,מועצה איזורית,517,199,318,90,427,286,509,0,3.92%
2016-04,הצפון,6,מ.א. עמק הירדן,מועצה איזורית,152,72,80,35,117,32,140,0,2.07%
2016-04,הצפון,7,מ.א. עמק המעיינות,מועצה איזורית,157,65,92,29,128,33,155,0,2.39%
2016-04,הצפון,9,מ.א. עמק יזרעאל,מועצה איזורית,317,131,186,150,167,30,315,0,1.63%
2016-04,הצפון,481,מגאר,יישוב,1278,520,758,17,1261,1053,1238,0,12.62%
2016-04,הצפון,516,מג'ד אל-כרום,יישוב,454,216,238,8,446,341,447,17,6.73%
2016-04,הצפון,65,מגדל,יישוב,32,14,18,1,31,14,28,0,2.98%
2016-04,הצפון,874,מגדל העמק,יישוב,736,337,399,66,670,284,696,53,5.14%
2016-04,הצפון,4201,מג'דל שמס,יישוב,422,160,262,9,413,332,405,1,8.26%
2016-04,הצפון,517,מזרעה,יישוב,143,56,87,3,140,112,138,5,7.00%
2016-04,הצפון,43,מטולה,יישוב,27,11,16,10,17,4,27,0,2.57%
2016-04,הצפון,4203,מסעדה,יישוב,196,70,126,4,192,158,184,0,10.87%
2016-04,הצפון,518,מעיליא,יישוב,46,24,22,5,41,27,44,1,2.73%
2016-04,הצפון,1063,מעלות-תרשיחא,יישוב,756,372,384,85,671,398,733,24,6.21%
2016-04,הצפון,520,משהד,יישוב,245,99,146,7,238,181,237,3,7.32%
2016-04,הצפון,9100,נהרייה,יישוב,1620,774,846,187,1433,891,1563,61,5.07%
2016-04,הצפון,522,נחף,יישוב,378,182,196,19,359,290,373,15,7.33%
2016-04,הצפון,7300,נצרת,יישוב,2909,1282,1627,103,2806,2284,2874,19,8.31%
2016-04,הצפון,1061,נצרת עילית,יישוב,1408,653,755,164,1244,751,1251,75,5.41%
2016-04,הצפון,525,סאג'ור,יישוב,123,43,80,5,118,67,121,2,6.08%
2016-04,הצפון,7500,סח'נין,יישוב,2065,885,1180,35,2030,1746,2027,17,14.26%
2016-04,הצפון,4501,ע'ג'ר,יישוב,92,38,54,1,91,59,90,1,8.50%
2016-04,הצפון,530,עיילבון,יישוב,154,70,84,2,152,111,151,0,5.47%
2016-04,הצפון,511,עילוט,יישוב,310,120,190,5,305,259,306,3,10.63%
2016-04,הצפון,532,עין מאהל,יישוב,424,204,220,7,417,336,412,2,7.83%
2016-04,הצפון,4502,עין קנייא,יישוב,140,55,85,2,138,108,136,1,13.24%
2016-04,הצפון,7600,עכו,יישוב,2822,1301,1521,120,2702,2082,2737,59,10.32%
2016-04,הצפון,7700,עפולה,יישוב,1327,556,771,153,1174,590,1266,47,4.98%
2016-04,הצפון,531,עראבה,יישוב,1519,657,862,27,1492,1332,1488,12,14.41%
2016-04,הצפון,535,פסוטה,יישוב,110,51,59,4,106,63,106,3,6.10%
2016-04,הצפון,536,פקיעין (בוקייעה),יישוב,122,66,56,5,117,75,117,0,4.16%
2016-04,הצפון,8000,צפת,יישוב,1118,629,489,78,1040,810,1054,17,7.84%
2016-04,הצפון,4100,קצרין,יישוב,169,57,112,28,141,75,167,2,4.17%
2016-04,הצפון,2800,קריית שמונה,יישוב,671,312,359,54,617,286,647,28,4.95%
2016-04,הצפון,543,ראמה,יישוב,253,106,147,6,247,190,250,1,6.40%
2016-04,הצפון,26,ראש פינה,יישוב,41,17,24,8,33,17,39,1,2.44%
2016-04,הצפון,542,ריינה,יישוב,498,207,291,6,492,397,477,5,7.01%
2016-04,הצפון,122,רמת ישי,יישוב,88,35,53,34,54,9,85,2,2.04%
2016-04,הצפון,913,שבלי - אום אל-גנם,יישוב,196,74,122,3,193,129,193,1,7.29%
2016-04,הצפון,812,שלומי,יישוב,196,87,109,11,185,92,190,8,5.29%
2016-04,הצפון,538,שעב,יישוב,518,203,315,3,515,460,510,1,16.44%
2016-04,הצפון,8800,שפרעם,יישוב,1612,648,964,23,1589,1280,1581,29,8.71%
2016-04,חיפה,1326,"בסמ""ה",יישוב,382,169,213,6,376,291,377,2,9.29%
2016-04,חיפה,2710,אום אל-פחם,יישוב,3007,1252,1755,47,2960,2536,2959,15,13.97%
2016-04,חיפה,1020,אור עקיבא,יישוב,419,198,221,39,380,126,410,8,4.04%
2016-04,חיפה,6000,באקה אל-גרביה,יישוב,560,263,297,18,542,352,553,23,4.71%
2016-04,חיפה,9800,בנימינה-גבעת עדה*,יישוב,159,62,97,50,109,47,158,1,2.18%
2016-04,חיפה,541,ג'סר א-זרקא,יישוב,395,206,189,3,392,287,393,6,6.49%
2016-04,חיפה,628,ג'ת,יישוב,194,92,102,7,187,117,191,8,3.62%
2016-04,חיפה,494,דאלית אל-כרמל,יישוב,437,166,271,11,426,240,409,4,4.96%
2016-04,חיפה,9300,זכרון יעקב,יישוב,224,104,120,82,142,39,222,1,2.00%
2016-04,חיפה,6500,חדרה,יישוב,1996,844,1152,215,1781,757,1860,21,3.72%
2016-04,חיפה,4000,חיפה,יישוב,5287,2647,2640,984,4303,2747,5030,106,3.61%
2016-04,חיפה,1247,חריש,יישוב,33,18,15,0,33,12,31,0,1.94%
2016-04,חיפה,2100,טירת כרמל,יישוב,586,293,293,33,553,328,573,17,5.11%
2016-04,חיפה,654,כפר קרע,יישוב,346,154,192,13,333,225,341,8,4.00%
2016-04,חיפה,45,מ.א. אלונה,מועצה איזורית,27,12,15,7,20,4,27,0,2.53%
2016-04,חיפה,12,מ.א. זבולון,מועצה איזורית,222,103,119,24,198,141,215,0,3.86%
2016-04,חיפה,15,מ.א. חוף הכרמל,מועצה איזורית,286,132,154,97,189,49,284,0,2.01%
2016-04,חיפה,14,מ.א. מנשה,מועצה איזורית,203,84,119,58,145,67,199,0,2.48%
2016-04,חיפה,1327,מעלה עירון,יישוב,757,289,468,8,749,626,745,8,12.61%
2016-04,חיפה,2500,נשר,יישוב,378,197,181,83,295,138,366,10,2.86%
2016-04,חיפה,534,עספיא,יישוב,284,115,169,17,267,158,258,2,4.57%
2016-04,חיפה,637,ערערה,יישוב,534,233,301,10,524,354,520,8,6.39%
2016-04,חיפה,537,פוריידיס,יישוב,364,192,172,11,353,255,356,2,6.28%
2016-04,חיפה,7800,פרדס חנה-כרכור,יישוב,716,316,400,148,568,219,699,16,3.44%
2016-04,חיפה,6800,קריית אתא,יישוב,1347,617,730,99,1248,724,1318,20,4.35%
2016-04,חיפה,9500,קריית ביאליק,יישוב,909,382,527,96,813,452,892,26,4.17%
2016-04,חיפה,2300,קריית טבעון,יישוב,158,63,95,54,104,38,156,0,1.87%
2016-04,חיפה,9600,קריית ים,יישוב,1259,589,670,111,1148,754,1214,25,5.69%
2016-04,חיפה,8200,קריית מוצקין,יישוב,875,390,485,140,735,406,846,14,3.68%
2016-04,חיפה,922,רכסים,יישוב,147,75,72,9,138,67,131,0,3.68%
2016-04,ירושלים,472,אבו גוש,יישוב,228,112,116,6,222,181,226,2,7.33%
2016-04,ירושלים,2610,בית שמש,יישוב,979,439,540,67,912,386,950,21,2.83%
2016-04,ירושלים,3000,ירושלים,יישוב,11082,4994,6088,1169,9913,7202,10838,90,3.65%
2016-04,ירושלים,26,מ.א. מטה יהודה,מועצה איזורית,441,232,209,109,332,112,435,1,1.82%
2016-04,ירושלים,1015,מבשרת ציון,יישוב,321,155,166,75,246,121,313,3,2.41%
2016-04,ירושלים,1137,קריית יערים,יישוב,45,16,29,12,33,14,45,1,3.16%
2016-04,תל אביב,2400,אור יהודה,יישוב,595,291,304,57,538,154,574,15,3.03%
2016-04,תל אביב,565,אזור,יישוב,179,88,91,31,148,33,178,0,2.71%
2016-04,תל אביב,6100,בני ברק,יישוב,1641,831,810,77,1564,780,1527,16,2.67%
2016-04,תל אביב,6200,בת ים,יישוב,2500,1142,1358,362,2138,933,2380,41,3.39%
2016-04,תל אביב,6300,גבעתיים,יישוב,604,272,332,283,321,66,604,1,1.96%
2016-04,תל אביב,6400,הרצלייה,יישוב,885,388,497,324,561,21,877,19,1.80%
2016-04,תל אביב,6600,חולון,יישוב,2619,1189,1430,406,2213,602,2582,29,2.61%
2016-04,תל אביב,267,כפר שמריהו,יישוב,7,4,3,3,4,0,7,0,0.83%
2016-04,תל אביב,2620,קריית אונו,יישוב,340,152,188,136,204,37,339,1,1.77%
2016-04,תל אביב,8600,רמת גן,יישוב,1622,743,879,575,1047,309,1592,24,2.04%
2016-04,תל אביב,2650,רמת השרון,יישוב,348,158,190,149,199,5,348,4,1.56%
2016-04,תל אביב,5000,תל אביב -יפו,יישוב,6219,3133,3086,2141,4078,1649,6121,86,2.42%
2016-05,אזור יהודה והשומרון,3760,אורנית,יישוב,112,59,53,37,75,1,111,0,2.28%
2016-05,אזור יהודה והשומרון,3750,אלפי מנשה,יישוב,80,38,42,23,57,0,80,1,1.82%
2016-05,אזור יהודה והשומרון,3560,אלקנה,יישוב,33,11,22,19,14,0,33,1,1.74%
2016-05,אזור יהודה והשומרון,3650,אפרת,יישוב,37,14,23,22,15,1,37,0,0.86%
2016-05,אזור יהודה והשומרון,3570,אריאל,יישוב,311,137,174,80,231,38,310,13,2.87%
2016-05,אזור יהודה והשומרון,3574,בית אל,יישוב,45,22,23,9,36,20,42,1,1.73%
2016-05,אזור יהודה והשומרון,3652,בית אריה,יישוב,46,15,31,15,31,0,45,0,1.68%
2016-05,אזור יהודה והשומרון,3780,ביתר עילית,יישוב,532,254,278,10,522,226,528,8,3.96%
2016-05,אזור יהודה והשומרון,3730,גבעת זאב,יישוב,195,84,111,43,152,34,193,2,2.48%
2016-05,אזור יהודה והשומרון,3769,הר אדר,יישוב,37,14,23,17,20,3,37,1,1.74%
2016-05,אזור יהודה והשומרון,76,מ.א. גוש עציון,מועצה איזורית,150,73,77,62,88,16,147,0,1.53%
2016-05,אזור יהודה והשומרון,78,מ.א. הר חברון,מועצה איזורית,56,25,31,21,35,4,54,0,1.54%
2016-05,אזור יהודה והשומרון,74,מ.א. מגילות ים המלח,מועצה איזורית,14,5,9,3,11,0,14,0,1.75%
2016-05,אזור יהודה והשומרון,73,מ.א. מטה בנימין,מועצה איזורית,591,289,302,177,414,136,581,0,2.32%
2016-05,אזור יהודה והשומרון,75,מ.א. ערבות הירדן,מועצה איזורית,48,24,24,10,38,3,48,0,1.97%
2016-05,אזור יהודה והשומרון,72,מ.א. שומרון,מועצה איזורית,389,201,188,133,256,38,386,0,2.29%
2016-05,אזור יהודה והשומרון,3797,מודיעין עילית,יישוב,370,119,251,23,347,39,366,6,2.61%
2016-05,אזור יהודה והשומרון,3616,מעלה אדומים,יישוב,600,263,337,87,513,168,595,17,2.90%
2016-05,אזור יהודה והשומרון,3608,מעלה אפרים,יישוב,37,20,17,2,35,12,37,0,4.44%
2016-05,אזור יהודה והשומרון,3660,עמנואל,יישוב,50,28,22,0,50,30,50,0,4.27%
2016-05,אזור יהודה והשומרון,3557,קדומים,יישוב,39,20,19,8,31,4,38,1,2.02%
2016-05,אזור יהודה והשומרון,3611,קריית ארבע,יישוב,98,50,48,15,83,55,93,3,2.84%
2016-05,אזור יהודה והשומרון,3640,קרני שומרון,יישוב,70,32,38,20,50,7,69,1,1.83%
2016-05,הדרום,31,אופקים,יישוב,977,409,568,57,920,549,947,48,7.07%
2016-05,הדרום,2600,אילת,יישוב,1155,590,565,54,1101,441,1114,55,3.29%
2016-05,הדרום,70,אשדוד,יישוב,5414,2296,3118,686,4728,2474,5165,143,4.71%
2016-05,הדרום,7100,אשקלון,יישוב,3767,1556,2211,424,3343,1825,3262,135,4.60%
2016-05,הדרום,9000,באר שבע,יישוב,5770,2562,3208,762,5008,3120,5480,163,5.16%
2016-05,הדרום,2200,דימונה,יישוב,1757,754,1003,99,1658,1144,1677,62,8.92%
2016-05,הדרום,1303,חורה,יישוב,603,243,360,2,601,546,590,8,14.31%
2016-05,הדרום,831,ירוחם,יישוב,394,213,181,15,379,224,374,44,7.74%
2016-05,הדרום,1059,כסיפה,יישוב,991,376,615,4,987,895,982,11,20.59%
2016-05,הדרום,1271,להבים,יישוב,44,18,26,22,22,3,44,0,1.22%
2016-05,הדרום,1060,לקיה,יישוב,684,288,396,2,682,611,670,14,15.69%
2016-05,הדרום,69,מ.א. אל קסום,מועצה איזורית,661,251,410,8,653,581,654,0,40.50%
2016-05,הדרום,38,מ.א. אשכול,מועצה איזורית,98,37,61,24,74,9,95,0,1.40%
2016-05,הדרום,33,מ.א. באר טוביה,מועצה איזורית,277,110,167,50,227,40,274,0,2.50%
2016-05,הדרום,41,מ.א. בני שמעון,מועצה איזורית,78,30,48,31,47,11,77,0,1.77%
2016-05,הדרום,54,מ.א. הערבה התיכונה,מועצה איזורית,35,15,20,11,24,4,35,0,1.93%
2016-05,הדרום,53,מ.א. חבל אילות,מועצה איזורית,18,6,12,5,13,1,17,5,0.72%
2016-05,הדרום,36,מ.א. חוף אשקלון,מועצה איזורית,206,93,113,37,169,47,198,0,2.39%
2016-05,הדרום,35,מ.א. יואב,מועצה איזורית,64,23,41,24,40,7,63,0,1.58%
2016-05,הדרום,50,מ.א. לכיש,מועצה איזורית,152,65,87,20,132,42,148,0,2.94%
2016-05,הדרום,42,מ.א. מרחבים,מועצה איזורית,182,63,119,24,158,34,175,0,2.96%
2016-05,הדרום,68,מ.א. נווה מדבר,מועצה איזורית,119,46,73,2,117,93,116,0,12.03%
2016-05,הדרום,48,מ.א. רמת נגב,מועצה איזורית,238,118,120,14,224,183,237,0,7.48%
2016-05,הדרום,39,מ.א. שדות נגב,מועצה איזורית,121,57,64,22,99,33,118,0,2.61%
2016-05,הדרום,37,מ.א. שער הנגב,מועצה איזורית,88,31,57,28,60,20,83,0,2.14%
2016-05,הדרום,34,מ.א. שפיר,מועצה איזורית,162,79,83,18,144,57,159,0,3.39%
2016-05,הדרום,51,מ.א. תמר,מועצה איזורית,16,5,11,5,11,1,15,0,2.37%
2016-05,הדרום,1268,מיתר,יישוב,65,26,39,23,42,7,63,1,1.41%
2016-05,הדרום,99,מצפה רמון,יישוב,220,90,130,19,201,138,207,17,7.61%
2016-05,הדרום,246,נתיבות,יישוב,966,437,529,47,919,466,915,70,6.17%
2016-05,הדרום,666,עומר,יישוב,59,18,41,27,32,3,58,1,1.37%
2016-05,הדרום,2560,ערד,יישוב,687,328,359,73,614,350,655,46,5.33%
2016-05,הדרום,1192,ערערה-בנגב,יישוב,1043,427,616,2,1041,963,1028,2,23.65%
2016-05,הדרום,2630,קריית גת,יישוב,1764,706,1058,113,1651,899,1686,69,5.92%
2016-05,הדרום,1034,קריית מלאכי,יישוב,844,374,470,23,821,389,811,75,6.93%
2016-05,הדרום,1161,רהט,יישוב,2594,1068,1526,11,2583,2109,2554,74,12.86%
2016-05,הדרום,1286,שגב-שלום,יישוב,380,129,251,2,378,333,370,7,13.29%
2016-05,הדרום,1031,שדרות,יישוב,951,437,514,56,895,525,866,31,6.45%
2016-05,הדרום,1054,תל שבע,יישוב,798,335,463,5,793,722,771,6,15.86%
2016-05,המרכז,1066,"בני עי""ש",יישוב,155,71,84,31,124,45,152,8,3.79%
2016-05,המרכז,182,אבן יהודה,יישוב,143,73,70,43,100,16,143,0,2.08%
2016-05,המרכז,41,אליכין,יישוב,52,25,27,7,45,17,49,0,2.55%
2016-05,המרכז,1309,אלעד,יישוב,348,165,183,29,319,50,339,6,2.62%
2016-05,המרכז,2530,באר יעקב,יישוב,235,86,149,70,165,45,232,4,2.32%
2016-05,המרכז,466,בית דגן,יישוב,90,47,43,5,85,35,88,1,2.38%
2016-05,המרכז,681,גבעת שמואל,יישוב,217,113,104,72,145,46,210,1,1.74%
2016-05,המרכז,2550,גדרה,יישוב,299,117,182,71,228,79,294,9,2.36%
2016-05,המרכז,627,ג'לג'וליה,יישוב,92,42,50,3,89,58,90,1,2.38%
2016-05,המרכז,166,גן יבנה,יישוב,288,132,156,50,238,63,280,4,2.32%
2016-05,המרכז,229,גני תקווה,יישוב,168,87,81,62,106,21,167,1,1.85%
2016-05,המרכז,9700,הוד השרון,יישוב,587,247,340,254,333,51,577,7,1.86%
2016-05,המרכז,1290,זמר,יישוב,146,48,98,3,143,91,144,8,4.85%
2016-05,המרכז,2730,טייבה,יישוב,1220,539,681,16,1204,937,1033,31,5.90%
2016-05,המרכז,2720,טירה,יישוב,190,93,97,13,177,71,185,9,1.62%
2016-05,המרכז,2660,יבנה,יישוב,695,321,374,107,588,213,686,34,2.81%
2016-05,המרכז,9400,יהוד,יישוב,387,178,209,102,285,61,378,6,2.35%
2016-05,המרכז,1224,כוכב יאיר,יישוב,91,48,43,56,35,2,91,0,1.58%
2016-05,המרכז,633,כפר ברא,יישוב,24,11,13,1,23,14,22,2,1.54%
2016-05,המרכז,168,כפר יונה,יישוב,315,132,183,49,266,39,314,2,2.78%
2016-05,המרכז,6900,כפר סבא,יישוב,1197,549,648,455,742,108,1172,35,2.21%
2016-05,המרכז,634,כפר קאסם,יישוב,218,95,123,14,204,118,210,2,2.28%
2016-05,המרכז,7000,לוד,יישוב,1848,846,1002,140,1708,965,1807,56,5.09%
2016-05,המרכז,28,מ.א. ברנר,מועצה איזורית,65,28,37,32,33,2,65,1,1.61%
2016-05,המרכז,32,מ.א. גדרות,מועצה איזורית,51,26,25,25,26,3,51,0,2.08%
2016-05,המרכז,30,מ.א. גזר,מועצה איזורית,296,116,180,137,159,25,292,0,2.21%
2016-05,המרכז,27,מ.א. גן רווה,מועצה איזורית,47,19,28,25,22,3,47,0,1.61%
2016-05,המרכז,20,מ.א. דרום השרון,מועצה איזורית,314,133,181,126,188,22,308,0,1.97%
2016-05,המרכז,29,מ.א. חבל יבנה,מועצה איזורית,34,14,20,16,18,3,34,0,1.37%
2016-05,המרכז,25,מ.א. חבל מודיעין,מועצה איזורית,216,103,113,74,142,18,212,0,1.97%
2016-05,המרכז,19,מ.א. חוף השרון,מועצה איזורית,100,44,56,45,55,3,99,0,1.77%
2016-05,המרכז,18,מ.א. לב השרון,מועצה איזורית,267,148,119,59,208,28,262,0,2.38%
2016-05,המרכז,31,מ.א. נחל שורק,מועצה איזורית,55,25,30,18,37,5,53,48,1.28%
2016-05,המרכז,16,מ.א. עמק חפר,מועצה איזורית,371,178,193,113,258,12,367,0,1.87%
2016-05,המרכז,40,מ.א. עמק לוד,מועצה איזורית,143,72,71,33,110,14,138,0,2.24%
2016-05,המרכז,1200,מודיעין-מכבים-רעות*,יישוב,876,409,467,337,539,55,858,23,1.91%
2016-05,המרכז,28,מזכרת בתיה,יישוב,132,58,74,52,80,23,132,1,1.76%
2016-05,המרכז,7200,נס ציונה,יישוב,642,294,348,200,442,150,635,13,2.65%
2016-05,המרכז,7400,נתניה,יישוב,4056,1861,2195,556,3500,1307,3968,66,3.75%
2016-05,המרכז,587,סביון*,יישוב,13,2,11,9,4,0,13,0,0.66%
2016-05,המרכז,171,פרדסייה,יישוב,85,33,52,21,64,7,84,0,2.21%
2016-05,המרכז,7900,פתח תקווה,יישוב,3690,1626,2064,842,2848,948,3604,47,2.86%
2016-05,המרכז,195,קדימה-צורן,יישוב,260,100,160,72,188,37,257,2,2.31%
2016-05,המרכז,638,קלנסווה,יישוב,470,225,245,7,463,344,421,10,4.79%
2016-05,המרכז,469,קריית עקרון,יישוב,226,125,101,23,203,91,219,12,3.64%
2016-05,המרכז,2640,ראש העין,יישוב,639,313,326,96,543,121,631,24,2.50%
2016-05,המרכז,8300,ראשון לציון,יישוב,4117,1831,2286,871,3246,1146,4071,89,2.92%
2016-05,המרכז,8400,רחובות,יישוב,2129,979,1150,500,1629,692,2072,73,3.01%
2016-05,המרכז,8500,רמלה,יישוב,1552,731,821,109,1443,657,1478,68,3.92%
2016-05,המרכז,8700,רעננה,יישוב,621,290,331,266,355,40,617,3,1.67%
2016-05,המרכז,1304,שוהם,יישוב,187,82,105,84,103,8,185,0,1.59%
2016-05,המרכז,154,תל מונד,יישוב,136,72,64,47,89,16,135,0,2.10%
2016-05,הצפון,473,אבו סנאן,יישוב,596,247,349,5,591,473,588,10,9.93%
2016-05,הצפון,478,אכסאל,יישוב,510,244,266,10,500,421,506,5,8.77%
2016-05,הצפון,529,אעבלין,יישוב,496,209,287,8,488,414,488,7,8.43%
2016-05,הצפון,482,בועיינה-נוג'ידאת,יישוב,287,128,159,8,279,227,284,9,7.41%
2016-05,הצפון,4001,בוקעאתא,יישוב,374,143,231,2,372,311,355,6,12.89%
2016-05,הצפון,998,ביר אל-מכסור,יישוב,361,145,216,4,357,286,355,2,9.19%
2016-05,הצפון,480,בית ג'ן,יישוב,394,117,277,9,385,259,381,4,6.76%
2016-05,הצפון,9200,בית שאן,יישוב,750,322,428,17,733,354,732,57,7.13%
2016-05,הצפון,944,בסמת טבעון,יישוב,183,82,101,3,180,138,179,2,5.46%
2016-05,הצפון,483,בענה,יישוב,305,133,172,9,296,256,302,12,8.84%
2016-05,הצפון,1292,ג'דיידה-מכר,יישוב,1149,503,646,6,1143,942,1124,25,12.00%
2016-05,הצפון,485,ג'ולס,יישוב,211,64,147,0,211,137,209,5,6.72%
2016-05,הצפון,487,ג'ש (גוש חלב),יישוב,70,30,40,5,65,31,67,0,4.03%
2016-05,הצפון,489,דבורייה,יישוב,332,137,195,16,316,247,325,3,7.54%
2016-05,הצפון,490,דייר אל-אסד,יישוב,320,137,183,13,307,253,317,5,6.08%
2016-05,הצפון,492,דייר חנא,יישוב,627,267,360,7,620,502,614,3,12.54%
2016-05,הצפון,975,זרזיר,יישוב,232,101,131,4,228,155,229,3,6.98%
2016-05,הצפון,496,חורפיש,יישוב,106,51,55,9,97,68,102,4,3.57%
2016-05,הצפון,2034,חצור הגלילית,יישוב,268,112,156,15,253,131,250,8,5.11%
2016-05,הצפון,6700,טבריה,יישוב,1494,700,794,77,1417,762,1297,51,5.93%
2016-05,הצפון,962,טובא-זנגרייה,יישוב,370,157,213,4,366,247,360,5,11.76%
2016-05,הצפון,498,טורעאן,יישוב,425,180,245,13,412,344,416,3,7.27%
2016-05,הצפון,8900,טמרה,יישוב,1496,678,818,14,1482,1303,1473,25,10.36%
2016-05,הצפון,1295,יאנוח-ג'ת,יישוב,158,51,107,6,152,92,151,3,5.13%
2016-05,הצפון,46,יבנאל,יישוב,127,79,48,10,117,79,101,5,6.34%
2016-05,הצפון,29,יסוד המעלה,יישוב,16,8,8,3,13,5,16,0,1.86%
2016-05,הצפון,499,יפיע,יישוב,569,247,322,13,556,438,556,7,7.00%
2016-05,הצפון,240,יקנעם עילית,יישוב,462,190,272,94,368,105,458,27,3.76%
2016-05,הצפון,502,ירכא,יישוב,527,217,310,1,526,405,519,9,8.02%
2016-05,הצפון,504,כאבול,יישוב,526,243,283,12,514,454,518,7,10.47%
2016-05,הצפון,505,כאוכב אבו אל-היג'א,יישוב,221,91,130,5,216,185,215,1,12.32%
2016-05,הצפון,1296,כסרא-סמיע,יישוב,234,88,146,3,231,156,207,2,5.87%
2016-05,הצפון,978,כעביה-טבאש-חג'אג'רה,יישוב,157,67,90,4,153,113,156,0,6.65%
2016-05,הצפון,1263,כפר ורדים,יישוב,65,34,31,30,35,4,63,0,2.05%
2016-05,הצפון,507,כפר יאסיף,יישוב,416,174,242,4,412,303,402,16,7.86%
2016-05,הצפון,508,כפר כמא,יישוב,57,23,34,3,54,26,56,1,3.31%
2016-05,הצפון,509,כפר כנא,יישוב,922,404,518,24,898,762,882,15,10.05%
2016-05,הצפון,510,כפר מנדא,יישוב,715,345,370,10,705,599,692,4,9.61%
2016-05,הצפון,47,כפר תבור,יישוב,34,15,19,16,18,1,33,1,1.45%
2016-05,הצפון,1139,כרמיאל,יישוב,1509,587,922,261,1248,708,1429,42,5.48%
2016-05,הצפון,65,מ.א. אל-בטוף,מועצה איזורית,307,115,192,6,301,247,295,2,10.17%
2016-05,הצפון,66,מ.א. בוסתן אל-מרג',מועצה איזורית,38,11,27,1,37,32,37,0,1.20%
2016-05,הצפון,71,מ.א. גולן,מועצה איזורית,154,63,91,43,111,14,154,0,1.79%
2016-05,הצפון,8,מ.א. הגלבוע,מועצה איזורית,688,285,403,62,626,400,677,0,4.70%
2016-05,הצפון,1,מ.א. הגליל העליון,מועצה איזורית,177,72,105,70,107,22,176,0,1.99%
2016-05,הצפון,3,מ.א. הגליל התחתון,מועצה איזורית,105,44,61,31,74,13,101,0,1.73%
2016-05,הצפון,55,מ.א. מבואות החרמון,מועצה איזורית,100,44,56,15,85,22,99,0,2.48%
2016-05,הצפון,13,מ.א. מגידו,מועצה איזורית,112,39,73,42,70,6,112,0,1.97%
2016-05,הצפון,4,מ.א. מטה אשר,מועצה איזורית,411,186,225,63,348,167,410,0,2.99%
2016-05,הצפון,52,מ.א. מעלה יוסף,מועצה איזורית,190,98,92,21,169,51,186,0,3.37%
2016-05,הצפון,2,מ.א. מרום הגליל,מועצה איזורית,268,120,148,31,237,106,261,0,3.82%
2016-05,הצפון,56,מ.א. משגב,מועצה איזורית,561,220,341,102,459,297,554,0,4.26%
2016-05,הצפון,6,מ.א. עמק הירדן,מועצה איזורית,160,75,85,40,120,33,147,0,2.18%
2016-05,הצפון,7,מ.א. עמק המעיינות,מועצה איזורית,165,69,96,36,129,37,162,0,2.50%
2016-05,הצפון,9,מ.א. עמק יזרעאל,מועצה איזורית,359,153,206,171,188,36,355,0,1.84%
2016-05,הצפון,481,מגאר,יישוב,1340,557,783,23,1317,1090,1293,12,13.10%
2016-05,הצפון,516,מג'ד אל-כרום,יישוב,446,209,237,7,439,326,438,16,6.60%
2016-05,הצפון,65,מגדל,יישוב,37,14,23,3,34,14,32,2,3.39%
2016-05,הצפון,874,מגדל העמק,יישוב,829,356,473,67,762,303,776,76,5.70%
2016-05,הצפון,4201,מג'דל שמס,יישוב,419,163,256,10,409,324,401,13,8.19%
2016-05,הצפון,517,מזרעה,יישוב,161,66,95,3,158,120,155,2,7.79%
2016-05,הצפון,43,מטולה,יישוב,23,12,11,8,15,4,23,1,2.20%
2016-05,הצפון,4203,מסעדה,יישוב,195,63,132,3,192,154,182,6,10.76%
2016-05,הצפון,518,מעיליא,יישוב,54,27,27,5,49,25,53,1,3.27%
2016-05,הצפון,1063,מעלות-תרשיחא,יישוב,804,390,414,85,719,416,769,39,6.50%
2016-05,הצפון,520,משהד,יישוב,244,97,147,6,238,186,236,8,7.29%
2016-05,הצפון,9100,נהרייה,יישוב,1783,843,940,198,1585,941,1704,73,5.50%
2016-05,הצפון,522,נחף,יישוב,366,176,190,21,345,277,361,10,7.11%
2016-05,הצפון,7300,נצרת,יישוב,2948,1317,1631,100,2848,2301,2893,28,8.36%
2016-05,הצפון,1061,נצרת עילית,יישוב,1525,696,829,158,1367,769,1341,88,5.78%
2016-05,הצפון,525,סאג'ור,יישוב,120,42,78,5,115,64,119,1,5.98%
2016-05,הצפון,7500,סח'נין,יישוב,2083,904,1179,38,2045,1767,2046,25,14.38%
2016-05,הצפון,4501,ע'ג'ר,יישוב,87,36,51,2,85,60,85,0,8.06%
2016-05,הצפון,530,עיילבון,יישוב,154,70,84,1,153,108,150,1,5.44%
2016-05,הצפון,511,עילוט,יישוב,311,122,189,4,307,253,309,7,10.72%
2016-05,הצפון,532,עין מאהל,יישוב,396,190,206,8,388,315,385,4,7.36%
2016-05,הצפון,4502,עין קנייא,יישוב,146,56,90,3,143,110,142,8,13.75%
2016-05,הצפון,7600,עכו,יישוב,2908,1341,1567,133,2775,2119,2832,63,10.64%
2016-05,הצפון,7700,עפולה,יישוב,1520,645,875,169,1351,629,1431,77,5.60%
2016-05,הצפון,531,עראבה,יישוב,1547,670,877,29,1518,1348,1515,18,14.64%
2016-05,הצפון,535,פסוטה,יישוב,107,52,55,4,103,62,105,4,6.05%
2016-05,הצפון,536,פקיעין (בוקייעה),יישוב,131,70,61,3,128,85,123,2,4.36%
2016-05,הצפון,8000,צפת,יישוב,1152,640,512,85,1067,812,1095,19,8.12%
2016-05,הצפון,4100,קצרין,יישוב,185,68,117,27,158,83,181,3,4.50%
2016-05,הצפון,2800,קריית שמונה,יישוב,736,336,400,51,685,293,707,35,5.39%
2016-05,הצפון,543,ראמה,יישוב,254,100,154,5,249,191,246,1,6.30%
2016-05,הצפון,26,ראש פינה,יישוב,42,15,27,10,32,16,41,0,2.56%
2016-05,הצפון,542,ריינה,יישוב,508,218,290,5,503,398,490,5,7.19%
2016-05,הצפון,122,רמת ישי,יישוב,95,37,58,40,55,15,91,1,2.18%
2016-05,הצפון,913,שבלי - אום אל-גנם,יישוב,193,74,119,3,190,130,191,3,7.22%
2016-05,הצפון,812,שלומי,יישוב,205,88,117,13,192,94,200,10,5.56%
2016-05,הצפון,538,שעב,יישוב,526,215,311,5,521,463,518,5,16.65%
2016-05,הצפון,8800,שפרעם,יישוב,1612,650,962,24,1588,1277,1580,27,8.70%
2016-05,חיפה,1326,"בסמ""ה",יישוב,395,170,225,7,388,300,387,7,9.52%
2016-05,חיפה,2710,אום אל-פחם,יישוב,3018,1250,1768,44,2974,2548,2955,39,13.95%
2016-05,חיפה,1020,אור עקיבא,יישוב,493,227,266,52,441,137,477,18,4.67%
2016-05,חיפה,6000,באקה אל-גרביה,יישוב,578,264,314,16,562,354,573,37,4.87%
2016-05,חיפה,9800,בנימינה-גבעת עדה*,יישוב,185,73,112,59,126,52,180,1,2.47%
2016-05,חיפה,541,ג'סר א-זרקא,יישוב,430,216,214,3,427,281,426,15,7.00%
2016-05,חיפה,628,ג'ת,יישוב,204,90,114,3,201,127,199,8,3.77%
2016-05,חיפה,494,דאלית אל-כרמל,יישוב,460,179,281,11,449,255,424,8,5.13%
2016-05,חיפה,9300,זכרון יעקב,יישוב,227,103,124,79,148,44,222,3,2.00%
2016-05,חיפה,6500,חדרה,יישוב,2231,919,1312,237,1994,803,2076,64,4.13%
2016-05,חיפה,4000,חיפה,יישוב,5689,2744,2945,1073,4616,2933,5348,141,3.83%
2016-05,חיפה,1247,חריש,יישוב,35,20,15,1,34,13,30,0,1.87%
2016-05,חיפה,2100,טירת כרמל,יישוב,628,313,315,34,594,334,609,19,5.41%
2016-05,חיפה,654,כפר קרע,יישוב,367,167,200,13,354,225,360,11,4.21%
2016-05,חיפה,45,מ.א. אלונה,מועצה איזורית,29,15,14,8,21,3,29,0,2.72%
2016-05,חיפה,12,מ.א. זבולון,מועצה איזורית,225,103,122,27,198,144,216,0,3.88%
2016-05,חיפה,15,מ.א. חוף הכרמל,מועצה איזורית,299,130,169,102,197,59,294,0,2.08%
2016-05,חיפה,14,מ.א. מנשה,מועצה איזורית,210,90,120,59,151,67,206,0,2.57%
2016-05,חיפה,1327,מעלה עירון,יישוב,764,295,469,10,754,627,748,12,12.65%
2016-05,חיפה,2500,נשר,יישוב,417,202,215,92,325,146,401,9,3.13%
2016-05,חיפה,534,עספיא,יישוב,292,124,168,16,276,155,271,6,4.79%
2016-05,חיפה,637,ערערה,יישוב,535,231,304,10,525,354,523,16,6.42%
2016-05,חיפה,537,פוריידיס,יישוב,357,185,172,11,346,246,349,1,6.16%
2016-05,חיפה,7800,פרדס חנה-כרכור,יישוב,793,349,444,158,635,234,765,29,3.76%
2016-05,חיפה,6800,קריית אתא,יישוב,1481,676,805,116,1365,768,1436,45,4.72%
2016-05,חיפה,9500,קריית ביאליק,יישוב,950,389,561,105,845,447,931,24,4.34%
2016-05,חיפה,2300,קריית טבעון,יישוב,165,69,96,60,105,39,163,1,1.95%
2016-05,חיפה,9600,קריית ים,יישוב,1348,629,719,118,1230,770,1302,45,6.08%
2016-05,חיפה,8200,קריית מוצקין,יישוב,946,423,523,160,786,405,917,33,3.98%
2016-05,חיפה,922,רכסים,יישוב,153,69,84,10,143,68,139,1,3.90%
2016-05,ירושלים,472,אבו גוש,יישוב,236,120,116,5,231,182,232,3,7.51%
2016-05,ירושלים,2610,בית שמש,יישוב,1187,526,661,83,1104,440,1145,34,3.39%
2016-05,ירושלים,3000,ירושלים,יישוב,11857,5320,6537,1345,10512,7375,11558,166,3.88%
2016-05,ירושלים,26,מ.א. מטה יהודה,מועצה איזורית,492,244,248,119,373,120,479,0,2.00%
2016-05,ירושלים,1015,מבשרת ציון,יישוב,353,167,186,84,269,126,345,2,2.65%
2016-05,ירושלים,1137,קריית יערים,יישוב,48,17,31,12,36,16,48,0,3.36%
2016-05,תל אביב,2400,אור יהודה,יישוב,675,317,358,72,603,174,640,31,3.36%
2016-05,תל אביב,565,אזור,יישוב,195,96,99,29,166,37,192,2,2.91%
2016-05,תל אביב,6100,בני ברק,יישוב,1838,899,939,99,1739,817,1715,29,2.99%
2016-05,תל אביב,6200,בת ים,יישוב,2700,1231,1469,375,2325,970,2562,68,3.64%
2016-05,תל אביב,6300,גבעתיים,יישוב,705,330,375,327,378,73,702,3,2.27%
2016-05,תל אביב,6400,הרצלייה,יישוב,971,426,545,366,605,29,961,28,1.97%
2016-05,תל אביב,6600,חולון,יישוב,2876,1330,1546,441,2435,650,2829,52,2.85%
2016-05,תל אביב,267,כפר שמריהו,יישוב,9,5,4,5,4,0,9,0,1.07%
2016-05,תל אביב,2620,קריית אונו,יישוב,370,158,212,152,218,38,368,1,1.92%
2016-05,תל אביב,8600,רמת גן,יישוב,1867,870,997,661,1206,336,1824,19,2.33%
2016-05,תל אביב,2650,רמת השרון,יישוב,377,173,204,166,211,7,376,3,1.68%
2016-05,תל אביב,5000,תל אביב -יפו,יישוב,6956,3481,3475,2485,4471,1797,6831,121,2.69%
2016-06,אזור יהודה והשומרון,3760,אורנית,יישוב,104,52,52,33,71,1,104,0,2.13%
2016-06,אזור יהודה והשומרון,3750,אלפי מנשה,יישוב,85,33,52,23,62,1,85,0,1.93%
2016-06,אזור יהודה והשומרון,3560,אלקנה,יישוב,32,11,21,17,15,0,32,0,1.69%
2016-06,אזור יהודה והשומרון,3650,אפרת,יישוב,38,12,26,21,17,3,38,4,0.88%
2016-06,אזור יהודה והשומרון,3570,אריאל,יישוב,285,123,162,80,205,33,283,11,2.62%
2016-06,אזור יהודה והשומרון,3574,בית אל,יישוב,47,22,25,12,35,18,46,1,1.89%
2016-06,אזור יהודה והשומרון,3652,בית אריה,יישוב,49,16,33,16,33,1,49,1,1.83%
2016-06,אזור יהודה והשומרון,3780,ביתר עילית,יישוב,515,243,272,10,505,228,509,4,3.83%
2016-06,אזור יהודה והשומרון,3730,גבעת זאב,יישוב,199,86,113,42,157,35,196,2,2.52%
2016-06,אזור יהודה והשומרון,3769,הר אדר,יישוב,32,15,17,17,15,3,32,0,1.51%
2016-06,אזור יהודה והשומרון,76,מ.א. גוש עציון,מועצה איזורית,124,58,66,53,71,18,121,0,1.26%
2016-06,אזור יהודה והשומרון,78,מ.א. הר חברון,מועצה איזורית,52,21,31,20,32,7,49,0,1.40%
2016-06,אזור יהודה והשומרון,74,מ.א. מגילות ים המלח,מועצה איזורית,12,3,9,1,11,0,12,0,1.50%
2016-06,אזור יהודה והשומרון,73,מ.א. מטה בנימין,מועצה איזורית,571,272,299,183,388,126,556,0,2.22%
2016-06,אזור יהודה והשומרון,75,מ.א. ערבות הירדן,מועצה איזורית,50,26,24,9,41,3,50,0,2.06%
2016-06,אזור יהודה והשומרון,72,מ.א. שומרון,מועצה איזורית,376,194,182,127,249,35,372,0,2.20%
2016-06,אזור יהודה והשומרון,3797,מודיעין עילית,יישוב,428,109,319,20,408,37,424,5,3.01%
2016-06,אזור יהודה והשומרון,3616,מעלה אדומים,יישוב,611,258,353,95,516,173,606,14,2.95%
2016-06,אזור יהודה והשומרון,3608,מעלה אפרים,יישוב,39,21,18,2,37,12,39,0,4.67%
2016-06,אזור יהודה והשומרון,3660,עמנואל,יישוב,56,31,25,0,56,28,56,1,4.76%
2016-06,אזור יהודה והשומרון,3557,קדומים,יישוב,39,25,14,12,27,4,38,1,2.02%
2016-06,אזור יהודה והשומרון,3611,קריית ארבע,יישוב,93,52,41,15,78,50,90,2,2.75%
2016-06,אזור יהודה והשומרון,3640,קרני שומרון,יישוב,65,32,33,18,47,6,65,1,1.72%
2016-06,הדרום,31,אופקים,יישוב,957,402,555,54,903,544,924,48,6.91%
2016-06,הדרום,2600,אילת,יישוב,1099,558,541,55,1044,419,1060,55,3.14%
2016-06,הדרום,70,אשדוד,יישוב,5391,2214,3177,677,4714,2508,5128,134,4.67%
2016-06,הדרום,7100,אשקלון,יישוב,3719,1527,2192,417,3302,1811,3232,118,4.56%
2016-06,הדרום,9000,באר שבע,יישוב,5677,2494,3183,768,4909,3091,5383,160,5.08%
2016-06,הדרום,2200,דימונה,יישוב,1731,746,985,92,1639,1150,1645,62,8.77%
2016-06,הדרום,1303,חורה,יישוב,581,225,356,2,579,530,568,11,13.85%
2016-06,הדרום,831,ירוחם,יישוב,372,197,175,11,361,223,355,31,7.37%
2016-06,הדרום,1059,כסיפה,יישוב,982,370,612,3,979,887,972,7,20.42%
2016-06,הדרום,1271,להבים,יישוב,48,22,26,20,28,3,47,0,1.30%
2016-06,הדרום,1060,לקיה,יישוב,677,286,391,0,677,604,663,7,15.55%
2016-06,הדרום,69,מ.א. אל קסום,מועצה איזורית,652,246,406,8,644,576,637,0,39.42%
2016-06,הדרום,38,מ.א. אשכול,מועצה איזורית,115,43,72,24,91,8,109,0,1.60%
2016-06,הדרום,33,מ.א. באר טוביה,מועצה איזורית,267,108,159,51,216,36,265,0,2.42%
2016-06,הדרום,41,מ.א. בני שמעון,מועצה איזורית,90,34,56,35,55,12,88,0,2.02%
2016-06,הדרום,54,מ.א. הערבה התיכונה,מועצה איזורית,32,14,18,9,23,2,32,0,1.76%
2016-06,הדרום,53,מ.א. חבל אילות,מועצה איזורית,15,4,11,0,15,0,15,2,0.64%
2016-06,הדרום,36,מ.א. חוף אשקלון,מועצה איזורית,186,84,102,33,153,41,179,2,2.16%
2016-06,הדרום,35,מ.א. יואב,מועצה איזורית,68,21,47,25,43,6,67,0,1.68%
2016-06,הדרום,50,מ.א. לכיש,מועצה איזורית,152,73,79,19,133,45,150,0,2.98%
2016-06,הדרום,42,מ.א. מרחבים,מועצה איזורית,174,65,109,25,149,35,171,0,2.89%
2016-06,הדרום,68,מ.א. נווה מדבר,מועצה איזורית,124,51,73,2,122,97,122,0,12.66%
2016-06,הדרום,48,מ.א. רמת נגב,מועצה איזורית,229,108,121,11,218,177,228,0,7.20%
2016-06,הדרום,39,מ.א. שדות נגב,מועצה איזורית,119,59,60,20,99,29,114,0,2.52%
2016-06,הדרום,37,מ.א. שער הנגב,מועצה איזורית,91,33,58,30,61,18,86,0,2.21%
2016-06,הדרום,34,מ.א. שפיר,מועצה איזורית,152,73,79,15,137,52,150,0,3.19%
2016-06,הדרום,51,מ.א. תמר,מועצה איזורית,17,7,10,6,11,1,17,0,2.69%
2016-06,הדרום,1268,מיתר,יישוב,67,27,40,25,42,6,67,2,1.50%
2016-06,הדרום,99,מצפה רמון,יישוב,214,86,128,16,198,136,205,17,7.54%
2016-06,הדרום,246,נתיבות,יישוב,991,448,543,44,947,455,929,87,6.26%
2016-06,הדרום,666,עומר,יישוב,58,15,43,21,37,4,57,1,1.35%
2016-06,הדרום,2560,ערד,יישוב,670,328,342,69,601,335,639,46,5.20%
2016-06,הדרום,1192,ערערה-בנגב,יישוב,1055,440,615,3,1052,966,1037,0,23.81%
2016-06,הדרום,2630,קריית גת,יישוב,1700,676,1024,108,1592,863,1628,55,5.73%
2016-06,הדרום,1034,קריית מלאכי,יישוב,806,362,444,22,784,357,775,74,6.64%
2016-06,הדרום,1161,רהט,יישוב,2639,1109,1530,9,2630,2081,2597,49,13.05%
2016-06,הדרום,1286,שגב-שלום,יישוב,394,119,275,3,391,325,382,4,13.66%
2016-06,הדרום,1031,שדרות,יישוב,930,430,500,59,871,508,854,26,6.36%
2016-06,הדרום,1054,תל שבע,יישוב,784,333,451,3,781,704,760,10,15.67%
2016-06,המרכז,1066,"בני עי""ש",יישוב,145,67,78,31,114,40,144,3,3.60%
2016-06,המרכז,182,אבן יהודה,יישוב,154,76,78,45,109,13,154,1,2.23%
2016-06,המרכז,41,אליכין,יישוב,60,30,30,11,49,18,56,0,2.90%
2016-06,המרכז,1309,אלעד,יישוב,345,167,178,29,316,42,330,5,2.55%
2016-06,המרכז,2530,באר יעקב,יישוב,245,86,159,63,182,49,240,7,2.40%
2016-06,המרכז,466,בית דגן,יישוב,90,47,43,5,85,32,89,3,2.40%
2016-06,המרכז,681,גבעת שמואל,יישוב,221,114,107,69,152,45,212,1,1.76%
2016-06,המרכז,2550,גדרה,יישוב,284,107,177,65,219,76,277,4,2.23%
2016-06,המרכז,627,ג'לג'וליה,יישוב,94,33,61,3,91,60,92,1,2.43%
2016-06,המרכז,166,גן יבנה,יישוב,275,125,150,45,230,60,270,10,2.24%
2016-06,המרכז,229,גני תקווה,יישוב,170,81,89,62,108,22,170,1,1.89%
2016-06,המרכז,9700,הוד השרון,יישוב,586,252,334,252,334,47,575,10,1.86%
2016-06,המרכז,1290,זמר,יישוב,151,54,97,3,148,93,149,3,5.01%
2016-06,המרכז,2730,טייבה,יישוב,1194,533,661,18,1176,906,1023,53,5.85%
2016-06,המרכז,2720,טירה,יישוב,202,94,108,14,188,82,196,5,1.72%
2016-06,המרכז,2660,יבנה,יישוב,720,332,388,107,613,220,710,24,2.91%
2016-06,המרכז,9400,יהוד,יישוב,365,168,197,92,273,53,359,8,2.24%
2016-06,המרכז,1224,כוכב יאיר,יישוב,77,42,35,43,34,0,77,2,1.34%
2016-06,המרכז,633,כפר ברא,יישוב,23,11,12,1,22,14,22,0,1.54%
2016-06,המרכז,168,כפר יונה,יישוב,304,131,173,52,252,40,303,5,2.69%
2016-06,המרכז,6900,כפר סבא,יישוב,1124,513,611,431,693,102,1102,32,2.08%
2016-06,המרכז,634,כפר קאסם,יישוב,220,92,128,11,209,116,211,0,2.29%
2016-06,המרכז,7000,לוד,יישוב,1780,820,960,124,1656,946,1739,51,4.91%
2016-06,המרכז,28,מ.א. ברנר,מועצה איזורית,61,22,39,28,33,3,60,1,1.49%
2016-06,המרכז,32,מ.א. גדרות,מועצה איזורית,43,22,21,19,24,3,43,1,1.75%
2016-06,המרכז,30,מ.א. גזר,מועצה איזורית,303,134,169,131,172,26,298,0,2.26%
2016-06,המרכז,27,מ.א. גן רווה,מועצה איזורית,45,21,24,22,23,3,45,0,1.54%
2016-06,המרכז,20,מ.א. דרום השרון,מועצה איזורית,300,130,170,119,181,17,297,0,1.90%
2016-06,המרכז,29,מ.א. חבל יבנה,מועצה איזורית,33,17,16,11,22,3,32,1,1.29%
2016-06,המרכז,25,מ.א. חבל מודיעין,מועצה איזורית,227,107,120,82,145,19,221,0,2.06%
2016-06,המרכז,19,מ.א. חוף השרון,מועצה איזורית,98,45,53,45,53,3,98,0,1.75%
2016-06,המרכז,18,מ.א. לב השרון,מועצה איזורית,265,139,126,66,199,29,261,0,2.37%
2016-06,המרכז,31,מ.א. נחל שורק,מועצה איזורית,59,27,32,16,43,5,57,48,1.38%
2016-06,המרכז,16,מ.א. עמק חפר,מועצה איזורית,340,161,179,113,227,16,337,0,1.71%
2016-06,המרכז,40,מ.א. עמק לוד,מועצה איזורית,130,64,66,36,94,11,128,0,2.08%
2016-06,המרכז,1200,מודיעין-מכבים-רעות*,יישוב,821,386,435,310,511,58,805,23,1.79%
2016-06,המרכז,28,מזכרת בתיה,יישוב,128,54,74,50,78,22,126,1,1.68%
2016-06,המרכז,7200,נס ציונה,יישוב,627,273,354,187,440,151,622,9,2.60%
2016-06,המרכז,7400,נתניה,יישוב,3949,1846,2103,526,3423,1294,3862,57,3.66%
2016-06,המרכז,587,סביון*,יישוב,13,1,12,8,5,0,13,0,0.66%
2016-06,המרכז,171,פרדסייה,יישוב,78,34,44,21,57,7,78,1,2.05%
2016-06,המרכז,7900,פתח תקווה,יישוב,3641,1620,2021,807,2834,917,3550,45,2.82%
2016-06,המרכז,195,קדימה-צורן,יישוב,255,100,155,72,183,36,251,5,2.26%
2016-06,המרכז,638,קלנסווה,יישוב,451,232,219,7,444,324,409,12,4.66%
2016-06,המרכז,469,קריית עקרון,יישוב,225,124,101,18,207,87,220,6,3.66%
2016-06,המרכז,2640,ראש העין,יישוב,603,293,310,105,498,125,594,19,2.36%
2016-06,המרכז,8300,ראשון לציון,יישוב,3927,1779,2148,789,3138,1114,3881,114,2.79%
2016-06,המרכז,8400,רחובות,יישוב,2088,933,1155,503,1585,665,2038,69,2.96%
2016-06,המרכז,8500,רמלה,יישוב,1492,715,777,104,1388,619,1431,70,3.80%
2016-06,המרכז,8700,רעננה,יישוב,621,298,323,258,363,41,617,19,1.67%
2016-06,המרכז,1304,שוהם,יישוב,172,74,98,77,95,9,170,0,1.46%
2016-06,המרכז,154,תל מונד,יישוב,126,65,61,47,79,19,125,1,1.94%
2016-06,הצפון,473,אבו סנאן,יישוב,586,242,344,4,582,476,580,8,9.81%
2016-06,הצפון,478,אכסאל,יישוב,498,240,258,9,489,413,494,4,8.58%
2016-06,הצפון,529,אעבלין,יישוב,497,217,280,9,488,409,488,5,8.43%
2016-06,הצפון,482,בועיינה-נוג'ידאת,יישוב,274,125,149,6,268,217,270,5,7.07%
2016-06,הצפון,4001,בוקעאתא,יישוב,368,142,226,1,367,304,354,2,12.85%
2016-06,הצפון,998,ביר אל-מכסור,יישוב,356,145,211,4,352,276,350,0,9.07%
2016-06,הצפון,480,בית ג'ן,יישוב,375,110,265,6,369,251,360,1,6.41%
2016-06,הצפון,9200,בית שאן,יישוב,758,347,411,20,738,354,730,56,7.11%
2016-06,הצפון,944,בסמת טבעון,יישוב,182,85,97,2,180,140,174,2,5.32%
2016-06,הצפון,483,בענה,יישוב,307,135,172,7,300,258,302,15,8.84%
2016-06,הצפון,1292,ג'דיידה-מכר,יישוב,1143,500,643,5,1138,933,1121,30,11.98%
2016-06,הצפון,485,ג'ולס,יישוב,208,68,140,1,207,136,206,5,6.63%
2016-06,הצפון,487,ג'ש (גוש חלב),יישוב,67,28,39,4,63,31,66,1,3.98%
2016-06,הצפון,489,דבורייה,יישוב,321,136,185,19,302,243,316,3,7.35%
2016-06,הצפון,490,דייר אל-אסד,יישוב,319,139,180,13,306,251,316,11,6.06%
2016-06,הצפון,492,דייר חנא,יישוב,627,261,366,9,618,506,614,8,12.54%
2016-06,הצפון,975,זרזיר,יישוב,237,105,132,3,234,153,232,6,7.06%
2016-06,הצפון,496,חורפיש,יישוב,109,54,55,7,102,65,105,5,3.67%
2016-06,הצפון,2034,חצור הגלילית,יישוב,275,119,156,16,259,131,258,12,5.27%
2016-06,הצפון,6700,טבריה,יישוב,1492,709,783,78,1414,754,1309,60,5.98%
2016-06,הצפון,962,טובא-זנגרייה,יישוב,363,161,202,4,359,243,354,5,11.58%
2016-06,הצפון,498,טורעאן,יישוב,427,186,241,10,417,342,416,5,7.27%
2016-06,הצפון,8900,טמרה,יישוב,1465,643,822,9,1456,1276,1440,18,10.15%
2016-06,הצפון,1295,יאנוח-ג'ת,יישוב,154,48,106,5,149,88,148,6,5.03%
2016-06,הצפון,46,יבנאל,יישוב,120,72,48,9,111,78,96,3,6.05%
2016-06,הצפון,29,יסוד המעלה,יישוב,14,6,8,4,10,5,14,1,1.64%
2016-06,הצפון,499,יפיע,יישוב,570,247,323,14,556,438,558,6,7.03%
2016-06,הצפון,240,יקנעם עילית,יישוב,444,191,253,92,352,101,443,28,3.64%
2016-06,הצפון,502,ירכא,יישוב,523,215,308,0,523,414,509,9,7.88%
2016-06,הצפון,504,כאבול,יישוב,521,243,278,11,510,439,512,4,10.36%
2016-06,הצפון,505,כאוכב אבו אל-היג'א,יישוב,222,94,128,3,219,191,216,3,12.37%
2016-06,הצפון,1296,כסרא-סמיע,יישוב,201,82,119,2,199,138,183,6,5.22%
2016-06,הצפון,978,כעביה-טבאש-חג'אג'רה,יישוב,154,63,91,3,151,109,150,3,6.41%
2016-06,הצפון,1263,כפר ורדים,יישוב,62,29,33,31,31,4,61,1,1.98%
2016-06,הצפון,507,כפר יאסיף,יישוב,418,176,242,4,414,303,405,4,7.92%
2016-06,הצפון,508,כפר כמא,יישוב,51,21,30,4,47,24,50,1,2.97%
2016-06,הצפון,509,כפר כנא,יישוב,904,401,503,21,883,741,868,13,9.91%
2016-06,הצפון,510,כפר מנדא,יישוב,733,362,371,11,722,604,712,3,9.86%
2016-06,הצפון,47,כפר תבור,יישוב,33,16,17,12,21,1,32,0,1.40%
2016-06,הצפון,1139,כרמיאל,יישוב,1443,577,866,248,1195,682,1370,39,5.26%
2016-06,הצפון,65,מ.א. אל-בטוף,מועצה איזורית,306,119,187,7,299,242,299,1,10.31%
2016-06,הצפון,66,מ.א. בוסתן אל-מרג',מועצה איזורית,34,8,26,1,33,32,33,1,1.07%
2016-06,הצפון,71,מ.א. גולן,מועצה איזורית,139,54,85,32,107,17,138,0,1.61%
2016-06,הצפון,8,מ.א. הגלבוע,מועצה איזורית,671,281,390,66,605,390,664,0,4.61%
2016-06,הצפון,1,מ.א. הגליל העליון,מועצה איזורית,173,67,106,67,106,21,172,0,1.95%
2016-06,הצפון,3,מ.א. הגליל התחתון,מועצה איזורית,98,44,54,28,70,9,95,0,1.62%
2016-06,הצפון,55,מ.א. מבואות החרמון,מועצה איזורית,95,39,56,15,80,20,94,0,2.35%
2016-06,הצפון,13,מ.א. מגידו,מועצה איזורית,108,39,69,35,73,11,108,0,1.90%
2016-06,הצפון,4,מ.א. מטה אשר,מועצה איזורית,415,192,223,65,350,166,413,0,3.01%
2016-06,הצפון,52,מ.א. מעלה יוסף,מועצה איזורית,173,85,88,19,154,43,170,0,3.08%
2016-06,הצפון,2,מ.א. מרום הגליל,מועצה איזורית,273,121,152,35,238,97,267,0,3.91%
2016-06,הצפון,56,מ.א. משגב,מועצה איזורית,542,209,333,94,448,297,531,0,4.09%
2016-06,הצפון,6,מ.א. עמק הירדן,מועצה איזורית,145,69,76,33,112,28,135,0,2.00%
2016-06,הצפון,7,מ.א. עמק המעיינות,מועצה איזורית,170,76,94,26,144,37,166,0,2.56%
2016-06,הצפון,9,מ.א. עמק יזרעאל,מועצה איזורית,363,156,207,174,189,36,360,0,1.86%
2016-06,הצפון,481,מגאר,יישוב,1300,529,771,20,1280,1055,1257,17,12.79%
2016-06,הצפון,516,מג'ד אל-כרום,יישוב,451,218,233,9,442,331,441,17,6.64%
2016-06,הצפון,65,מגדל,יישוב,36,15,21,2,34,13,31,1,3.29%
2016-06,הצפון,874,מגדל העמק,יישוב,763,312,451,68,695,308,708,51,5.23%
2016-06,הצפון,4201,מג'דל שמס,יישוב,400,159,241,9,391,325,378,5,7.75%
2016-06,הצפון,517,מזרעה,יישוב,161,65,96,3,158,119,157,9,7.89%
2016-06,הצפון,43,מטולה,יישוב,18,11,7,5,13,4,18,0,1.73%
2016-06,הצפון,4203,מסעדה,יישוב,192,61,131,3,189,157,179,3,10.60%
2016-06,הצפון,518,מעיליא,יישוב,54,25,29,7,47,26,52,0,3.21%
2016-06,הצפון,1063,מעלות-תרשיחא,יישוב,765,369,396,93,672,406,732,34,6.20%
2016-06,הצפון,520,משהד,יישוב,222,86,136,4,218,176,216,3,6.71%
2016-06,הצפון,9100,נהרייה,יישוב,1747,826,921,191,1556,928,1671,75,5.40%
2016-06,הצפון,522,נחף,יישוב,369,180,189,20,349,278,365,17,7.19%
2016-06,הצפון,7300,נצרת,יישוב,2905,1290,1615,98,2807,2270,2840,22,8.22%
2016-06,הצפון,1061,נצרת עילית,יישוב,1491,671,820,151,1340,750,1326,95,5.72%
2016-06,הצפון,525,סאג'ור,יישוב,118,40,78,4,114,64,117,1,5.89%
2016-06,הצפון,7500,סח'נין,יישוב,2075,901,1174,35,2040,1764,2036,19,14.32%
2016-06,הצפון,4501,ע'ג'ר,יישוב,85,35,50,1,84,60,84,0,7.98%
2016-06,הצפון,530,עיילבון,יישוב,153,64,89,2,151,112,150,0,5.44%
2016-06,הצפון,511,עילוט,יישוב,309,120,189,5,304,254,307,2,10.66%
2016-06,הצפון,532,עין מאהל,יישוב,384,187,197,5,379,309,373,2,7.14%
2016-06,הצפון,4502,עין קנייא,יישוב,138,53,85,2,136,112,133,2,12.99%
2016-06,הצפון,7600,עכו,יישוב,2867,1314,1553,127,2740,2097,2781,69,10.47%
2016-06,הצפון,7700,עפולה,יישוב,1455,603,852,170,1285,611,1378,85,5.40%
2016-06,הצפון,531,עראבה,יישוב,1549,683,866,31,1518,1351,1520,10,14.68%
2016-06,הצפון,535,פסוטה,יישוב,100,48,52,7,93,58,97,5,5.61%
2016-06,הצפון,536,פקיעין (בוקייעה),יישוב,138,74,64,3,135,85,130,5,4.60%
2016-06,הצפון,8000,צפת,יישוב,1091,606,485,77,1014,779,1021,22,7.61%
2016-06,הצפון,4100,קצרין,יישוב,173,62,111,25,148,81,171,3,4.26%
2016-06,הצפון,2800,קריית שמונה,יישוב,693,317,376,48,645,291,665,28,5.08%
2016-06,הצפון,543,ראמה,יישוב,236,96,140,6,230,179,232,1,5.96%
2016-06,הצפון,26,ראש פינה,יישוב,45,16,29,9,36,18,43,1,2.69%
2016-06,הצפון,542,ריינה,יישוב,509,219,290,5,504,395,488,12,7.16%
2016-06,הצפון,122,רמת ישי,יישוב,88,36,52,42,46,13,85,1,2.04%
2016-06,הצפון,913,שבלי - אום אל-גנם,יישוב,191,75,116,3,188,124,190,0,7.18%
2016-06,הצפון,812,שלומי,יישוב,200,91,109,13,187,101,193,9,5.37%
2016-06,הצפון,538,שעב,יישוב,528,217,311,4,524,467,520,3,16.70%
2016-06,הצפון,8800,שפרעם,יישוב,1599,631,968,23,1576,1281,1565,33,8.62%
2016-06,חיפה,1326,"בסמ""ה",יישוב,383,162,221,7,376,287,378,8,9.31%
2016-06,חיפה,2710,אום אל-פחם,יישוב,2945,1211,1734,39,2906,2501,2893,40,13.70%
2016-06,חיפה,1020,אור עקיבא,יישוב,483,217,266,57,426,138,466,12,4.57%
2016-06,חיפה,6000,באקה אל-גרביה,יישוב,582,263,319,14,568,355,574,28,4.88%
2016-06,חיפה,9800,בנימינה-גבעת עדה*,יישוב,181,72,109,52,129,51,178,2,2.44%
2016-06,חיפה,541,ג'סר א-זרקא,יישוב,408,208,200,2,406,256,405,23,6.68%
2016-06,חיפה,628,ג'ת,יישוב,203,88,115,2,201,124,199,14,3.77%
2016-06,חיפה,494,דאלית אל-כרמל,יישוב,453,182,271,11,442,238,431,10,5.21%
2016-06,חיפה,9300,זכרון יעקב,יישוב,217,103,114,71,146,46,212,4,1.91%
2016-06,חיפה,6500,חדרה,יישוב,2206,897,1309,234,1972,796,2048,48,4.08%
2016-06,חיפה,4000,חיפה,יישוב,5464,2630,2834,1018,4446,2880,5114,127,3.67%
2016-06,חיפה,1247,חריש,יישוב,37,18,19,0,37,14,32,3,2.00%
2016-06,חיפה,2100,טירת כרמל,יישוב,611,309,302,31,580,333,594,20,5.29%
2016-06,חיפה,654,כפר קרע,יישוב,381,172,209,12,369,235,371,8,4.34%
2016-06,חיפה,45,מ.א. אלונה,מועצה איזורית,26,11,15,7,19,4,26,0,2.43%
2016-06,חיפה,12,מ.א. זבולון,מועצה איזורית,218,98,120,20,198,144,208,0,3.73%
2016-06,חיפה,15,מ.א. חוף הכרמל,מועצה איזורית,281,124,157,95,186,48,277,0,1.96%
2016-06,חיפה,14,מ.א. מנשה,מועצה איזורית,206,93,113,51,155,68,203,0,2.53%
2016-06,חיפה,1327,מעלה עירון,יישוב,764,298,466,10,754,618,751,8,12.69%
2016-06,חיפה,2500,נשר,יישוב,437,222,215,89,348,160,417,10,3.25%
2016-06,חיפה,534,עספיא,יישוב,287,118,169,17,270,152,269,5,4.76%
2016-06,חיפה,637,ערערה,יישוב,530,227,303,12,518,365,517,15,6.35%
2016-06,חיפה,537,פוריידיס,יישוב,329,171,158,8,321,222,323,0,5.73%
2016-06,חיפה,7800,פרדס חנה-כרכור,יישוב,777,342,435,161,616,221,757,29,3.72%
2016-06,חיפה,6800,קריית אתא,יישוב,1461,670,791,118,1343,780,1404,40,4.62%
2016-06,חיפה,9500,קריית ביאליק,יישוב,966,389,577,104,862,450,938,30,4.37%
2016-06,חיפה,2300,קריית טבעון,יישוב,145,65,80,54,91,34,142,1,1.70%
2016-06,חיפה,9600,קריית ים,יישוב,1318,617,701,114,1204,761,1264,39,5.91%
2016-06,חיפה,8200,קריית מוצקין,יישוב,929,411,518,155,774,399,890,18,3.87%
2016-06,חיפה,922,רכסים,יישוב,140,70,70,11,129,66,126,0,3.55%
2016-06,ירושלים,472,אבו גוש,יישוב,234,118,116,6,228,176,232,2,7.51%
2016-06,ירושלים,2610,בית שמש,יישוב,1176,486,690,88,1088,433,1133,39,3.36%
2016-06,ירושלים,3000,ירושלים,יישוב,11476,5135,6341,1295,10181,7206,11193,188,3.76%
2016-06,ירושלים,26,מ.א. מטה יהודה,מועצה איזורית,494,249,245,111,383,122,480,1,2.01%
2016-06,ירושלים,1015,מבשרת ציון,יישוב,325,155,170,79,246,121,318,3,2.45%
2016-06,ירושלים,1137,קריית יערים,יישוב,48,16,32,12,36,16,48,1,3.36%
2016-06,תל אביב,2400,אור יהודה,יישוב,680,321,359,67,613,173,653,22,3.43%
2016-06,תל אביב,565,אזור,יישוב,183,93,90,32,151,31,182,6,2.76%
2016-06,תל אביב,6100,בני ברק,יישוב,1784,883,901,89,1695,788,1659,24,2.90%
2016-06,תל אביב,6200,בת ים,יישוב,2642,1209,1433,368,2274,945,2507,94,3.56%
2016-06,תל אביב,6300,גבעתיים,יישוב,704,322,382,343,361,76,701,5,2.27%
2016-06,תל אביב,6400,הרצלייה,יישוב,1037,467,570,372,665,37,1027,32,2.10%
2016-06,תל אביב,6600,חולון,יישוב,2833,1303,1530,441,2392,663,2774,67,2.80%
2016-06,תל אביב,267,כפר שמריהו,יישוב,7,4,3,4,3,0,7,0,0.83%
2016-06,תל אביב,2620,קריית אונו,יישוב,341,154,187,148,193,39,339,1,1.77%
2016-06,תל אביב,8600,רמת גן,יישוב,1889,872,1017,690,1199,332,1847,25,2.35%
2016-06,תל אביב,2650,רמת השרון,יישוב,377,162,215,160,217,6,375,5,1.68%
2016-06,תל אביב,5000,תל אביב -יפו,יישוב,6858,3428,3430,2424,4434,1752,6738,105,2.65%
2016-07,אזור יהודה והשומרון,3760,אורנית,יישוב,96,47,49,36,60,2,96,1,1.97%
2016-07,אזור יהודה והשומרון,3750,אלפי מנשה,יישוב,83,33,50,21,62,2,83,1,1.89%
2016-07,אזור יהודה והשומרון,3560,אלקנה,יישוב,32,11,21,19,13,0,32,1,1.69%
2016-07,אזור יהודה והשומרון,3650,אפרת,יישוב,44,16,28,19,25,3,42,1,0.98%
2016-07,אזור יהודה והשומרון,3570,אריאל,יישוב,305,137,168,85,220,32,302,14,2.80%
2016-07,אזור יהודה והשומרון,3574,בית אל,יישוב,46,23,23,12,34,16,46,0,1.89%
2016-07,אזור יהודה והשומרון,3652,בית אריה,יישוב,45,17,28,16,29,1,45,1,1.68%
2016-07,אזור יהודה והשומרון,3780,ביתר עילית,יישוב,771,274,497,14,757,221,766,17,5.65%
2016-07,אזור יהודה והשומרון,3730,גבעת זאב,יישוב,195,82,113,41,154,35,193,3,2.48%
2016-07,אזור יהודה והשומרון,3769,הר אדר,יישוב,31,12,19,15,16,3,31,0,1.46%
2016-07,אזור יהודה והשומרון,76,מ.א. גוש עציון,מועצה איזורית,149,67,82,59,90,21,147,0,1.53%
2016-07,אזור יהודה והשומרון,78,מ.א. הר חברון,מועצה איזורית,66,28,38,26,40,4,65,0,1.86%
2016-07,אזור יהודה והשומרון,74,מ.א. מגילות ים המלח,מועצה איזורית,12,4,8,2,10,0,12,0,1.50%
2016-07,אזור יהודה והשומרון,73,מ.א. מטה בנימין,מועצה איזורית,631,312,319,188,443,123,621,0,2.48%
2016-07,אזור יהודה והשומרון,75,מ.א. ערבות הירדן,מועצה איזורית,48,23,25,11,37,3,48,0,1.97%
2016-07,אזור יהודה והשומרון,72,מ.א. שומרון,מועצה איזורית,390,196,194,146,244,35,387,0,2.29%
2016-07,אזור יהודה והשומרון,3797,מודיעין עילית,יישוב,781,137,644,28,753,41,776,6,5.38%
2016-07,אזור יהודה והשומרון,3616,מעלה אדומים,יישוב,679,276,403,99,580,185,673,14,3.27%
2016-07,אזור יהודה והשומרון,3608,מעלה אפרים,יישוב,39,19,20,2,37,11,39,1,4.67%
2016-07,אזור יהודה והשומרון,3660,עמנואל,יישוב,70,38,32,1,69,27,69,0,5.80%
2016-07,אזור יהודה והשומרון,3557,קדומים,יישוב,47,27,20,14,33,4,46,1,2.44%
2016-07,אזור יהודה והשומרון,3611,קריית ארבע,יישוב,109,58,51,14,95,43,106,2,3.23%
2016-07,אזור יהודה והשומרון,3640,קרני שומרון,יישוב,64,32,32,17,47,4,62,1,1.64%
2016-07,הדרום,31,אופקים,יישוב,1121,439,682,46,1075,548,1087,43,8.03%
2016-07,הדרום,2600,אילת,יישוב,1154,546,608,60,1094,412,1108,42,3.27%
2016-07,הדרום,70,אשדוד,יישוב,5794,2313,3481,711,5083,2461,5523,119,5.02%
2016-07,הדרום,7100,אשקלון,יישוב,3898,1558,2340,481,3417,1797,3392,90,4.77%
2016-07,הדרום,9000,באר שבע,יישוב,5874,2576,3298,775,5099,3074,5572,141,5.25%
2016-07,הדרום,2200,דימונה,יישוב,1901,777,1124,96,1805,1163,1802,62,9.52%
2016-07,הדרום,1303,חורה,יישוב,575,211,364,2,573,514,566,6,13.80%
2016-07,הדרום,831,ירוחם,יישוב,437,201,236,13,424,225,411,24,8.44%
2016-07,הדרום,1059,כסיפה,יישוב,1003,382,621,3,1000,874,994,7,20.79%
2016-07,הדרום,1271,להבים,יישוב,56,26,30,29,27,2,56,0,1.54%
2016-07,הדרום,1060,לקיה,יישוב,717,301,416,1,716,612,704,3,16.35%
2016-07,הדרום,69,מ.א. אל קסום,מועצה איזורית,660,241,419,7,653,571,649,0,40.11%
2016-07,הדרום,38,מ.א. אשכול,מועצה איזורית,129,48,81,24,105,6,127,0,1.87%
2016-07,הדרום,33,מ.א. באר טוביה,מועצה איזורית,321,112,209,57,264,40,319,0,2.92%
2016-07,הדרום,41,מ.א. בני שמעון,מועצה איזורית,89,34,55,36,53,12,88,0,2.01%
2016-07,הדרום,54,מ.א. הערבה התיכונה,מועצה איזורית,34,16,18,10,24,3,34,0,1.87%
2016-07,הדרום,53,מ.א. חבל אילות,מועצה איזורית,10,4,6,1,9,0,10,3,0.42%
2016-07,הדרום,36,מ.א. חוף אשקלון,מועצה איזורית,204,82,122,35,169,41,194,0,2.34%
2016-07,הדרום,35,מ.א. יואב,מועצה איזורית,71,20,51,28,43,7,69,0,1.73%
2016-07,הדרום,50,מ.א. לכיש,מועצה איזורית,176,75,101,20,156,45,174,0,3.46%
2016-07,הדרום,42,מ.א. מרחבים,מועצה איזורית,208,72,136,30,178,33,205,0,3.47%
2016-07,הדרום,68,מ.א. נווה מדבר,מועצה איזורית,131,52,79,2,129,95,128,0,13.28%
2016-07,הדרום,48,מ.א. רמת נגב,מועצה איזורית,237,119,118,18,219,179,234,0,7.39%
2016-07,הדרום,39,מ.א. שדות נגב,מועצה איזורית,120,48,72,20,100,27,117,1,2.59%
2016-07,הדרום,37,מ.א. שער הנגב,מועצה איזורית,98,39,59,35,63,15,93,0,2.39%
2016-07,הדרום,34,מ.א. שפיר,מועצה איזורית,178,80,98,15,163,53,177,0,3.77%
2016-07,הדרום,51,מ.א. תמר,מועצה איזורית,15,5,10,6,9,2,15,0,2.37%
2016-07,הדרום,1268,מיתר,יישוב,69,24,45,25,44,6,69,1,1.55%
2016-07,הדרום,99,מצפה רמון,יישוב,237,85,152,21,216,145,227,15,8.28%
2016-07,הדרום,246,נתיבות,יישוב,1191,478,713,63,1128,455,1140,62,7.58%
2016-07,הדרום,666,עומר,יישוב,57,20,37,15,42,3,57,0,1.35%
2016-07,הדרום,2560,ערד,יישוב,707,335,372,73,634,342,672,33,5.46%
2016-07,הדרום,1192,ערערה-בנגב,יישוב,1057,447,610,4,1053,962,1032,24,23.72%
2016-07,הדרום,2630,קריית גת,יישוב,1764,678,1086,104,1660,844,1684,56,5.92%
2016-07,הדרום,1034,קריית מלאכי,יישוב,861,378,483,25,836,356,834,78,7.11%
2016-07,הדרום,1161,רהט,יישוב,2736,1140,1596,12,2724,2082,2704,72,13.51%
2016-07,הדרום,1286,שגב-שלום,יישוב,409,122,287,2,407,310,401,5,14.24%
2016-07,הדרום,1031,שדרות,יישוב,978,439,539,68,910,512,900,25,6.68%
2016-07,הדרום,1054,תל שבע,יישוב,819,331,488,3,816,719,800,15,16.36%
2016-07,המרכז,1066,"בני עי""ש",יישוב,150,69,81,28,122,42,149,7,3.72%
2016-07,המרכז,182,אבן יהודה,יישוב,153,70,83,47,106,16,153,2,2.22%
2016-07,המרכז,41,אליכין,יישוב,75,37,38,10,65,21,70,0,3.60%
2016-07,המרכז,1309,אלעד,יישוב,549,192,357,32,517,45,536,6,4.08%
2016-07,המרכז,2530,באר יעקב,יישוב,270,94,176,62,208,42,265,6,2.64%
2016-07,המרכז,466,בית דגן,יישוב,110,58,52,8,102,38,108,2,2.90%
2016-07,המרכז,681,גבעת שמואל,יישוב,238,120,118,76,162,45,229,2,1.89%
2016-07,המרכז,2550,גדרה,יישוב,308,117,191,69,239,73,303,9,2.43%
2016-07,המרכז,627,ג'לג'וליה,יישוב,105,36,69,1,104,64,101,1,2.67%
2016-07,המרכז,166,גן יבנה,יישוב,289,125,164,55,234,56,283,3,2.34%
2016-07,המרכז,229,גני תקווה,יישוב,174,77,97,65,109,22,174,1,1.93%
2016-07,המרכז,9700,הוד השרון,יישוב,626,275,351,256,370,46,620,9,2.00%
2016-07,המרכז,1290,זמר,יישוב,143,48,95,4,139,88,141,5,4.75%
2016-07,המרכז,2730,טייבה,יישוב,1180,521,659,18,1162,878,1012,26,5.79%
2016-07,המרכז,2720,טירה,יישוב,198,90,108,11,187,75,194,9,1.70%
2016-07,המרכז,2660,יבנה,יישוב,778,333,445,124,654,214,771,23,3.15%
2016-07,המרכז,9400,יהוד,יישוב,394,176,218,94,300,51,391,3,2.43%
2016-07,המרכז,1224,כוכב יאיר,יישוב,84,45,39,48,36,0,84,2,1.46%
2016-07,המרכז,633,כפר ברא,יישוב,24,12,12,0,24,16,22,0,1.54%
2016-07,המרכז,168,כפר יונה,יישוב,304,126,178,50,254,35,300,1,2.66%
2016-07,המרכז,6900,כפר סבא,יישוב,1165,516,649,419,746,95,1142,23,2.15%
2016-07,המרכז,634,כפר קאסם,יישוב,253,100,153,7,246,117,245,2,2.65%
2016-07,המרכז,7000,לוד,יישוב,1896,837,1059,131,1765,954,1855,35,5.22%
2016-07,המרכז,28,מ.א. ברנר,מועצה איזורית,69,25,44,27,42,3,69,2,1.70%
2016-07,המרכז,32,מ.א. גדרות,מועצה איזורית,43,21,22,24,19,1,43,2,1.75%
2016-07,המרכז,30,מ.א. גזר,מועצה איזורית,319,133,186,137,182,26,317,0,2.40%
2016-07,המרכז,27,מ.א. גן רווה,מועצה איזורית,49,24,25,27,22,4,49,0,1.67%
2016-07,המרכז,20,מ.א. דרום השרון,מועצה איזורית,316,140,176,124,192,16,312,0,1.99%
2016-07,המרכז,29,מ.א. חבל יבנה,מועצה איזורית,30,13,17,8,22,3,30,0,1.20%
2016-07,המרכז,25,מ.א. חבל מודיעין,מועצה איזורית,221,97,124,78,143,17,219,0,2.04%
2016-07,המרכז,19,מ.א. חוף השרון,מועצה איזורית,104,44,60,46,58,3,104,0,1.85%
2016-07,המרכז,18,מ.א. לב השרון,מועצה איזורית,296,142,154,69,227,33,290,1,2.64%
2016-07,המרכז,31,מ.א. נחל שורק,מועצה איזורית,62,24,38,17,45,4,60,43,1.40%
2016-07,המרכז,16,מ.א. עמק חפר,מועצה איזורית,374,167,207,130,244,18,370,0,1.88%
2016-07,המרכז,40,מ.א. עמק לוד,מועצה איזורית,152,77,75,38,114,15,148,0,2.40%
2016-07,המרכז,1200,מודיעין-מכבים-רעות*,יישוב,896,399,497,316,580,55,885,20,1.97%
2016-07,המרכז,28,מזכרת בתיה,יישוב,156,69,87,53,103,24,151,2,2.01%
2016-07,המרכז,7200,נס ציונה,יישוב,675,281,394,185,490,143,667,8,2.78%
2016-07,המרכז,7400,נתניה,יישוב,4146,1847,2299,559,3587,1280,4055,62,3.83%
2016-07,המרכז,587,סביון*,יישוב,14,2,12,9,5,0,14,0,0.71%
2016-07,המרכז,171,פרדסייה,יישוב,64,28,36,19,45,6,64,0,1.69%
2016-07,המרכז,7900,פתח תקווה,יישוב,3838,1666,2172,880,2958,905,3754,45,2.98%
2016-07,המרכז,195,קדימה-צורן,יישוב,274,108,166,79,195,37,269,1,2.41%
2016-07,המרכז,638,קלנסווה,יישוב,436,226,210,8,428,310,397,15,4.53%
2016-07,המרכז,469,קריית עקרון,יישוב,251,118,133,16,235,94,244,5,4.04%
2016-07,המרכז,2640,ראש העין,יישוב,688,317,371,112,576,125,681,19,2.69%
2016-07,המרכז,8300,ראשון לציון,יישוב,4080,1790,2290,817,3263,1094,4044,74,2.90%
2016-07,המרכז,8400,רחובות,יישוב,2432,991,1441,566,1866,666,2382,58,3.45%
2016-07,המרכז,8500,רמלה,יישוב,1624,728,896,116,1508,620,1551,57,4.10%
2016-07,המרכז,8700,רעננה,יישוב,687,329,358,287,400,44,678,9,1.83%
2016-07,המרכז,1304,שוהם,יישוב,178,78,100,76,102,10,177,1,1.52%
2016-07,המרכז,154,תל מונד,יישוב,132,59,73,45,87,16,132,1,2.05%
2016-07,הצפון,473,אבו סנאן,יישוב,590,238,352,4,586,471,583,8,9.85%
2016-07,הצפון,478,אכסאל,יישוב,492,236,256,10,482,390,488,1,8.49%
2016-07,הצפון,529,אעבלין,יישוב,475,203,272,9,466,387,467,12,8.10%
2016-07,הצפון,482,בועיינה-נוג'ידאת,יישוב,271,122,149,8,263,214,263,2,6.90%
2016-07,הצפון,4001,בוקעאתא,יישוב,368,134,234,3,365,296,354,0,12.85%
2016-07,הצפון,998,ביר אל-מכסור,יישוב,343,136,207,3,340,261,341,4,8.86%
2016-07,הצפון,480,בית ג'ן,יישוב,370,110,260,8,362,252,361,2,6.43%
2016-07,הצפון,9200,בית שאן,יישוב,812,368,444,23,789,363,787,59,7.63%
2016-07,הצפון,944,בסמת טבעון,יישוב,185,90,95,2,183,134,179,4,5.46%
2016-07,הצפון,483,בענה,יישוב,325,143,182,8,317,269,317,3,9.24%
2016-07,הצפון,1292,ג'דיידה-מכר,יישוב,1145,492,653,4,1141,932,1125,13,12.01%
2016-07,הצפון,485,ג'ולס,יישוב,204,65,139,1,203,131,201,8,6.48%
2016-07,הצפון,487,ג'ש (גוש חלב),יישוב,61,21,40,5,56,28,60,2,3.63%
2016-07,הצפון,489,דבורייה,יישוב,324,134,190,20,304,244,320,3,7.43%
2016-07,הצפון,490,דייר אל-אסד,יישוב,337,143,194,16,321,256,330,12,6.31%
2016-07,הצפון,492,דייר חנא,יישוב,627,262,365,9,618,498,618,3,12.61%
2016-07,הצפון,975,זרזיר,יישוב,253,111,142,3,250,150,248,2,7.52%
2016-07,הצפון,496,חורפיש,יישוב,123,62,61,8,115,64,119,4,4.14%
2016-07,הצפון,2034,חצור הגלילית,יישוב,290,115,175,20,270,131,275,7,5.59%
2016-07,הצפון,6700,טבריה,יישוב,1541,705,836,83,1458,736,1378,43,6.28%
2016-07,הצפון,962,טובא-זנגרייה,יישוב,337,151,186,5,332,233,329,1,10.85%
2016-07,הצפון,498,טורעאן,יישוב,424,178,246,8,416,334,417,9,7.29%
2016-07,הצפון,8900,טמרה,יישוב,1478,624,854,22,1456,1245,1453,18,10.23%
2016-07,הצפון,1295,יאנוח-ג'ת,יישוב,146,50,96,4,142,82,144,9,4.90%
2016-07,הצפון,46,יבנאל,יישוב,126,73,53,6,120,83,99,2,6.22%
2016-07,הצפון,29,יסוד המעלה,יישוב,22,9,13,5,17,5,22,0,2.55%
2016-07,הצפון,499,יפיע,יישוב,558,233,325,14,544,429,552,1,6.95%
2016-07,הצפון,240,יקנעם עילית,יישוב,457,174,283,88,369,104,453,26,3.72%
2016-07,הצפון,502,ירכא,יישוב,521,214,307,0,521,403,510,7,7.89%
2016-07,הצפון,504,כאבול,יישוב,522,233,289,13,509,433,514,4,10.40%
2016-07,הצפון,505,כאוכב אבו אל-היג'א,יישוב,213,86,127,4,209,181,207,1,11.92%
2016-07,הצפון,1296,כסרא-סמיע,יישוב,203,81,122,5,198,137,189,2,5.38%
2016-07,הצפון,978,כעביה-טבאש-חג'אג'רה,יישוב,159,68,91,2,157,112,157,2,6.69%
2016-07,הצפון,1263,כפר ורדים,יישוב,67,30,37,26,41,3,66,0,2.14%
2016-07,הצפון,507,כפר יאסיף,יישוב,413,176,237,5,408,301,401,2,7.84%
2016-07,הצפון,508,כפר כמא,יישוב,45,14,31,3,42,23,45,0,2.68%
2016-07,הצפון,509,כפר כנא,יישוב,894,389,505,20,874,700,864,10,9.87%
2016-07,הצפון,510,כפר מנדא,יישוב,757,359,398,15,742,610,742,6,10.24%
2016-07,הצפון,47,כפר תבור,יישוב,33,13,20,12,21,1,32,0,1.40%
2016-07,הצפון,1139,כרמיאל,יישוב,1475,591,884,248,1227,667,1392,30,5.34%
2016-07,הצפון,65,מ.א. אל-בטוף,מועצה איזורית,289,121,168,6,283,229,282,1,9.71%
2016-07,הצפון,66,מ.א. בוסתן אל-מרג',מועצה איזורית,33,9,24,0,33,30,31,0,1.01%
2016-07,הצפון,71,מ.א. גולן,מועצה איזורית,167,81,86,36,131,18,166,1,1.93%
2016-07,הצפון,8,מ.א. הגלבוע,מועצה איזורית,693,287,406,69,624,387,684,0,4.74%
2016-07,הצפון,1,מ.א. הגליל העליון,מועצה איזורית,168,55,113,71,97,15,168,0,1.90%
2016-07,הצפון,3,מ.א. הגליל התחתון,מועצה איזורית,110,45,65,29,81,10,108,0,1.85%
2016-07,הצפון,55,מ.א. מבואות החרמון,מועצה איזורית,102,44,58,16,86,18,102,0,2.55%
2016-07,הצפון,13,מ.א. מגידו,מועצה איזורית,94,34,60,28,66,9,93,0,1.64%
2016-07,הצפון,4,מ.א. מטה אשר,מועצה איזורית,412,186,226,69,343,162,409,0,2.98%
2016-07,הצפון,52,מ.א. מעלה יוסף,מועצה איזורית,182,86,96,17,165,46,179,0,3.24%
2016-07,הצפון,2,מ.א. מרום הגליל,מועצה איזורית,279,127,152,35,244,98,270,0,3.95%
2016-07,הצפון,56,מ.א. משגב,מועצה איזורית,560,223,337,114,446,295,548,0,4.22%
2016-07,הצפון,6,מ.א. עמק הירדן,מועצה איזורית,151,72,79,37,114,27,142,0,2.10%
2016-07,הצפון,7,מ.א. עמק המעיינות,מועצה איזורית,177,78,99,24,153,37,171,0,2.64%
2016-07,הצפון,9,מ.א. עמק יזרעאל,מועצה איזורית,395,167,228,185,210,35,392,0,2.03%
2016-07,הצפון,481,מגאר,יישוב,1314,523,791,26,1288,1064,1275,11,12.95%
2016-07,הצפון,516,מג'ד אל-כרום,יישוב,501,212,289,12,489,334,487,11,7.28%
2016-07,הצפון,65,מגדל,יישוב,40,15,25,3,37,16,35,1,3.70%
2016-07,הצפון,874,מגדל העמק,יישוב,845,345,500,76,769,321,792,75,5.81%
2016-07,הצפון,4201,מג'דל שמס,יישוב,411,159,252,9,402,326,391,2,8.00%
2016-07,הצפון,517,מזרעה,יישוב,153,64,89,3,150,108,150,1,7.56%
2016-07,הצפון,43,מטולה,יישוב,16,10,6,4,12,4,16,0,1.54%
2016-07,הצפון,4203,מסעדה,יישוב,199,65,134,5,194,155,185,3,10.92%
2016-07,הצפון,518,מעיליא,יישוב,55,26,29,7,48,25,54,1,3.33%
2016-07,הצפון,1063,מעלות-תרשיחא,יישוב,814,396,418,87,727,408,777,37,6.56%
2016-07,הצפון,520,משהד,יישוב,231,91,140,6,225,176,225,6,6.97%
2016-07,הצפון,9100,נהרייה,יישוב,1771,842,929,193,1578,931,1689,78,5.46%
2016-07,הצפון,522,נחף,יישוב,356,175,181,17,339,280,343,10,6.78%
2016-07,הצפון,7300,נצרת,יישוב,2955,1252,1703,112,2843,2260,2904,7,8.39%
2016-07,הצפון,1061,נצרת עילית,יישוב,1516,671,845,151,1365,727,1353,90,5.83%
2016-07,הצפון,525,סאג'ור,יישוב,115,43,72,5,110,70,114,3,5.75%
2016-07,הצפון,7500,סח'נין,יישוב,2072,878,1194,38,2034,1747,2035,15,14.31%
2016-07,הצפון,4501,ע'ג'ר,יישוב,86,36,50,2,84,59,85,1,8.06%
2016-07,הצפון,530,עיילבון,יישוב,151,61,90,3,148,107,148,0,5.37%
2016-07,הצפון,511,עילוט,יישוב,292,109,183,2,290,244,292,1,10.19%
2016-07,הצפון,532,עין מאהל,יישוב,393,190,203,7,386,318,373,2,7.14%
2016-07,הצפון,4502,עין קנייא,יישוב,133,52,81,3,130,109,130,1,12.73%
2016-07,הצפון,7600,עכו,יישוב,2992,1325,1667,134,2858,2117,2895,67,10.85%
2016-07,הצפון,7700,עפולה,יישוב,1551,639,912,180,1371,607,1465,78,5.72%
2016-07,הצפון,531,עראבה,יישוב,1553,669,884,38,1515,1352,1527,9,14.74%
2016-07,הצפון,535,פסוטה,יישוב,101,42,59,9,92,48,98,4,5.67%
2016-07,הצפון,536,פקיעין (בוקייעה),יישוב,138,73,65,4,134,84,132,4,4.67%
2016-07,הצפון,8000,צפת,יישוב,1186,605,581,83,1103,755,1114,26,8.25%
2016-07,הצפון,4100,קצרין,יישוב,189,72,117,28,161,87,187,2,4.64%
2016-07,הצפון,2800,קריית שמונה,יישוב,725,321,404,59,666,286,701,17,5.34%
2016-07,הצפון,543,ראמה,יישוב,246,95,151,14,232,181,238,0,6.11%
2016-07,הצפון,26,ראש פינה,יישוב,44,16,28,8,36,18,43,1,2.69%
2016-07,הצפון,542,ריינה,יישוב,526,216,310,7,519,395,513,6,7.50%
2016-07,הצפון,122,רמת ישי,יישוב,90,40,50,38,52,13,88,0,2.11%
2016-07,הצפון,913,שבלי - אום אל-גנם,יישוב,209,81,128,5,204,120,207,1,7.77%
2016-07,הצפון,812,שלומי,יישוב,204,92,112,11,193,95,192,4,5.35%
2016-07,הצפון,538,שעב,יישוב,522,207,315,3,519,462,516,2,16.60%
2016-07,הצפון,8800,שפרעם,יישוב,1573,615,958,34,1539,1239,1545,34,8.52%
2016-07,חיפה,1326,"בסמ""ה",יישוב,389,170,219,9,380,294,380,1,9.36%
2016-07,חיפה,2710,אום אל-פחם,יישוב,2997,1181,1816,39,2958,2457,2949,41,13.93%
2016-07,חיפה,1020,אור עקיבא,יישוב,486,213,273,54,432,127,470,12,4.60%
2016-07,חיפה,6000,באקה אל-גרביה,יישוב,579,256,323,17,562,364,573,18,4.87%
2016-07,חיפה,9800,בנימינה-גבעת עדה*,יישוב,189,74,115,58,131,47,187,3,2.56%
2016-07,חיפה,541,ג'סר א-זרקא,יישוב,372,187,185,3,369,231,368,13,6.10%
2016-07,חיפה,628,ג'ת,יישוב,197,83,114,3,194,119,195,7,3.70%
2016-07,חיפה,494,דאלית אל-כרמל,יישוב,475,181,294,10,465,248,439,5,5.30%
2016-07,חיפה,9300,זכרון יעקב,יישוב,232,115,117,71,161,39,228,2,2.05%
2016-07,חיפה,6500,חדרה,יישוב,2233,920,1313,234,1999,797,2087,41,4.15%
2016-07,חיפה,4000,חיפה,יישוב,5587,2668,2919,1069,4518,2790,5295,109,3.79%
2016-07,חיפה,1247,חריש,יישוב,37,15,22,1,36,10,34,0,2.12%
2016-07,חיפה,2100,טירת כרמל,יישוב,618,310,308,32,586,327,602,16,5.35%
2016-07,חיפה,654,כפר קרע,יישוב,372,170,202,15,357,226,366,2,4.28%
2016-07,חיפה,45,מ.א. אלונה,מועצה איזורית,28,11,17,7,21,4,28,0,2.62%
2016-07,חיפה,12,מ.א. זבולון,מועצה איזורית,231,108,123,22,209,147,226,0,4.06%
2016-07,חיפה,15,מ.א. חוף הכרמל,מועצה איזורית,288,131,157,95,193,50,285,0,2.01%
2016-07,חיפה,14,מ.א. מנשה,מועצה איזורית,214,93,121,58,156,68,212,0,2.65%
2016-07,חיפה,1327,מעלה עירון,יישוב,775,289,486,7,768,606,762,13,12.86%
2016-07,חיפה,2500,נשר,יישוב,430,207,223,81,349,156,417,7,3.25%
2016-07,חיפה,534,עספיא,יישוב,296,130,166,16,280,151,274,4,4.84%
2016-07,חיפה,637,ערערה,יישוב,557,240,317,14,543,364,547,7,6.70%
2016-07,חיפה,537,פוריידיס,יישוב,341,166,175,10,331,210,336,6,5.94%
2016-07,חיפה,7800,פרדס חנה-כרכור,יישוב,786,336,450,169,617,215,762,24,3.74%
2016-07,חיפה,6800,קריית אתא,יישוב,1581,657,924,117,1464,779,1534,37,5.02%
2016-07,חיפה,9500,קריית ביאליק,יישוב,987,401,586,114,873,454,962,27,4.48%
2016-07,חיפה,2300,קריית טבעון,יישוב,151,67,84,63,88,34,148,1,1.78%
2016-07,חיפה,9600,קריית ים,יישוב,1320,612,708,124,1196,749,1274,34,5.95%
2016-07,חיפה,8200,קריית מוצקין,יישוב,949,403,546,163,786,405,916,18,3.97%
2016-07,חיפה,922,רכסים,יישוב,190,62,128,10,180,72,177,1,4.92%
2016-07,ירושלים,472,אבו גוש,יישוב,232,109,123,7,225,177,230,1,7.45%
2016-07,ירושלים,2610,בית שמש,יישוב,1563,546,1017,112,1451,464,1514,25,4.44%
2016-07,ירושלים,3000,ירושלים,יישוב,12468,5180,7288,1390,11078,7182,12155,119,4.07%
2016-07,ירושלים,26,מ.א. מטה יהודה,מועצה איזורית,568,251,317,120,448,118,557,1,2.33%
2016-07,ירושלים,1015,מבשרת ציון,יישוב,350,165,185,82,268,121,344,6,2.64%
2016-07,ירושלים,1137,קריית יערים,יישוב,52,17,35,13,39,14,52,0,3.63%
2016-07,תל אביב,2400,אור יהודה,יישוב,744,347,397,69,675,167,719,33,3.76%
2016-07,תל אביב,565,אזור,יישוב,190,83,107,34,156,29,189,5,2.87%
2016-07,תל אביב,6100,בני ברק,יישוב,2448,888,1560,94,2354,781,2333,17,4.02%
2016-07,תל אביב,6200,בת ים,יישוב,2625,1174,1451,373,2252,902,2493,76,3.54%
2016-07,תל אביב,6300,גבעתיים,יישוב,743,306,437,340,403,76,741,5,2.40%
2016-07,תל אביב,6400,הרצלייה,יישוב,1087,465,622,372,715,28,1083,20,2.21%
2016-07,תל אביב,6600,חולון,יישוב,2910,1291,1619,460,2450,629,2861,53,2.88%
2016-07,תל אביב,267,כפר שמריהו,יישוב,9,4,5,5,4,0,9,0,1.07%
2016-07,תל אביב,2620,קריית אונו,יישוב,395,156,239,169,226,37,394,0,2.05%
2016-07,תל אביב,8600,רמת גן,יישוב,2086,884,1202,708,1378,329,2047,23,2.60%
2016-07,תל אביב,2650,רמת השרון,יישוב,390,159,231,150,240,12,386,7,1.73%
2016-07,תל אביב,5000,תל אביב -יפו,יישוב,7047,3485,3562,2549,4498,1720,6918,90,2.72%
2016-08,אזור יהודה והשומרון,3760,אורנית,יישוב,97,48,49,36,61,2,96,1,1.97%
2016-08,אזור יהודה והשומרון,3750,אלפי מנשה,יישוב,87,34,53,23,64,1,87,1,1.98%
2016-08,אזור יהודה והשומרון,3560,אלקנה,יישוב,35,13,22,20,15,0,35,1,1.84%
2016-08,אזור יהודה והשומרון,3650,אפרת,יישוב,50,23,27,25,25,2,50,1,1.16%
2016-08,אזור יהודה והשומרון,3570,אריאל,יישוב,320,148,172,83,237,32,315,12,2.91%
2016-08,אזור יהודה והשומרון,3574,בית אל,יישוב,58,32,26,15,43,16,58,0,2.38%
2016-08,אזור יהודה והשומרון,3652,בית אריה,יישוב,45,18,27,15,30,1,45,1,1.68%
2016-08,אזור יהודה והשומרון,3780,ביתר עילית,יישוב,860,283,577,17,843,218,852,3,6.24%
2016-08,אזור יהודה והשומרון,3730,גבעת זאב,יישוב,201,75,126,39,162,36,198,2,2.54%
2016-08,אזור יהודה והשומרון,3769,הר אדר,יישוב,28,13,15,10,18,4,28,0,1.32%
2016-08,אזור יהודה והשומרון,76,מ.א. גוש עציון,מועצה איזורית,148,60,88,53,95,15,146,0,1.52%
2016-08,אזור יהודה והשומרון,78,מ.א. הר חברון,מועצה איזורית,75,30,45,29,46,6,74,0,2.11%
2016-08,אזור יהודה והשומרון,74,מ.א. מגילות ים המלח,מועצה איזורית,11,6,5,1,10,0,11,0,1.37%
2016-08,אזור יהודה והשומרון,73,מ.א. מטה בנימין,מועצה איזורית,682,330,352,192,490,124,673,0,2.68%
2016-08,אזור יהודה והשומרון,75,מ.א. ערבות הירדן,מועצה איזורית,53,27,26,16,37,3,53,0,2.18%
2016-08,אזור יהודה והשומרון,72,מ.א. שומרון,מועצה איזורית,399,195,204,153,246,35,395,0,2.34%
2016-08,אזור יהודה והשומרון,3797,מודיעין עילית,יישוב,920,144,776,28,892,42,916,3,6.28%
2016-08,אזור יהודה והשומרון,3616,מעלה אדומים,יישוב,696,280,416,101,595,195,691,13,3.35%
2016-08,אזור יהודה והשומרון,3608,מעלה אפרים,יישוב,43,21,22,4,39,10,43,1,5.13%
2016-08,אזור יהודה והשומרון,3660,עמנואל,יישוב,71,38,33,1,70,30,71,1,5.96%
2016-08,אזור יהודה והשומרון,3557,קדומים,יישוב,45,24,21,14,31,5,43,0,2.28%
2016-08,אזור יהודה והשומרון,3611,קריית ארבע,יישוב,110,61,49,17,93,44,108,3,3.29%
2016-08,אזור יהודה והשומרון,3640,קרני שומרון,יישוב,69,35,34,16,53,4,69,3,1.83%
2016-08,הדרום,31,אופקים,יישוב,1145,414,731,48,1097,536,1112,38,8.20%
2016-08,הדרום,2600,אילת,יישוב,1119,524,595,66,1053,384,1072,57,3.17%
2016-08,הדרום,70,אשדוד,יישוב,6036,2286,3750,709,5327,2490,5746,151,5.21%
2016-08,הדרום,7100,אשקלון,יישוב,4029,1588,2441,487,3542,1777,3529,92,4.95%
2016-08,הדרום,9000,באר שבע,יישוב,6013,2567,3446,761,5252,3066,5701,109,5.36%
2016-08,הדרום,2200,דימונה,יישוב,1897,767,1130,103,1794,1157,1812,36,9.57%
2016-08,הדרום,1303,חורה,יישוב,588,221,367,0,588,520,579,3,14.08%
2016-08,הדרום,831,ירוחם,יישוב,439,204,235,13,426,223,418,24,8.57%
2016-08,הדרום,1059,כסיפה,יישוב,1002,374,628,3,999,879,996,7,20.82%
2016-08,הדרום,1271,להבים,יישוב,56,22,34,28,28,2,56,1,1.54%
2016-08,הדרום,1060,לקיה,יישוב,727,308,419,1,726,615,712,7,16.51%
2016-08,הדרום,69,מ.א. אל קסום,מועצה איזורית,678,259,419,8,670,587,668,0,41.34%
2016-08,הדרום,38,מ.א. אשכול,מועצה איזורית,128,47,81,29,99,7,127,0,1.87%
2016-08,הדרום,33,מ.א. באר טוביה,מועצה איזורית,325,104,221,54,271,39,324,0,2.96%
2016-08,הדרום,41,מ.א. בני שמעון,מועצה איזורית,95,37,58,37,58,12,94,3,2.15%
2016-08,הדרום,54,מ.א. הערבה התיכונה,מועצה איזורית,33,14,19,10,23,2,32,0,1.76%
2016-08,הדרום,53,מ.א. חבל אילות,מועצה איזורית,15,7,8,3,12,0,15,0,0.63%
2016-08,הדרום,36,מ.א. חוף אשקלון,מועצה איזורית,206,84,122,30,176,39,198,0,2.39%
2016-08,הדרום,35,מ.א. יואב,מועצה איזורית,74,19,55,29,45,6,74,0,1.86%
2016-08,הדרום,50,מ.א. לכיש,מועצה איזורית,184,77,107,22,162,44,182,0,3.62%
2016-08,הדרום,42,מ.א. מרחבים,מועצה איזורית,216,72,144,30,186,34,213,0,3.60%
2016-08,הדרום,68,מ.א. נווה מדבר,מועצה איזורית,137,56,81,2,135,98,133,0,13.80%
2016-08,הדרום,48,מ.א. רמת נגב,מועצה איזורית,230,108,122,20,210,172,230,0,7.25%
2016-08,הדרום,39,מ.א. שדות נגב,מועצה איזורית,138,63,75,20,118,29,132,0,2.93%
2016-08,הדרום,37,מ.א. שער הנגב,מועצה איזורית,109,41,68,37,72,15,104,0,2.67%
2016-08,הדרום,34,מ.א. שפיר,מועצה איזורית,169,72,97,9,160,52,166,0,3.53%
2016-08,הדרום,51,מ.א. תמר,מועצה איזורית,13,6,7,4,9,1,13,0,2.05%
2016-08,הדרום,1268,מיתר,יישוב,73,26,47,25,48,4,73,0,1.63%
2016-08,הדרום,99,מצפה רמון,יישוב,255,95,160,18,237,149,246,7,8.91%
2016-08,הדרום,246,נתיבות,יישוב,1202,452,750,72,1130,466,1133,53,7.53%
2016-08,הדרום,666,עומר,יישוב,50,16,34,12,38,4,49,0,1.16%
2016-08,הדרום,2560,ערד,יישוב,705,315,390,72,633,341,668,35,5.43%
2016-08,הדרום,1192,ערערה-בנגב,יישוב,1067,447,620,5,1062,963,1047,7,23.99%
2016-08,הדרום,2630,קריית גת,יישוב,1811,713,1098,104,1707,813,1747,64,6.12%
2016-08,הדרום,1034,קריית מלאכי,יישוב,859,370,489,29,830,343,830,77,7.08%
2016-08,הדרום,1161,רהט,יישוב,2705,1087,1618,14,2691,2100,2677,76,13.39%
2016-08,הדרום,1286,שגב-שלום,יישוב,420,128,292,1,419,317,408,2,14.45%
2016-08,הדרום,1031,שדרות,יישוב,1007,453,554,71,936,514,934,24,6.92%
2016-08,הדרום,1054,תל שבע,יישוב,844,346,498,2,842,728,820,8,16.70%
2016-08,המרכז,1066,"בני עי""ש",יישוב,159,69,90,27,132,41,156,8,3.89%
2016-08,המרכז,182,אבן יהודה,יישוב,157,68,89,51,106,16,157,0,2.28%
2016-08,המרכז,41,אליכין,יישוב,72,34,38,7,65,22,69,3,3.55%
2016-08,המרכז,1309,אלעד,יישוב,667,219,448,34,633,50,652,5,4.91%
2016-08,המרכז,2530,באר יעקב,יישוב,285,99,186,68,217,37,282,4,2.81%
2016-08,המרכז,466,בית דגן,יישוב,113,60,53,11,102,37,110,1,2.95%
2016-08,המרכז,681,גבעת שמואל,יישוב,254,127,127,81,173,47,247,2,2.04%
2016-08,המרכז,2550,גדרה,יישוב,338,125,213,72,266,75,331,3,2.65%
2016-08,המרכז,627,ג'לג'וליה,יישוב,119,43,76,4,115,67,113,3,2.97%
2016-08,המרכז,166,גן יבנה,יישוב,316,135,181,59,257,57,311,3,2.57%
2016-08,המרכז,229,גני תקווה,יישוב,180,78,102,65,115,26,179,1,1.98%
2016-08,המרכז,9700,הוד השרון,יישוב,672,279,393,248,424,45,665,14,2.14%
2016-08,המרכז,1290,זמר,יישוב,145,53,92,5,140,86,144,3,4.85%
2016-08,המרכז,2730,טייבה,יישוב,1210,530,680,23,1187,885,1032,32,5.90%
2016-08,המרכז,2720,טירה,יישוב,210,87,123,11,199,70,205,9,1.79%
2016-08,המרכז,2660,יבנה,יישוב,854,349,505,135,719,217,842,23,3.43%
2016-08,המרכז,9400,יהוד,יישוב,425,177,248,93,332,59,417,3,2.59%
2016-08,המרכז,1224,כוכב יאיר,יישוב,87,45,42,54,33,0,87,1,1.51%
2016-08,המרכז,633,כפר ברא,יישוב,29,15,14,1,28,16,28,1,1.95%
2016-08,המרכז,168,כפר יונה,יישוב,325,128,197,55,270,32,322,2,2.85%
2016-08,המרכז,6900,כפר סבא,יישוב,1192,520,672,413,779,96,1170,28,2.20%
2016-08,המרכז,634,כפר קאסם,יישוב,267,103,164,11,256,120,257,6,2.77%
2016-08,המרכז,7000,לוד,יישוב,1964,843,1121,145,1819,938,1924,49,5.40%
2016-08,המרכז,28,מ.א. ברנר,מועצה איזורית,68,28,40,24,44,3,68,2,1.66%
2016-08,המרכז,32,מ.א. גדרות,מועצה איזורית,38,17,21,23,15,2,37,0,1.51%
2016-08,המרכז,30,מ.א. גזר,מועצה איזורית,351,146,205,133,218,25,349,0,2.65%
2016-08,המרכז,27,מ.א. גן רווה,מועצה איזורית,51,25,26,25,26,4,51,0,1.74%
2016-08,המרכז,20,מ.א. דרום השרון,מועצה איזורית,344,148,196,134,210,15,341,0,2.18%
2016-08,המרכז,29,מ.א. חבל יבנה,מועצה איזורית,37,15,22,8,29,3,37,0,1.48%
2016-08,המרכז,25,מ.א. חבל מודיעין,מועצה איזורית,230,93,137,74,156,15,229,0,2.13%
2016-08,המרכז,19,מ.א. חוף השרון,מועצה איזורית,105,44,61,49,56,3,105,0,1.87%
2016-08,המרכז,18,מ.א. לב השרון,מועצה איזורית,300,140,160,68,232,35,296,0,2.69%
2016-08,המרכז,31,מ.א. נחל שורק,מועצה איזורית,71,30,41,17,54,5,70,38,1.62%
2016-08,המרכז,16,מ.א. עמק חפר,מועצה איזורית,379,166,213,136,243,14,376,0,1.91%
2016-08,המרכז,40,מ.א. עמק לוד,מועצה איזורית,158,74,84,39,119,12,156,0,2.53%
2016-08,המרכז,1200,מודיעין-מכבים-רעות*,יישוב,954,404,550,333,621,52,946,15,2.10%
2016-08,המרכז,28,מזכרת בתיה,יישוב,193,78,115,68,125,26,190,2,2.52%
2016-08,המרכז,7200,נס ציונה,יישוב,686,287,399,173,513,150,680,16,2.83%
2016-08,המרכז,7400,נתניה,יישוב,4447,1878,2569,542,3905,1308,4344,55,4.10%
2016-08,המרכז,587,סביון*,יישוב,13,1,12,8,5,0,13,0,0.66%
2016-08,המרכז,171,פרדסייה,יישוב,68,28,40,17,51,6,68,0,1.79%
2016-08,המרכז,7900,פתח תקווה,יישוב,4078,1699,2379,897,3181,902,3991,41,3.16%
2016-08,המרכז,195,קדימה-צורן,יישוב,279,115,164,83,196,37,276,2,2.48%
2016-08,המרכז,638,קלנסווה,יישוב,443,228,215,8,435,317,403,14,4.60%
2016-08,המרכז,469,קריית עקרון,יישוב,286,121,165,21,265,95,278,6,4.58%
2016-08,המרכז,2640,ראש העין,יישוב,794,325,469,121,673,121,784,17,3.09%
2016-08,המרכז,8300,ראשון לציון,יישוב,4222,1809,2413,827,3395,1116,4169,69,2.99%
2016-08,המרכז,8400,רחובות,יישוב,2586,996,1590,608,1978,685,2528,55,3.65%
2016-08,המרכז,8500,רמלה,יישוב,1670,737,933,120,1550,613,1604,61,4.24%
2016-08,המרכז,8700,רעננה,יישוב,691,323,368,282,409,45,684,3,1.85%
2016-08,המרכז,1304,שוהם,יישוב,173,77,96,76,97,8,172,0,1.48%
2016-08,המרכז,154,תל מונד,יישוב,131,60,71,47,84,15,130,0,2.02%
2016-08,הצפון,473,אבו סנאן,יישוב,602,242,360,4,598,481,589,5,9.94%
2016-08,הצפון,478,אכסאל,יישוב,503,236,267,8,495,399,498,3,8.64%
2016-08,הצפון,529,אעבלין,יישוב,468,193,275,14,454,385,465,14,8.06%
2016-08,הצפון,482,בועיינה-נוג'ידאת,יישוב,265,120,145,10,255,214,256,2,6.73%
2016-08,הצפון,4001,בוקעאתא,יישוב,367,138,229,3,364,298,357,1,12.95%
2016-08,הצפון,998,ביר אל-מכסור,יישוב,334,131,203,3,331,266,330,4,8.60%
2016-08,הצפון,480,בית ג'ן,יישוב,385,113,272,11,374,251,374,2,6.64%
2016-08,הצפון,9200,בית שאן,יישוב,838,378,460,24,814,359,807,73,7.80%
2016-08,הצפון,944,בסמת טבעון,יישוב,174,80,94,2,172,134,166,2,5.09%
2016-08,הצפון,483,בענה,יישוב,337,146,191,10,327,267,328,5,9.53%
2016-08,הצפון,1292,ג'דיידה-מכר,יישוב,1166,492,674,5,1161,933,1143,17,12.18%
2016-08,הצפון,485,ג'ולס,יישוב,203,74,129,2,201,125,201,4,6.48%
2016-08,הצפון,487,ג'ש (גוש חלב),יישוב,57,21,36,3,54,27,55,4,3.34%
2016-08,הצפון,489,דבורייה,יישוב,321,135,186,20,301,232,318,4,7.39%
2016-08,הצפון,490,דייר אל-אסד,יישוב,337,141,196,15,322,257,330,5,6.31%
2016-08,הצפון,492,דייר חנא,יישוב,608,257,351,8,600,494,600,6,12.29%
2016-08,הצפון,975,זרזיר,יישוב,255,108,147,7,248,150,249,7,7.54%
2016-08,הצפון,496,חורפיש,יישוב,124,63,61,10,114,60,120,2,4.18%
2016-08,הצפון,2034,חצור הגלילית,יישוב,293,115,178,20,273,131,280,4,5.69%
2016-08,הצפון,6700,טבריה,יישוב,1537,688,849,79,1458,725,1375,62,6.27%
2016-08,הצפון,962,טובא-זנגרייה,יישוב,327,149,178,5,322,231,316,5,10.47%
2016-08,הצפון,498,טורעאן,יישוב,465,186,279,10,455,354,454,10,7.88%
2016-08,הצפון,8900,טמרה,יישוב,1465,631,834,25,1440,1238,1445,21,10.18%
2016-08,הצפון,1295,יאנוח-ג'ת,יישוב,140,47,93,4,136,82,137,6,4.67%
2016-08,הצפון,46,יבנאל,יישוב,129,70,59,5,124,77,108,2,6.75%
2016-08,הצפון,29,יסוד המעלה,יישוב,22,8,14,7,15,3,22,0,2.55%
2016-08,הצפון,499,יפיע,יישוב,562,233,329,18,544,428,553,1,6.97%
2016-08,הצפון,240,יקנעם עילית,יישוב,501,204,297,93,408,107,496,25,4.06%
2016-08,הצפון,502,ירכא,יישוב,521,217,304,0,521,393,512,4,7.92%
2016-08,הצפון,504,כאבול,יישוב,521,231,290,9,512,432,514,9,10.40%
2016-08,הצפון,505,כאוכב אבו אל-היג'א,יישוב,213,85,128,3,210,180,207,1,11.92%
2016-08,הצפון,1296,כסרא-סמיע,יישוב,190,78,112,8,182,122,180,4,5.14%
2016-08,הצפון,978,כעביה-טבאש-חג'אג'רה,יישוב,162,73,89,3,159,117,156,2,6.65%
2016-08,הצפון,1263,כפר ורדים,יישוב,65,29,36,27,38,3,64,0,2.08%
2016-08,הצפון,507,כפר יאסיף,יישוב,426,170,256,3,423,298,417,7,8.13%
2016-08,הצפון,508,כפר כמא,יישוב,49,15,34,4,45,22,49,0,2.91%
2016-08,הצפון,509,כפר כנא,יישוב,892,381,511,19,873,704,853,14,9.75%
2016-08,הצפון,510,כפר מנדא,יישוב,774,367,407,16,758,619,760,3,10.46%
2016-08,הצפון,47,כפר תבור,יישוב,35,14,21,12,23,1,34,0,1.49%
2016-08,הצפון,1139,כרמיאל,יישוב,1496,584,912,253,1243,683,1407,43,5.40%
2016-08,הצפון,65,מ.א. אל-בטוף,מועצה איזורית,306,130,176,4,302,246,292,2,10.04%
2016-08,הצפון,66,מ.א. בוסתן אל-מרג',מועצה איזורית,32,7,25,1,31,28,31,1,1.01%
2016-08,הצפון,71,מ.א. גולן,מועצה איזורית,176,84,92,40,136,20,174,2,2.02%
2016-08,הצפון,8,מ.א. הגלבוע,מועצה איזורית,711,289,422,68,643,385,707,0,4.90%
2016-08,הצפון,1,מ.א. הגליל העליון,מועצה איזורית,175,60,115,70,105,18,175,0,1.98%
2016-08,הצפון,3,מ.א. הגליל התחתון,מועצה איזורית,114,51,63,26,88,11,109,0,1.86%
2016-08,הצפון,55,מ.א. מבואות החרמון,מועצה איזורית,108,43,65,14,94,18,105,0,2.63%
2016-08,הצפון,13,מ.א. מגידו,מועצה איזורית,103,41,62,31,72,7,102,0,1.80%
2016-08,הצפון,4,מ.א. מטה אשר,מועצה איזורית,435,189,246,76,359,166,427,0,3.11%
2016-08,הצפון,52,מ.א. מעלה יוסף,מועצה איזורית,193,84,109,19,174,43,189,0,3.43%
2016-08,הצפון,2,מ.א. מרום הגליל,מועצה איזורית,285,132,153,42,243,103,277,0,4.06%
2016-08,הצפון,56,מ.א. משגב,מועצה איזורית,593,242,351,122,471,310,575,0,4.43%
2016-08,הצפון,6,מ.א. עמק הירדן,מועצה איזורית,158,73,85,35,123,34,145,0,2.15%
2016-08,הצפון,7,מ.א. עמק המעיינות,מועצה איזורית,188,90,98,35,153,38,182,1,2.81%
2016-08,הצפון,9,מ.א. עמק יזרעאל,מועצה איזורית,405,170,235,205,200,36,402,0,2.08%
2016-08,הצפון,481,מגאר,יישוב,1319,534,785,31,1288,1058,1280,15,12.99%
2016-08,הצפון,516,מג'ד אל-כרום,יישוב,509,205,304,15,494,327,498,12,7.44%
2016-08,הצפון,65,מגדל,יישוב,44,14,30,3,41,16,38,2,4.00%
2016-08,הצפון,874,מגדל העמק,יישוב,908,376,532,76,832,323,851,69,6.22%
2016-08,הצפון,4201,מג'דל שמס,יישוב,397,152,245,9,388,326,374,2,7.68%
2016-08,הצפון,517,מזרעה,יישוב,158,66,92,1,157,113,151,4,7.61%
2016-08,הצפון,43,מטולה,יישוב,21,11,10,6,15,4,21,1,2.01%
2016-08,הצפון,4203,מסעדה,יישוב,189,62,127,5,184,154,177,2,10.50%
2016-08,הצפון,518,מעיליא,יישוב,58,25,33,5,53,22,57,1,3.51%
2016-08,הצפון,1063,מעלות-תרשיחא,יישוב,831,417,414,84,747,396,798,41,6.73%
2016-08,הצפון,520,משהד,יישוב,231,96,135,7,224,174,227,2,7.03%
2016-08,הצפון,9100,נהרייה,יישוב,1766,827,939,189,1577,918,1686,68,5.45%
2016-08,הצפון,522,נחף,יישוב,349,165,184,14,335,279,345,6,6.82%
2016-08,הצפון,7300,נצרת,יישוב,3015,1252,1763,113,2902,2291,2959,20,8.54%
2016-08,הצפון,1061,נצרת עילית,יישוב,1563,694,869,145,1418,722,1390,96,5.98%
2016-08,הצפון,525,סאג'ור,יישוב,117,44,73,4,113,75,115,4,5.79%
2016-08,הצפון,7500,סח'נין,יישוב,2073,880,1193,37,2036,1746,2038,15,14.33%
2016-08,הצפון,4501,ע'ג'ר,יישוב,90,37,53,2,88,59,89,1,8.41%
2016-08,הצפון,530,עיילבון,יישוב,149,59,90,4,145,106,146,1,5.30%
2016-08,הצפון,511,עילוט,יישוב,294,112,182,1,293,248,290,5,10.13%
2016-08,הצפון,532,עין מאהל,יישוב,406,197,209,7,399,314,389,7,7.43%
2016-08,הצפון,4502,עין קנייא,יישוב,142,60,82,4,138,114,138,4,13.41%
2016-08,הצפון,7600,עכו,יישוב,2991,1297,1694,140,2851,2088,2911,58,10.91%
2016-08,הצפון,7700,עפולה,יישוב,1620,642,978,193,1427,620,1537,81,5.99%
2016-08,הצפון,531,עראבה,יישוב,1537,657,880,35,1502,1343,1508,12,14.58%
2016-08,הצפון,535,פסוטה,יישוב,95,38,57,8,87,42,91,3,5.28%
2016-08,הצפון,536,פקיעין (בוקייעה),יישוב,147,72,75,7,140,82,142,6,5.01%
2016-08,הצפון,8000,צפת,יישוב,1199,586,613,86,1113,745,1129,26,8.35%
2016-08,הצפון,4100,קצרין,יישוב,191,71,120,31,160,86,189,2,4.69%
2016-08,הצפון,2800,קריית שמונה,יישוב,743,321,422,66,677,283,711,34,5.42%
2016-08,הצפון,543,ראמה,יישוב,266,109,157,15,251,180,254,4,6.49%
2016-08,הצפון,26,ראש פינה,יישוב,42,14,28,5,37,19,39,2,2.44%
2016-08,הצפון,542,ריינה,יישוב,543,226,317,9,534,399,522,12,7.62%
2016-08,הצפון,122,רמת ישי,יישוב,96,44,52,41,55,12,94,0,2.25%
2016-08,הצפון,913,שבלי - אום אל-גנם,יישוב,211,73,138,6,205,129,208,3,7.81%
2016-08,הצפון,812,שלומי,יישוב,215,92,123,10,205,98,207,6,5.74%
2016-08,הצפון,538,שעב,יישוב,516,203,313,3,513,456,508,1,16.38%
2016-08,הצפון,8800,שפרעם,יישוב,1563,614,949,38,1525,1222,1535,25,8.47%
2016-08,חיפה,1326,"בסמ""ה",יישוב,389,171,218,10,379,289,384,4,9.45%
2016-08,חיפה,2710,אום אל-פחם,יישוב,3012,1182,1830,38,2974,2474,2967,41,14.00%
2016-08,חיפה,1020,אור עקיבא,יישוב,493,215,278,55,438,128,472,21,4.62%
2016-08,חיפה,6000,באקה אל-גרביה,יישוב,591,280,311,15,576,360,587,16,4.99%
2016-08,חיפה,9800,בנימינה-גבעת עדה*,יישוב,198,81,117,59,139,48,197,1,2.70%
2016-08,חיפה,541,ג'סר א-זרקא,יישוב,379,191,188,4,375,220,376,15,6.23%
2016-08,חיפה,628,ג'ת,יישוב,208,90,118,3,205,121,206,11,3.90%
2016-08,חיפה,494,דאלית אל-כרמל,יישוב,478,184,294,11,467,251,441,4,5.32%
2016-08,חיפה,9300,זכרון יעקב,יישוב,263,132,131,92,171,40,261,0,2.34%
2016-08,חיפה,6500,חדרה,יישוב,2307,943,1364,237,2070,801,2155,53,4.28%
2016-08,חיפה,4000,חיפה,יישוב,5811,2729,3082,1131,4680,2797,5492,113,3.93%
2016-08,חיפה,1247,חריש,יישוב,37,16,21,4,33,11,34,1,2.12%
2016-08,חיפה,2100,טירת כרמל,יישוב,671,319,352,34,637,330,653,26,5.78%
2016-08,חיפה,654,כפר קרע,יישוב,385,175,210,16,369,231,380,4,4.44%
2016-08,חיפה,45,מ.א. אלונה,מועצה איזורית,29,13,16,6,23,4,28,0,2.62%
2016-08,חיפה,12,מ.א. זבולון,מועצה איזורית,232,107,125,24,208,146,224,0,4.02%
2016-08,חיפה,15,מ.א. חוף הכרמל,מועצה איזורית,314,147,167,110,204,53,310,0,2.19%
2016-08,חיפה,14,מ.א. מנשה,מועצה איזורית,219,94,125,52,167,65,214,0,2.67%
2016-08,חיפה,1327,מעלה עירון,יישוב,763,281,482,6,757,596,749,7,12.66%
2016-08,חיפה,2500,נשר,יישוב,440,205,235,86,354,145,428,3,3.33%
2016-08,חיפה,534,עספיא,יישוב,292,132,160,15,277,154,275,1,4.86%
2016-08,חיפה,637,ערערה,יישוב,548,233,315,15,533,348,541,20,6.63%
2016-08,חיפה,537,פוריידיס,יישוב,329,154,175,8,321,196,323,6,5.73%
2016-08,חיפה,7800,פרדס חנה-כרכור,יישוב,780,326,454,165,615,207,764,21,3.75%
2016-08,חיפה,6800,קריית אתא,יישוב,1665,700,965,134,1531,771,1623,32,5.30%
2016-08,חיפה,9500,קריית ביאליק,יישוב,1006,397,609,119,887,448,974,22,4.53%
2016-08,חיפה,2300,קריית טבעון,יישוב,169,74,95,69,100,36,165,1,1.98%
2016-08,חיפה,9600,קריית ים,יישוב,1347,610,737,127,1220,732,1307,32,6.10%
2016-08,חיפה,8200,קריית מוצקין,יישוב,982,404,578,168,814,408,947,27,4.10%
2016-08,חיפה,922,רכסים,יישוב,248,70,178,11,237,70,234,0,6.40%
2016-08,ירושלים,472,אבו גוש,יישוב,243,110,133,7,236,179,239,2,7.72%
2016-08,ירושלים,2610,בית שמש,יישוב,1597,543,1054,117,1480,447,1556,35,4.55%
2016-08,ירושלים,3000,ירושלים,יישוב,13209,5344,7865,1438,11771,7254,12888,122,4.31%
2016-08,ירושלים,26,מ.א. מטה יהודה,מועצה איזורית,574,247,327,121,453,122,564,2,2.36%
2016-08,ירושלים,1015,מבשרת ציון,יישוב,348,167,181,78,270,119,340,5,2.61%
2016-08,ירושלים,1137,קריית יערים,יישוב,52,16,36,12,40,12,52,1,3.63%
2016-08,תל אביב,2400,אור יהודה,יישוב,802,346,456,67,735,152,772,34,4.03%
2016-08,תל אביב,565,אזור,יישוב,182,76,106,30,152,27,182,5,2.76%
2016-08,תל אביב,6100,בני ברק,יישוב,2826,911,1915,95,2731,779,2705,17,4.64%
2016-08,תל אביב,6200,בת ים,יישוב,2706,1224,1482,375,2331,895,2576,73,3.66%
2016-08,תל אביב,6300,גבעתיים,יישוב,735,290,445,330,405,77,731,3,2.37%
2016-08,תל אביב,6400,הרצלייה,יישוב,1185,471,714,379,806,25,1177,14,2.40%
2016-08,תל אביב,6600,חולון,יישוב,3007,1332,1675,469,2538,627,2944,53,2.96%
2016-08,תל אביב,267,כפר שמריהו,יישוב,7,3,4,4,3,0,7,0,0.83%
2016-08,תל אביב,2620,קריית אונו,יישוב,400,153,247,177,223,36,398,0,2.07%
2016-08,תל אביב,8600,רמת גן,יישוב,2084,876,1208,671,1413,323,2047,16,2.60%
2016-08,תל אביב,2650,רמת השרון,יישוב,423,165,258,163,260,5,422,3,1.88%
2016-08,תל אביב,5000,תל אביב -יפו,יישוב,7198,3483,3715,2588,4610,1716,7056,89,2.77%
2016-09,אזור יהודה והשומרון,3760,אורנית,יישוב,91,50,41,33,58,3,91,2,1.87%
2016-09,אזור יהודה והשומרון,3750,אלפי מנשה,יישוב,84,31,53,25,59,1,84,0,1.91%
2016-09,אזור יהודה והשומרון,3560,אלקנה,יישוב,29,13,16,18,11,0,29,0,1.53%
2016-09,אזור יהודה והשומרון,3650,אפרת,יישוב,56,28,28,30,26,2,55,0,1.27%
2016-09,אזור יהודה והשומרון,3570,אריאל,יישוב,324,147,177,84,240,34,320,14,2.96%
2016-09,אזור יהודה והשומרון,3574,בית אל,יישוב,50,22,28,18,32,14,50,1,2.06%
2016-09,אזור יהודה והשומרון,3652,בית אריה,יישוב,39,16,23,10,29,1,39,0,1.46%
2016-09,אזור יהודה והשומרון,3780,ביתר עילית,יישוב,577,238,339,17,560,201,573,1,4.29%
2016-09,אזור יהודה והשומרון,3730,גבעת זאב,יישוב,192,79,113,38,154,36,188,2,2.42%
2016-09,אזור יהודה והשומרון,3769,הר אדר,יישוב,28,15,13,11,17,4,28,0,1.32%
2016-09,אזור יהודה והשומרון,76,מ.א. גוש עציון,מועצה איזורית,153,59,94,53,100,16,151,0,1.57%
2016-09,אזור יהודה והשומרון,78,מ.א. הר חברון,מועצה איזורית,90,34,56,38,52,4,89,1,2.54%
2016-09,אזור יהודה והשומרון,74,מ.א. מגילות ים המלח,מועצה איזורית,12,6,6,2,10,0,12,0,1.49%
2016-09,אזור יהודה והשומרון,73,מ.א. מטה בנימין,מועצה איזורית,646,310,336,202,444,121,635,0,2.53%
2016-09,אזור יהודה והשומרון,75,מ.א. ערבות הירדן,מועצה איזורית,57,29,28,22,35,3,57,0,2.34%
2016-09,אזור יהודה והשומרון,72,מ.א. שומרון,מועצה איזורית,414,191,223,141,273,36,409,0,2.42%
2016-09,אזור יהודה והשומרון,3797,מודיעין עילית,יישוב,553,117,436,25,528,35,552,2,3.88%
2016-09,אזור יהודה והשומרון,3616,מעלה אדומים,יישוב,639,265,374,100,539,193,632,19,3.07%
2016-09,אזור יהודה והשומרון,3608,מעלה אפרים,יישוב,32,17,15,2,30,10,32,0,3.86%
2016-09,אזור יהודה והשומרון,3660,עמנואל,יישוב,74,39,35,1,73,29,73,2,6.12%
2016-09,אזור יהודה והשומרון,3557,קדומים,יישוב,40,22,18,12,28,4,39,0,2.07%
2016-09,אזור יהודה והשומרון,3611,קריית ארבע,יישוב,100,52,48,11,89,42,99,4,3.02%
2016-09,אזור יהודה והשומרון,3640,קרני שומרון,יישוב,76,37,39,19,57,6,75,3,1.98%
2016-09,הדרום,31,אופקים,יישוב,1048,405,643,59,989,520,1016,42,7.54%
2016-09,הדרום,2600,אילת,יישוב,1037,512,525,62,975,382,979,59,2.90%
2016-09,הדרום,70,אשדוד,יישוב,5590,2241,3349,695,4895,2430,5325,173,4.85%
2016-09,הדרום,7100,אשקלון,יישוב,3840,1541,2299,463,3377,1764,3372,86,4.74%
2016-09,הדרום,9000,באר שבע,יישוב,5754,2452,3302,716,5038,3035,5464,146,5.15%
2016-09,הדרום,2200,דימונה,יישוב,1780,774,1006,93,1687,1152,1692,66,8.99%
2016-09,הדרום,1303,חורה,יישוב,551,211,340,0,551,500,540,7,13.25%
2016-09,הדרום,831,ירוחם,יישוב,417,200,217,19,398,220,397,33,8.17%
2016-09,הדרום,1059,כסיפה,יישוב,971,364,607,3,968,859,965,3,20.30%
2016-09,הדרום,1271,להבים,יישוב,59,20,39,30,29,4,59,0,1.62%
2016-09,הדרום,1060,לקיה,יישוב,690,310,380,1,689,605,674,3,15.77%
2016-09,הדרום,69,מ.א. אל קסום,מועצה איזורית,634,243,391,9,625,561,625,0,38.70%
2016-09,הדרום,38,מ.א. אשכול,מועצה איזורית,133,48,85,35,98,10,129,0,1.90%
2016-09,הדרום,33,מ.א. באר טוביה,מועצה איזורית,281,104,177,44,237,38,280,0,2.56%
2016-09,הדרום,41,מ.א. בני שמעון,מועצה איזורית,93,30,63,37,56,12,91,1,2.09%
2016-09,הדרום,54,מ.א. הערבה התיכונה,מועצה איזורית,25,10,15,7,18,1,25,0,1.38%
2016-09,הדרום,53,מ.א. חבל אילות,מועצה איזורית,19,5,14,4,15,0,19,3,0.80%
2016-09,הדרום,36,מ.א. חוף אשקלון,מועצה איזורית,211,74,137,32,179,37,204,0,2.47%
2016-09,הדרום,35,מ.א. יואב,מועצה איזורית,79,25,54,32,47,5,78,0,1.96%
2016-09,הדרום,50,מ.א. לכיש,מועצה איזורית,181,69,112,27,154,49,178,0,3.54%
2016-09,הדרום,42,מ.א. מרחבים,מועצה איזורית,205,70,135,34,171,34,201,0,3.40%
2016-09,הדרום,68,מ.א. נווה מדבר,מועצה איזורית,129,51,78,1,128,96,126,0,13.07%
2016-09,הדרום,48,מ.א. רמת נגב,מועצה איזורית,246,120,126,23,223,175,245,1,7.72%
2016-09,הדרום,39,מ.א. שדות נגב,מועצה איזורית,132,57,75,19,113,28,124,0,2.75%
2016-09,הדרום,37,מ.א. שער הנגב,מועצה איזורית,99,39,60,36,63,17,93,0,2.39%
2016-09,הדרום,34,מ.א. שפיר,מועצה איזורית,145,64,81,7,138,54,143,0,3.05%
2016-09,הדרום,51,מ.א. תמר,מועצה איזורית,14,7,7,3,11,2,14,0,2.21%
2016-09,הדרום,1268,מיתר,יישוב,81,30,51,32,49,4,81,2,1.81%
2016-09,הדרום,99,מצפה רמון,יישוב,260,91,169,22,238,161,252,13,9.11%
2016-09,הדרום,246,נתיבות,יישוב,1086,438,648,59,1027,456,1019,65,6.83%
2016-09,הדרום,666,עומר,יישוב,55,17,38,15,40,5,54,2,1.28%
2016-09,הדרום,2560,ערד,יישוב,717,318,399,73,644,349,682,43,5.53%
2016-09,הדרום,1192,ערערה-בנגב,יישוב,1054,431,623,5,1049,955,1036,0,23.79%
2016-09,הדרום,2630,קריית גת,יישוב,1718,677,1041,92,1626,804,1647,67,5.79%
2016-09,הדרום,1034,קריית מלאכי,יישוב,811,354,457,21,790,344,778,78,6.66%
2016-09,הדרום,1161,רהט,יישוב,2548,996,1552,13,2535,2077,2507,67,12.65%
2016-09,הדרום,1286,שגב-שלום,יישוב,365,118,247,2,363,301,359,13,12.94%
2016-09,הדרום,1031,שדרות,יישוב,991,433,558,67,924,547,903,26,6.70%
2016-09,הדרום,1054,תל שבע,יישוב,779,335,444,1,778,703,754,11,15.57%
2016-09,המרכז,1066,"בני עי""ש",יישוב,144,66,78,24,120,42,141,7,3.53%
2016-09,המרכז,182,אבן יהודה,יישוב,166,74,92,55,111,18,165,0,2.39%
2016-09,המרכז,41,אליכין,יישוב,58,33,25,7,51,19,56,1,2.90%
2016-09,המרכז,1309,אלעד,יישוב,454,167,287,27,427,43,443,12,3.39%
2016-09,המרכז,2530,באר יעקב,יישוב,248,81,167,68,180,40,246,5,2.46%
2016-09,המרכז,466,בית דגן,יישוב,122,60,62,13,109,38,120,3,3.21%
2016-09,המרכז,681,גבעת שמואל,יישוב,238,116,122,91,147,48,232,2,1.92%
2016-09,המרכז,2550,גדרה,יישוב,321,126,195,65,256,78,312,7,2.50%
2016-09,המרכז,627,ג'לג'וליה,יישוב,86,33,53,1,85,55,84,0,2.23%
2016-09,המרכז,166,גן יבנה,יישוב,300,123,177,51,249,54,296,8,2.45%
2016-09,המרכז,229,גני תקווה,יישוב,180,84,96,76,104,27,178,1,1.97%
2016-09,המרכז,9700,הוד השרון,יישוב,633,269,364,270,363,44,626,9,2.02%
2016-09,המרכז,1290,זמר,יישוב,135,46,89,4,131,81,134,4,4.52%
2016-09,המרכז,2730,טייבה,יישוב,1181,519,662,26,1155,861,1012,29,5.79%
2016-09,המרכז,2720,טירה,יישוב,184,84,100,9,175,64,182,3,1.60%
2016-09,המרכז,2660,יבנה,יישוב,839,324,515,157,682,212,830,27,3.38%
2016-09,המרכז,9400,יהוד,יישוב,386,167,219,92,294,55,378,8,2.35%
2016-09,המרכז,1224,כוכב יאיר,יישוב,86,48,38,46,40,0,86,0,1.49%
2016-09,המרכז,633,כפר ברא,יישוב,31,17,14,3,28,16,30,1,2.09%
2016-09,המרכז,168,כפר יונה,יישוב,312,131,181,59,253,35,311,4,2.76%
2016-09,המרכז,6900,כפר סבא,יישוב,1176,516,660,423,753,106,1150,47,2.17%
2016-09,המרכז,634,כפר קאסם,יישוב,224,100,124,16,208,124,217,3,2.35%
2016-09,המרכז,7000,לוד,יישוב,1812,784,1028,137,1675,923,1764,48,4.97%
2016-09,המרכז,28,מ.א. ברנר,מועצה איזורית,64,22,42,29,35,3,64,7,1.58%
2016-09,המרכז,32,מ.א. גדרות,מועצה איזורית,32,14,18,16,16,2,32,0,1.31%
2016-09,המרכז,30,מ.א. גזר,מועצה איזורית,321,147,174,118,203,27,320,0,2.43%
2016-09,המרכז,27,מ.א. גן רווה,מועצה איזורית,56,25,31,25,31,3,56,0,1.91%
2016-09,המרכז,20,מ.א. דרום השרון,מועצה איזורית,345,144,201,150,195,12,341,0,2.18%
2016-09,המרכז,29,מ.א. חבל יבנה,מועצה איזורית,42,17,25,15,27,3,42,1,1.69%
2016-09,המרכז,25,מ.א. חבל מודיעין,מועצה איזורית,214,85,129,81,133,14,211,0,1.96%
2016-09,המרכז,19,מ.א. חוף השרון,מועצה איזורית,107,48,59,45,62,3,107,0,1.91%
2016-09,המרכז,18,מ.א. לב השרון,מועצה איזורית,280,134,146,67,213,36,273,0,2.48%
2016-09,המרכז,31,מ.א. נחל שורק,מועצה איזורית,63,26,37,15,48,5,63,42,1.50%
2016-09,המרכז,16,מ.א. עמק חפר,מועצה איזורית,383,156,227,152,231,20,379,0,1.93%
2016-09,המרכז,40,מ.א. עמק לוד,מועצה איזורית,142,65,77,36,106,14,141,0,2.29%
2016-09,המרכז,1200,מודיעין-מכבים-רעות*,יישוב,868,374,494,320,548,50,862,11,1.92%
2016-09,המרכז,28,מזכרת בתיה,יישוב,158,68,90,64,94,26,154,7,2.05%
2016-09,המרכז,7200,נס ציונה,יישוב,617,262,355,160,457,150,608,11,2.54%
2016-09,המרכז,7400,נתניה,יישוב,4070,1840,2230,501,3569,1298,3977,96,3.76%
2016-09,המרכז,587,סביון*,יישוב,17,4,13,8,9,0,17,0,0.86%
2016-09,המרכז,171,פרדסייה,יישוב,75,31,44,16,59,9,75,0,1.97%
2016-09,המרכז,7900,פתח תקווה,יישוב,3761,1625,2136,869,2892,903,3661,59,2.91%
2016-09,המרכז,195,קדימה-צורן,יישוב,271,112,159,79,192,38,267,5,2.40%
2016-09,המרכז,638,קלנסווה,יישוב,429,217,212,7,422,312,390,15,4.46%
2016-09,המרכז,469,קריית עקרון,יישוב,250,118,132,26,224,97,244,8,4.04%
2016-09,המרכז,2640,ראש העין,יישוב,721,334,387,123,598,124,708,26,2.80%
2016-09,המרכז,8300,ראשון לציון,יישוב,4127,1751,2376,821,3306,1138,4085,106,2.93%
2016-09,המרכז,8400,רחובות,יישוב,2273,998,1275,552,1721,686,2214,68,3.21%
2016-09,המרכז,8500,רמלה,יישוב,1563,713,850,123,1440,613,1491,72,3.95%
2016-09,המרכז,8700,רעננה,יישוב,656,301,355,271,385,44,650,11,1.76%
2016-09,המרכז,1304,שוהם,יישוב,169,69,100,69,100,8,168,2,1.44%
2016-09,המרכז,154,תל מונד,יישוב,129,59,70,43,86,17,128,0,1.99%
2016-09,הצפון,473,אבו סנאן,יישוב,578,239,339,4,574,469,572,2,9.68%
2016-09,הצפון,478,אכסאל,יישוב,486,215,271,7,479,391,478,3,8.33%
2016-09,הצפון,529,אעבלין,יישוב,459,182,277,8,451,383,452,8,7.86%
2016-09,הצפון,482,בועיינה-נוג'ידאת,יישוב,254,116,138,8,246,207,247,0,6.51%
2016-09,הצפון,4001,בוקעאתא,יישוב,367,133,234,4,363,295,357,1,12.95%
2016-09,הצפון,998,ביר אל-מכסור,יישוב,342,145,197,2,340,265,339,1,8.81%
2016-09,הצפון,480,בית ג'ן,יישוב,355,98,257,9,346,242,345,3,6.16%
2016-09,הצפון,9200,בית שאן,יישוב,829,351,478,30,799,355,805,65,7.79%
2016-09,הצפון,944,בסמת טבעון,יישוב,165,77,88,3,162,130,154,2,4.74%
2016-09,הצפון,483,בענה,יישוב,312,135,177,6,306,262,303,2,8.86%
2016-09,הצפון,1292,ג'דיידה-מכר,יישוב,1109,482,627,3,1106,912,1088,17,11.66%
2016-09,הצפון,485,ג'ולס,יישוב,191,59,132,1,190,123,190,0,6.14%
2016-09,הצפון,487,ג'ש (גוש חלב),יישוב,62,25,37,6,56,29,61,0,3.69%
2016-09,הצפון,489,דבורייה,יישוב,309,125,184,19,290,221,306,3,7.13%
2016-09,הצפון,490,דייר אל-אסד,יישוב,323,145,178,14,309,265,313,5,6.01%
2016-09,הצפון,492,דייר חנא,יישוב,596,246,350,7,589,488,584,2,12.00%
2016-09,הצפון,975,זרזיר,יישוב,241,101,140,7,234,154,236,7,7.18%
2016-09,הצפון,496,חורפיש,יישוב,112,48,64,8,104,61,108,2,3.77%
2016-09,הצפון,2034,חצור הגלילית,יישוב,286,108,178,22,264,129,269,12,5.48%
2016-09,הצפון,6700,טבריה,יישוב,1500,654,846,79,1421,742,1313,59,6.00%
2016-09,הצפון,962,טובא-זנגרייה,יישוב,311,143,168,5,306,226,299,8,9.96%
2016-09,הצפון,498,טורעאן,יישוב,417,171,246,12,405,344,404,11,7.08%
2016-09,הצפון,8900,טמרה,יישוב,1377,597,780,25,1352,1189,1360,12,9.64%
2016-09,הצפון,1295,יאנוח-ג'ת,יישוב,119,40,79,5,114,80,117,5,4.02%
2016-09,הצפון,46,יבנאל,יישוב,127,64,63,6,121,77,100,3,6.28%
2016-09,הצפון,29,יסוד המעלה,יישוב,21,9,12,8,13,4,21,1,2.43%
2016-09,הצפון,499,יפיע,יישוב,527,205,322,21,506,411,521,3,6.59%
2016-09,הצפון,240,יקנעם עילית,יישוב,432,174,258,88,344,105,425,36,3.50%
2016-09,הצפון,502,ירכא,יישוב,478,195,283,0,478,360,470,3,7.32%
2016-09,הצפון,504,כאבול,יישוב,494,226,268,10,484,421,489,4,9.94%
2016-09,הצפון,505,כאוכב אבו אל-היג'א,יישוב,207,80,127,2,205,174,202,0,11.66%
2016-09,הצפון,1296,כסרא-סמיע,יישוב,190,73,117,5,185,122,180,4,5.14%
2016-09,הצפון,978,כעביה-טבאש-חג'אג'רה,יישוב,153,64,89,3,150,111,149,1,6.37%
2016-09,הצפון,1263,כפר ורדים,יישוב,66,32,34,29,37,5,66,3,2.14%
2016-09,הצפון,507,כפר יאסיף,יישוב,410,168,242,4,406,290,398,6,7.79%
2016-09,הצפון,508,כפר כמא,יישוב,47,14,33,5,42,21,47,0,2.79%
2016-09,הצפון,509,כפר כנא,יישוב,845,372,473,23,822,687,810,18,9.31%
2016-09,הצפון,510,כפר מנדא,יישוב,720,333,387,13,707,578,709,4,9.83%
2016-09,הצפון,47,כפר תבור,יישוב,35,13,22,13,22,1,34,0,1.49%
2016-09,הצפון,1139,כרמיאל,יישוב,1481,581,900,255,1226,692,1379,40,5.29%
2016-09,הצפון,65,מ.א. אל-בטוף,מועצה איזורית,289,116,173,5,284,238,272,1,9.37%
2016-09,הצפון,66,מ.א. בוסתן אל-מרג',מועצה איזורית,33,8,25,0,33,28,32,0,1.04%
2016-09,הצפון,71,מ.א. גולן,מועצה איזורית,188,95,93,46,142,22,186,0,2.16%
2016-09,הצפון,8,מ.א. הגלבוע,מועצה איזורית,695,277,418,75,620,371,689,0,4.78%
2016-09,הצפון,1,מ.א. הגליל העליון,מועצה איזורית,186,54,132,84,102,14,184,0,2.08%
2016-09,הצפון,3,מ.א. הגליל התחתון,מועצה איזורית,118,57,61,26,92,11,113,0,1.93%
2016-09,הצפון,55,מ.א. מבואות החרמון,מועצה איזורית,112,41,71,18,94,19,112,0,2.80%
2016-09,הצפון,13,מ.א. מגידו,מועצה איזורית,98,34,64,32,66,9,97,0,1.71%
2016-09,הצפון,4,מ.א. מטה אשר,מועצה איזורית,453,193,260,82,371,163,447,0,3.26%
2016-09,הצפון,52,מ.א. מעלה יוסף,מועצה איזורית,194,85,109,19,175,46,190,0,3.45%
2016-09,הצפון,2,מ.א. מרום הגליל,מועצה איזורית,260,122,138,39,221,104,254,0,3.72%
2016-09,הצפון,56,מ.א. משגב,מועצה איזורית,608,242,366,135,473,297,588,0,4.53%
2016-09,הצפון,6,מ.א. עמק הירדן,מועצה איזורית,162,74,88,33,129,36,148,0,2.19%
2016-09,הצפון,7,מ.א. עמק המעיינות,מועצה איזורית,206,94,112,37,169,41,202,0,3.12%
2016-09,הצפון,9,מ.א. עמק יזרעאל,מועצה איזורית,403,173,230,195,208,37,397,0,2.05%
2016-09,הצפון,481,מגאר,יישוב,1259,501,758,18,1241,1037,1217,11,12.43%
2016-09,הצפון,516,מג'ד אל-כרום,יישוב,468,198,270,9,459,334,448,8,6.74%
2016-09,הצפון,65,מגדל,יישוב,38,14,24,2,36,16,35,1,3.70%
2016-09,הצפון,874,מגדל העמק,יישוב,893,361,532,84,809,319,830,66,6.07%
2016-09,הצפון,4201,מג'דל שמס,יישוב,412,156,256,12,400,328,390,2,7.98%
2016-09,הצפון,517,מזרעה,יישוב,151,57,94,0,151,113,144,3,7.28%
2016-09,הצפון,43,מטולה,יישוב,21,11,10,7,14,6,21,0,2.01%
2016-09,הצפון,4203,מסעדה,יישוב,195,62,133,4,191,157,181,3,10.71%
2016-09,הצפון,518,מעיליא,יישוב,60,25,35,5,55,24,58,0,3.57%
2016-09,הצפון,1063,מעלות-תרשיחא,יישוב,791,395,396,82,709,393,758,39,6.41%
2016-09,הצפון,520,משהד,יישוב,217,90,127,3,214,165,212,4,6.60%
2016-09,הצפון,9100,נהרייה,יישוב,1801,798,1003,180,1621,954,1711,91,5.52%
2016-09,הצפון,522,נחף,יישוב,338,154,184,12,326,280,330,7,6.54%
2016-09,הצפון,7300,נצרת,יישוב,2873,1183,1690,118,2755,2179,2837,16,8.22%
2016-09,הצפון,1061,נצרת עילית,יישוב,1539,680,859,158,1381,725,1376,111,5.92%
2016-09,הצפון,525,סאג'ור,יישוב,105,36,69,5,100,70,104,0,5.27%
2016-09,הצפון,7500,סח'נין,יישוב,2018,857,1161,38,1980,1709,1979,14,13.97%
2016-09,הצפון,4501,ע'ג'ר,יישוב,87,33,54,2,85,61,86,0,8.15%
2016-09,הצפון,530,עיילבון,יישוב,152,61,91,6,146,104,149,1,5.41%
2016-09,הצפון,511,עילוט,יישוב,276,104,172,2,274,230,273,0,9.59%
2016-09,הצפון,532,עין מאהל,יישוב,379,183,196,8,371,305,367,1,7.04%
2016-09,הצפון,4502,עין קנייא,יישוב,139,53,86,5,134,112,134,0,13.07%
2016-09,הצפון,7600,עכו,יישוב,2828,1255,1573,139,2689,2057,2742,58,10.34%
2016-09,הצפון,7700,עפולה,יישוב,1632,632,1000,198,1434,624,1546,107,6.02%
2016-09,הצפון,531,עראבה,יישוב,1475,630,845,26,1449,1305,1444,10,14.05%
2016-09,הצפון,535,פסוטה,יישוב,89,38,51,7,82,45,84,1,4.90%
2016-09,הצפון,536,פקיעין (בוקייעה),יישוב,129,69,60,6,123,78,121,5,4.30%
2016-09,הצפון,8000,צפת,יישוב,1141,565,576,101,1040,741,1077,23,7.99%
2016-09,הצפון,4100,קצרין,יישוב,197,71,126,32,165,89,195,3,4.83%
2016-09,הצפון,2800,קריית שמונה,יישוב,758,335,423,71,687,279,731,44,5.56%
2016-09,הצפון,543,ראמה,יישוב,247,100,147,18,229,170,238,0,6.11%
2016-09,הצפון,26,ראש פינה,יישוב,40,12,28,9,31,16,40,0,2.50%
2016-09,הצפון,542,ריינה,יישוב,505,212,293,9,496,381,490,12,7.19%
2016-09,הצפון,122,רמת ישי,יישוב,101,40,61,38,63,14,99,1,2.37%
2016-09,הצפון,913,שבלי - אום אל-גנם,יישוב,194,71,123,7,187,129,192,1,7.25%
2016-09,הצפון,812,שלומי,יישוב,217,86,131,12,205,104,203,5,5.64%
2016-09,הצפון,538,שעב,יישוב,501,192,309,6,495,451,493,4,15.98%
2016-09,הצפון,8800,שפרעם,יישוב,1497,605,892,45,1452,1214,1467,31,8.13%
2016-09,חיפה,1326,"בסמ""ה",יישוב,363,158,205,10,353,277,355,6,8.80%
2016-09,חיפה,2710,אום אל-פחם,יישוב,2871,1140,1731,35,2836,2399,2824,32,13.42%
2016-09,חיפה,1020,אור עקיבא,יישוב,472,190,282,53,419,128,452,18,4.44%
2016-09,חיפה,6000,באקה אל-גרביה,יישוב,543,240,303,13,530,349,540,21,4.61%
2016-09,חיפה,9800,בנימינה-גבעת עדה*,יישוב,191,81,110,59,132,43,191,4,2.62%
2016-09,חיפה,541,ג'סר א-זרקא,יישוב,324,181,143,4,320,196,324,13,5.41%
2016-09,חיפה,628,ג'ת,יישוב,193,87,106,4,189,113,192,6,3.64%
2016-09,חיפה,494,דאלית אל-כרמל,יישוב,448,172,276,15,433,244,417,8,5.05%
2016-09,חיפה,9300,זכרון יעקב,יישוב,268,127,141,100,168,38,266,1,2.38%
2016-09,חיפה,6500,חדרה,יישוב,2281,903,1378,244,2037,797,2133,36,4.24%
2016-09,חיפה,4000,חיפה,יישוב,5585,2637,2948,1120,4465,2761,5275,149,3.78%
2016-09,חיפה,1247,חריש,יישוב,37,16,21,6,31,11,35,0,2.18%
2016-09,חיפה,2100,טירת כרמל,יישוב,652,307,345,34,618,317,639,21,5.66%
2016-09,חיפה,654,כפר קרע,יישוב,378,178,200,14,364,234,373,13,4.36%
2016-09,חיפה,45,מ.א. אלונה,מועצה איזורית,30,15,15,9,21,2,30,0,2.81%
2016-09,חיפה,12,מ.א. זבולון,מועצה איזורית,226,103,123,31,195,133,223,0,4.00%
2016-09,חיפה,15,מ.א. חוף הכרמל,מועצה איזורית,326,158,168,120,206,52,322,0,2.28%
2016-09,חיפה,14,מ.א. מנשה,מועצה איזורית,233,103,130,61,172,68,229,0,2.86%
2016-09,חיפה,1327,מעלה עירון,יישוב,710,262,448,5,705,570,700,4,11.94%
2016-09,חיפה,2500,נשר,יישוב,445,204,241,99,346,157,430,10,3.35%
2016-09,חיפה,534,עספיא,יישוב,271,116,155,17,254,149,249,5,4.42%
2016-09,חיפה,637,ערערה,יישוב,526,235,291,13,513,337,519,10,6.38%
2016-09,חיפה,537,פוריידיס,יישוב,289,147,142,5,284,180,286,4,5.10%
2016-09,חיפה,7800,פרדס חנה-כרכור,יישוב,790,329,461,174,616,192,775,33,3.81%
2016-09,חיפה,6800,קריית אתא,יישוב,1499,694,805,117,1382,747,1458,45,4.78%
2016-09,חיפה,9500,קריית ביאליק,יישוב,997,392,605,120,877,441,970,31,4.52%
2016-09,חיפה,2300,קריית טבעון,יישוב,185,82,103,76,109,36,181,0,2.16%
2016-09,חיפה,9600,קריית ים,יישוב,1298,588,710,114,1184,730,1259,33,5.89%
2016-09,חיפה,8200,קריית מוצקין,יישוב,913,371,542,156,757,403,881,18,3.83%
2016-09,חיפה,922,רכסים,יישוב,162,65,97,14,148,68,145,1,4.06%
2016-09,ירושלים,472,אבו גוש,יישוב,229,109,120,7,222,177,224,2,7.27%
2016-09,ירושלים,2610,בית שמש,יישוב,1408,504,904,122,1286,437,1363,44,4.01%
2016-09,ירושלים,3000,ירושלים,יישוב,12001,5153,6848,1362,10639,7131,11672,152,3.92%
2016-09,ירושלים,26,מ.א. מטה יהודה,מועצה איזורית,528,237,291,129,399,119,517,0,2.16%
2016-09,ירושלים,1015,מבשרת ציון,יישוב,336,164,172,74,262,118,332,5,2.55%
2016-09,ירושלים,1137,קריית יערים,יישוב,44,17,27,12,32,10,44,0,3.09%
2016-09,תל אביב,2400,אור יהודה,יישוב,670,310,360,62,608,159,641,25,3.37%
2016-09,תל אביב,565,אזור,יישוב,170,81,89,27,143,25,169,9,2.57%
2016-09,תל אביב,6100,בני ברק,יישוב,2014,877,1137,90,1924,748,1895,21,3.29%
2016-09,תל אביב,6200,בת ים,יישוב,2631,1188,1443,366,2265,924,2491,84,3.54%
2016-09,תל אביב,6300,גבעתיים,יישוב,707,289,418,328,379,76,704,2,2.28%
2016-09,תל אביב,6400,הרצלייה,יישוב,1038,452,586,381,657,29,1027,26,2.10%
2016-09,תל אביב,6600,חולון,יישוב,2911,1257,1654,459,2452,638,2845,59,2.86%
2016-09,תל אביב,267,כפר שמריהו,יישוב,6,3,3,2,4,0,6,0,0.72%
2016-09,תל אביב,2620,קריית אונו,יישוב,386,146,240,178,208,33,384,0,2.00%
2016-09,תל אביב,8600,רמת גן,יישוב,1924,835,1089,642,1282,326,1884,22,2.40%
2016-09,תל אביב,2650,רמת השרון,יישוב,372,144,228,149,223,10,369,2,1.65%
2016-09,תל אביב,5000,תל אביב -יפו,יישוב,6927,3311,3616,2483,4444,1690,6781,91,2.67%
2016-10,אזור יהודה והשומרון,3760,אורנית,יישוב,75,41,34,27,48,3,75,0,1.55%
2016-10,אזור יהודה והשומרון,3750,אלפי מנשה,יישוב,85,30,55,28,57,1,85,2,1.93%
2016-10,אזור יהודה והשומרון,3560,אלקנה,יישוב,29,15,14,20,9,0,29,0,1.53%
2016-10,אזור יהודה והשומרון,3650,אפרת,יישוב,51,25,26,26,25,3,50,0,1.16%
2016-10,אזור יהודה והשומרון,3570,אריאל,יישוב,270,126,144,77,193,33,268,6,2.49%
2016-10,אזור יהודה והשומרון,3574,בית אל,יישוב,46,18,28,22,24,13,46,0,1.89%
2016-10,אזור יהודה והשומרון,3652,בית אריה,יישוב,37,16,21,5,32,1,37,0,1.39%
2016-10,אזור יהודה והשומרון,3780,ביתר עילית,יישוב,452,214,238,10,442,182,448,3,3.38%
2016-10,אזור יהודה והשומרון,3730,גבעת זאב,יישוב,165,76,89,33,132,37,163,0,2.10%
2016-10,אזור יהודה והשומרון,3769,הר אדר,יישוב,27,15,12,12,15,3,27,0,1.28%
2016-10,אזור יהודה והשומרון,76,מ.א. גוש עציון,מועצה איזורית,125,45,80,46,79,14,123,0,1.28%
2016-10,אזור יהודה והשומרון,78,מ.א. הר חברון,מועצה איזורית,84,35,49,36,48,4,83,0,2.37%
2016-10,אזור יהודה והשומרון,74,מ.א. מגילות ים המלח,מועצה איזורית,14,6,8,2,12,0,14,0,1.74%
2016-10,אזור יהודה והשומרון,73,מ.א. מטה בנימין,מועצה איזורית,552,265,287,176,376,110,543,0,2.17%
2016-10,אזור יהודה והשומרון,75,מ.א. ערבות הירדן,מועצה איזורית,57,30,27,20,37,5,57,0,2.34%
2016-10,אזור יהודה והשומרון,72,מ.א. שומרון,מועצה איזורית,334,154,180,124,210,33,329,0,1.95%
2016-10,אזור יהודה והשומרון,3797,מודיעין עילית,יישוב,408,105,303,20,388,23,408,2,2.90%
2016-10,אזור יהודה והשומרון,3616,מעלה אדומים,יישוב,543,223,320,91,452,172,537,10,2.62%
2016-10,אזור יהודה והשומרון,3608,מעלה אפרים,יישוב,32,16,16,1,31,12,32,0,3.86%
2016-10,אזור יהודה והשומרון,3660,עמנואל,יישוב,44,23,21,1,43,28,44,0,3.78%
2016-10,אזור יהודה והשומרון,3557,קדומים,יישוב,36,22,14,10,26,4,35,0,1.86%
2016-10,אזור יהודה והשומרון,3611,קריית ארבע,יישוב,82,42,40,14,68,41,81,2,2.49%
2016-10,אזור יהודה והשומרון,3640,קרני שומרון,יישוב,69,34,35,17,52,5,69,0,1.83%
2016-10,הדרום,31,אופקים,יישוב,865,359,506,54,811,478,839,23,6.31%
2016-10,הדרום,2600,אילת,יישוב,913,465,448,56,857,351,850,24,2.53%
2016-10,הדרום,70,אשדוד,יישוב,4920,1990,2930,626,4294,2274,4704,79,4.30%
2016-10,הדרום,7100,אשקלון,יישוב,3404,1385,2019,412,2992,1634,2982,30,4.22%
2016-10,הדרום,9000,באר שבע,יישוב,5148,2267,2881,666,4482,2875,4891,64,4.63%
2016-10,הדרום,2200,דימונה,יישוב,1604,709,895,88,1516,1100,1530,12,8.20%
2016-10,הדרום,1303,חורה,יישוב,514,201,313,0,514,466,501,1,12.42%
2016-10,הדרום,831,ירוחם,יישוב,382,181,201,20,362,213,363,6,7.53%
2016-10,הדרום,1059,כסיפה,יישוב,947,349,598,3,944,846,937,3,19.83%
2016-10,הדרום,1271,להבים,יישוב,53,20,33,26,27,3,53,0,1.46%
2016-10,הדרום,1060,לקיה,יישוב,615,275,340,0,615,539,602,4,14.32%
2016-10,הדרום,69,מ.א. אל קסום,מועצה איזורית,615,235,380,9,606,548,600,0,37.15%
2016-10,הדרום,38,מ.א. אשכול,מועצה איזורית,100,39,61,25,75,8,98,0,1.44%
2016-10,הדרום,33,מ.א. באר טוביה,מועצה איזורית,253,99,154,43,210,38,251,0,2.29%
2016-10,הדרום,41,מ.א. בני שמעון,מועצה איזורית,78,22,56,31,47,11,78,0,1.79%
2016-10,הדרום,54,מ.א. הערבה התיכונה,מועצה איזורית,18,8,10,6,12,1,18,0,0.99%
2016-10,הדרום,53,מ.א. חבל אילות,מועצה איזורית,20,7,13,2,18,0,20,0,0.85%
2016-10,הדרום,36,מ.א. חוף אשקלון,מועצה איזורית,206,76,130,29,177,40,199,0,2.41%
2016-10,הדרום,35,מ.א. יואב,מועצה איזורית,75,23,52,32,43,6,75,0,1.88%
2016-10,הדרום,50,מ.א. לכיש,מועצה איזורית,152,63,89,27,125,43,149,0,2.96%
2016-10,הדרום,42,מ.א. מרחבים,מועצה איזורית,161,50,111,31,130,29,159,0,2.69%
2016-10,הדרום,68,מ.א. נווה מדבר,מועצה איזורית,126,51,75,0,126,93,123,0,12.76%
2016-10,הדרום,48,מ.א. רמת נגב,מועצה איזורית,237,114,123,24,213,176,237,0,7.48%
2016-10,הדרום,39,מ.א. שדות נגב,מועצה איזורית,100,43,57,19,81,23,96,0,2.13%
2016-10,הדרום,37,מ.א. שער הנגב,מועצה איזורית,90,37,53,32,58,15,88,0,2.27%
2016-10,הדרום,34,מ.א. שפיר,מועצה איזורית,141,67,74,12,129,52,139,0,2.96%
2016-10,הדרום,51,מ.א. תמר,מועצה איזורית,10,5,5,2,8,1,10,0,1.58%
2016-10,הדרום,1268,מיתר,יישוב,78,29,49,34,44,4,77,0,1.72%
2016-10,הדרום,99,מצפה רמון,יישוב,230,88,142,19,211,154,221,3,8.08%
2016-10,הדרום,246,נתיבות,יישוב,858,360,498,45,813,399,814,22,5.53%
2016-10,הדרום,666,עומר,יישוב,44,15,29,15,29,1,44,0,1.05%
2016-10,הדרום,2560,ערד,יישוב,628,292,336,71,557,333,595,22,4.86%
2016-10,הדרום,1192,ערערה-בנגב,יישוב,1032,428,604,4,1028,936,1011,14,23.35%
2016-10,הדרום,2630,קריית גת,יישוב,1498,608,890,86,1412,731,1439,16,5.10%
2016-10,הדרום,1034,קריית מלאכי,יישוב,675,297,378,18,657,317,649,25,5.62%
2016-10,הדרום,1161,רהט,יישוב,2355,937,1418,15,2340,1935,2322,33,11.83%
2016-10,הדרום,1286,שגב-שלום,יישוב,339,117,222,1,338,288,330,4,12.02%
2016-10,הדרום,1031,שדרות,יישוב,889,384,505,63,826,511,817,14,6.11%
2016-10,הדרום,1054,תל שבע,יישוב,704,299,405,1,703,651,686,6,14.37%
2016-10,המרכז,1066,"בני עי""ש",יישוב,129,55,74,21,108,42,125,3,3.14%
2016-10,המרכז,182,אבן יהודה,יישוב,151,74,77,56,95,17,151,1,2.19%
2016-10,המרכז,41,אליכין,יישוב,58,32,26,10,48,18,57,0,2.95%
2016-10,המרכז,1309,אלעד,יישוב,348,135,213,22,326,33,340,1,2.62%
2016-10,המרכז,2530,באר יעקב,יישוב,226,84,142,70,156,41,223,1,2.23%
2016-10,המרכז,466,בית דגן,יישוב,107,56,51,14,93,32,106,0,2.85%
2016-10,המרכז,681,גבעת שמואל,יישוב,211,108,103,68,143,43,205,1,1.70%
2016-10,המרכז,2550,גדרה,יישוב,282,108,174,57,225,67,278,4,2.24%
2016-10,המרכז,627,ג'לג'וליה,יישוב,77,29,48,0,77,50,76,0,2.02%
2016-10,המרכז,166,גן יבנה,יישוב,266,104,162,49,217,52,264,2,2.19%
2016-10,המרכז,229,גני תקווה,יישוב,176,78,98,77,99,23,176,0,1.95%
2016-10,המרכז,9700,הוד השרון,יישוב,574,242,332,239,335,36,573,4,1.85%
2016-10,המרכז,1290,זמר,יישוב,122,43,79,3,119,79,121,3,4.10%
2016-10,המרכז,2730,טייבה,יישוב,1118,501,617,28,1090,839,959,19,5.50%
2016-10,המרכז,2720,טירה,יישוב,177,83,94,5,172,69,171,9,1.50%
2016-10,המרכז,2660,יבנה,יישוב,667,290,377,132,535,196,658,3,2.70%
2016-10,המרכז,9400,יהוד,יישוב,328,144,184,79,249,47,321,0,2.00%
2016-10,המרכז,1224,כוכב יאיר,יישוב,76,41,35,43,33,0,76,0,1.32%
2016-10,המרכז,633,כפר ברא,יישוב,19,8,11,2,17,13,17,0,1.19%
2016-10,המרכז,168,כפר יונה,יישוב,275,126,149,49,226,40,274,1,2.44%
2016-10,המרכז,6900,כפר סבא,יישוב,1007,448,559,397,610,91,988,15,1.87%
2016-10,המרכז,634,כפר קאסם,יישוב,205,96,109,12,193,111,200,5,2.17%
2016-10,המרכז,7000,לוד,יישוב,1577,728,849,114,1463,872,1534,14,4.35%
2016-10,המרכז,28,מ.א. ברנר,מועצה איזורית,54,21,33,26,28,3,54,0,1.34%
2016-10,המרכז,32,מ.א. גדרות,מועצה איזורית,23,10,13,10,13,2,23,0,0.94%
2016-10,המרכז,30,מ.א. גזר,מועצה איזורית,275,131,144,96,179,26,273,0,2.07%
2016-10,המרכז,27,מ.א. גן רווה,מועצה איזורית,52,23,29,26,26,5,52,0,1.78%
2016-10,המרכז,20,מ.א. דרום השרון,מועצה איזורית,272,117,155,120,152,13,269,0,1.72%
2016-10,המרכז,29,מ.א. חבל יבנה,מועצה איזורית,34,14,20,12,22,3,33,0,1.33%
2016-10,המרכז,25,מ.א. חבל מודיעין,מועצה איזורית,196,80,116,68,128,14,195,0,1.82%
2016-10,המרכז,19,מ.א. חוף השרון,מועצה איזורית,94,45,49,42,52,2,93,0,1.66%
2016-10,המרכז,18,מ.א. לב השרון,מועצה איזורית,230,109,121,61,169,26,226,1,2.05%
2016-10,המרכז,31,מ.א. נחל שורק,מועצה איזורית,57,26,31,14,43,7,56,23,1.39%
2016-10,המרכז,16,מ.א. עמק חפר,מועצה איזורית,332,137,195,138,194,16,329,0,1.67%
2016-10,המרכז,40,מ.א. עמק לוד,מועצה איזורית,124,57,67,34,90,13,123,0,1.99%
2016-10,המרכז,1200,מודיעין-מכבים-רעות*,יישוב,759,346,413,317,442,44,754,6,1.68%
2016-10,המרכז,28,מזכרת בתיה,יישוב,137,60,77,59,78,23,134,0,1.79%
2016-10,המרכז,7200,נס ציונה,יישוב,569,252,317,152,417,146,561,2,2.35%
2016-10,המרכז,7400,נתניה,יישוב,3600,1657,1943,467,3133,1183,3524,46,3.35%
2016-10,המרכז,587,סביון*,יישוב,14,3,11,7,7,0,14,0,0.71%
2016-10,המרכז,171,פרדסייה,יישוב,79,33,46,20,59,6,79,0,2.08%
2016-10,המרכז,7900,פתח תקווה,יישוב,3310,1476,1834,790,2520,825,3253,15,2.59%
2016-10,המרכז,195,קדימה-צורן,יישוב,250,105,145,81,169,37,249,0,2.24%
2016-10,המרכז,638,קלנסווה,יישוב,396,200,196,8,388,293,364,6,4.17%
2016-10,המרכז,469,קריית עקרון,יישוב,228,104,124,29,199,93,223,1,3.71%
2016-10,המרכז,2640,ראש העין,יישוב,604,292,312,98,506,124,596,12,2.36%
2016-10,המרכז,8300,ראשון לציון,יישוב,3684,1566,2118,769,2915,1037,3652,27,2.63%
2016-10,המרכז,8400,רחובות,יישוב,2036,908,1128,503,1533,653,1985,23,2.89%
2016-10,המרכז,8500,רמלה,יישוב,1372,653,719,111,1261,585,1315,22,3.50%
2016-10,המרכז,8700,רעננה,יישוב,602,285,317,267,335,44,594,2,1.61%
2016-10,המרכז,1304,שוהם,יישוב,157,58,99,60,97,8,156,0,1.34%
2016-10,המרכז,154,תל מונד,יישוב,119,51,68,35,84,14,119,0,1.85%
2016-10,הצפון,473,אבו סנאן,יישוב,564,234,330,3,561,459,553,1,9.39%
2016-10,הצפון,478,אכסאל,יישוב,464,210,254,8,456,393,458,2,8.01%
2016-10,הצפון,529,אעבלין,יישוב,422,172,250,6,416,350,419,7,7.33%
2016-10,הצפון,482,בועיינה-נוג'ידאת,יישוב,252,118,134,5,247,199,249,0,6.55%
2016-10,הצפון,4001,בוקעאתא,יישוב,369,144,225,3,366,297,354,1,12.85%
2016-10,הצפון,998,ביר אל-מכסור,יישוב,321,133,188,3,318,255,320,2,8.36%
2016-10,הצפון,480,בית ג'ן,יישוב,349,93,256,9,340,241,338,1,6.04%
2016-10,הצפון,9200,בית שאן,יישוב,703,299,404,24,679,329,682,33,6.68%
2016-10,הצפון,944,בסמת טבעון,יישוב,145,67,78,2,143,112,139,3,4.29%
2016-10,הצפון,483,בענה,יישוב,303,131,172,7,296,252,296,0,8.68%
2016-10,הצפון,1292,ג'דיידה-מכר,יישוב,1064,455,609,3,1061,887,1048,4,11.28%
2016-10,הצפון,485,ג'ולס,יישוב,197,59,138,1,196,123,196,3,6.33%
2016-10,הצפון,487,ג'ש (גוש חלב),יישוב,57,19,38,6,51,28,57,1,3.45%
2016-10,הצפון,489,דבורייה,יישוב,296,117,179,16,280,214,292,0,6.83%
2016-10,הצפון,490,דייר אל-אסד,יישוב,311,141,170,12,299,260,299,1,5.76%
2016-10,הצפון,492,דייר חנא,יישוב,589,247,342,6,583,473,579,3,11.91%
2016-10,הצפון,975,זרזיר,יישוב,216,93,123,5,211,144,210,4,6.44%
2016-10,הצפון,496,חורפיש,יישוב,101,40,61,7,94,57,97,2,3.40%
2016-10,הצפון,2034,חצור הגלילית,יישוב,231,86,145,20,211,116,222,1,4.57%
2016-10,הצפון,6700,טבריה,יישוב,1323,587,736,62,1261,692,1150,35,5.30%
2016-10,הצפון,962,טובא-זנגרייה,יישוב,287,138,149,5,282,216,276,1,9.27%
2016-10,הצפון,498,טורעאן,יישוב,381,158,223,11,370,324,373,3,6.57%
2016-10,הצפון,8900,טמרה,יישוב,1293,566,727,19,1274,1122,1276,6,9.10%
2016-10,הצפון,1295,יאנוח-ג'ת,יישוב,113,31,82,6,107,78,109,1,3.75%
2016-10,הצפון,46,יבנאל,יישוב,87,45,42,4,83,60,64,0,4.11%
2016-10,הצפון,29,יסוד המעלה,יישוב,20,6,14,9,11,4,19,0,2.21%
2016-10,הצפון,499,יפיע,יישוב,512,201,311,16,496,394,506,0,6.41%
2016-10,הצפון,240,יקנעם עילית,יישוב,376,145,231,74,302,100,372,13,3.08%
2016-10,הצפון,502,ירכא,יישוב,453,187,266,0,453,349,448,2,7.00%
2016-10,הצפון,504,כאבול,יישוב,463,207,256,6,457,399,457,0,9.35%
2016-10,הצפון,505,כאוכב אבו אל-היג'א,יישוב,201,82,119,1,200,169,197,1,11.41%
2016-10,הצפון,1296,כסרא-סמיע,יישוב,164,67,97,3,161,107,155,1,4.46%
2016-10,הצפון,978,כעביה-טבאש-חג'אג'רה,יישוב,143,57,86,3,140,106,140,1,6.01%
2016-10,הצפון,1263,כפר ורדים,יישוב,59,28,31,27,32,6,59,0,1.92%
2016-10,הצפון,507,כפר יאסיף,יישוב,406,168,238,4,402,288,399,0,7.81%
2016-10,הצפון,508,כפר כמא,יישוב,50,21,29,3,47,24,50,1,2.97%
2016-10,הצפון,509,כפר כנא,יישוב,783,351,432,20,763,651,758,6,8.76%
2016-10,הצפון,510,כפר מנדא,יישוב,667,317,350,9,658,547,654,2,9.13%
2016-10,הצפון,47,כפר תבור,יישוב,35,14,21,16,19,1,34,0,1.49%
2016-10,הצפון,1139,כרמיאל,יישוב,1356,540,816,255,1101,656,1270,21,4.90%
2016-10,הצפון,65,מ.א. אל-בטוף,מועצה איזורית,279,112,167,5,274,226,267,0,9.18%
2016-10,הצפון,66,מ.א. בוסתן אל-מרג',מועצה איזורית,31,7,24,0,31,25,30,0,0.98%
2016-10,הצפון,71,מ.א. גולן,מועצה איזורית,175,87,88,47,128,20,172,0,2.00%
2016-10,הצפון,8,מ.א. הגלבוע,מועצה איזורית,612,240,372,60,552,350,604,0,4.19%
2016-10,הצפון,1,מ.א. הגליל העליון,מועצה איזורית,164,48,116,74,90,13,163,0,1.85%
2016-10,הצפון,3,מ.א. הגליל התחתון,מועצה איזורית,97,48,49,23,74,10,95,0,1.62%
2016-10,הצפון,55,מ.א. מבואות החרמון,מועצה איזורית,90,38,52,14,76,13,90,0,2.25%
2016-10,הצפון,13,מ.א. מגידו,מועצה איזורית,83,31,52,31,52,8,83,0,1.46%
2016-10,הצפון,4,מ.א. מטה אשר,מועצה איזורית,412,181,231,73,339,160,406,0,2.96%
2016-10,הצפון,52,מ.א. מעלה יוסף,מועצה איזורית,172,85,87,16,156,43,170,0,3.08%
2016-10,הצפון,2,מ.א. מרום הגליל,מועצה איזורית,227,107,120,32,195,101,220,0,3.22%
2016-10,הצפון,56,מ.א. משגב,מועצה איזורית,585,236,349,128,457,286,569,0,4.38%
2016-10,הצפון,6,מ.א. עמק הירדן,מועצה איזורית,131,61,70,27,104,32,118,0,1.75%
2016-10,הצפון,7,מ.א. עמק המעיינות,מועצה איזורית,175,77,98,36,139,37,171,0,2.64%
2016-10,הצפון,9,מ.א. עמק יזרעאל,מועצה איזורית,361,157,204,168,193,37,356,0,1.84%
2016-10,הצפון,481,מגאר,יישוב,1210,494,716,16,1194,1011,1171,8,12.02%
2016-10,הצפון,516,מג'ד אל-כרום,יישוב,455,189,266,7,448,324,437,0,6.59%
2016-10,הצפון,65,מגדל,יישוב,43,17,26,0,43,18,40,0,4.20%
2016-10,הצפון,874,מגדל העמק,יישוב,682,295,387,70,612,287,638,18,4.74%
2016-10,הצפון,4201,מג'דל שמס,יישוב,392,150,242,11,381,308,378,2,7.75%
2016-10,הצפון,517,מזרעה,יישוב,145,55,90,1,144,110,139,3,7.05%
2016-10,הצפון,43,מטולה,יישוב,13,8,5,5,8,4,13,0,1.25%
2016-10,הצפון,4203,מסעדה,יישוב,184,61,123,4,180,144,174,2,10.34%
2016-10,הצפון,518,מעיליא,יישוב,52,23,29,3,49,20,51,0,3.15%
2016-10,הצפון,1063,מעלות-תרשיחא,יישוב,689,336,353,82,607,368,660,17,5.63%
2016-10,הצפון,520,משהד,יישוב,209,88,121,4,205,164,200,1,6.25%
2016-10,הצפון,9100,נהרייה,יישוב,1586,727,859,152,1434,874,1515,38,4.92%
2016-10,הצפון,522,נחף,יישוב,343,152,191,11,332,283,331,1,6.56%
2016-10,הצפון,7300,נצרת,יישוב,2654,1116,1538,120,2534,2059,2626,6,7.65%
2016-10,הצפון,1061,נצרת עילית,יישוב,1307,569,738,143,1164,674,1160,42,5.04%
2016-10,הצפון,525,סאג'ור,יישוב,102,33,69,5,97,75,98,1,4.98%
2016-10,הצפון,7500,סח'נין,יישוב,1919,817,1102,30,1889,1632,1885,10,13.40%
2016-10,הצפון,4501,ע'ג'ר,יישוב,83,29,54,0,83,62,81,1,7.71%
2016-10,הצפון,530,עיילבון,יישוב,159,69,90,12,147,106,156,0,5.65%
2016-10,הצפון,511,עילוט,יישוב,270,103,167,3,267,217,265,5,9.33%
2016-10,הצפון,532,עין מאהל,יישוב,359,169,190,9,350,289,348,1,6.70%
2016-10,הצפון,4502,עין קנייא,יישוב,138,56,82,5,133,108,135,2,13.16%
2016-10,הצפון,7600,עכו,יישוב,2616,1186,1430,118,2498,1941,2540,16,9.65%
2016-10,הצפון,7700,עפולה,יישוב,1334,541,793,168,1166,571,1262,39,4.97%
2016-10,הצפון,531,עראבה,יישוב,1392,591,801,17,1375,1241,1368,7,13.41%
2016-10,הצפון,535,פסוטה,יישוב,79,34,45,7,72,45,75,0,4.40%
2016-10,הצפון,536,פקיעין (בוקייעה),יישוב,127,63,64,1,126,79,120,1,4.26%
2016-10,הצפון,8000,צפת,יישוב,1014,511,503,94,920,690,947,17,7.10%
2016-10,הצפון,4100,קצרין,יישוב,170,66,104,27,143,81,168,0,4.19%
2016-10,הצפון,2800,קריית שמונה,יישוב,644,284,360,63,581,264,621,10,4.76%
2016-10,הצפון,543,ראמה,יישוב,253,110,143,18,235,174,242,1,6.20%
2016-10,הצפון,26,ראש פינה,יישוב,44,13,31,9,35,16,43,0,2.69%
2016-10,הצפון,542,ריינה,יישוב,480,212,268,9,471,372,463,6,6.82%
2016-10,הצפון,122,רמת ישי,יישוב,87,36,51,31,56,13,86,1,2.07%
2016-10,הצפון,913,שבלי - אום אל-גנם,יישוב,188,71,117,6,182,127,186,1,7.04%
2016-10,הצפון,812,שלומי,יישוב,196,78,118,15,181,98,187,2,5.21%
2016-10,הצפון,538,שעב,יישוב,478,186,292,4,474,427,472,1,15.40%
2016-10,הצפון,8800,שפרעם,יישוב,1389,563,826,36,1353,1128,1368,15,7.62%
2016-10,חיפה,1326,"בסמ""ה",יישוב,345,154,191,7,338,270,338,2,8.41%
2016-10,חיפה,2710,אום אל-פחם,יישוב,2736,1106,1630,29,2707,2332,2691,11,12.87%
2016-10,חיפה,1020,אור עקיבא,יישוב,406,175,231,39,367,114,389,9,3.84%
2016-10,חיפה,6000,באקה אל-גרביה,יישוב,514,229,285,10,504,351,511,9,4.37%
2016-10,חיפה,9800,בנימינה-גבעת עדה*,יישוב,154,62,92,50,104,40,154,1,2.12%
2016-10,חיפה,541,ג'סר א-זרקא,יישוב,278,148,130,2,276,179,277,4,4.66%
2016-10,חיפה,628,ג'ת,יישוב,177,85,92,5,172,101,177,2,3.37%
2016-10,חיפה,494,דאלית אל-כרמל,יישוב,415,160,255,15,400,238,390,2,4.74%
2016-10,חיפה,9300,זכרון יעקב,יישוב,253,116,137,95,158,37,249,2,2.24%
2016-10,חיפה,6500,חדרה,יישוב,1973,805,1168,227,1746,737,1847,23,3.69%
2016-10,חיפה,4000,חיפה,יישוב,5066,2436,2630,1030,4036,2566,4788,64,3.44%
2016-10,חיפה,1247,חריש,יישוב,34,13,21,7,27,7,32,0,2.00%
2016-10,חיפה,2100,טירת כרמל,יישוב,572,288,284,30,542,293,561,9,5.01%
2016-10,חיפה,654,כפר קרע,יישוב,359,162,197,10,349,225,354,4,4.15%
2016-10,חיפה,45,מ.א. אלונה,מועצה איזורית,28,12,16,7,21,2,28,0,2.62%
2016-10,חיפה,12,מ.א. זבולון,מועצה איזורית,228,109,119,34,194,132,221,0,3.97%
2016-10,חיפה,15,מ.א. חוף הכרמל,מועצה איזורית,275,131,144,103,172,46,272,0,1.92%
2016-10,חיפה,14,מ.א. מנשה,מועצה איזורית,216,93,123,60,156,60,213,0,2.66%
2016-10,חיפה,1327,מעלה עירון,יישוב,671,257,414,7,664,551,660,2,11.33%
2016-10,חיפה,2500,נשר,יישוב,385,175,210,85,300,129,374,1,2.93%
2016-10,חיפה,534,עספיא,יישוב,277,121,156,17,260,147,250,1,4.43%
2016-10,חיפה,637,ערערה,יישוב,484,209,275,9,475,324,477,9,5.89%
2016-10,חיפה,537,פוריידיס,יישוב,267,136,131,6,261,162,265,3,4.75%
2016-10,חיפה,7800,פרדס חנה-כרכור,יישוב,685,294,391,152,533,162,671,18,3.31%
2016-10,חיפה,6800,קריית אתא,יישוב,1308,604,704,112,1196,686,1281,13,4.23%
2016-10,חיפה,9500,קריית ביאליק,יישוב,884,355,529,113,771,395,859,10,4.02%
2016-10,חיפה,2300,קריית טבעון,יישוב,162,75,87,70,92,29,161,0,1.93%
2016-10,חיפה,9600,קריית ים,יישוב,1191,533,658,110,1081,687,1150,17,5.40%
2016-10,חיפה,8200,קריית מוצקין,יישוב,810,326,484,152,658,362,780,14,3.40%
2016-10,חיפה,922,רכסים,יישוב,133,57,76,11,122,61,124,1,3.49%
2016-10,ירושלים,472,אבו גוש,יישוב,221,112,109,9,212,169,218,3,7.09%
2016-10,ירושלים,2610,בית שמש,יישוב,1116,429,687,111,1005,385,1088,12,3.23%
2016-10,ירושלים,3000,ירושלים,יישוב,10855,4781,6074,1225,9630,6799,10586,56,3.56%
2016-10,ירושלים,26,מ.א. מטה יהודה,מועצה איזורית,457,217,240,118,339,107,448,0,1.87%
2016-10,ירושלים,1015,מבשרת ציון,יישוב,288,143,145,60,228,109,281,2,2.17%
2016-10,ירושלים,1137,קריית יערים,יישוב,40,19,21,8,32,14,40,0,2.82%
2016-10,תל אביב,2400,אור יהודה,יישוב,560,264,296,58,502,152,541,5,2.86%
2016-10,תל אביב,565,אזור,יישוב,146,72,74,27,119,25,145,2,2.22%
2016-10,תל אביב,6100,בני ברק,יישוב,1679,787,892,87,1592,709,1568,10,2.74%
2016-10,תל אביב,6200,בת ים,יישוב,2389,1102,1287,318,2071,873,2270,24,3.24%
2016-10,תל אביב,6300,גבעתיים,יישוב,655,291,364,307,348,73,651,0,2.11%
2016-10,תל אביב,6400,הרצלייה,יישוב,933,403,530,359,574,22,930,4,1.91%
2016-10,תל אביב,6600,חולון,יישוב,2622,1177,1445,419,2203,585,2579,33,2.60%
2016-10,תל אביב,267,כפר שמריהו,יישוב,8,4,4,3,5,0,8,0,0.95%
2016-10,תל אביב,2620,קריית אונו,יישוב,360,138,222,157,203,35,357,1,1.86%
2016-10,תל אביב,8600,רמת גן,יישוב,1749,789,960,609,1140,285,1718,10,2.19%
2016-10,תל אביב,2650,רמת השרון,יישוב,318,126,192,133,185,9,317,1,1.42%
2016-10,תל אביב,5000,תל אביב -יפו,יישוב,6372,3087,3285,2303,4069,1561,6265,39,2.47%
2016-11,אזור יהודה והשומרון,3760,אורנית,יישוב,96,51,45,30,66,5,96,1,1.97%
2016-11,אזור יהודה והשומרון,3750,אלפי מנשה,יישוב,106,40,66,31,75,0,105,2,2.37%
2016-11,אזור יהודה והשומרון,3560,אלקנה,יישוב,33,17,16,22,11,1,33,0,1.74%
2016-11,אזור יהודה והשומרון,3650,אפרת,יישוב,61,34,27,28,33,3,61,3,1.41%
2016-11,אזור יהודה והשומרון,3570,אריאל,יישוב,313,145,168,80,233,32,310,14,2.87%
2016-11,אזור יהודה והשומרון,3574,בית אל,יישוב,55,22,33,28,27,13,55,0,2.26%
2016-11,אזור יהודה והשומרון,3652,בית אריה,יישוב,45,23,22,6,39,0,45,1,1.68%
2016-11,אזור יהודה והשומרון,3780,ביתר עילית,יישוב,496,238,258,7,489,186,493,3,3.71%
2016-11,אזור יהודה והשומרון,3730,גבעת זאב,יישוב,197,83,114,47,150,36,195,2,2.51%
2016-11,אזור יהודה והשומרון,3769,הר אדר,יישוב,28,15,13,12,16,3,28,1,1.32%
2016-11,אזור יהודה והשומרון,76,מ.א. גוש עציון,מועצה איזורית,156,63,93,56,100,17,154,0,1.60%
2016-11,אזור יהודה והשומרון,78,מ.א. הר חברון,מועצה איזורית,84,39,45,35,49,4,83,0,2.37%
2016-11,אזור יהודה והשומרון,74,מ.א. מגילות ים המלח,מועצה איזורית,15,7,8,2,13,0,15,0,1.87%
2016-11,אזור יהודה והשומרון,73,מ.א. מטה בנימין,מועצה איזורית,596,303,293,178,418,125,588,0,2.34%
2016-11,אזור יהודה והשומרון,75,מ.א. ערבות הירדן,מועצה איזורית,53,29,24,21,32,5,53,0,2.18%
2016-11,אזור יהודה והשומרון,72,מ.א. שומרון,מועצה איזורית,373,170,203,136,237,32,366,0,2.17%
2016-11,אזור יהודה והשומרון,3797,מודיעין עילית,יישוב,431,124,307,23,408,32,426,5,3.02%
2016-11,אזור יהודה והשומרון,3616,מעלה אדומים,יישוב,617,255,362,101,516,171,606,11,2.95%
2016-11,אזור יהודה והשומרון,3608,מעלה אפרים,יישוב,28,13,15,1,27,11,28,0,3.40%
2016-11,אזור יהודה והשומרון,3660,עמנואל,יישוב,47,26,21,3,44,29,47,2,4.03%
2016-11,אזור יהודה והשומרון,3557,קדומים,יישוב,36,20,16,10,26,3,35,0,1.86%
2016-11,אזור יהודה והשומרון,3611,קריית ארבע,יישוב,91,49,42,14,77,46,90,3,2.75%
2016-11,אזור יהודה והשומרון,3640,קרני שומרון,יישוב,78,36,42,17,61,6,76,2,2.01%
2016-11,הדרום,31,אופקים,יישוב,893,381,512,49,844,483,858,44,6.45%
2016-11,הדרום,2600,אילת,יישוב,1020,516,504,61,959,380,955,57,2.83%
2016-11,הדרום,70,אשדוד,יישוב,5312,2145,3167,658,4654,2365,5073,146,4.63%
2016-11,הדרום,7100,אשקלון,יישוב,3612,1508,2104,417,3195,1728,3168,71,4.47%
2016-11,הדרום,9000,באר שבע,יישוב,5645,2547,3098,757,4888,3004,5348,134,5.05%
2016-11,הדרום,2200,דימונה,יישוב,1759,779,980,97,1662,1144,1672,58,8.90%
2016-11,הדרום,1303,חורה,יישוב,565,226,339,1,564,502,553,11,13.53%
2016-11,הדרום,831,ירוחם,יישוב,405,194,211,20,385,222,383,30,7.91%
2016-11,הדרום,1059,כסיפה,יישוב,992,380,612,2,990,873,983,15,20.60%
2016-11,הדרום,1271,להבים,יישוב,57,18,39,29,28,4,57,0,1.57%
2016-11,הדרום,1060,לקיה,יישוב,686,302,384,5,681,587,669,13,15.67%
2016-11,הדרום,69,מ.א. אל קסום,מועצה איזורית,655,260,395,11,644,577,640,0,39.60%
2016-11,הדרום,38,מ.א. אשכול,מועצה איזורית,110,39,71,34,76,7,104,0,1.53%
2016-11,הדרום,33,מ.א. באר טוביה,מועצה איזורית,260,102,158,43,217,40,257,0,2.35%
2016-11,הדרום,41,מ.א. בני שמעון,מועצה איזורית,83,27,56,29,54,11,83,1,1.90%
2016-11,הדרום,54,מ.א. הערבה התיכונה,מועצה איזורית,22,11,11,7,15,1,22,0,1.21%
2016-11,הדרום,53,מ.א. חבל אילות,מועצה איזורית,24,9,15,3,21,1,24,1,1.02%
2016-11,הדרום,36,מ.א. חוף אשקלון,מועצה איזורית,213,77,136,27,186,45,205,0,2.48%
2016-11,הדרום,35,מ.א. יואב,מועצה איזורית,85,27,58,33,52,6,84,0,2.11%
2016-11,הדרום,50,מ.א. לכיש,מועצה איזורית,154,63,91,24,130,43,153,0,3.04%
2016-11,הדרום,42,מ.א. מרחבים,מועצה איזורית,171,58,113,29,142,28,169,0,2.86%
2016-11,הדרום,68,מ.א. נווה מדבר,מועצה איזורית,123,49,74,1,122,90,122,0,12.66%
2016-11,הדרום,48,מ.א. רמת נגב,מועצה איזורית,255,132,123,24,231,187,254,1,8.01%
2016-11,הדרום,39,מ.א. שדות נגב,מועצה איזורית,108,49,59,18,90,24,103,0,2.28%
2016-11,הדרום,37,מ.א. שער הנגב,מועצה איזורית,105,46,59,37,68,17,101,0,2.60%
2016-11,הדרום,34,מ.א. שפיר,מועצה איזורית,156,71,85,16,140,53,153,0,3.26%
2016-11,הדרום,51,מ.א. תמר,מועצה איזורית,11,5,6,3,8,1,11,0,1.74%
2016-11,הדרום,1268,מיתר,יישוב,87,33,54,39,48,4,87,0,1.94%
2016-11,הדרום,99,מצפה רמון,יישוב,242,96,146,15,227,159,231,8,8.42%
2016-11,הדרום,246,נתיבות,יישוב,890,391,499,47,843,416,841,51,5.70%
2016-11,הדרום,666,עומר,יישוב,60,23,37,21,39,4,58,0,1.37%
2016-11,הדרום,2560,ערד,יישוב,678,321,357,64,614,352,642,45,5.23%
2016-11,הדרום,1192,ערערה-בנגב,יישוב,1068,454,614,5,1063,944,1051,13,24.06%
2016-11,הדרום,2630,קריית גת,יישוב,1643,663,980,95,1548,760,1564,53,5.52%
2016-11,הדרום,1034,קריית מלאכי,יישוב,774,342,432,23,751,340,742,66,6.37%
2016-11,הדרום,1161,רהט,יישוב,2533,1052,1481,13,2520,1969,2493,69,12.59%
2016-11,הדרום,1286,שגב-שלום,יישוב,362,133,229,2,360,302,350,5,12.66%
2016-11,הדרום,1031,שדרות,יישוב,934,417,517,65,869,513,859,34,6.40%
2016-11,הדרום,1054,תל שבע,יישוב,780,337,443,1,779,699,754,9,15.57%
2016-11,המרכז,1066,"בני עי""ש",יישוב,133,62,71,19,114,42,129,7,3.24%
2016-11,המרכז,182,אבן יהודה,יישוב,159,83,76,50,109,18,158,2,2.29%
2016-11,המרכז,41,אליכין,יישוב,64,35,29,11,53,18,62,1,3.20%
2016-11,המרכז,1309,אלעד,יישוב,358,138,220,26,332,41,345,6,2.66%
2016-11,המרכז,2530,באר יעקב,יישוב,248,97,151,72,176,42,247,9,2.47%
2016-11,המרכז,466,בית דגן,יישוב,115,62,53,14,101,30,113,1,3.03%
2016-11,המרכז,681,גבעת שמואל,יישוב,243,121,122,76,167,43,237,2,1.96%
2016-11,המרכז,2550,גדרה,יישוב,317,124,193,68,249,77,304,14,2.44%
2016-11,המרכז,627,ג'לג'וליה,יישוב,96,37,59,2,94,58,88,2,2.33%
2016-11,המרכז,166,גן יבנה,יישוב,305,123,182,49,256,58,301,5,2.49%
2016-11,המרכז,229,גני תקווה,יישוב,188,79,109,80,108,22,188,4,2.08%
2016-11,המרכז,9700,הוד השרון,יישוב,625,277,348,262,363,36,621,4,2.00%
2016-11,המרכז,1290,זמר,יישוב,144,53,91,3,141,92,141,6,4.75%
2016-11,המרכז,2730,טייבה,יישוב,1177,540,637,29,1148,856,1009,31,5.77%
2016-11,המרכז,2720,טירה,יישוב,196,97,99,11,185,66,189,18,1.66%
2016-11,המרכז,2660,יבנה,יישוב,731,329,402,139,592,199,722,20,2.96%
2016-11,המרכז,9400,יהוד,יישוב,361,161,200,91,270,48,356,7,2.22%
2016-11,המרכז,1224,כוכב יאיר,יישוב,87,46,41,52,35,1,86,2,1.49%
2016-11,המרכז,633,כפר ברא,יישוב,18,8,10,2,16,11,18,0,1.26%
2016-11,המרכז,168,כפר יונה,יישוב,302,136,166,49,253,43,299,0,2.65%
2016-11,המרכז,6900,כפר סבא,יישוב,1114,500,614,423,691,93,1092,33,2.06%
2016-11,המרכז,634,כפר קאסם,יישוב,223,100,123,13,210,122,216,4,2.34%
2016-11,המרכז,7000,לוד,יישוב,1745,798,947,118,1627,916,1705,40,4.81%
2016-11,המרכז,28,מ.א. ברנר,מועצה איזורית,69,28,41,30,39,3,69,4,1.70%
2016-11,המרכז,32,מ.א. גדרות,מועצה איזורית,34,16,18,16,18,1,34,0,1.39%
2016-11,המרכז,30,מ.א. גזר,מועצה איזורית,302,146,156,106,196,33,299,0,2.27%
2016-11,המרכז,27,מ.א. גן רווה,מועצה איזורית,54,24,30,23,31,5,54,0,1.85%
2016-11,המרכז,20,מ.א. דרום השרון,מועצה איזורית,311,129,182,130,181,12,306,0,1.95%
2016-11,המרכז,29,מ.א. חבל יבנה,מועצה איזורית,38,15,23,13,25,2,38,0,1.52%
2016-11,המרכז,25,מ.א. חבל מודיעין,מועצה איזורית,211,85,126,77,134,15,209,0,1.95%
2016-11,המרכז,19,מ.א. חוף השרון,מועצה איזורית,97,43,54,47,50,3,97,0,1.73%
2016-11,המרכז,18,מ.א. לב השרון,מועצה איזורית,270,129,141,65,205,34,263,0,2.39%
2016-11,המרכז,31,מ.א. נחל שורק,מועצה איזורית,59,29,30,13,46,7,57,44,1.41%
2016-11,המרכז,16,מ.א. עמק חפר,מועצה איזורית,378,161,217,152,226,13,375,0,1.91%
2016-11,המרכז,40,מ.א. עמק לוד,מועצה איזורית,126,53,73,34,92,13,125,0,2.03%
2016-11,המרכז,1200,מודיעין-מכבים-רעות*,יישוב,846,391,455,330,516,55,833,4,1.85%
2016-11,המרכז,28,מזכרת בתיה,יישוב,155,60,95,61,94,22,150,4,2.00%
2016-11,המרכז,7200,נס ציונה,יישוב,603,276,327,157,446,154,590,10,2.47%
2016-11,המרכז,7400,נתניה,יישוב,3904,1829,2075,478,3426,1276,3812,66,3.61%
2016-11,המרכז,587,סביון*,יישוב,16,5,11,6,10,1,16,0,0.81%
2016-11,המרכז,171,פרדסייה,יישוב,75,30,45,22,53,6,75,0,1.97%
2016-11,המרכז,7900,פתח תקווה,יישוב,3633,1603,2030,852,2781,858,3557,40,2.83%
2016-11,המרכז,195,קדימה-צורן,יישוב,271,118,153,85,186,40,269,3,2.41%
2016-11,המרכז,638,קלנסווה,יישוב,411,207,204,9,402,295,374,11,4.28%
2016-11,המרכז,469,קריית עקרון,יישוב,235,109,126,31,204,92,230,5,3.82%
2016-11,המרכז,2640,ראש העין,יישוב,703,354,349,121,582,135,690,19,2.73%
2016-11,המרכז,8300,ראשון לציון,יישוב,4050,1736,2314,824,3226,1094,4004,80,2.87%
2016-11,המרכז,8400,רחובות,יישוב,2226,1003,1223,546,1680,679,2159,51,3.14%
2016-11,המרכז,8500,רמלה,יישוב,1527,732,795,123,1404,634,1452,72,3.85%
2016-11,המרכז,8700,רעננה,יישוב,652,299,353,290,362,45,645,8,1.74%
2016-11,המרכז,1304,שוהם,יישוב,184,64,120,72,112,7,183,1,1.57%
2016-11,המרכז,154,תל מונד,יישוב,142,71,71,40,102,18,142,1,2.20%
2016-11,הצפון,473,אבו סנאן,יישוב,585,245,340,2,583,465,572,8,9.68%
2016-11,הצפון,478,אכסאל,יישוב,474,206,268,7,467,403,469,5,8.18%
2016-11,הצפון,529,אעבלין,יישוב,456,186,270,7,449,360,448,9,7.79%
2016-11,הצפון,482,בועיינה-נוג'ידאת,יישוב,279,135,144,7,272,218,272,7,7.12%
2016-11,הצפון,4001,בוקעאתא,יישוב,390,152,238,4,386,303,376,4,13.54%
2016-11,הצפון,998,ביר אל-מכסור,יישוב,344,144,200,5,339,269,340,2,8.84%
2016-11,הצפון,480,בית ג'ן,יישוב,366,99,267,7,359,252,355,3,6.33%
2016-11,הצפון,9200,בית שאן,יישוב,757,340,417,29,728,348,736,55,7.17%
2016-11,הצפון,944,בסמת טבעון,יישוב,159,77,82,2,157,120,154,1,4.74%
2016-11,הצפון,483,בענה,יישוב,330,140,190,9,321,272,314,4,9.16%
2016-11,הצפון,1292,ג'דיידה-מכר,יישוב,1102,480,622,2,1100,905,1082,23,11.61%
2016-11,הצפון,485,ג'ולס,יישוב,206,60,146,2,204,121,206,3,6.63%
2016-11,הצפון,487,ג'ש (גוש חלב),יישוב,56,24,32,6,50,24,56,1,3.39%
2016-11,הצפון,489,דבורייה,יישוב,303,122,181,17,286,217,298,4,6.96%
2016-11,הצפון,490,דייר אל-אסד,יישוב,329,150,179,10,319,270,319,4,6.12%
2016-11,הצפון,492,דייר חנא,יישוב,605,249,356,5,600,476,594,5,12.18%
2016-11,הצפון,975,זרזיר,יישוב,233,98,135,4,229,147,228,6,6.95%
2016-11,הצפון,496,חורפיש,יישוב,110,41,69,7,103,61,104,3,3.64%
2016-11,הצפון,2034,חצור הגלילית,יישוב,275,106,169,21,254,127,259,3,5.29%
2016-11,הצפון,6700,טבריה,יישוב,1472,701,771,72,1400,719,1283,63,5.87%
2016-11,הצפון,962,טובא-זנגרייה,יישוב,305,136,169,7,298,229,294,2,9.81%
2016-11,הצפון,498,טורעאן,יישוב,401,167,234,11,390,336,389,6,6.83%
2016-11,הצפון,8900,טמרה,יישוב,1350,600,750,16,1334,1165,1331,9,9.46%
2016-11,הצפון,1295,יאנוח-ג'ת,יישוב,131,42,89,5,126,87,123,0,4.22%
2016-11,הצפון,46,יבנאל,יישוב,96,47,49,5,91,59,71,2,4.54%
2016-11,הצפון,29,יסוד המעלה,יישוב,25,9,16,10,15,4,24,0,2.77%
2016-11,הצפון,499,יפיע,יישוב,542,216,326,16,526,420,536,2,6.77%
2016-11,הצפון,240,יקנעם עילית,יישוב,405,167,238,69,336,100,398,24,3.28%
2016-11,הצפון,502,ירכא,יישוב,439,175,264,0,439,333,434,8,6.80%
2016-11,הצפון,504,כאבול,יישוב,471,218,253,5,466,403,459,5,9.39%
2016-11,הצפון,505,כאוכב אבו אל-היג'א,יישוב,204,85,119,2,202,171,199,3,11.51%
2016-11,הצפון,1296,כסרא-סמיע,יישוב,190,73,117,3,187,123,175,8,5.00%
2016-11,הצפון,978,כעביה-טבאש-חג'אג'רה,יישוב,146,60,86,2,144,105,142,5,6.09%
2016-11,הצפון,1263,כפר ורדים,יישוב,63,30,33,26,37,6,63,1,2.05%
2016-11,הצפון,507,כפר יאסיף,יישוב,420,169,251,9,411,291,410,7,8.01%
2016-11,הצפון,508,כפר כמא,יישוב,57,24,33,4,53,24,57,1,3.37%
2016-11,הצפון,509,כפר כנא,יישוב,814,363,451,26,788,674,783,17,9.02%
2016-11,הצפון,510,כפר מנדא,יישוב,691,328,363,9,682,550,679,6,9.45%
2016-11,הצפון,47,כפר תבור,יישוב,38,14,24,17,21,1,38,0,1.66%
2016-11,הצפון,1139,כרמיאל,יישוב,1451,575,876,269,1182,682,1356,38,5.21%
2016-11,הצפון,65,מ.א. אל-בטוף,מועצה איזורית,303,124,179,7,296,232,287,1,9.87%
2016-11,הצפון,66,מ.א. בוסתן אל-מרג',מועצה איזורית,32,6,26,0,32,27,31,0,1.01%
2016-11,הצפון,71,מ.א. גולן,מועצה איזורית,190,92,98,51,139,19,187,0,2.18%
2016-11,הצפון,8,מ.א. הגלבוע,מועצה איזורית,705,284,421,75,630,375,693,0,4.81%
2016-11,הצפון,1,מ.א. הגליל העליון,מועצה איזורית,194,72,122,74,120,16,193,0,2.19%
2016-11,הצפון,3,מ.א. הגליל התחתון,מועצה איזורית,107,49,58,26,81,12,105,0,1.79%
2016-11,הצפון,55,מ.א. מבואות החרמון,מועצה איזורית,110,41,69,23,87,20,107,0,2.68%
2016-11,הצפון,13,מ.א. מגידו,מועצה איזורית,91,36,55,31,60,11,91,0,1.60%
2016-11,הצפון,4,מ.א. מטה אשר,מועצה איזורית,463,209,254,84,379,168,454,0,3.31%
2016-11,הצפון,52,מ.א. מעלה יוסף,מועצה איזורית,195,96,99,14,181,47,191,1,3.46%
2016-11,הצפון,2,מ.א. מרום הגליל,מועצה איזורית,255,121,134,41,214,105,247,0,3.62%
2016-11,הצפון,56,מ.א. משגב,מועצה איזורית,604,242,362,125,479,301,583,0,4.49%
2016-11,הצפון,6,מ.א. עמק הירדן,מועצה איזורית,148,78,70,31,117,34,134,0,1.98%
2016-11,הצפון,7,מ.א. עמק המעיינות,מועצה איזורית,194,90,104,36,158,39,191,0,2.95%
2016-11,הצפון,9,מ.א. עמק יזרעאל,מועצה איזורית,391,164,227,173,218,36,383,0,1.98%
2016-11,הצפון,481,מגאר,יישוב,1280,540,740,16,1264,1050,1242,20,12.65%
2016-11,הצפון,516,מג'ד אל-כרום,יישוב,488,208,280,9,479,343,472,6,7.08%
2016-11,הצפון,65,מגדל,יישוב,42,17,25,1,41,17,40,1,4.20%
2016-11,הצפון,874,מגדל העמק,יישוב,821,365,456,80,741,292,758,75,5.58%
2016-11,הצפון,4201,מג'דל שמס,יישוב,414,164,250,9,405,306,403,8,8.22%
2016-11,הצפון,517,מזרעה,יישוב,155,66,89,1,154,113,146,6,7.37%
2016-11,הצפון,43,מטולה,יישוב,23,13,10,5,18,5,23,0,2.20%
2016-11,הצפון,4203,מסעדה,יישוב,193,67,126,2,191,149,182,3,10.76%
2016-11,הצפון,518,מעיליא,יישוב,59,29,30,4,55,19,59,1,3.63%
2016-11,הצפון,1063,מעלות-תרשיחא,יישוב,768,379,389,90,678,394,738,35,6.25%
2016-11,הצפון,520,משהד,יישוב,225,97,128,5,220,177,213,5,6.63%
2016-11,הצפון,9100,נהרייה,יישוב,1798,842,956,168,1630,947,1709,68,5.52%
2016-11,הצפון,522,נחף,יישוב,356,155,201,11,345,292,344,5,6.80%
2016-11,הצפון,7300,נצרת,יישוב,2775,1189,1586,140,2635,2101,2743,16,7.96%
2016-11,הצפון,1061,נצרת עילית,יישוב,1464,640,824,145,1319,707,1300,104,5.61%
2016-11,הצפון,525,סאג'ור,יישוב,104,38,66,5,99,71,104,1,5.27%
2016-11,הצפון,7500,סח'נין,יישוב,1992,875,1117,32,1960,1664,1957,31,13.84%
2016-11,הצפון,4501,ע'ג'ר,יישוב,95,30,65,0,95,63,92,1,8.67%
2016-11,הצפון,530,עיילבון,יישוב,173,80,93,10,163,107,169,3,6.09%
2016-11,הצפון,511,עילוט,יישוב,280,112,168,6,274,224,277,2,9.72%
2016-11,הצפון,532,עין מאהל,יישוב,389,189,200,10,379,316,373,4,7.14%
2016-11,הצפון,4502,עין קנייא,יישוב,144,63,81,5,139,105,141,2,13.66%
2016-11,הצפון,7600,עכו,יישוב,2775,1262,1513,130,2645,2024,2688,49,10.16%
2016-11,הצפון,7700,עפולה,יישוב,1530,622,908,180,1350,602,1432,73,5.60%
2016-11,הצפון,531,עראבה,יישוב,1436,607,829,20,1416,1266,1409,20,13.75%
2016-11,הצפון,535,פסוטה,יישוב,83,38,45,7,76,47,80,2,4.68%
2016-11,הצפון,536,פקיעין (בוקייעה),יישוב,131,70,61,4,127,77,125,4,4.43%
2016-11,הצפון,8000,צפת,יישוב,1115,585,530,98,1017,717,1054,30,7.84%
2016-11,הצפון,4100,קצרין,יישוב,185,72,113,28,157,90,178,2,4.43%
2016-11,הצפון,2800,קריית שמונה,יישוב,722,342,380,58,664,268,696,35,5.31%
2016-11,הצפון,543,ראמה,יישוב,266,107,159,22,244,183,257,1,6.56%
2016-11,הצפון,26,ראש פינה,יישוב,44,13,31,9,35,17,44,2,2.75%
2016-11,הצפון,542,ריינה,יישוב,503,222,281,13,490,380,486,6,7.14%
2016-11,הצפון,122,רמת ישי,יישוב,92,36,56,36,56,12,90,2,2.16%
2016-11,הצפון,913,שבלי - אום אל-גנם,יישוב,189,74,115,4,185,125,188,3,7.11%
2016-11,הצפון,812,שלומי,יישוב,202,82,120,17,185,99,193,6,5.37%
2016-11,הצפון,538,שעב,יישוב,480,189,291,3,477,425,475,5,15.48%
2016-11,הצפון,8800,שפרעם,יישוב,1508,597,911,43,1465,1208,1468,33,8.13%
2016-11,חיפה,1326,"בסמ""ה",יישוב,353,160,193,6,347,275,347,3,8.62%
2016-11,חיפה,2710,אום אל-פחם,יישוב,2833,1153,1680,30,2803,2363,2786,31,13.26%
2016-11,חיפה,1020,אור עקיבא,יישוב,459,194,265,47,412,123,446,17,4.38%
2016-11,חיפה,6000,באקה אל-גרביה,יישוב,570,262,308,13,557,359,566,19,4.82%
2016-11,חיפה,9800,בנימינה-גבעת עדה*,יישוב,176,75,101,55,121,41,176,2,2.42%
2016-11,חיפה,541,ג'סר א-זרקא,יישוב,293,151,142,2,291,185,293,16,4.92%
2016-11,חיפה,628,ג'ת,יישוב,189,91,98,6,183,108,186,6,3.53%
2016-11,חיפה,494,דאלית אל-כרמל,יישוב,443,180,263,14,429,248,411,8,4.98%
2016-11,חיפה,9300,זכרון יעקב,יישוב,262,112,150,88,174,41,258,3,2.31%
2016-11,חיפה,6500,חדרה,יישוב,2131,878,1253,242,1889,766,1992,45,3.97%
2016-11,חיפה,4000,חיפה,יישוב,5519,2651,2868,1141,4378,2729,5192,158,3.72%
2016-11,חיפה,1247,חריש,יישוב,33,12,21,8,25,7,31,0,1.94%
2016-11,חיפה,2100,טירת כרמל,יישוב,653,328,325,29,624,323,637,21,5.65%
2016-11,חיפה,654,כפר קרע,יישוב,389,176,213,9,380,240,383,3,4.47%
2016-11,חיפה,45,מ.א. אלונה,מועצה איזורית,29,11,18,7,22,3,29,0,2.72%
2016-11,חיפה,12,מ.א. זבולון,מועצה איזורית,246,117,129,36,210,141,240,0,4.31%
2016-11,חיפה,15,מ.א. חוף הכרמל,מועצה איזורית,309,145,164,112,197,51,305,1,2.15%
2016-11,חיפה,14,מ.א. מנשה,מועצה איזורית,225,95,130,65,160,60,223,0,2.78%
2016-11,חיפה,1327,מעלה עירון,יישוב,694,257,437,6,688,565,686,10,11.72%
2016-11,חיפה,2500,נשר,יישוב,399,187,212,78,321,137,391,8,3.05%
2016-11,חיפה,534,עספיא,יישוב,286,122,164,16,270,152,258,7,4.57%
2016-11,חיפה,637,ערערה,יישוב,517,233,284,11,506,335,509,10,6.26%
2016-11,חיפה,537,פוריידיס,יישוב,284,146,138,4,280,153,281,2,5.02%
2016-11,חיפה,7800,פרדס חנה-כרכור,יישוב,734,312,422,164,570,170,716,22,3.53%
2016-11,חיפה,6800,קריית אתא,יישוב,1463,670,793,129,1334,719,1419,44,4.66%
2016-11,חיפה,9500,קריית ביאליק,יישוב,950,389,561,124,826,409,917,25,4.28%
2016-11,חיפה,2300,קריית טבעון,יישוב,181,83,98,79,102,27,180,0,2.15%
2016-11,חיפה,9600,קריית ים,יישוב,1263,579,684,110,1153,709,1216,39,5.70%
2016-11,חיפה,8200,קריית מוצקין,יישוב,875,368,507,162,713,370,846,17,3.68%
2016-11,חיפה,922,רכסים,יישוב,147,65,82,11,136,71,132,3,3.71%
2016-11,ירושלים,472,אבו גוש,יישוב,230,119,111,8,222,179,226,1,7.33%
2016-11,ירושלים,2610,בית שמש,יישוב,1207,481,726,106,1101,418,1160,25,3.43%
2016-11,ירושלים,3000,ירושלים,יישוב,11654,5195,6459,1342,10312,7077,11352,156,3.81%
2016-11,ירושלים,26,מ.א. מטה יהודה,מועצה איזורית,494,229,265,126,368,119,484,2,2.02%
2016-11,ירושלים,1015,מבשרת ציון,יישוב,318,161,157,68,250,116,308,6,2.37%
2016-11,ירושלים,1137,קריית יערים,יישוב,46,20,26,10,36,15,46,0,3.23%
2016-11,תל אביב,2400,אור יהודה,יישוב,669,313,356,62,607,167,636,37,3.34%
2016-11,תל אביב,565,אזור,יישוב,163,84,79,31,132,25,162,4,2.47%
2016-11,תל אביב,6100,בני ברק,יישוב,1752,822,930,88,1664,712,1640,28,2.86%
2016-11,תל אביב,6200,בת ים,יישוב,2637,1230,1407,333,2304,923,2492,69,3.54%
2016-11,תל אביב,6300,גבעתיים,יישוב,729,325,404,338,391,76,723,7,2.34%
2016-11,תל אביב,6400,הרצלייה,יישוב,1072,475,597,401,671,33,1062,19,2.17%
2016-11,תל אביב,6600,חולון,יישוב,2925,1328,1597,477,2448,641,2858,52,2.88%
2016-11,תל אביב,267,כפר שמריהו,יישוב,10,5,5,5,5,0,10,0,1.19%
2016-11,תל אביב,2620,קריית אונו,יישוב,399,165,234,180,219,35,395,6,2.06%
2016-11,תל אביב,8600,רמת גן,יישוב,1994,908,1086,679,1315,313,1957,22,2.49%
2016-11,תל אביב,2650,רמת השרון,יישוב,375,143,232,158,217,9,373,4,1.67%
2016-11,תל אביב,5000,תל אביב -יפו,יישוב,7254,3553,3701,2636,4618,1655,7127,78,2.80%
2016-12,אזור יהודה והשומרון,3760,אורנית,יישוב,91,54,37,29,62,2,91,2,1.87%
2016-12,אזור יהודה והשומרון,3750,אלפי מנשה,יישוב,102,36,66,38,64,1,102,0,2.31%
2016-12,אזור יהודה והשומרון,3560,אלקנה,יישוב,34,20,14,20,14,0,34,0,1.79%
2016-12,אזור יהודה והשומרון,3650,אפרת,יישוב,62,33,29,25,37,3,62,0,1.43%
2016-12,אזור יהודה והשומרון,3570,אריאל,יישוב,314,157,157,73,241,28,312,14,2.89%
2016-12,אזור יהודה והשומרון,3574,בית אל,יישוב,49,18,31,20,29,12,49,0,2.01%
2016-12,אזור יהודה והשומרון,3652,בית אריה,יישוב,52,28,24,11,41,2,50,1,1.87%
2016-12,אזור יהודה והשומרון,3780,ביתר עילית,יישוב,491,228,263,8,483,171,489,1,3.68%
2016-12,אזור יהודה והשומרון,3730,גבעת זאב,יישוב,188,86,102,45,143,35,186,1,2.39%
2016-12,אזור יהודה והשומרון,3769,הר אדר,יישוב,22,12,10,10,12,3,22,0,1.04%
2016-12,אזור יהודה והשומרון,76,מ.א. גוש עציון,מועצה איזורית,144,59,85,55,89,14,141,0,1.46%
2016-12,אזור יהודה והשומרון,78,מ.א. הר חברון,מועצה איזורית,70,35,35,32,38,4,69,0,1.97%
2016-12,אזור יהודה והשומרון,74,מ.א. מגילות ים המלח,מועצה איזורית,13,3,10,4,9,0,13,0,1.62%
2016-12,אזור יהודה והשומרון,73,מ.א. מטה בנימין,מועצה איזורית,570,292,278,178,392,113,563,0,2.24%
2016-12,אזור יהודה והשומרון,75,מ.א. ערבות הירדן,מועצה איזורית,51,28,23,17,34,5,51,0,2.10%
2016-12,אזור יהודה והשומרון,72,מ.א. שומרון,מועצה איזורית,359,169,190,133,226,31,354,0,2.10%
2016-12,אזור יהודה והשומרון,3797,מודיעין עילית,יישוב,405,124,281,22,383,30,402,7,2.86%
2016-12,אזור יהודה והשומרון,3616,מעלה אדומים,יישוב,572,234,338,95,477,175,565,17,2.76%
2016-12,אזור יהודה והשומרון,3608,מעלה אפרים,יישוב,27,13,14,0,27,8,27,0,3.28%
2016-12,אזור יהודה והשומרון,3660,עמנואל,יישוב,49,27,22,2,47,29,49,2,4.19%
2016-12,אזור יהודה והשומרון,3557,קדומים,יישוב,28,18,10,7,21,3,27,1,1.44%
2016-12,אזור יהודה והשומרון,3611,קריית ארבע,יישוב,76,44,32,13,63,36,74,2,2.28%
2016-12,אזור יהודה והשומרון,3640,קרני שומרון,יישוב,77,37,40,20,57,6,75,2,1.98%
2016-12,הדרום,31,אופקים,יישוב,788,347,441,37,751,466,770,40,5.82%
2016-12,הדרום,2600,אילת,יישוב,1034,523,511,63,971,371,969,49,2.87%
2016-12,הדרום,70,אשדוד,יישוב,5048,2086,2962,621,4427,2328,4828,134,4.41%
2016-12,הדרום,7100,אשקלון,יישוב,3421,1461,1960,395,3026,1669,3001,55,4.24%
2016-12,הדרום,9000,באר שבע,יישוב,5321,2428,2893,704,4617,2924,5026,90,4.76%
2016-12,הדרום,2200,דימונה,יישוב,1676,759,917,95,1581,1114,1595,46,8.52%
2016-12,הדרום,1303,חורה,יישוב,550,225,325,1,549,475,531,1,13.06%
2016-12,הדרום,831,ירוחם,יישוב,377,187,190,21,356,214,358,24,7.43%
2016-12,הדרום,1059,כסיפה,יישוב,969,378,591,2,967,863,954,3,20.12%
2016-12,הדרום,1271,להבים,יישוב,57,17,40,29,28,3,57,1,1.57%
2016-12,הדרום,1060,לקיה,יישוב,682,310,372,4,678,597,651,4,15.31%
2016-12,הדרום,69,מ.א. אל קסום,מועצה איזורית,636,252,384,9,627,567,623,0,38.55%
2016-12,הדרום,38,מ.א. אשכול,מועצה איזורית,106,44,62,28,78,7,104,0,1.53%
2016-12,הדרום,33,מ.א. באר טוביה,מועצה איזורית,246,94,152,41,205,38,245,0,2.24%
2016-12,הדרום,41,מ.א. בני שמעון,מועצה איזורית,78,27,51,31,47,8,78,0,1.79%
2016-12,הדרום,54,מ.א. הערבה התיכונה,מועצה איזורית,21,11,10,7,14,1,21,0,1.16%
2016-12,הדרום,53,מ.א. חבל אילות,מועצה איזורית,21,8,13,3,18,1,21,0,0.89%
2016-12,הדרום,36,מ.א. חוף אשקלון,מועצה איזורית,210,81,129,24,186,43,197,0,2.38%
2016-12,הדרום,35,מ.א. יואב,מועצה איזורית,80,27,53,28,52,9,77,0,1.93%
2016-12,הדרום,50,מ.א. לכיש,מועצה איזורית,156,63,93,27,129,41,155,0,3.08%
2016-12,הדרום,42,מ.א. מרחבים,מועצה איזורית,157,55,102,27,130,29,156,0,2.64%
2016-12,הדרום,68,מ.א. נווה מדבר,מועצה איזורית,114,43,71,1,113,89,113,0,11.72%
2016-12,הדרום,48,מ.א. רמת נגב,מועצה איזורית,263,134,129,28,235,193,261,0,8.24%
2016-12,הדרום,39,מ.א. שדות נגב,מועצה איזורית,104,55,49,19,85,24,100,0,2.21%
2016-12,הדרום,37,מ.א. שער הנגב,מועצה איזורית,83,34,49,32,51,14,79,0,2.03%
2016-12,הדרום,34,מ.א. שפיר,מועצה איזורית,136,63,73,15,121,49,134,0,2.85%
2016-12,הדרום,51,מ.א. תמר,מועצה איזורית,10,5,5,2,8,1,10,0,1.58%
2016-12,הדרום,1268,מיתר,יישוב,81,31,50,36,45,4,80,0,1.79%
2016-12,הדרום,99,מצפה רמון,יישוב,237,91,146,10,227,160,226,5,8.25%
2016-12,הדרום,246,נתיבות,יישוב,850,388,462,44,806,393,803,49,5.46%
2016-12,הדרום,666,עומר,יישוב,55,20,35,23,32,3,54,0,1.28%
2016-12,הדרום,2560,ערד,יישוב,630,288,342,66,564,344,598,35,4.88%
2016-12,הדרום,1192,ערערה-בנגב,יישוב,1091,468,623,5,1086,964,1068,0,24.35%
2016-12,הדרום,2630,קריית גת,יישוב,1573,669,904,86,1487,736,1490,47,5.27%
2016-12,הדרום,1034,קריית מלאכי,יישוב,699,315,384,21,678,313,670,53,5.79%
2016-12,הדרום,1161,רהט,יישוב,2415,1021,1394,15,2400,1916,2382,57,12.10%
2016-12,הדרום,1286,שגב-שלום,יישוב,349,128,221,2,347,301,340,3,12.34%
2016-12,הדרום,1031,שדרות,יישוב,928,432,496,63,865,512,851,23,6.34%
2016-12,הדרום,1054,תל שבע,יישוב,756,323,433,2,754,687,731,7,15.17%
2016-12,המרכז,1066,"בני עי""ש",יישוב,132,63,69,14,118,48,125,4,3.14%
2016-12,המרכז,182,אבן יהודה,יישוב,140,65,75,44,96,14,140,0,2.04%
2016-12,המרכז,41,אליכין,יישוב,57,33,24,10,47,17,55,0,2.85%
2016-12,המרכז,1309,אלעד,יישוב,324,138,186,22,302,34,313,4,2.42%
2016-12,המרכז,2530,באר יעקב,יישוב,230,95,135,64,166,38,229,5,2.29%
2016-12,המרכז,466,בית דגן,יישוב,111,62,49,13,98,27,109,0,2.93%
2016-12,המרכז,681,גבעת שמואל,יישוב,241,127,114,73,168,43,235,3,1.94%
2016-12,המרכז,2550,גדרה,יישוב,315,137,178,54,261,73,303,3,2.43%
2016-12,המרכז,627,ג'לג'וליה,יישוב,87,37,50,2,85,53,85,2,2.25%
2016-12,המרכז,166,גן יבנה,יישוב,287,119,168,46,241,60,284,4,2.35%
2016-12,המרכז,229,גני תקווה,יישוב,193,88,105,77,116,24,193,5,2.14%
2016-12,המרכז,9700,הוד השרון,יישוב,578,255,323,258,320,40,565,11,1.82%
2016-12,המרכז,1290,זמר,יישוב,129,46,83,3,126,85,127,6,4.30%
2016-12,המרכז,2730,טייבה,יישוב,1114,506,608,30,1084,816,972,27,5.57%
2016-12,המרכז,2720,טירה,יישוב,185,94,91,12,173,64,184,16,1.61%
2016-12,המרכז,2660,יבנה,יישוב,684,310,374,132,552,189,667,21,2.74%
2016-12,המרכז,9400,יהוד,יישוב,337,155,182,85,252,48,330,3,2.06%
2016-12,המרכז,1224,כוכב יאיר,יישוב,94,49,45,52,42,1,94,1,1.63%
2016-12,המרכז,633,כפר ברא,יישוב,21,12,9,2,19,10,21,0,1.47%
2016-12,המרכז,168,כפר יונה,יישוב,297,133,164,58,239,40,294,2,2.61%
2016-12,המרכז,6900,כפר סבא,יישוב,1073,463,610,411,662,85,1055,25,1.99%
2016-12,המרכז,634,כפר קאסם,יישוב,229,99,130,13,216,129,220,3,2.38%
2016-12,המרכז,7000,לוד,יישוב,1650,777,873,112,1538,886,1616,44,4.57%
2016-12,המרכז,28,מ.א. ברנר,מועצה איזורית,67,25,42,32,35,3,67,4,1.65%
2016-12,המרכז,32,מ.א. גדרות,מועצה איזורית,36,17,19,19,17,1,36,0,1.47%
2016-12,המרכז,30,מ.א. גזר,מועצה איזורית,289,141,148,98,191,32,286,0,2.17%
2016-12,המרכז,27,מ.א. גן רווה,מועצה איזורית,52,26,26,23,29,5,52,0,1.78%
2016-12,המרכז,20,מ.א. דרום השרון,מועצה איזורית,322,141,181,144,178,11,319,0,2.04%
2016-12,המרכז,29,מ.א. חבל יבנה,מועצה איזורית,37,17,20,13,24,2,37,0,1.49%
2016-12,המרכז,25,מ.א. חבל מודיעין,מועצה איזורית,202,80,122,76,126,16,199,0,1.85%
2016-12,המרכז,19,מ.א. חוף השרון,מועצה איזורית,89,37,52,39,50,4,89,0,1.59%
2016-12,המרכז,18,מ.א. לב השרון,מועצה איזורית,254,123,131,68,186,33,249,0,2.26%
2016-12,המרכז,31,מ.א. נחל שורק,מועצה איזורית,53,24,29,15,38,3,52,40,1.31%
2016-12,המרכז,16,מ.א. עמק חפר,מועצה איזורית,378,146,232,154,224,14,376,0,1.91%
2016-12,המרכז,40,מ.א. עמק לוד,מועצה איזורית,125,54,71,32,93,14,124,0,2.01%
2016-12,המרכז,1200,מודיעין-מכבים-רעות*,יישוב,778,355,423,320,458,57,769,20,1.71%
2016-12,המרכז,28,מזכרת בתיה,יישוב,153,59,94,48,105,23,145,4,1.93%
2016-12,המרכז,7200,נס ציונה,יישוב,597,276,321,152,445,157,586,6,2.45%
2016-12,המרכז,7400,נתניה,יישוב,3758,1777,1981,473,3285,1277,3658,84,3.47%
2016-12,המרכז,587,סביון*,יישוב,15,3,12,6,9,1,15,1,0.76%
2016-12,המרכז,171,פרדסייה,יישוב,67,32,35,21,46,5,67,2,1.77%
2016-12,המרכז,7900,פתח תקווה,יישוב,3542,1591,1951,823,2719,850,3455,49,2.75%
2016-12,המרכז,195,קדימה-צורן,יישוב,247,109,138,68,179,39,242,1,2.18%
2016-12,המרכז,638,קלנסווה,יישוב,398,202,196,11,387,287,360,16,4.13%
2016-12,המרכז,469,קריית עקרון,יישוב,240,112,128,27,213,95,236,7,3.91%
2016-12,המרכז,2640,ראש העין,יישוב,707,355,352,106,601,133,694,11,2.74%
2016-12,המרכז,8300,ראשון לציון,יישוב,3900,1716,2184,784,3116,1031,3851,65,2.76%
2016-12,המרכז,8400,רחובות,יישוב,2146,962,1184,516,1630,678,2075,76,3.02%
2016-12,המרכז,8500,רמלה,יישוב,1399,676,723,110,1289,587,1336,48,3.55%
2016-12,המרכז,8700,רעננה,יישוב,653,304,349,277,376,40,644,10,1.74%
2016-12,המרכז,1304,שוהם,יישוב,170,59,111,71,99,7,169,0,1.45%
2016-12,המרכז,154,תל מונד,יישוב,142,77,65,41,101,17,140,2,2.17%
2016-12,הצפון,473,אבו סנאן,יישוב,574,240,334,3,571,457,564,9,9.56%
2016-12,הצפון,478,אכסאל,יישוב,456,201,255,8,448,381,453,1,7.93%
2016-12,הצפון,529,אעבלין,יישוב,443,179,264,9,434,354,434,12,7.57%
2016-12,הצפון,482,בועיינה-נוג'ידאת,יישוב,283,138,145,9,274,222,279,1,7.29%
2016-12,הצפון,4001,בוקעאתא,יישוב,397,156,241,5,392,308,383,3,13.76%
2016-12,הצפון,998,ביר אל-מכסור,יישוב,336,138,198,5,331,261,333,2,8.67%
2016-12,הצפון,480,בית ג'ן,יישוב,385,110,275,9,376,261,370,2,6.58%
2016-12,הצפון,9200,בית שאן,יישוב,706,327,379,29,677,319,681,42,6.67%
2016-12,הצפון,944,בסמת טבעון,יישוב,164,77,87,3,161,122,156,1,4.79%
2016-12,הצפון,483,בענה,יישוב,318,133,185,7,311,263,308,8,9.00%
2016-12,הצפון,1292,ג'דיידה-מכר,יישוב,1096,483,613,3,1093,897,1075,11,11.54%
2016-12,הצפון,485,ג'ולס,יישוב,194,58,136,2,192,124,194,3,6.27%
2016-12,הצפון,487,ג'ש (גוש חלב),יישוב,56,24,32,8,48,25,56,1,3.39%
2016-12,הצפון,489,דבורייה,יישוב,283,116,167,14,269,207,281,2,6.59%
2016-12,הצפון,490,דייר אל-אסד,יישוב,330,148,182,11,319,272,321,4,6.15%
2016-12,הצפון,492,דייר חנא,יישוב,603,246,357,4,599,465,593,6,12.16%
2016-12,הצפון,975,זרזיר,יישוב,220,94,126,3,217,137,212,12,6.50%
2016-12,הצפון,496,חורפיש,יישוב,100,40,60,7,93,60,93,2,3.27%
2016-12,הצפון,2034,חצור הגלילית,יישוב,262,105,157,16,246,118,249,10,5.09%
2016-12,הצפון,6700,טבריה,יישוב,1421,675,746,68,1353,691,1226,66,5.63%
2016-12,הצפון,962,טובא-זנגרייה,יישוב,317,151,166,5,312,224,307,3,10.20%
2016-12,הצפון,498,טורעאן,יישוב,403,179,224,8,395,337,393,3,6.90%
2016-12,הצפון,8900,טמרה,יישוב,1326,591,735,19,1307,1139,1300,16,9.26%
2016-12,הצפון,1295,יאנוח-ג'ת,יישוב,145,50,95,4,141,90,140,0,4.77%
2016-12,הצפון,46,יבנאל,יישוב,95,51,44,5,90,62,72,2,4.60%
2016-12,הצפון,29,יסוד המעלה,יישוב,20,8,12,8,12,4,19,0,2.21%
2016-12,הצפון,499,יפיע,יישוב,533,220,313,16,517,406,529,6,6.68%
2016-12,הצפון,240,יקנעם עילית,יישוב,397,165,232,66,331,105,388,26,3.20%
2016-12,הצפון,502,ירכא,יישוב,444,172,272,1,443,338,437,6,6.84%
2016-12,הצפון,504,כאבול,יישוב,453,213,240,7,446,386,446,3,9.15%
2016-12,הצפון,505,כאוכב אבו אל-היג'א,יישוב,205,87,118,2,203,172,201,2,11.61%
2016-12,הצפון,1296,כסרא-סמיע,יישוב,189,66,123,5,184,121,177,1,5.06%
2016-12,הצפון,978,כעביה-טבאש-חג'אג'רה,יישוב,138,55,83,2,136,101,135,2,5.81%
2016-12,הצפון,1263,כפר ורדים,יישוב,68,33,35,26,42,6,67,0,2.17%
2016-12,הצפון,507,כפר יאסיף,יישוב,398,165,233,8,390,274,391,4,7.66%
2016-12,הצפון,508,כפר כמא,יישוב,56,21,35,5,51,23,56,1,3.31%
2016-12,הצפון,509,כפר כנא,יישוב,797,367,430,30,767,654,772,9,8.91%
2016-12,הצפון,510,כפר מנדא,יישוב,670,321,349,8,662,522,664,0,9.26%
2016-12,הצפון,47,כפר תבור,יישוב,41,14,27,20,21,2,39,0,1.70%
2016-12,הצפון,1139,כרמיאל,יישוב,1394,574,820,254,1140,662,1299,38,5.00%
2016-12,הצפון,65,מ.א. אל-בטוף,מועצה איזורית,288,115,173,8,280,221,275,1,9.48%
2016-12,הצפון,66,מ.א. בוסתן אל-מרג',מועצה איזורית,33,9,24,0,33,29,31,0,1.01%
2016-12,הצפון,71,מ.א. גולן,מועצה איזורית,177,89,88,50,127,17,174,0,2.03%
2016-12,הצפון,8,מ.א. הגלבוע,מועצה איזורית,685,294,391,68,617,371,673,0,4.67%
2016-12,הצפון,1,מ.א. הגליל העליון,מועצה איזורית,195,82,113,79,116,11,193,0,2.19%
2016-12,הצפון,3,מ.א. הגליל התחתון,מועצה איזורית,108,48,60,25,83,10,106,0,1.81%
2016-12,הצפון,55,מ.א. מבואות החרמון,מועצה איזורית,103,37,66,23,80,21,100,0,2.50%
2016-12,הצפון,13,מ.א. מגידו,מועצה איזורית,82,33,49,32,50,8,82,0,1.44%
2016-12,הצפון,4,מ.א. מטה אשר,מועצה איזורית,445,199,246,81,364,161,434,0,3.16%
2016-12,הצפון,52,מ.א. מעלה יוסף,מועצה איזורית,180,89,91,12,168,48,178,0,3.23%
2016-12,הצפון,2,מ.א. מרום הגליל,מועצה איזורית,251,125,126,38,213,100,244,0,3.57%
2016-12,הצפון,56,מ.א. משגב,מועצה איזורית,574,236,338,121,453,296,552,0,4.25%
2016-12,הצפון,6,מ.א. עמק הירדן,מועצה איזורית,160,85,75,39,121,29,147,0,2.18%
2016-12,הצפון,7,מ.א. עמק המעיינות,מועצה איזורית,177,80,97,33,144,36,173,0,2.67%
2016-12,הצפון,9,מ.א. עמק יזרעאל,מועצה איזורית,359,149,210,164,195,34,352,0,1.82%
2016-12,הצפון,481,מגאר,יישוב,1235,534,701,18,1217,1005,1200,17,12.28%
2016-12,הצפון,516,מג'ד אל-כרום,יישוב,469,206,263,8,461,340,451,14,6.78%
2016-12,הצפון,65,מגדל,יישוב,37,18,19,1,36,16,33,1,3.49%
2016-12,הצפון,874,מגדל העמק,יישוב,742,316,426,74,668,289,685,56,5.07%
2016-12,הצפון,4201,מג'דל שמס,יישוב,420,160,260,9,411,320,402,3,8.20%
2016-12,הצפון,517,מזרעה,יישוב,151,64,87,1,150,112,146,6,7.37%
2016-12,הצפון,43,מטולה,יישוב,22,13,9,6,16,5,22,1,2.11%
2016-12,הצפון,4203,מסעדה,יישוב,195,69,126,2,193,158,184,5,10.87%
2016-12,הצפון,518,מעיליא,יישוב,53,28,25,4,49,19,53,0,3.27%
2016-12,הצפון,1063,מעלות-תרשיחא,יישוב,736,359,377,87,649,391,697,45,5.92%
2016-12,הצפון,520,משהד,יישוב,218,94,124,6,212,167,207,7,6.45%
2016-12,הצפון,9100,נהרייה,יישוב,1693,800,893,146,1547,935,1600,69,5.18%
2016-12,הצפון,522,נחף,יישוב,364,161,203,14,350,297,353,5,6.97%
2016-12,הצפון,7300,נצרת,יישוב,2682,1142,1540,124,2558,2045,2651,17,7.72%
2016-12,הצפון,1061,נצרת עילית,יישוב,1362,601,761,137,1225,683,1210,75,5.25%
2016-12,הצפון,525,סאג'ור,יישוב,110,40,70,5,105,79,107,1,5.41%
2016-12,הצפון,7500,סח'נין,יישוב,1956,867,1089,34,1922,1630,1921,23,13.62%
2016-12,הצפון,4501,ע'ג'ר,יישוב,90,30,60,1,89,61,89,1,8.41%
2016-12,הצפון,530,עיילבון,יישוב,172,79,93,11,161,102,169,0,6.09%
2016-12,הצפון,511,עילוט,יישוב,270,108,162,5,265,219,270,1,9.49%
2016-12,הצפון,532,עין מאהל,יישוב,383,189,194,12,371,309,368,2,7.06%
2016-12,הצפון,4502,עין קנייא,יישוב,145,62,83,5,140,105,141,0,13.66%
2016-12,הצפון,7600,עכו,יישוב,2699,1252,1447,130,2569,1992,2609,53,9.89%
2016-12,הצפון,7700,עפולה,יישוב,1410,586,824,173,1237,591,1333,66,5.23%
2016-12,הצפון,531,עראבה,יישוב,1417,580,837,20,1397,1240,1391,19,13.60%
2016-12,הצפון,535,פסוטה,יישוב,82,40,42,7,75,46,80,1,4.68%
2016-12,הצפון,536,פקיעין (בוקייעה),יישוב,134,70,64,6,128,83,126,1,4.47%
2016-12,הצפון,8000,צפת,יישוב,1041,546,495,98,943,680,979,22,7.32%
2016-12,הצפון,4100,קצרין,יישוב,206,90,116,29,177,93,203,2,5.02%
2016-12,הצפון,2800,קריית שמונה,יישוב,683,329,354,62,621,279,658,22,5.03%
2016-12,הצפון,543,ראמה,יישוב,252,101,151,19,233,174,245,2,6.28%
2016-12,הצפון,26,ראש פינה,יישוב,45,17,28,9,36,17,44,0,2.75%
2016-12,הצפון,542,ריינה,יישוב,487,216,271,9,478,367,474,9,6.97%
2016-12,הצפון,122,רמת ישי,יישוב,82,33,49,29,53,10,81,3,1.95%
2016-12,הצפון,913,שבלי - אום אל-גנם,יישוב,183,73,110,3,180,124,181,6,6.86%
2016-12,הצפון,812,שלומי,יישוב,200,78,122,18,182,92,190,8,5.29%
2016-12,הצפון,538,שעב,יישוב,459,187,272,2,457,400,454,4,14.90%
2016-12,הצפון,8800,שפרעם,יישוב,1470,575,895,44,1426,1174,1433,29,7.96%
2016-12,חיפה,1326,"בסמ""ה",יישוב,348,158,190,5,343,267,343,0,8.53%
2016-12,חיפה,2710,אום אל-פחם,יישוב,2776,1161,1615,29,2747,2289,2723,25,13.00%
2016-12,חיפה,1020,אור עקיבא,יישוב,447,193,254,44,403,123,435,17,4.28%
2016-12,חיפה,6000,באקה אל-גרביה,יישוב,551,254,297,11,540,347,545,24,4.65%
2016-12,חיפה,9800,בנימינה-גבעת עדה*,יישוב,188,87,101,61,127,41,188,5,2.58%
2016-12,חיפה,541,ג'סר א-זרקא,יישוב,275,142,133,2,273,166,274,11,4.62%
2016-12,חיפה,628,ג'ת,יישוב,186,93,93,5,181,114,183,6,3.48%
2016-12,חיפה,494,דאלית אל-כרמל,יישוב,439,176,263,15,424,248,402,8,4.87%
2016-12,חיפה,9300,זכרון יעקב,יישוב,242,108,134,82,160,36,239,3,2.15%
2016-12,חיפה,6500,חדרה,יישוב,2014,872,1142,228,1786,711,1890,49,3.77%
2016-12,חיפה,4000,חיפה,יישוב,5353,2615,2738,1135,4218,2678,5017,108,3.60%
2016-12,חיפה,1247,חריש,יישוב,36,17,19,6,30,7,32,0,2.00%
2016-12,חיפה,2100,טירת כרמל,יישוב,637,322,315,29,608,319,625,20,5.55%
2016-12,חיפה,654,כפר קרע,יישוב,403,185,218,9,394,247,397,5,4.63%
2016-12,חיפה,45,מ.א. אלונה,מועצה איזורית,28,9,19,8,20,3,28,0,2.62%
2016-12,חיפה,12,מ.א. זבולון,מועצה איזורית,249,121,128,43,206,144,244,0,4.38%
2016-12,חיפה,15,מ.א. חוף הכרמל,מועצה איזורית,306,141,165,106,200,51,301,0,2.13%
2016-12,חיפה,14,מ.א. מנשה,מועצה איזורית,215,85,130,58,157,56,214,0,2.67%
2016-12,חיפה,1327,מעלה עירון,יישוב,675,265,410,3,672,549,658,10,11.30%
2016-12,חיפה,2500,נשר,יישוב,355,159,196,74,281,135,338,16,2.65%
2016-12,חיפה,534,עספיא,יישוב,292,126,166,16,276,153,266,4,4.71%
2016-12,חיפה,637,ערערה,יישוב,499,223,276,10,489,329,487,16,6.01%
2016-12,חיפה,537,פוריידיס,יישוב,275,149,126,4,271,145,271,3,4.85%
2016-12,חיפה,7800,פרדס חנה-כרכור,יישוב,670,280,390,166,504,163,659,19,3.25%
2016-12,חיפה,6800,קריית אתא,יישוב,1398,641,757,122,1276,692,1363,27,4.49%
2016-12,חיפה,9500,קריית ביאליק,יישוב,913,382,531,114,799,390,885,12,4.14%
2016-12,חיפה,2300,קריית טבעון,יישוב,169,74,95,76,93,24,168,0,2.01%
2016-12,חיפה,9600,קריית ים,יישוב,1199,544,655,103,1096,681,1151,33,5.41%
2016-12,חיפה,8200,קריית מוצקין,יישוב,856,368,488,142,714,358,830,18,3.62%
2016-12,חיפה,922,רכסים,יישוב,144,68,76,12,132,69,131,2,3.68%
2016-12,ירושלים,472,אבו גוש,יישוב,238,123,115,9,229,178,235,1,7.60%
2016-12,ירושלים,2610,בית שמש,יישוב,1163,499,664,108,1055,418,1113,31,3.30%
2016-12,ירושלים,3000,ירושלים,יישוב,11275,5080,6195,1303,9972,6978,10951,125,3.68%
2016-12,ירושלים,26,מ.א. מטה יהודה,מועצה איזורית,495,220,275,129,366,119,480,0,2.01%
2016-12,ירושלים,1015,מבשרת ציון,יישוב,307,158,149,67,240,113,297,5,2.29%
2016-12,ירושלים,1137,קריית יערים,יישוב,44,23,21,10,34,13,44,0,3.09%
2016-12,תל אביב,2400,אור יהודה,יישוב,627,311,316,62,565,150,600,25,3.16%
2016-12,תל אביב,565,אזור,יישוב,142,75,67,26,116,23,142,1,2.17%
2016-12,תל אביב,6100,בני ברק,יישוב,1634,790,844,85,1549,695,1535,31,2.68%
2016-12,תל אביב,6200,בת ים,יישוב,2476,1176,1300,316,2160,882,2331,76,3.32%
2016-12,תל אביב,6300,גבעתיים,יישוב,684,318,366,317,367,73,679,3,2.20%
2016-12,תל אביב,6400,הרצלייה,יישוב,991,453,538,367,624,29,984,17,2.02%
2016-12,תל אביב,6600,חולון,יישוב,2777,1270,1507,467,2310,609,2715,67,2.74%
2016-12,תל אביב,267,כפר שמריהו,יישוב,8,3,5,4,4,0,8,0,0.95%
2016-12,תל אביב,2620,קריית אונו,יישוב,392,156,236,179,213,33,388,1,2.02%
2016-12,תל אביב,8600,רמת גן,יישוב,1917,889,1028,677,1240,313,1882,17,2.40%
2016-12,תל אביב,2650,רמת השרון,יישוב,340,130,210,163,177,5,339,3,1.52%
2016-12,תל אביב,5000,תל אביב -יפו,יישוב,7007,3456,3551,2555,4452,1619,6876,85,2.71%
2017-01,אזור יהודה והשומרון,3760,אורנית,יישוב,98,52,46,36,62,1,98,0,1.95%
2017-01,אזור יהודה והשומרון,3750,אלפי מנשה,יישוב,105,38,67,38,67,2,104,2,2.34%
2017-01,אזור יהודה והשומרון,3560,אלקנה,יישוב,35,19,16,19,16,0,35,0,1.90%
2017-01,אזור יהודה והשומרון,3650,אפרת,יישוב,63,35,28,27,36,3,63,2,1.28%
2017-01,אזור יהודה והשומרון,3570,אריאל,יישוב,320,162,158,71,249,23,314,24,2.85%
2017-01,אזור יהודה והשומרון,3574,בית אל,יישוב,49,21,28,21,28,15,49,0,1.96%
2017-01,אזור יהודה והשומרון,3652,בית אריה,יישוב,59,34,25,15,44,0,58,1,2.02%
2017-01,אזור יהודה והשומרון,3780,ביתר עילית,יישוב,480,222,258,8,472,170,478,6,3.07%
2017-01,אזור יהודה והשומרון,3730,גבעת זאב,יישוב,189,82,107,39,150,40,186,4,2.29%
2017-01,אזור יהודה והשומרון,3769,הר אדר,יישוב,25,12,13,12,13,4,25,0,1.15%
2017-01,אזור יהודה והשומרון,76,מ.א. גוש עציון,מועצה איזורית,163,78,85,59,104,19,159,0,1.57%
2017-01,אזור יהודה והשומרון,78,מ.א. הר חברון,מועצה איזורית,72,43,29,30,42,3,72,0,1.81%
2017-01,אזור יהודה והשומרון,74,מ.א. מגילות ים המלח,מועצה איזורית,17,6,11,5,12,0,16,0,1.74%
2017-01,אזור יהודה והשומרון,73,מ.א. מטה בנימין,מועצה איזורית,600,303,297,183,417,120,587,0,2.07%
2017-01,אזור יהודה והשומרון,75,מ.א. ערבות הירדן,מועצה איזורית,50,26,24,14,36,5,50,0,1.94%
2017-01,אזור יהודה והשומרון,72,מ.א. שומרון,מועצה איזורית,377,184,193,141,236,33,372,0,1.96%
2017-01,אזור יהודה והשומרון,3797,מודיעין עילית,יישוב,404,126,278,23,381,30,400,5,2.50%
2017-01,אזור יהודה והשומרון,3616,מעלה אדומים,יישוב,603,266,337,98,505,171,590,20,2.82%
2017-01,אזור יהודה והשומרון,3608,מעלה אפרים,יישוב,30,15,15,0,30,8,29,2,3.63%
2017-01,אזור יהודה והשומרון,3660,עמנואל,יישוב,48,29,19,2,46,28,48,2,3.53%
2017-01,אזור יהודה והשומרון,3557,קדומים,יישוב,27,18,9,8,19,3,25,4,1.26%
2017-01,אזור יהודה והשומרון,3611,קריית ארבע,יישוב,82,48,34,16,66,39,78,3,2.33%
2017-01,אזור יהודה והשומרון,3640,קרני שומרון,יישוב,84,43,41,24,60,4,84,6,2.06%
2017-01,הדרום,31,אופקים,יישוב,842,375,467,51,791,470,815,49,5.64%
2017-01,הדרום,2600,אילת,יישוב,1206,601,605,62,1144,377,1131,52,3.26%
2017-01,הדרום,70,אשדוד,יישוב,5228,2181,3047,656,4572,2352,4958,145,4.41%
2017-01,הדרום,7100,אשקלון,יישוב,3578,1549,2029,430,3148,1691,3153,66,4.25%
2017-01,הדרום,9000,באר שבע,יישוב,5531,2551,2980,716,4815,2939,5188,134,4.83%
2017-01,הדרום,2200,דימונה,יישוב,1716,787,929,97,1619,1118,1613,76,8.22%
2017-01,הדרום,1303,חורה,יישוב,549,231,318,3,546,473,533,3,10.96%
2017-01,הדרום,831,ירוחם,יישוב,400,193,207,25,375,230,366,29,7.12%
2017-01,הדרום,1059,כסיפה,יישוב,966,386,580,2,964,854,954,4,17.56%
2017-01,הדרום,1271,להבים,יישוב,53,15,38,28,25,3,53,0,1.50%
2017-01,הדרום,1060,לקיה,יישוב,660,296,364,4,656,579,632,4,12.75%
2017-01,הדרום,69,מ.א. אל קסום,מועצה איזורית,645,259,386,7,638,576,623,0,18.26%
2017-01,הדרום,38,מ.א. אשכול,מועצה איזורית,101,41,60,25,76,6,100,0,1.43%
2017-01,הדרום,33,מ.א. באר טוביה,מועצה איזורית,264,108,156,47,217,36,262,0,2.31%
2017-01,הדרום,41,מ.א. בני שמעון,מועצה איזורית,74,28,46,32,42,9,74,4,1.53%
2017-01,הדרום,54,מ.א. הערבה התיכונה,מועצה איזורית,25,12,13,10,15,1,25,0,1.31%
2017-01,הדרום,53,מ.א. חבל אילות,מועצה איזורית,27,10,17,5,22,0,27,2,1.09%
2017-01,הדרום,36,מ.א. חוף אשקלון,מועצה איזורית,200,86,114,26,174,39,192,0,2.21%
2017-01,הדרום,35,מ.א. יואב,מועצה איזורית,83,28,55,31,52,10,82,0,2.01%
2017-01,הדרום,50,מ.א. לכיש,מועצה איזורית,170,73,97,21,149,44,170,0,3.05%
2017-01,הדרום,42,מ.א. מרחבים,מועצה איזורית,166,58,108,35,131,26,163,0,2.59%
2017-01,הדרום,68,מ.א. נווה מדבר,מועצה איזורית,118,46,72,1,117,89,116,0,6.14%
2017-01,הדרום,48,מ.א. רמת נגב,מועצה איזורית,267,140,127,22,245,197,263,0,7.90%
2017-01,הדרום,39,מ.א. שדות נגב,מועצה איזורית,113,55,58,21,92,26,109,0,2.24%
2017-01,הדרום,37,מ.א. שער הנגב,מועצה איזורית,92,41,51,38,54,15,90,1,2.25%
2017-01,הדרום,34,מ.א. שפיר,מועצה איזורית,145,69,76,15,130,48,142,0,2.85%
2017-01,הדרום,51,מ.א. תמר,מועצה איזורית,10,5,5,2,8,1,10,0,1.54%
2017-01,הדרום,1268,מיתר,יישוב,86,34,52,38,48,5,83,1,1.68%
2017-01,הדרום,99,מצפה רמון,יישוב,254,100,154,16,238,157,243,12,8.65%
2017-01,הדרום,246,נתיבות,יישוב,868,396,472,51,817,414,811,46,4.94%
2017-01,הדרום,666,עומר,יישוב,63,24,39,30,33,3,62,0,1.47%
2017-01,הדרום,2560,ערד,יישוב,701,315,386,72,629,343,666,33,5.21%
2017-01,הדרום,1192,ערערה-בנגב,יישוב,1089,472,617,6,1083,963,1065,34,20.32%
2017-01,הדרום,2630,קריית גת,יישוב,1608,654,954,93,1515,719,1529,62,5.21%
2017-01,הדרום,1034,קריית מלאכי,יישוב,717,329,388,22,695,314,685,55,5.54%
2017-01,הדרום,1161,רהט,יישוב,2477,1039,1438,10,2467,1918,2437,75,10.68%
2017-01,הדרום,1286,שגב-שלום,יישוב,355,137,218,2,353,299,340,2,10.44%
2017-01,הדרום,1031,שדרות,יישוב,900,410,490,67,833,491,827,25,5.57%
2017-01,הדרום,1054,תל שבע,יישוב,766,338,428,2,764,682,732,11,12.57%
2017-01,המרכז,1066,"בני עי""ש",יישוב,139,72,67,13,126,41,136,7,3.38%
2017-01,המרכז,182,אבן יהודה,יישוב,155,72,83,46,109,14,155,2,2.22%
2017-01,המרכז,41,אליכין,יישוב,54,30,24,9,45,15,51,4,2.60%
2017-01,המרכז,1309,אלעד,יישוב,321,135,186,23,298,30,311,1,2.19%
2017-01,המרכז,2530,באר יעקב,יישוב,245,99,146,75,170,42,242,5,1.88%
2017-01,המרכז,466,בית דגן,יישוב,105,57,48,11,94,29,102,1,2.72%
2017-01,המרכז,681,גבעת שמואל,יישוב,250,134,116,77,173,38,245,2,1.96%
2017-01,המרכז,2550,גדרה,יישוב,319,134,185,50,269,72,308,11,2.37%
2017-01,המרכז,627,ג'לג'וליה,יישוב,78,35,43,4,74,43,76,1,1.77%
2017-01,המרכז,166,גן יבנה,יישוב,307,118,189,54,253,60,302,6,2.38%
2017-01,המרכז,229,גני תקווה,יישוב,210,99,111,86,124,27,207,1,2.14%
2017-01,המרכז,9700,הוד השרון,יישוב,610,263,347,270,340,41,600,10,1.84%
2017-01,המרכז,1290,זמר,יישוב,127,47,80,3,124,81,125,6,3.81%
2017-01,המרכז,2730,טייבה,יישוב,1123,510,613,32,1091,801,968,40,4.95%
2017-01,המרכז,2720,טירה,יישוב,186,94,92,15,171,58,180,10,1.44%
2017-01,המרכז,2660,יבנה,יישוב,712,339,373,136,576,180,700,29,2.77%
2017-01,המרכז,9400,יהוד,יישוב,366,164,202,90,276,44,357,13,2.19%
2017-01,המרכז,1224,כוכב יאיר,יישוב,88,45,43,56,32,0,87,1,1.56%
2017-01,המרכז,633,כפר ברא,יישוב,13,8,5,0,13,7,13,2,0.81%
2017-01,המרכז,168,כפר יונה,יישוב,319,143,176,64,255,42,316,4,2.69%
2017-01,המרכז,6900,כפר סבא,יישוב,1148,515,633,439,709,93,1127,23,2.13%
2017-01,המרכז,634,כפר קאסם,יישוב,240,99,141,11,229,126,230,3,2.22%
2017-01,המרכז,7000,לוד,יישוב,1734,822,912,135,1599,907,1689,46,4.56%
2017-01,המרכז,28,מ.א. ברנר,מועצה איזורית,66,26,40,33,33,2,66,5,1.62%
2017-01,המרכז,32,מ.א. גדרות,מועצה איזורית,48,21,27,24,24,2,47,0,1.90%
2017-01,המרכז,30,מ.א. גזר,מועצה איזורית,283,135,148,96,187,30,280,0,2.09%
2017-01,המרכז,27,מ.א. גן רווה,מועצה איזורית,62,28,34,24,38,1,62,0,2.07%
2017-01,המרכז,20,מ.א. דרום השרון,מועצה איזורית,342,145,197,161,181,11,338,0,2.09%
2017-01,המרכז,29,מ.א. חבל יבנה,מועצה איזורית,33,16,17,13,20,3,33,1,1.26%
2017-01,המרכז,25,מ.א. חבל מודיעין,מועצה איזורית,220,92,128,80,140,21,217,0,1.97%
2017-01,המרכז,19,מ.א. חוף השרון,מועצה איזורית,91,32,59,41,50,3,91,0,1.63%
2017-01,המרכז,18,מ.א. לב השרון,מועצה איזורית,262,124,138,75,187,33,257,0,2.31%
2017-01,המרכז,31,מ.א. נחל שורק,מועצה איזורית,64,30,34,14,50,6,62,49,1.44%
2017-01,המרכז,16,מ.א. עמק חפר,מועצה איזורית,392,150,242,163,229,15,387,0,1.97%
2017-01,המרכז,40,מ.א. שדות דן,מועצה איזורית,132,61,71,40,92,10,131,0,2.03%
2017-01,המרכז,1200,מודיעין-מכבים-רעות*,יישוב,846,380,466,342,504,52,834,23,1.81%
2017-01,המרכז,28,מזכרת בתיה,יישוב,170,77,93,51,119,23,164,5,2.01%
2017-01,המרכז,7200,נס ציונה,יישוב,634,295,339,154,480,162,624,14,2.52%
2017-01,המרכז,7400,נתניה,יישוב,3918,1864,2054,498,3420,1268,3827,115,3.52%
2017-01,המרכז,587,סביון*,יישוב,16,6,10,8,8,1,16,0,0.77%
2017-01,המרכז,171,פרדסייה,יישוב,71,35,36,25,46,5,71,1,1.89%
2017-01,המרכז,7900,פתח תקווה,יישוב,3750,1713,2037,876,2874,853,3650,60,2.82%
2017-01,המרכז,195,קדימה-צורן,יישוב,265,117,148,70,195,43,262,3,2.23%
2017-01,המרכז,638,קלנסווה,יישוב,372,198,174,10,362,261,338,8,3.46%
2017-01,המרכז,469,קריית עקרון,יישוב,220,96,124,27,193,93,213,9,3.50%
2017-01,המרכז,2640,ראש העין,יישוב,774,377,397,118,656,128,763,16,2.47%
2017-01,המרכז,8300,ראשון לציון,יישוב,4059,1754,2305,813,3246,1029,4017,82,2.85%
2017-01,המרכז,8400,רחובות,יישוב,2215,986,1229,539,1676,694,2138,72,3.01%
2017-01,המרכז,8500,רמלה,יישוב,1483,712,771,129,1354,601,1415,76,3.64%
2017-01,המרכז,8700,רעננה,יישוב,678,320,358,285,393,38,672,10,1.78%
2017-01,המרכז,1304,שוהם,יישוב,177,64,113,72,105,10,176,1,1.46%
2017-01,המרכז,154,תל מונד,יישוב,143,74,69,48,95,17,143,0,2.07%
2017-01,הצפון,473,אבו סנאן,יישוב,575,241,334,4,571,445,562,8,8.81%
2017-01,הצפון,478,אכסאל,יישוב,449,191,258,7,442,384,446,9,6.95%
2017-01,הצפון,529,אעבלין,יישוב,443,184,259,10,433,348,432,8,6.89%
2017-01,הצפון,482,בועיינה-נוג'ידאת,יישוב,278,134,144,8,270,219,270,4,6.18%
2017-01,הצפון,4001,בוקעאתא,יישוב,414,161,253,4,410,305,399,0,12.84%
2017-01,הצפון,998,ביר אל-מכסור,יישוב,341,143,198,6,335,258,336,6,7.91%
2017-01,הצפון,480,בית ג'ן,יישוב,390,118,272,9,381,263,370,1,6.15%
2017-01,הצפון,9200,בית שאן,יישוב,716,336,380,24,692,323,687,43,6.49%
2017-01,הצפון,944,בסמת טבעון,יישוב,178,84,94,3,175,129,165,5,4.54%
2017-01,הצפון,483,בענה,יישוב,340,142,198,7,333,282,324,7,8.27%
2017-01,הצפון,1292,ג'דיידה-מכר,יישוב,1112,499,613,2,1110,900,1093,15,10.50%
2017-01,הצפון,485,ג'ולס,יישוב,197,58,139,2,195,127,196,0,5.93%
2017-01,הצפון,487,ג'ש (גוש חלב),יישוב,60,25,35,7,53,25,60,1,3.48%
2017-01,הצפון,489,דבורייה,יישוב,293,121,172,15,278,211,289,2,6.03%
2017-01,הצפון,490,דייר אל-אסד,יישוב,337,147,190,12,325,278,321,9,5.56%
2017-01,הצפון,492,דייר חנא,יישוב,612,259,353,4,608,467,598,7,11.05%
2017-01,הצפון,975,זרזיר,יישוב,221,96,125,3,218,143,218,6,6.02%
2017-01,הצפון,496,חורפיש,יישוב,114,43,71,12,102,58,107,5,3.49%
2017-01,הצפון,2034,חצור הגלילית,יישוב,248,99,149,17,231,119,230,4,4.69%
2017-01,הצפון,6700,טבריה,יישוב,1518,725,793,83,1435,730,1327,72,5.90%
2017-01,הצפון,962,טובא-זנגרייה,יישוב,329,162,167,5,324,226,317,4,9.20%
2017-01,הצפון,498,טורעאן,יישוב,409,180,229,8,401,338,401,12,6.25%
2017-01,הצפון,8900,טמרה,יישוב,1328,607,721,21,1307,1119,1296,12,8.25%
2017-01,הצפון,1295,יאנוח-ג'ת,יישוב,147,54,93,5,142,85,142,3,4.40%
2017-01,הצפון,46,יבנאל,יישוב,116,59,57,9,107,72,94,4,5.84%
2017-01,הצפון,29,יסוד המעלה,יישוב,24,11,13,9,15,4,23,1,2.60%
2017-01,הצפון,499,יפיע,יישוב,540,234,306,14,526,408,531,10,6.09%
2017-01,הצפון,240,יקנעם עילית,יישוב,445,185,260,79,366,113,431,28,3.34%
2017-01,הצפון,502,ירכא,יישוב,420,161,259,1,419,320,415,5,5.86%
2017-01,הצפון,504,כאבול,יישוב,467,226,241,6,461,394,456,4,8.30%
2017-01,הצפון,505,כאוכב אבו אל-היג'א,יישוב,209,89,120,3,206,176,206,3,10.71%
2017-01,הצפון,1296,כסרא-סמיע,יישוב,208,79,129,8,200,129,189,1,4.83%
2017-01,הצפון,978,כעביה-טבאש-חג'אג'רה,יישוב,149,61,88,2,147,107,147,1,5.69%
2017-01,הצפון,1263,כפר ורדים,יישוב,68,31,37,28,40,5,67,0,2.15%
2017-01,הצפון,507,כפר יאסיף,יישוב,401,163,238,9,392,272,395,7,7.21%
2017-01,הצפון,508,כפר כמא,יישוב,57,25,32,5,52,25,56,0,3.21%
2017-01,הצפון,509,כפר כנא,יישוב,812,377,435,30,782,650,788,28,8.01%
2017-01,הצפון,510,כפר מנדא,יישוב,683,331,352,6,677,530,677,4,8.32%
2017-01,הצפון,47,כפר תבור,יישוב,34,10,24,15,19,1,33,1,1.40%
2017-01,הצפון,1139,כרמיאל,יישוב,1409,574,835,278,1131,665,1299,42,5.00%
2017-01,הצפון,65,מ.א. אל-בטוף,מועצה איזורית,291,123,168,7,284,221,280,3,8.59%
2017-01,הצפון,66,מ.א. בוסתן אל-מרג,מועצה איזורית,35,9,26,0,35,30,34,0,0.97%
2017-01,הצפון,71,מ.א. גולן,מועצה איזורית,199,99,100,54,145,16,197,0,2.24%
2017-01,הצפון,8,מ.א. הגלבוע,מועצה איזורית,698,301,397,68,630,372,683,0,4.84%
2017-01,הצפון,1,מ.א. הגליל העליון,מועצה איזורית,208,87,121,81,127,12,207,0,2.31%
2017-01,הצפון,3,מ.א. הגליל התחתון,מועצה איזורית,113,46,67,32,81,9,112,0,1.86%
2017-01,הצפון,55,מ.א. מבואות החרמון,מועצה איזורית,114,47,67,27,87,20,111,0,2.77%
2017-01,הצפון,13,מ.א. מגידו,מועצה איזורית,92,32,60,34,58,7,92,0,1.63%
2017-01,הצפון,4,מ.א. מטה אשר,מועצה איזורית,460,208,252,88,372,164,449,0,3.16%
2017-01,הצפון,52,מ.א. מעלה יוסף,מועצה איזורית,183,89,94,18,165,48,180,0,3.14%
2017-01,הצפון,2,מ.א. מרום הגליל,מועצה איזורית,257,131,126,39,218,104,249,0,3.49%
2017-01,הצפון,56,מ.א. משגב,מועצה איזורית,598,238,360,129,469,304,579,0,4.09%
2017-01,הצפון,6,מ.א. עמק הירדן,מועצה איזורית,176,96,80,36,140,40,165,0,2.43%
2017-01,הצפון,7,מ.א. עמק המעיינות,מועצה איזורית,182,83,99,36,146,36,179,0,2.73%
2017-01,הצפון,9,מ.א. עמק יזרעאל,מועצה איזורית,375,165,210,171,204,31,368,0,1.88%
2017-01,הצפון,481,מגאר,יישוב,1246,541,705,22,1224,1005,1210,23,11.13%
2017-01,הצפון,516,מג'ד אל-כרום,יישוב,485,206,279,8,477,351,459,12,6.19%
2017-01,הצפון,65,מגדל,יישוב,41,21,20,2,39,18,36,3,3.60%
2017-01,הצפון,874,מגדל העמק,יישוב,771,328,443,88,683,292,709,77,5.16%
2017-01,הצפון,4201,מג'דל שמס,יישוב,426,166,260,10,416,311,409,6,7.67%
2017-01,הצפון,517,מזרעה,יישוב,157,69,88,0,157,114,152,4,7.01%
2017-01,הצפון,43,מטולה,יישוב,20,13,7,6,14,4,19,0,1.89%
2017-01,הצפון,4203,מסעדה,יישוב,202,73,129,3,199,157,188,4,10.22%
2017-01,הצפון,518,מעיליא,יישוב,61,33,28,7,54,19,61,1,3.53%
2017-01,הצפון,1063,מעלות-תרשיחא,יישוב,791,392,399,87,704,388,748,39,6.08%
2017-01,הצפון,520,משהד,יישוב,205,91,114,3,202,167,197,4,5.44%
2017-01,הצפון,9100,נהרייה,יישוב,1763,853,910,163,1600,952,1660,74,5.22%
2017-01,הצפון,522,נחף,יישוב,385,176,209,16,369,307,366,10,6.49%
2017-01,הצפון,7300,נצרת,יישוב,2739,1187,1552,129,2610,2052,2699,37,7.26%
2017-01,הצפון,1061,נצרת עילית,יישוב,1434,628,806,140,1294,678,1259,113,5.34%
2017-01,הצפון,525,סאג'ור,יישוב,104,36,68,7,97,75,102,1,4.69%
2017-01,הצפון,7500,סח'נין,יישוב,1920,870,1050,37,1883,1578,1883,15,11.89%
2017-01,הצפון,4501,ע'ג'ר,יישוב,87,28,59,0,87,57,86,0,7.13%
2017-01,הצפון,530,עיילבון,יישוב,179,84,95,11,168,101,175,4,5.96%
2017-01,הצפון,511,עילוט,יישוב,274,110,164,8,266,220,271,4,8.36%
2017-01,הצפון,532,עין מאהל,יישוב,395,203,192,13,382,301,380,4,6.42%
2017-01,הצפון,4502,עין קנייא,יישוב,144,56,88,5,139,106,139,2,12.15%
2017-01,הצפון,7600,עכו,יישוב,2776,1291,1485,145,2631,2013,2666,48,9.73%
2017-01,הצפון,7700,עפולה,יישוב,1485,617,868,180,1305,583,1392,69,5.06%
2017-01,הצפון,531,עראבה,יישוב,1423,604,819,21,1402,1232,1400,9,12.10%
2017-01,הצפון,535,פסוטה,יישוב,87,42,45,7,80,50,83,2,4.60%
2017-01,הצפון,536,פקיעין (בוקייעה),יישוב,133,74,59,7,126,82,127,5,4.21%
2017-01,הצפון,8000,צפת,יישוב,1053,542,511,104,949,674,979,26,6.97%
2017-01,הצפון,4100,קצרין,יישוב,201,92,109,26,175,87,198,6,4.90%
2017-01,הצפון,2800,קריית שמונה,יישוב,731,356,375,68,663,282,698,34,5.35%
2017-01,הצפון,543,ראמה,יישוב,257,102,155,21,236,179,247,4,5.97%
2017-01,הצפון,26,ראש פינה,יישוב,42,18,24,6,36,15,41,0,2.49%
2017-01,הצפון,542,ריינה,יישוב,481,224,257,9,472,368,468,4,6.26%
2017-01,הצפון,122,רמת ישי,יישוב,92,41,51,44,48,10,91,0,2.20%
2017-01,הצפון,913,שבלי - אום אל-גנם,יישוב,206,87,119,6,200,130,201,8,6.96%
2017-01,הצפון,812,שלומי,יישוב,201,75,126,20,181,104,193,9,5.27%
2017-01,הצפון,538,שעב,יישוב,462,191,271,5,457,396,457,3,13.20%
2017-01,הצפון,8800,שפרעם,יישוב,1425,573,852,37,1388,1145,1390,28,7.04%
2017-01,חיפה,1326,"בסמ""ה",יישוב,357,161,196,7,350,276,352,5,7.77%
2017-01,חיפה,2710,אום אל-פחם,יישוב,2790,1186,1604,27,2763,2301,2725,40,11.50%
2017-01,חיפה,1020,אור עקיבא,יישוב,454,196,258,47,407,124,436,23,4.14%
2017-01,חיפה,6000,באקה אל-גרביה,יישוב,529,243,286,7,522,333,524,33,4.01%
2017-01,חיפה,9800,בנימינה-גבעת עדה*,יישוב,190,88,102,64,126,39,190,4,2.52%
2017-01,חיפה,541,ג'סר א-זרקא,יישוב,267,148,119,3,264,154,266,13,4.11%
2017-01,חיפה,628,ג'ת,יישוב,189,96,93,6,183,112,186,10,3.22%
2017-01,חיפה,494,דאלית אל-כרמל,יישוב,454,180,274,14,440,265,407,8,4.63%
2017-01,חיפה,9300,זכרון יעקב,יישוב,262,116,146,94,168,35,257,1,2.25%
2017-01,חיפה,6500,חדרה,יישוב,2108,939,1169,254,1854,712,1979,54,3.80%
2017-01,חיפה,4000,חיפה,יישוב,5563,2693,2870,1198,4365,2709,5193,146,3.67%
2017-01,חיפה,1247,חריש,יישוב,41,18,23,8,33,8,36,2,0.86%
2017-01,חיפה,2100,טירת כרמל,יישוב,633,316,317,27,606,322,615,16,5.01%
2017-01,חיפה,654,כפר קרע,יישוב,415,194,221,12,403,248,408,16,4.32%
2017-01,חיפה,45,מ.א. אלונה,מועצה איזורית,27,8,19,8,19,2,27,0,2.53%
2017-01,חיפה,12,מ.א. זבולון,מועצה איזורית,249,123,126,41,208,144,242,0,4.08%
2017-01,חיפה,15,מ.א. חוף הכרמל,מועצה איזורית,320,162,158,113,207,48,314,0,2.12%
2017-01,חיפה,14,מ.א. מנשה,מועצה איזורית,233,96,137,60,173,60,230,0,2.67%
2017-01,חיפה,1327,מעלה עירון,יישוב,662,258,404,4,658,545,647,8,9.78%
2017-01,חיפה,2500,נשר,יישוב,366,180,186,74,292,134,356,4,2.81%
2017-01,חיפה,534,עספיא,יישוב,297,130,167,16,281,152,272,5,4.44%
2017-01,חיפה,637,ערערה,יישוב,494,223,271,8,486,327,482,16,5.34%
2017-01,חיפה,537,פוריידיס,יישוב,283,156,127,5,278,134,280,4,4.55%
2017-01,חיפה,7800,פרדס חנה-כרכור,יישוב,721,309,412,180,541,164,709,22,3.30%
2017-01,חיפה,6800,קריית אתא,יישוב,1435,659,776,118,1317,685,1403,42,4.51%
2017-01,חיפה,9500,קריית ביאליק,יישוב,955,418,537,117,838,413,926,19,4.31%
2017-01,חיפה,2300,קריית טבעון,יישוב,187,79,108,84,103,29,185,2,2.20%
2017-01,חיפה,9600,קריית ים,יישוב,1258,577,681,117,1141,702,1212,31,5.68%
2017-01,חיפה,8200,קריית מוצקין,יישוב,894,375,519,150,744,355,864,18,3.70%
2017-01,חיפה,922,רכסים,יישוב,145,69,76,10,135,74,129,2,3.44%
2017-01,ירושלים,472,אבו גוש,יישוב,245,133,112,7,238,174,242,7,6.90%
2017-01,ירושלים,2610,בית שמש,יישוב,1213,524,689,111,1102,424,1163,50,3.10%
2017-01,ירושלים,3000,ירושלים,יישוב,11434,5154,6280,1355,10079,6978,11097,156,3.46%
2017-01,ירושלים,26,מ.א. מטה יהודה,מועצה איזורית,513,229,284,154,359,113,499,0,1.93%
2017-01,ירושלים,1015,מבשרת ציון,יישוב,320,157,163,70,250,109,311,7,2.43%
2017-01,ירושלים,1137,קריית יערים,יישוב,45,23,22,9,36,15,45,2,2.52%
2017-01,תל אביב,2400,אור יהודה,יישוב,624,316,308,63,561,153,598,41,3.10%
2017-01,תל אביב,565,אזור,יישוב,173,87,86,29,144,33,168,4,2.51%
2017-01,תל אביב,6100,בני ברק,יישוב,1654,815,839,89,1565,698,1530,26,2.53%
2017-01,תל אביב,6200,בת ים,יישוב,2637,1277,1360,358,2279,891,2493,109,3.53%
2017-01,תל אביב,6300,גבעתיים,יישוב,725,331,394,347,378,79,721,10,2.27%
2017-01,תל אביב,6400,הרצלייה,יישוב,1052,479,573,376,676,30,1043,15,2.12%
2017-01,תל אביב,6600,חולון,יישוב,2889,1309,1580,485,2404,628,2813,68,2.79%
2017-01,תל אביב,267,כפר שמריהו,יישוב,9,4,5,5,4,0,9,0,1.08%
2017-01,תל אביב,2620,קריית אונו,יישוב,405,162,243,182,223,34,401,4,2.05%
2017-01,תל אביב,8600,רמת גן,יישוב,1977,933,1044,698,1279,316,1942,27,2.38%
2017-01,תל אביב,2650,רמת השרון,יישוב,375,158,217,175,200,12,373,7,1.63%
2017-01,תל אביב,5000,תל אביב -יפו,יישוב,7266,3604,3662,2658,4608,1635,7130,110,2.70%
2017-02,אזור יהודה והשומרון,3760,אורנית,יישוב,81,41,40,33,48,2,81,4,1.62%
2017-02,אזור יהודה והשומרון,3750,אלפי מנשה,יישוב,92,33,59,35,57,4,90,2,2.03%
2017-02,אזור יהודה והשומרון,3560,אלקנה,יישוב,32,16,16,15,17,0,32,0,1.74%
2017-02,אזור יהודה והשומרון,3650,אפרת,יישוב,62,35,27,30,32,3,62,2,1.26%
2017-02,אזור יהודה והשומרון,3570,אריאל,יישוב,303,141,162,67,236,22,300,14,2.72%
2017-02,אזור יהודה והשומרון,3574,בית אל,יישוב,52,26,26,19,33,16,52,0,2.08%
2017-02,אזור יהודה והשומרון,3652,בית אריה,יישוב,54,30,24,14,40,0,54,1,1.88%
2017-02,אזור יהודה והשומרון,3780,ביתר עילית,יישוב,455,210,245,11,444,161,450,1,2.89%
2017-02,אזור יהודה והשומרון,3730,גבעת זאב,יישוב,176,77,99,41,135,38,172,4,2.12%
2017-02,אזור יהודה והשומרון,3769,הר אדר,יישוב,26,11,15,13,13,2,26,0,1.19%
2017-02,אזור יהודה והשומרון,76,מ.א. גוש עציון,מועצה איזורית,159,73,86,55,104,16,154,0,1.52%
2017-02,אזור יהודה והשומרון,78,מ.א. הר חברון,מועצה איזורית,76,39,37,33,43,5,76,0,1.91%
2017-02,אזור יהודה והשומרון,74,מ.א. מגילות ים המלח,מועצה איזורית,20,7,13,7,13,0,20,0,2.17%
2017-02,אזור יהודה והשומרון,73,מ.א. מטה בנימין,מועצה איזורית,583,291,292,180,403,113,575,0,2.03%
2017-02,אזור יהודה והשומרון,75,מ.א. ערבות הירדן,מועצה איזורית,44,24,20,11,33,5,44,0,1.71%
2017-02,אזור יהודה והשומרון,72,מ.א. שומרון,מועצה איזורית,368,183,185,144,224,32,364,0,1.92%
2017-02,אזור יהודה והשומרון,3797,מודיעין עילית,יישוב,387,124,263,24,363,30,383,5,2.40%
2017-02,אזור יהודה והשומרון,3616,מעלה אדומים,יישוב,563,250,313,91,472,158,551,14,2.64%
2017-02,אזור יהודה והשומרון,3608,מעלה אפרים,יישוב,26,12,14,0,26,10,25,1,3.14%
2017-02,אזור יהודה והשומרון,3660,עמנואל,יישוב,44,27,17,2,42,23,44,5,3.24%
2017-02,אזור יהודה והשומרון,3557,קדומים,יישוב,26,17,9,7,19,5,24,0,1.21%
2017-02,אזור יהודה והשומרון,3611,קריית ארבע,יישוב,88,51,37,18,70,40,83,4,2.47%
2017-02,אזור יהודה והשומרון,3640,קרני שומרון,יישוב,70,42,28,21,49,5,69,1,1.70%
2017-02,הדרום,31,אופקים,יישוב,798,350,448,50,748,452,775,41,5.37%
2017-02,הדרום,2600,אילת,יישוב,1194,597,597,58,1136,378,1122,56,3.23%
2017-02,הדרום,70,אשדוד,יישוב,5059,2099,2960,648,4411,2293,4801,118,4.28%
2017-02,הדרום,7100,אשקלון,יישוב,3480,1502,1978,414,3066,1659,3063,58,4.13%
2017-02,הדרום,9000,באר שבע,יישוב,5256,2413,2843,662,4594,2838,4967,121,4.63%
2017-02,הדרום,2200,דימונה,יישוב,1641,743,898,93,1548,1118,1545,37,7.91%
2017-02,הדרום,1303,חורה,יישוב,543,229,314,4,539,456,526,4,10.83%
2017-02,הדרום,831,ירוחם,יישוב,379,185,194,25,354,220,352,27,6.87%
2017-02,הדרום,1059,כסיפה,יישוב,984,393,591,4,980,862,972,7,17.83%
2017-02,הדרום,1271,להבים,יישוב,52,14,38,29,23,3,52,0,1.47%
2017-02,הדרום,1060,לקיה,יישוב,644,286,358,8,636,559,628,3,12.68%
2017-02,הדרום,69,מ.א. אל קסום,מועצה איזורית,635,254,381,6,629,566,621,0,18.20%
2017-02,הדרום,38,מ.א. אשכול,מועצה איזורית,112,45,67,31,81,9,110,0,1.57%
2017-02,הדרום,33,מ.א. באר טוביה,מועצה איזורית,264,111,153,48,216,40,263,0,2.32%
2017-02,הדרום,41,מ.א. בני שמעון,מועצה איזורית,79,32,47,32,47,11,78,1,1.61%
2017-02,הדרום,54,מ.א. הערבה התיכונה,מועצה איזורית,24,12,12,8,16,0,24,0,1.26%
2017-02,הדרום,53,מ.א. חבל אילות,מועצה איזורית,22,6,16,3,19,0,22,2,0.89%
2017-02,הדרום,36,מ.א. חוף אשקלון,מועצה איזורית,188,85,103,21,167,39,180,2,2.07%
2017-02,הדרום,35,מ.א. יואב,מועצה איזורית,83,35,48,29,54,8,82,0,2.00%
2017-02,הדרום,50,מ.א. לכיש,מועצה איזורית,160,69,91,20,140,41,158,0,2.84%
2017-02,הדרום,42,מ.א. מרחבים,מועצה איזורית,155,53,102,32,123,26,153,0,2.43%
2017-02,הדרום,68,מ.א. נווה מדבר,מועצה איזורית,124,50,74,0,124,96,122,0,6.46%
2017-02,הדרום,48,מ.א. רמת נגב,מועצה איזורית,252,127,125,20,232,185,251,0,7.55%
2017-02,הדרום,39,מ.א. שדות נגב,מועצה איזורית,114,55,59,17,97,26,111,0,2.28%
2017-02,הדרום,37,מ.א. שער הנגב,מועצה איזורית,98,46,52,39,59,16,95,1,2.38%
2017-02,הדרום,34,מ.א. שפיר,מועצה איזורית,148,76,72,19,129,47,146,0,2.93%
2017-02,הדרום,51,מ.א. תמר,מועצה איזורית,7,3,4,1,6,1,7,0,1.08%
2017-02,הדרום,1268,מיתר,יישוב,84,34,50,34,50,5,82,0,1.66%
2017-02,הדרום,99,מצפה רמון,יישוב,231,91,140,14,217,154,220,11,7.90%
2017-02,הדרום,246,נתיבות,יישוב,877,396,481,52,825,406,820,61,5.00%
2017-02,הדרום,666,עומר,יישוב,57,20,37,29,28,3,56,1,1.33%
2017-02,הדרום,2560,ערד,יישוב,673,295,378,60,613,333,642,29,5.03%
2017-02,הדרום,1192,ערערה-בנגב,יישוב,1090,475,615,6,1084,971,1064,17,20.31%
2017-02,הדרום,2630,קריית גת,יישוב,1535,624,911,88,1447,705,1461,67,4.99%
2017-02,הדרום,1034,קריית מלאכי,יישוב,691,302,389,25,666,288,660,49,5.35%
2017-02,הדרום,1161,רהט,יישוב,2399,1003,1396,10,2389,1860,2358,102,10.37%
2017-02,הדרום,1286,שגב-שלום,יישוב,331,128,203,2,329,280,320,3,9.89%
2017-02,הדרום,1031,שדרות,יישוב,897,413,484,65,832,485,827,32,5.57%
2017-02,הדרום,1054,תל שבע,יישוב,732,325,407,2,730,644,701,7,12.10%
2017-02,המרכז,1066,"בני עי""ש",יישוב,129,70,59,15,114,39,126,6,3.14%
2017-02,המרכז,182,אבן יהודה,יישוב,163,76,87,54,109,15,162,1,2.31%
2017-02,המרכז,41,אליכין,יישוב,57,30,27,12,45,15,54,1,2.75%
2017-02,המרכז,1309,אלעד,יישוב,302,126,176,25,277,30,293,2,2.06%
2017-02,המרכז,2530,באר יעקב,יישוב,240,93,147,73,167,44,235,4,1.83%
2017-02,המרכז,466,בית דגן,יישוב,97,52,45,13,84,29,95,1,2.54%
2017-02,המרכז,681,גבעת שמואל,יישוב,249,133,116,77,172,37,246,0,1.97%
2017-02,המרכז,2550,גדרה,יישוב,292,132,160,48,244,74,284,4,2.19%
2017-02,המרכז,627,ג'לג'וליה,יישוב,72,38,34,2,70,38,72,0,1.68%
2017-02,המרכז,166,גן יבנה,יישוב,294,119,175,48,246,58,289,2,2.28%
2017-02,המרכז,229,גני תקווה,יישוב,208,101,107,81,127,24,206,0,2.13%
2017-02,המרכז,9700,הוד השרון,יישוב,639,281,358,301,338,31,632,17,1.94%
2017-02,המרכז,1290,זמר,יישוב,117,42,75,2,115,77,115,7,3.51%
2017-02,המרכז,2730,טייבה,יישוב,1077,492,585,33,1044,768,938,47,4.81%
2017-02,המרכז,2720,טירה,יישוב,174,91,83,12,162,55,168,7,1.34%
2017-02,המרכז,2660,יבנה,יישוב,680,322,358,139,541,181,671,25,2.66%
2017-02,המרכז,9400,יהוד,יישוב,355,160,195,87,268,40,344,7,2.11%
2017-02,המרכז,1224,כוכב יאיר,יישוב,81,43,38,51,30,0,81,0,1.46%
2017-02,המרכז,633,כפר ברא,יישוב,11,7,4,1,10,6,11,0,0.68%
2017-02,המרכז,168,כפר יונה,יישוב,300,135,165,63,237,41,297,4,2.53%
2017-02,המרכז,6900,כפר סבא,יישוב,1073,494,579,415,658,89,1056,20,2.00%
2017-02,המרכז,634,כפר קאסם,יישוב,202,82,120,12,190,100,201,1,1.94%
2017-02,המרכז,7000,לוד,יישוב,1704,822,882,131,1573,877,1665,48,4.49%
2017-02,המרכז,28,מ.א. ברנר,מועצה איזורית,65,28,37,29,36,3,64,1,1.57%
2017-02,המרכז,32,מ.א. גדרות,מועצה איזורית,46,21,25,24,22,4,44,0,1.78%
2017-02,המרכז,30,מ.א. גזר,מועצה איזורית,252,115,137,97,155,27,248,0,1.85%
2017-02,המרכז,27,מ.א. גן רווה,מועצה איזורית,55,25,30,22,33,1,55,0,1.84%
2017-02,המרכז,20,מ.א. דרום השרון,מועצה איזורית,329,132,197,160,169,11,325,0,2.01%
2017-02,המרכז,29,מ.א. חבל יבנה,מועצה איזורית,33,15,18,17,16,1,33,0,1.26%
2017-02,המרכז,25,מ.א. חבל מודיעין,מועצה איזורית,208,89,119,75,133,19,207,0,1.88%
2017-02,המרכז,19,מ.א. חוף השרון,מועצה איזורית,93,30,63,40,53,3,93,0,1.67%
2017-02,המרכז,18,מ.א. לב השרון,מועצה איזורית,260,127,133,71,189,31,256,0,2.30%
2017-02,המרכז,31,מ.א. נחל שורק,מועצה איזורית,51,26,25,11,40,5,51,41,1.20%
2017-02,המרכז,16,מ.א. עמק חפר,מועצה איזורית,373,142,231,160,213,11,371,0,1.89%
2017-02,המרכז,40,מ.א. שדות דן,מועצה איזורית,129,56,73,39,90,10,129,0,2.00%
2017-02,המרכז,1200,מודיעין-מכבים-רעות*,יישוב,828,383,445,341,487,47,815,22,1.77%
2017-02,המרכז,28,מזכרת בתיה,יישוב,155,67,88,50,105,19,152,1,1.87%
2017-02,המרכז,7200,נס ציונה,יישוב,623,293,330,149,474,155,612,13,2.47%
2017-02,המרכז,7400,נתניה,יישוב,3782,1832,1950,481,3301,1235,3687,91,3.40%
2017-02,המרכז,587,סביון*,יישוב,17,6,11,10,7,1,17,0,0.82%
2017-02,המרכז,171,פרדסייה,יישוב,74,39,35,29,45,5,74,0,1.97%
2017-02,המרכז,7900,פתח תקווה,יישוב,3580,1645,1935,816,2764,827,3480,61,2.69%
2017-02,המרכז,195,קדימה-צורן,יישוב,250,104,146,73,177,35,249,2,2.12%
2017-02,המרכז,638,קלנסווה,יישוב,370,198,172,8,362,257,331,10,3.39%
2017-02,המרכז,469,קריית עקרון,יישוב,212,95,117,27,185,87,210,7,3.45%
2017-02,המרכז,2640,ראש העין,יישוב,719,345,374,122,597,119,713,20,2.31%
2017-02,המרכז,8300,ראשון לציון,יישוב,3881,1668,2213,784,3097,975,3833,70,2.73%
2017-02,המרכז,8400,רחובות,יישוב,2106,906,1200,528,1578,671,2035,49,2.87%
2017-02,המרכז,8500,רמלה,יישוב,1425,684,741,126,1299,575,1360,56,3.50%
2017-02,המרכז,8700,רעננה,יישוב,652,296,356,285,367,40,638,10,1.69%
2017-02,המרכז,1304,שוהם,יישוב,154,57,97,72,82,8,152,0,1.26%
2017-02,המרכז,154,תל מונד,יישוב,147,77,70,49,98,14,147,2,2.13%
2017-02,הצפון,473,אבו סנאן,יישוב,557,234,323,4,553,436,548,5,8.61%
2017-02,הצפון,478,אכסאל,יישוב,451,197,254,10,441,383,448,1,6.98%
2017-02,הצפון,529,אעבלין,יישוב,439,187,252,12,427,350,429,4,6.85%
2017-02,הצפון,482,בועיינה-נוג'ידאת,יישוב,268,125,143,6,262,216,257,3,5.90%
2017-02,הצפון,4001,בוקעאתא,יישוב,403,155,248,4,399,301,390,2,12.59%
2017-02,הצפון,998,ביר אל-מכסור,יישוב,329,139,190,6,323,243,325,8,7.67%
2017-02,הצפון,480,בית ג'ן,יישוב,389,116,273,7,382,260,371,1,6.16%
2017-02,הצפון,9200,בית שאן,יישוב,700,310,390,26,674,310,677,50,6.40%
2017-02,הצפון,944,בסמת טבעון,יישוב,162,71,91,3,159,119,154,4,4.25%
2017-02,הצפון,483,בענה,יישוב,333,143,190,7,326,281,323,5,8.25%
2017-02,הצפון,1292,ג'דיידה-מכר,יישוב,1074,482,592,4,1070,862,1055,15,10.17%
2017-02,הצפון,485,ג'ולס,יישוב,192,53,139,3,189,122,192,1,5.81%
2017-02,הצפון,487,ג'ש (גוש חלב),יישוב,54,24,30,8,46,23,53,0,3.09%
2017-02,הצפון,489,דבורייה,יישוב,289,120,169,18,271,209,286,3,5.97%
2017-02,הצפון,490,דייר אל-אסד,יישוב,311,139,172,14,297,257,306,6,5.32%
2017-02,הצפון,492,דייר חנא,יישוב,598,259,339,6,592,456,591,4,10.93%
2017-02,הצפון,975,זרזיר,יישוב,209,86,123,5,204,142,204,5,5.65%
2017-02,הצפון,496,חורפיש,יישוב,95,40,55,6,89,53,93,2,3.05%
2017-02,הצפון,2034,חצור הגלילית,יישוב,246,101,145,13,233,117,229,10,4.67%
2017-02,הצפון,6700,טבריה,יישוב,1451,683,768,88,1363,701,1272,58,5.67%
2017-02,הצפון,962,טובא-זנגרייה,יישוב,323,156,167,4,319,226,312,3,9.07%
2017-02,הצפון,498,טורעאן,יישוב,382,176,206,5,377,319,370,4,5.79%
2017-02,הצפון,8900,טמרה,יישוב,1303,606,697,18,1285,1102,1276,11,8.14%
2017-02,הצפון,1295,יאנוח-ג'ת,יישוב,140,50,90,5,135,81,137,7,4.25%
2017-02,הצפון,46,יבנאל,יישוב,105,54,51,6,99,60,86,4,5.37%
2017-02,הצפון,29,יסוד המעלה,יישוב,19,8,11,7,12,3,18,0,2.05%
2017-02,הצפון,499,יפיע,יישוב,547,246,301,21,526,401,542,2,6.21%
2017-02,הצפון,240,יקנעם עילית,יישוב,410,173,237,65,345,108,403,29,3.13%
2017-02,הצפון,502,ירכא,יישוב,414,159,255,1,413,319,410,3,5.79%
2017-02,הצפון,504,כאבול,יישוב,451,217,234,6,445,387,440,2,8.03%
2017-02,הצפון,505,כאוכב אבו אל-היג'א,יישוב,205,91,114,2,203,169,203,0,10.57%
2017-02,הצפון,1296,כסרא-סמיע,יישוב,208,80,128,7,201,125,194,5,4.95%
2017-02,הצפון,978,כעביה-טבאש-חג'אג'רה,יישוב,158,61,97,0,158,112,153,3,5.91%
2017-02,הצפון,1263,כפר ורדים,יישוב,63,29,34,29,34,7,62,0,1.99%
2017-02,הצפון,507,כפר יאסיף,יישוב,402,165,237,8,394,271,394,4,7.19%
2017-02,הצפון,508,כפר כמא,יישוב,54,20,34,4,50,24,53,0,3.04%
2017-02,הצפון,509,כפר כנא,יישוב,771,373,398,25,746,633,737,15,7.53%
2017-02,הצפון,510,כפר מנדא,יישוב,684,346,338,7,677,520,677,4,8.32%
2017-02,הצפון,47,כפר תבור,יישוב,37,12,25,15,22,2,36,0,1.52%
2017-02,הצפון,1139,כרמיאל,יישוב,1400,573,827,278,1122,668,1290,48,4.96%
2017-02,הצפון,65,מ.א. אל-בטוף,מועצה איזורית,276,109,167,10,266,217,265,0,8.13%
2017-02,הצפון,66,מ.א. בוסתן אל-מרג,מועצה איזורית,36,10,26,1,35,29,34,0,0.97%
2017-02,הצפון,71,מ.א. גולן,מועצה איזורית,193,92,101,56,137,16,191,0,2.18%
2017-02,הצפון,8,מ.א. הגלבוע,מועצה איזורית,631,260,371,60,571,348,620,0,4.39%
2017-02,הצפון,1,מ.א. הגליל העליון,מועצה איזורית,212,98,114,77,135,16,211,0,2.36%
2017-02,הצפון,3,מ.א. הגליל התחתון,מועצה איזורית,100,44,56,30,70,9,100,0,1.66%
2017-02,הצפון,55,מ.א. מבואות החרמון,מועצה איזורית,100,37,63,25,75,16,99,0,2.47%
2017-02,הצפון,13,מ.א. מגידו,מועצה איזורית,91,34,57,37,54,9,91,0,1.61%
2017-02,הצפון,4,מ.א. מטה אשר,מועצה איזורית,445,199,246,87,358,170,431,0,3.03%
2017-02,הצפון,52,מ.א. מעלה יוסף,מועצה איזורית,178,84,94,21,157,46,176,0,3.07%
2017-02,הצפון,2,מ.א. מרום הגליל,מועצה איזורית,249,118,131,40,209,101,238,0,3.33%
2017-02,הצפון,56,מ.א. משגב,מועצה איזורית,565,222,343,128,437,291,547,0,3.87%
2017-02,הצפון,6,מ.א. עמק הירדן,מועצה איזורית,166,97,69,33,133,38,155,0,2.28%
2017-02,הצפון,7,מ.א. עמק המעיינות,מועצה איזורית,157,71,86,29,128,37,153,0,2.34%
2017-02,הצפון,9,מ.א. עמק יזרעאל,מועצה איזורית,329,142,187,148,181,33,324,0,1.66%
2017-02,הצפון,481,מגאר,יישוב,1243,532,711,23,1220,1007,1204,24,11.08%
2017-02,הצפון,516,מג'ד אל-כרום,יישוב,472,214,258,10,462,334,453,14,6.11%
2017-02,הצפון,65,מגדל,יישוב,38,19,19,2,36,17,34,0,3.41%
2017-02,הצפון,874,מגדל העמק,יישוב,715,320,395,73,642,285,669,67,4.89%
2017-02,הצפון,4201,מג'דל שמס,יישוב,425,168,257,8,417,311,401,4,7.53%
2017-02,הצפון,517,מזרעה,יישוב,152,73,79,2,150,113,149,4,6.88%
2017-02,הצפון,43,מטולה,יישוב,19,13,6,5,14,4,19,0,1.89%
2017-02,הצפון,4203,מסעדה,יישוב,191,67,124,3,188,153,175,4,9.58%
2017-02,הצפון,518,מעיליא,יישוב,61,35,26,7,54,18,61,1,3.53%
2017-02,הצפון,1063,מעלות-תרשיחא,יישוב,783,385,398,80,703,382,746,38,6.07%
2017-02,הצפון,520,משהד,יישוב,194,91,103,4,190,162,187,4,5.17%
2017-02,הצפון,9100,נהרייה,יישוב,1720,837,883,161,1559,931,1617,65,5.09%
2017-02,הצפון,522,נחף,יישוב,372,167,205,15,357,295,362,8,6.43%
2017-02,הצפון,7300,נצרת,יישוב,2694,1176,1518,126,2568,2007,2660,23,7.16%
2017-02,הצפון,1061,נצרת עילית,יישוב,1324,607,717,137,1187,640,1180,60,5.02%
2017-02,הצפון,525,סאג'ור,יישוב,94,35,59,6,88,71,93,0,4.29%
2017-02,הצפון,7500,סח'נין,יישוב,1887,851,1036,43,1844,1535,1865,13,11.79%
2017-02,הצפון,4501,ע'ג'ר,יישוב,91,29,62,1,90,62,90,0,7.43%
2017-02,הצפון,530,עיילבון,יישוב,165,77,88,10,155,101,161,2,5.51%
2017-02,הצפון,511,עילוט,יישוב,267,109,158,6,261,213,265,1,8.19%
2017-02,הצפון,532,עין מאהל,יישוב,386,196,190,11,375,293,374,2,6.33%
2017-02,הצפון,4502,עין קנייא,יישוב,141,56,85,4,137,105,135,3,11.84%
2017-02,הצפון,7600,עכו,יישוב,2752,1258,1494,144,2608,1999,2646,41,9.67%
2017-02,הצפון,7700,עפולה,יישוב,1405,608,797,166,1239,558,1337,78,4.87%
2017-02,הצפון,531,עראבה,יישוב,1396,588,808,33,1363,1198,1372,12,11.88%
2017-02,הצפון,535,פסוטה,יישוב,80,39,41,7,73,46,76,2,4.23%
2017-02,הצפון,536,פקיעין (בוקייעה),יישוב,129,72,57,4,125,81,124,3,4.11%
2017-02,הצפון,8000,צפת,יישוב,997,521,476,101,896,662,922,22,6.59%
2017-02,הצפון,4100,קצרין,יישוב,176,75,101,23,153,82,172,5,4.29%
2017-02,הצפון,2800,קריית שמונה,יישוב,718,362,356,80,638,283,692,36,5.30%
2017-02,הצפון,543,ראמה,יישוב,250,95,155,23,227,173,240,3,5.81%
2017-02,הצפון,26,ראש פינה,יישוב,42,18,24,6,36,19,39,1,2.37%
2017-02,הצפון,542,ריינה,יישוב,464,212,252,9,455,363,447,6,6.00%
2017-02,הצפון,122,רמת ישי,יישוב,78,32,46,35,43,9,75,0,1.82%
2017-02,הצפון,913,שבלי - אום אל-גנם,יישוב,194,86,108,6,188,123,190,7,6.61%
2017-02,הצפון,812,שלומי,יישוב,216,81,135,24,192,110,206,3,5.61%
2017-02,הצפון,538,שעב,יישוב,455,195,260,6,449,384,450,1,13.02%
2017-02,הצפון,8800,שפרעם,יישוב,1427,580,847,47,1380,1128,1387,33,7.03%
2017-02,חיפה,1326,"בסמ""ה",יישוב,355,156,199,5,350,275,351,2,7.75%
2017-02,חיפה,2710,אום אל-פחם,יישוב,2694,1125,1569,28,2666,2220,2648,33,11.21%
2017-02,חיפה,1020,אור עקיבא,יישוב,432,185,247,48,384,117,419,21,3.98%
2017-02,חיפה,6000,באקה אל-גרביה,יישוב,530,245,285,7,523,328,528,38,4.04%
2017-02,חיפה,9800,בנימינה-גבעת עדה*,יישוב,181,82,99,62,119,38,181,5,2.40%
2017-02,חיפה,541,ג'סר א-זרקא,יישוב,234,130,104,1,233,131,231,12,3.59%
2017-02,חיפה,628,ג'ת,יישוב,197,100,97,10,187,113,194,7,3.35%
2017-02,חיפה,494,דאלית אל-כרמל,יישוב,454,178,276,21,433,246,420,8,4.77%
2017-02,חיפה,9300,זכרון יעקב,יישוב,263,123,140,102,161,32,259,5,2.27%
2017-02,חיפה,6500,חדרה,יישוב,2053,940,1113,258,1795,686,1945,59,3.74%
2017-02,חיפה,4000,חיפה,יישוב,5400,2622,2778,1162,4238,2607,5063,146,3.58%
2017-02,חיפה,1247,חריש,יישוב,42,15,27,9,33,8,38,0,0.91%
2017-02,חיפה,2100,טירת כרמל,יישוב,637,310,327,36,601,315,623,22,5.08%
2017-02,חיפה,654,כפר קרע,יישוב,398,185,213,14,384,242,392,16,4.16%
2017-02,חיפה,45,מ.א. אלונה,מועצה איזורית,29,7,22,9,20,2,29,0,2.72%
2017-02,חיפה,12,מ.א. זבולון,מועצה איזורית,250,126,124,43,207,137,245,0,4.13%
2017-02,חיפה,15,מ.א. חוף הכרמל,מועצה איזורית,305,149,156,106,199,50,300,1,2.03%
2017-02,חיפה,14,מ.א. מנשה,מועצה איזורית,226,95,131,55,171,58,226,0,2.63%
2017-02,חיפה,1327,מעלה עירון,יישוב,658,261,397,4,654,532,649,10,9.81%
2017-02,חיפה,2500,נשר,יישוב,373,173,200,79,294,130,355,13,2.80%
2017-02,חיפה,534,עספיא,יישוב,299,133,166,15,284,151,276,5,4.50%
2017-02,חיפה,637,ערערה,יישוב,481,218,263,10,471,326,467,20,5.18%
2017-02,חיפה,537,פוריידיס,יישוב,259,149,110,6,253,124,257,8,4.19%
2017-02,חיפה,7800,פרדס חנה-כרכור,יישוב,707,310,397,180,527,153,696,26,3.24%
2017-02,חיפה,6800,קריית אתא,יישוב,1358,625,733,101,1257,665,1319,35,4.25%
2017-02,חיפה,9500,קריית ביאליק,יישוב,915,413,502,115,800,398,885,33,4.13%
2017-02,חיפה,2300,קריית טבעון,יישוב,179,77,102,82,97,29,174,0,2.07%
2017-02,חיפה,9600,קריית ים,יישוב,1234,574,660,108,1126,669,1187,40,5.57%
2017-02,חיפה,8200,קריית מוצקין,יישוב,853,357,496,141,712,345,828,24,3.55%
2017-02,חיפה,922,רכסים,יישוב,144,72,72,10,134,77,130,4,3.46%
2017-02,ירושלים,472,אבו גוש,יישוב,232,126,106,8,224,171,229,1,6.56%
2017-02,ירושלים,2610,בית שמש,יישוב,1134,475,659,97,1037,426,1081,41,2.89%
2017-02,ירושלים,3000,ירושלים,יישוב,11052,5026,6026,1314,9738,6832,10738,156,3.35%
2017-02,ירושלים,26,מ.א. מטה יהודה,מועצה איזורית,483,227,256,151,332,108,474,1,1.83%
2017-02,ירושלים,1015,מבשרת ציון,יישוב,319,158,161,68,251,111,311,4,2.43%
2017-02,ירושלים,1137,קריית יערים,יישוב,42,22,20,8,34,15,42,0,2.36%
2017-02,תל אביב,2400,אור יהודה,יישוב,582,289,293,61,521,134,563,30,2.93%
2017-02,תל אביב,565,אזור,יישוב,168,91,77,32,136,26,166,0,2.48%
2017-02,תל אביב,6100,בני ברק,יישוב,1546,793,753,79,1467,657,1429,20,2.36%
2017-02,תל אביב,6200,בת ים,יישוב,2543,1237,1306,358,2185,850,2404,80,3.41%
2017-02,תל אביב,6300,גבעתיים,יישוב,690,313,377,329,361,68,688,8,2.16%
2017-02,תל אביב,6400,הרצלייה,יישוב,1013,461,552,371,642,31,1007,7,2.05%
2017-02,תל אביב,6600,חולון,יישוב,2764,1233,1531,463,2301,619,2692,66,2.67%
2017-02,תל אביב,267,כפר שמריהו,יישוב,7,3,4,5,2,0,7,0,0.84%
2017-02,תל אביב,2620,קריית אונו,יישוב,380,159,221,175,205,32,375,4,1.92%
2017-02,תל אביב,8600,רמת גן,יישוב,1899,889,1010,662,1237,309,1858,32,2.27%
2017-02,תל אביב,2650,רמת השרון,יישוב,369,148,221,175,194,11,367,5,1.60%
2017-02,תל אביב,5000,תל אביב -יפו,יישוב,6943,3506,3437,2570,4373,1540,6811,106,2.58%
2017-03,אזור יהודה והשומרון,3760,אורנית,יישוב,80,37,43,31,49,4,80,0,1.60%
2017-03,אזור יהודה והשומרון,3750,אלפי מנשה,יישוב,89,31,58,30,59,1,88,2,1.98%
2017-03,אזור יהודה והשומרון,3560,אלקנה,יישוב,29,13,16,16,13,0,29,0,1.58%
2017-03,אזור יהודה והשומרון,3650,אפרת,יישוב,55,31,24,28,27,2,55,1,1.12%
2017-03,אזור יהודה והשומרון,3570,אריאל,יישוב,277,126,151,65,212,22,272,18,2.48%
2017-03,אזור יהודה והשומרון,3574,בית אל,יישוב,56,25,31,20,36,15,56,0,2.23%
2017-03,אזור יהודה והשומרון,3652,בית אריה,יישוב,53,28,25,13,40,1,53,1,1.85%
2017-03,אזור יהודה והשומרון,3780,ביתר עילית,יישוב,459,208,251,13,446,154,451,2,2.90%
2017-03,אזור יהודה והשומרון,3730,גבעת זאב,יישוב,176,81,95,43,133,33,174,1,2.15%
2017-03,אזור יהודה והשומרון,3769,הר אדר,יישוב,28,10,18,15,13,2,28,0,1.28%
2017-03,אזור יהודה והשומרון,76,מ.א. גוש עציון,מועצה איזורית,156,69,87,54,102,13,155,0,1.53%
2017-03,אזור יהודה והשומרון,78,מ.א. הר חברון,מועצה איזורית,73,36,37,35,38,4,73,0,1.84%
2017-03,אזור יהודה והשומרון,74,מ.א. מגילות ים המלח,מועצה איזורית,15,4,11,5,10,0,15,0,1.63%
2017-03,אזור יהודה והשומרון,73,מ.א. מטה בנימין,מועצה איזורית,588,298,290,185,403,102,581,0,2.05%
2017-03,אזור יהודה והשומרון,75,מ.א. ערבות הירדן,מועצה איזורית,49,25,24,12,37,6,48,0,1.87%
2017-03,אזור יהודה והשומרון,72,מ.א. שומרון,מועצה איזורית,368,191,177,124,244,33,362,0,1.91%
2017-03,אזור יהודה והשומרון,3797,מודיעין עילית,יישוב,382,118,264,23,359,28,377,7,2.36%
2017-03,אזור יהודה והשומרון,3616,מעלה אדומים,יישוב,559,245,314,85,474,165,552,17,2.64%
2017-03,אזור יהודה והשומרון,3608,מעלה אפרים,יישוב,29,10,19,0,29,10,28,1,3.50%
2017-03,אזור יהודה והשומרון,3660,עמנואל,יישוב,40,22,18,2,38,23,40,0,2.96%
2017-03,אזור יהודה והשומרון,3557,קדומים,יישוב,30,17,13,12,18,3,29,0,1.46%
2017-03,אזור יהודה והשומרון,3611,קריית ארבע,יישוב,89,51,38,21,68,41,87,4,2.59%
2017-03,אזור יהודה והשומרון,3640,קרני שומרון,יישוב,68,40,28,18,50,5,68,1,1.68%
2017-03,הדרום,31,אופקים,יישוב,789,366,423,49,740,451,761,35,5.28%
2017-03,הדרום,2600,אילת,יישוב,1075,538,537,65,1010,352,1010,56,2.92%
2017-03,הדרום,70,אשדוד,יישוב,5019,2096,2923,632,4387,2270,4752,126,4.24%
2017-03,הדרום,7100,אשקלון,יישוב,3431,1473,1958,380,3051,1644,3020,68,4.08%
2017-03,הדרום,9000,באר שבע,יישוב,5271,2449,2822,682,4589,2845,4977,121,4.64%
2017-03,הדרום,2200,דימונה,יישוב,1610,750,860,95,1515,1107,1516,40,7.77%
2017-03,הדרום,1303,חורה,יישוב,541,230,311,7,534,458,521,7,10.74%
2017-03,הדרום,831,ירוחם,יישוב,367,179,188,19,348,216,341,19,6.67%
2017-03,הדרום,1059,כסיפה,יישוב,984,394,590,4,980,868,970,2,17.80%
2017-03,הדרום,1271,להבים,יישוב,51,16,35,28,23,4,51,1,1.44%
2017-03,הדרום,1060,לקיה,יישוב,633,280,353,9,624,547,612,4,12.40%
2017-03,הדרום,69,מ.א. אל קסום,מועצה איזורית,632,250,382,5,627,562,612,0,17.94%
2017-03,הדרום,38,מ.א. אשכול,מועצה איזורית,114,42,72,38,76,7,111,0,1.58%
2017-03,הדרום,33,מ.א. באר טוביה,מועצה איזורית,276,123,153,54,222,41,276,0,2.44%
2017-03,הדרום,41,מ.א. בני שמעון,מועצה איזורית,81,31,50,29,52,13,81,1,1.67%
2017-03,הדרום,54,מ.א. הערבה התיכונה,מועצה איזורית,20,11,9,5,15,0,20,0,1.05%
2017-03,הדרום,53,מ.א. חבל אילות,מועצה איזורית,25,8,17,6,19,0,25,2,1.01%
2017-03,הדרום,36,מ.א. חוף אשקלון,מועצה איזורית,183,83,100,25,158,38,172,0,1.98%
2017-03,הדרום,35,מ.א. יואב,מועצה איזורית,79,32,47,29,50,6,79,0,1.93%
2017-03,הדרום,50,מ.א. לכיש,מועצה איזורית,153,71,82,20,133,38,152,0,2.73%
2017-03,הדרום,42,מ.א. מרחבים,מועצה איזורית,161,54,107,30,131,27,158,0,2.51%
2017-03,הדרום,68,מ.א. נווה מדבר,מועצה איזורית,116,45,71,0,116,93,114,0,6.03%
2017-03,הדרום,48,מ.א. רמת נגב,מועצה איזורית,250,130,120,19,231,181,247,0,7.42%
2017-03,הדרום,39,מ.א. שדות נגב,מועצה איזורית,117,58,59,18,99,27,112,0,2.30%
2017-03,הדרום,37,מ.א. שער הנגב,מועצה איזורית,93,46,47,39,54,14,91,0,2.28%
2017-03,הדרום,34,מ.א. שפיר,מועצה איזורית,129,60,69,18,111,42,127,0,2.55%
2017-03,הדרום,51,מ.א. תמר,מועצה איזורית,8,4,4,1,7,1,8,0,1.23%
2017-03,הדרום,1268,מיתר,יישוב,74,28,46,29,45,4,72,1,1.46%
2017-03,הדרום,99,מצפה רמון,יישוב,236,90,146,18,218,151,224,17,8.03%
2017-03,הדרום,246,נתיבות,יישוב,849,377,472,49,800,396,797,56,4.86%
2017-03,הדרום,666,עומר,יישוב,61,21,40,29,32,3,60,0,1.42%
2017-03,הדרום,2560,ערד,יישוב,680,321,359,63,617,330,648,28,5.08%
2017-03,הדרום,1192,ערערה-בנגב,יישוב,1071,457,614,4,1067,960,1051,2,20.11%
2017-03,הדרום,2630,קריית גת,יישוב,1501,622,879,79,1422,688,1428,47,4.88%
2017-03,הדרום,1034,קריית מלאכי,יישוב,692,316,376,25,667,280,669,37,5.41%
2017-03,הדרום,1161,רהט,יישוב,2236,905,1331,14,2222,1822,2212,90,9.79%
2017-03,הדרום,1286,שגב-שלום,יישוב,339,135,204,4,335,284,325,2,10.03%
2017-03,הדרום,1031,שדרות,יישוב,884,408,476,57,827,484,811,27,5.47%
2017-03,הדרום,1054,תל שבע,יישוב,728,321,407,1,727,635,702,7,12.12%
2017-03,המרכז,1066,"בני עי""ש",יישוב,125,63,62,18,107,41,122,2,3.04%
2017-03,המרכז,182,אבן יהודה,יישוב,168,81,87,53,115,19,166,0,2.37%
2017-03,המרכז,41,אליכין,יישוב,56,33,23,7,49,17,52,1,2.65%
2017-03,המרכז,1309,אלעד,יישוב,294,115,179,23,271,31,287,2,2.02%
2017-03,המרכז,2530,באר יעקב,יישוב,235,96,139,71,164,41,232,7,1.81%
2017-03,המרכז,466,בית דגן,יישוב,102,56,46,11,91,29,100,1,2.67%
2017-03,המרכז,681,גבעת שמואל,יישוב,257,136,121,81,176,36,250,1,2.00%
2017-03,המרכז,2550,גדרה,יישוב,294,124,170,47,247,76,283,3,2.18%
2017-03,המרכז,627,ג'לג'וליה,יישוב,72,35,37,2,70,40,69,1,1.61%
2017-03,המרכז,166,גן יבנה,יישוב,321,134,187,47,274,63,311,7,2.44%
2017-03,המרכז,229,גני תקווה,יישוב,212,101,111,82,130,26,210,0,2.17%
2017-03,המרכז,9700,הוד השרון,יישוב,625,270,355,296,329,27,618,7,1.89%
2017-03,המרכז,1290,זמר,יישוב,118,45,73,3,115,75,116,10,3.54%
2017-03,המרכז,2730,טייבה,יישוב,1060,501,559,38,1022,755,906,27,4.65%
2017-03,המרכז,2720,טירה,יישוב,184,90,94,13,171,57,178,16,1.42%
2017-03,המרכז,2660,יבנה,יישוב,684,329,355,137,547,170,673,20,2.67%
2017-03,המרכז,9400,יהוד,יישוב,345,152,193,85,260,37,338,4,2.07%
2017-03,המרכז,1224,כוכב יאיר,יישוב,79,42,37,48,31,1,79,1,1.42%
2017-03,המרכז,633,כפר ברא,יישוב,10,5,5,2,8,7,9,0,0.56%
2017-03,המרכז,168,כפר יונה,יישוב,288,133,155,62,226,48,287,9,2.45%
2017-03,המרכז,6900,כפר סבא,יישוב,1046,489,557,428,618,85,1029,16,1.95%
2017-03,המרכז,634,כפר קאסם,יישוב,223,92,131,11,212,109,216,3,2.09%
2017-03,המרכז,7000,לוד,יישוב,1683,826,857,137,1546,875,1646,54,4.44%
2017-03,המרכז,28,מ.א. ברנר,מועצה איזורית,68,27,41,33,35,2,67,0,1.65%
2017-03,המרכז,32,מ.א. גדרות,מועצה איזורית,45,17,28,25,20,3,45,0,1.82%
2017-03,המרכז,30,מ.א. גזר,מועצה איזורית,241,115,126,90,151,27,237,0,1.77%
2017-03,המרכז,27,מ.א. גן רווה,מועצה איזורית,57,26,31,24,33,1,57,0,1.90%
2017-03,המרכז,20,מ.א. דרום השרון,מועצה איזורית,336,131,205,158,178,11,332,0,2.05%
2017-03,המרכז,29,מ.א. חבל יבנה,מועצה איזורית,32,17,15,17,15,2,32,0,1.22%
2017-03,המרכז,25,מ.א. חבל מודיעין,מועצה איזורית,192,84,108,63,129,19,188,0,1.71%
2017-03,המרכז,19,מ.א. חוף השרון,מועצה איזורית,88,33,55,42,46,3,88,0,1.58%
2017-03,המרכז,18,מ.א. לב השרון,מועצה איזורית,253,125,128,78,175,29,249,0,2.24%
2017-03,המרכז,31,מ.א. נחל שורק,מועצה איזורית,49,24,25,9,40,6,49,35,1.15%
2017-03,המרכז,16,מ.א. עמק חפר,מועצה איזורית,363,137,226,154,209,13,362,0,1.84%
2017-03,המרכז,40,מ.א. שדות דן,מועצה איזורית,125,54,71,39,86,10,124,0,1.92%
2017-03,המרכז,1200,מודיעין-מכבים-רעות*,יישוב,811,366,445,342,469,47,799,22,1.73%
2017-03,המרכז,28,מזכרת בתיה,יישוב,150,55,95,50,100,18,148,0,1.82%
2017-03,המרכז,7200,נס ציונה,יישוב,621,302,319,157,464,155,611,13,2.46%
2017-03,המרכז,7400,נתניה,יישוב,3752,1848,1904,475,3277,1214,3671,86,3.38%
2017-03,המרכז,587,סביון*,יישוב,14,4,10,8,6,1,14,0,0.67%
2017-03,המרכז,171,פרדסייה,יישוב,76,38,38,28,48,8,75,0,1.99%
2017-03,המרכז,7900,פתח תקווה,יישוב,3510,1621,1889,777,2733,821,3416,41,2.64%
2017-03,המרכז,195,קדימה-צורן,יישוב,255,114,141,77,178,38,253,1,2.16%
2017-03,המרכז,638,קלנסווה,יישוב,358,190,168,9,349,249,320,14,3.28%
2017-03,המרכז,469,קריית עקרון,יישוב,218,101,117,27,191,93,209,6,3.43%
2017-03,המרכז,2640,ראש העין,יישוב,719,336,383,132,587,121,711,14,2.30%
2017-03,המרכז,8300,ראשון לציון,יישוב,3865,1687,2178,767,3098,935,3824,65,2.72%
2017-03,המרכז,8400,רחובות,יישוב,2090,923,1167,525,1565,674,2008,44,2.83%
2017-03,המרכז,8500,רמלה,יישוב,1438,691,747,125,1313,570,1381,55,3.55%
2017-03,המרכז,8700,רעננה,יישוב,656,296,360,283,373,41,646,8,1.71%
2017-03,המרכז,1304,שוהם,יישוב,163,65,98,77,86,7,162,1,1.34%
2017-03,המרכז,154,תל מונד,יישוב,144,71,73,52,92,15,144,0,2.08%
2017-03,הצפון,473,אבו סנאן,יישוב,547,227,320,4,543,429,539,11,8.48%
2017-03,הצפון,478,אכסאל,יישוב,435,190,245,12,423,375,429,4,6.70%
2017-03,הצפון,529,אעבלין,יישוב,423,176,247,12,411,342,417,10,6.67%
2017-03,הצפון,482,בועיינה-נוג'ידאת,יישוב,291,131,160,6,285,216,285,3,6.51%
2017-03,הצפון,4001,בוקעאתא,יישוב,408,152,256,6,402,303,393,9,12.67%
2017-03,הצפון,998,ביר אל-מכסור,יישוב,322,144,178,6,316,236,317,2,7.50%
2017-03,הצפון,480,בית ג'ן,יישוב,394,112,282,7,387,248,376,6,6.24%
2017-03,הצפון,9200,בית שאן,יישוב,669,297,372,28,641,309,646,51,6.12%
2017-03,הצפון,944,בסמת טבעון,יישוב,169,77,92,2,167,118,160,4,4.41%
2017-03,הצפון,483,בענה,יישוב,337,145,192,6,331,284,325,5,8.30%
2017-03,הצפון,1292,ג'דיידה-מכר,יישוב,1065,474,591,3,1062,846,1043,11,10.07%
2017-03,הצפון,485,ג'ולס,יישוב,178,49,129,2,176,118,178,3,5.41%
2017-03,הצפון,487,ג'ש (גוש חלב),יישוב,50,24,26,4,46,22,50,1,2.92%
2017-03,הצפון,489,דבורייה,יישוב,299,124,175,16,283,214,294,4,6.13%
2017-03,הצפון,490,דייר אל-אסד,יישוב,316,143,173,15,301,259,309,9,5.37%
2017-03,הצפון,492,דייר חנא,יישוב,596,258,338,12,584,449,588,6,10.88%
2017-03,הצפון,975,זרזיר,יישוב,212,88,124,4,208,139,208,6,5.76%
2017-03,הצפון,496,חורפיש,יישוב,88,39,49,6,82,52,86,1,2.83%
2017-03,הצפון,2034,חצור הגלילית,יישוב,240,96,144,15,225,118,223,6,4.56%
2017-03,הצפון,6700,טבריה,יישוב,1376,656,720,75,1301,693,1181,64,5.28%
2017-03,הצפון,962,טובא-זנגרייה,יישוב,312,153,159,3,309,214,302,6,8.80%
2017-03,הצפון,498,טורעאן,יישוב,369,159,210,5,364,305,359,10,5.63%
2017-03,הצפון,8900,טמרה,יישוב,1270,589,681,18,1252,1070,1241,11,7.93%
2017-03,הצפון,1295,יאנוח-ג'ת,יישוב,146,49,97,7,139,82,142,3,4.40%
2017-03,הצפון,46,יבנאל,יישוב,102,52,50,7,95,60,80,2,5.02%
2017-03,הצפון,29,יסוד המעלה,יישוב,21,10,11,8,13,3,20,0,2.27%
2017-03,הצפון,499,יפיע,יישוב,544,248,296,24,520,394,540,4,6.19%
2017-03,הצפון,240,יקנעם עילית,יישוב,406,171,235,64,342,103,396,32,3.07%
2017-03,הצפון,502,ירכא,יישוב,397,151,246,2,395,306,395,3,5.59%
2017-03,הצפון,504,כאבול,יישוב,450,220,230,5,445,377,438,2,8.00%
2017-03,הצפון,505,כאוכב אבו אל-היג'א,יישוב,205,90,115,2,203,166,204,4,10.62%
2017-03,הצפון,1296,כסרא-סמיע,יישוב,214,74,140,5,209,125,200,3,5.10%
2017-03,הצפון,978,כעביה-טבאש-חג'אג'רה,יישוב,156,60,96,1,155,105,151,2,5.84%
2017-03,הצפון,1263,כפר ורדים,יישוב,56,27,29,25,31,6,54,0,1.74%
2017-03,הצפון,507,כפר יאסיף,יישוב,384,163,221,9,375,254,379,6,6.94%
2017-03,הצפון,508,כפר כמא,יישוב,50,19,31,5,45,23,49,1,2.82%
2017-03,הצפון,509,כפר כנא,יישוב,764,374,390,23,741,621,730,12,7.47%
2017-03,הצפון,510,כפר מנדא,יישוב,676,344,332,9,667,510,669,3,8.23%
2017-03,הצפון,47,כפר תבור,יישוב,47,16,31,20,27,2,44,1,1.86%
2017-03,הצפון,1139,כרמיאל,יישוב,1366,577,789,269,1097,671,1259,39,4.85%
2017-03,הצפון,65,מ.א. אל-בטוף,מועצה איזורית,263,106,157,8,255,210,254,3,7.81%
2017-03,הצפון,66,מ.א. בוסתן אל-מרג,מועצה איזורית,37,11,26,0,37,31,35,0,0.99%
2017-03,הצפון,71,מ.א. גולן,מועצה איזורית,191,85,106,49,142,18,189,0,2.15%
2017-03,הצפון,8,מ.א. הגלבוע,מועצה איזורית,603,256,347,51,552,330,593,0,4.20%
2017-03,הצפון,1,מ.א. הגליל העליון,מועצה איזורית,208,91,117,75,133,19,207,0,2.31%
2017-03,הצפון,3,מ.א. הגליל התחתון,מועצה איזורית,95,40,55,26,69,11,93,0,1.54%
2017-03,הצפון,55,מ.א. מבואות החרמון,מועצה איזורית,89,31,58,20,69,15,89,1,2.22%
2017-03,הצפון,13,מ.א. מגידו,מועצה איזורית,87,27,60,33,54,9,87,0,1.54%
2017-03,הצפון,4,מ.א. מטה אשר,מועצה איזורית,427,187,240,80,347,167,415,0,2.92%
2017-03,הצפון,52,מ.א. מעלה יוסף,מועצה איזורית,176,85,91,24,152,45,175,0,3.05%
2017-03,הצפון,2,מ.א. מרום הגליל,מועצה איזורית,229,107,122,34,195,99,216,0,3.03%
2017-03,הצפון,56,מ.א. משגב,מועצה איזורית,556,218,338,124,432,287,542,0,3.83%
2017-03,הצפון,6,מ.א. עמק הירדן,מועצה איזורית,169,93,76,31,138,35,161,0,2.37%
2017-03,הצפון,7,מ.א. עמק המעיינות,מועצה איזורית,160,75,85,29,131,38,157,0,2.40%
2017-03,הצפון,9,מ.א. עמק יזרעאל,מועצה איזורית,304,140,164,143,161,35,300,0,1.53%
2017-03,הצפון,481,מגאר,יישוב,1221,517,704,24,1197,979,1181,20,10.89%
2017-03,הצפון,516,מג'ד אל-כרום,יישוב,476,217,259,11,465,338,454,14,6.13%
2017-03,הצפון,65,מגדל,יישוב,30,15,15,1,29,14,27,3,2.72%
2017-03,הצפון,874,מגדל העמק,יישוב,706,310,396,75,631,281,648,58,4.74%
2017-03,הצפון,4201,מג'דל שמס,יישוב,433,176,257,11,422,319,412,2,7.72%
2017-03,הצפון,517,מזרעה,יישוב,157,72,85,2,155,115,150,4,6.93%
2017-03,הצפון,43,מטולה,יישוב,20,13,7,6,14,4,19,0,1.89%
2017-03,הצפון,4203,מסעדה,יישוב,190,73,117,3,187,145,178,0,9.73%
2017-03,הצפון,518,מעיליא,יישוב,63,33,30,9,54,21,60,4,3.47%
2017-03,הצפון,1063,מעלות-תרשיחא,יישוב,737,370,367,83,654,370,704,36,5.75%
2017-03,הצפון,520,משהד,יישוב,193,91,102,3,190,148,186,5,5.15%
2017-03,הצפון,9100,נהרייה,יישוב,1694,815,879,157,1537,924,1594,71,5.02%
2017-03,הצפון,522,נחף,יישוב,371,178,193,17,354,287,357,3,6.34%
2017-03,הצפון,7300,נצרת,יישוב,2653,1164,1489,120,2533,1981,2629,21,7.09%
2017-03,הצפון,1061,נצרת עילית,יישוב,1348,599,749,146,1202,664,1183,85,5.03%
2017-03,הצפון,525,סאג'ור,יישוב,107,39,68,6,101,72,105,2,4.82%
2017-03,הצפון,7500,סח'נין,יישוב,1837,830,1007,42,1795,1490,1816,23,11.52%
2017-03,הצפון,4501,ע'ג'ר,יישוב,90,28,62,1,89,62,89,1,7.36%
2017-03,הצפון,530,עיילבון,יישוב,154,70,84,10,144,93,150,3,5.15%
2017-03,הצפון,511,עילוט,יישוב,254,102,152,3,251,202,253,4,7.84%
2017-03,הצפון,532,עין מאהל,יישוב,386,200,186,14,372,288,376,3,6.36%
2017-03,הצפון,4502,עין קנייא,יישוב,129,46,83,3,126,105,122,0,10.83%
2017-03,הצפון,7600,עכו,יישוב,2752,1268,1484,154,2598,1977,2662,33,9.72%
2017-03,הצפון,7700,עפולה,יישוב,1401,584,817,174,1227,557,1334,63,4.86%
2017-03,הצפון,531,עראבה,יישוב,1362,576,786,35,1327,1160,1341,9,11.65%
2017-03,הצפון,535,פסוטה,יישוב,86,44,42,11,75,44,83,3,4.60%
2017-03,הצפון,536,פקיעין (בוקייעה),יישוב,126,73,53,4,122,79,119,5,3.95%
2017-03,הצפון,8000,צפת,יישוב,943,496,447,104,839,637,868,15,6.23%
2017-03,הצפון,4100,קצרין,יישוב,185,76,109,25,160,87,181,6,4.50%
2017-03,הצפון,2800,קריית שמונה,יישוב,679,347,332,74,605,289,653,37,5.02%
2017-03,הצפון,543,ראמה,יישוב,246,92,154,18,228,169,238,4,5.77%
2017-03,הצפון,26,ראש פינה,יישוב,38,17,21,4,34,18,37,1,2.25%
2017-03,הצפון,542,ריינה,יישוב,450,211,239,9,441,344,439,10,5.90%
2017-03,הצפון,122,רמת ישי,יישוב,84,37,47,30,54,12,80,1,1.94%
2017-03,הצפון,913,שבלי - אום אל-גנם,יישוב,190,82,108,4,186,119,185,6,6.44%
2017-03,הצפון,812,שלומי,יישוב,213,78,135,23,190,106,205,4,5.58%
2017-03,הצפון,538,שעב,יישוב,454,201,253,6,448,377,448,1,12.97%
2017-03,הצפון,8800,שפרעם,יישוב,1381,570,811,55,1326,1093,1343,33,6.82%
2017-03,חיפה,1326,"בסמ""ה",יישוב,340,154,186,5,335,262,334,8,7.41%
2017-03,חיפה,2710,אום אל-פחם,יישוב,2643,1121,1522,25,2618,2167,2593,40,11.00%
2017-03,חיפה,1020,אור עקיבא,יישוב,417,181,236,41,376,113,399,18,3.80%
2017-03,חיפה,6000,באקה אל-גרביה,יישוב,521,254,267,8,513,329,519,21,3.98%
2017-03,חיפה,9800,בנימינה-גבעת עדה*,יישוב,174,77,97,67,107,34,173,1,2.30%
2017-03,חיפה,541,ג'סר א-זרקא,יישוב,220,132,88,1,219,118,220,14,3.43%
2017-03,חיפה,628,ג'ת,יישוב,187,98,89,9,178,113,185,5,3.20%
2017-03,חיפה,494,דאלית אל-כרמל,יישוב,450,174,276,24,426,238,416,4,4.73%
2017-03,חיפה,9300,זכרון יעקב,יישוב,262,125,137,102,160,36,258,1,2.26%
2017-03,חיפה,6500,חדרה,יישוב,2023,910,1113,247,1776,679,1909,40,3.67%
2017-03,חיפה,4000,חיפה,יישוב,5306,2558,2748,1148,4158,2555,4982,147,3.52%
2017-03,חיפה,1247,חריש,יישוב,48,13,35,10,38,9,43,0,1.03%
2017-03,חיפה,2100,טירת כרמל,יישוב,629,313,316,36,593,325,612,24,4.99%
2017-03,חיפה,654,כפר קרע,יישוב,395,180,215,16,379,241,388,16,4.12%
2017-03,חיפה,45,מ.א. אלונה,מועצה איזורית,25,6,19,9,16,1,25,0,2.34%
2017-03,חיפה,12,מ.א. זבולון,מועצה איזורית,249,122,127,42,207,131,240,0,4.05%
2017-03,חיפה,15,מ.א. חוף הכרמל,מועצה איזורית,287,142,145,95,192,48,280,3,1.89%
2017-03,חיפה,14,מ.א. מנשה,מועצה איזורית,225,98,127,60,165,52,225,0,2.62%
2017-03,חיפה,1327,מעלה עירון,יישוב,650,250,400,3,647,520,638,9,9.66%
2017-03,חיפה,2500,נשר,יישוב,390,194,196,74,316,144,370,5,2.92%
2017-03,חיפה,534,עספיא,יישוב,293,126,167,17,276,145,274,10,4.47%
2017-03,חיפה,637,ערערה,יישוב,480,218,262,10,470,324,465,17,5.16%
2017-03,חיפה,537,פוריידיס,יישוב,244,143,101,3,241,124,243,5,3.97%
2017-03,חיפה,7800,פרדס חנה-כרכור,יישוב,712,318,394,177,535,137,705,32,3.28%
2017-03,חיפה,6800,קריית אתא,יישוב,1342,625,717,96,1246,656,1306,20,4.21%
2017-03,חיפה,9500,קריית ביאליק,יישוב,915,408,507,116,799,389,888,30,4.14%
2017-03,חיפה,2300,קריית טבעון,יישוב,161,64,97,76,85,29,159,2,1.90%
2017-03,חיפה,9600,קריית ים,יישוב,1215,547,668,114,1101,668,1164,29,5.47%
2017-03,חיפה,8200,קריית מוצקין,יישוב,838,344,494,127,711,347,806,31,3.46%
2017-03,חיפה,922,רכסים,יישוב,137,64,73,10,127,77,120,3,3.21%
2017-03,ירושלים,472,אבו גוש,יישוב,225,115,110,7,218,166,221,2,6.34%
2017-03,ירושלים,2610,בית שמש,יישוב,1043,443,600,92,951,415,987,28,2.64%
2017-03,ירושלים,3000,ירושלים,יישוב,11092,5016,6076,1276,9816,6794,10783,159,3.37%
2017-03,ירושלים,26,מ.א. מטה יהודה,מועצה איזורית,505,232,273,154,351,106,494,1,1.91%
2017-03,ירושלים,1015,מבשרת ציון,יישוב,295,142,153,66,229,112,287,2,2.25%
2017-03,ירושלים,1137,קריית יערים,יישוב,39,21,18,6,33,13,39,0,2.19%
2017-03,תל אביב,2400,אור יהודה,יישוב,561,270,291,62,499,129,539,27,2.81%
2017-03,תל אביב,565,אזור,יישוב,164,90,74,23,141,27,162,1,2.42%
2017-03,תל אביב,6100,בני ברק,יישוב,1497,760,737,77,1420,628,1376,22,2.28%
2017-03,תל אביב,6200,בת ים,יישוב,2491,1227,1264,379,2112,825,2364,78,3.35%
2017-03,תל אביב,6300,גבעתיים,יישוב,661,303,358,324,337,60,657,5,2.07%
2017-03,תל אביב,6400,הרצלייה,יישוב,1032,470,562,392,640,31,1021,11,2.08%
2017-03,תל אביב,6600,חולון,יישוב,2744,1225,1519,474,2270,609,2669,55,2.65%
2017-03,תל אביב,267,כפר שמריהו,יישוב,7,3,4,5,2,0,7,0,0.84%
2017-03,תל אביב,2620,קריית אונו,יישוב,381,157,224,176,205,35,375,3,1.92%
2017-03,תל אביב,8600,רמת גן,יישוב,1898,899,999,682,1216,284,1861,22,2.28%
2017-03,תל אביב,2650,רמת השרון,יישוב,383,154,229,175,208,12,377,1,1.64%
2017-03,תל אביב,5000,תל אביב -יפו,יישוב,6964,3510,3454,2575,4389,1512,6822,103,2.59%
2017-04,אזור יהודה והשומרון,3760,אורנית,יישוב,79,33,46,31,48,2,79,1,1.58%
2017-04,אזור יהודה והשומרון,3750,אלפי מנשה,יישוב,83,28,55,26,57,1,83,0,1.87%
2017-04,אזור יהודה והשומרון,3560,אלקנה,יישוב,30,15,15,18,12,0,30,1,1.63%
2017-04,אזור יהודה והשומרון,3650,אפרת,יישוב,62,38,24,32,30,0,60,1,1.22%
2017-04,אזור יהודה והשומרון,3570,אריאל,יישוב,261,122,139,65,196,21,259,10,2.36%
2017-04,אזור יהודה והשומרון,3574,בית אל,יישוב,52,24,28,21,31,12,51,1,2.04%
2017-04,אזור יהודה והשומרון,3652,בית אריה,יישוב,53,29,24,12,41,0,52,0,1.81%
2017-04,אזור יהודה והשומרון,3780,ביתר עילית,יישוב,421,196,225,12,409,146,418,2,2.69%
2017-04,אזור יהודה והשומרון,3730,גבעת זאב,יישוב,162,76,86,36,126,29,162,3,2.00%
2017-04,אזור יהודה והשומרון,3769,הר אדר,יישוב,24,8,16,14,10,3,24,0,1.10%
2017-04,אזור יהודה והשומרון,76,מ.א. גוש עציון,מועצה איזורית,154,68,86,53,101,15,153,0,1.51%
2017-04,אזור יהודה והשומרון,78,מ.א. הר חברון,מועצה איזורית,61,32,29,30,31,3,61,0,1.54%
2017-04,אזור יהודה והשומרון,74,מ.א. מגילות ים המלח,מועצה איזורית,17,6,11,5,12,0,17,0,1.85%
2017-04,אזור יהודה והשומרון,73,מ.א. מטה בנימין,מועצה איזורית,555,278,277,189,366,106,548,0,1.93%
2017-04,אזור יהודה והשומרון,75,מ.א. ערבות הירדן,מועצה איזורית,46,21,25,11,35,5,46,0,1.79%
2017-04,אזור יהודה והשומרון,72,מ.א. שומרון,מועצה איזורית,341,163,178,111,230,36,339,0,1.79%
2017-04,אזור יהודה והשומרון,3797,מודיעין עילית,יישוב,373,113,260,23,350,26,371,1,2.32%
2017-04,אזור יהודה והשומרון,3616,מעלה אדומים,יישוב,528,232,296,72,456,148,518,11,2.48%
2017-04,אזור יהודה והשומרון,3608,מעלה אפרים,יישוב,29,11,18,1,28,10,29,0,3.63%
2017-04,אזור יהודה והשומרון,3660,עמנואל,יישוב,40,24,16,2,38,23,40,0,2.96%
2017-04,אזור יהודה והשומרון,3557,קדומים,יישוב,27,13,14,10,17,4,26,0,1.31%
2017-04,אזור יהודה והשומרון,3611,קריית ארבע,יישוב,94,52,42,23,71,41,90,2,2.67%
2017-04,אזור יהודה והשומרון,3640,קרני שומרון,יישוב,64,33,31,21,43,5,64,0,1.58%
2017-04,הדרום,31,אופקים,יישוב,774,345,429,48,726,438,741,20,5.15%
2017-04,הדרום,2600,אילת,יישוב,892,465,427,63,829,328,834,30,2.42%
2017-04,הדרום,70,אשדוד,יישוב,4751,2009,2742,598,4153,2165,4509,70,4.03%
2017-04,הדרום,7100,אשקלון,יישוב,3301,1418,1883,377,2924,1550,2933,39,3.96%
2017-04,הדרום,9000,באר שבע,יישוב,5016,2329,2687,688,4328,2715,4765,58,4.45%
2017-04,הדרום,2200,דימונה,יישוב,1578,745,833,89,1489,1072,1493,35,7.66%
2017-04,הדרום,1303,חורה,יישוב,514,212,302,6,508,438,501,3,10.37%
2017-04,הדרום,831,ירוחם,יישוב,345,161,184,18,327,207,322,7,6.32%
2017-04,הדרום,1059,כסיפה,יישוב,955,372,583,3,952,862,945,1,17.42%
2017-04,הדרום,1271,להבים,יישוב,46,13,33,21,25,5,46,0,1.30%
2017-04,הדרום,1060,לקיה,יישוב,614,272,342,8,606,533,595,4,12.10%
2017-04,הדרום,69,מ.א. אל קסום,מועצה איזורית,607,239,368,4,603,537,590,0,17.30%
2017-04,הדרום,38,מ.א. אשכול,מועצה איזורית,109,44,65,33,76,9,106,0,1.51%
2017-04,הדרום,33,מ.א. באר טוביה,מועצה איזורית,261,116,145,50,211,40,259,0,2.29%
2017-04,הדרום,41,מ.א. בני שמעון,מועצה איזורית,73,32,41,30,43,8,72,1,1.49%
2017-04,הדרום,54,מ.א. הערבה התיכונה,מועצה איזורית,22,8,14,10,12,0,22,0,1.15%
2017-04,הדרום,53,מ.א. חבל אילות,מועצה איזורית,21,5,16,5,16,0,21,1,0.85%
2017-04,הדרום,36,מ.א. חוף אשקלון,מועצה איזורית,174,87,87,26,148,37,164,0,1.89%
2017-04,הדרום,35,מ.א. יואב,מועצה איזורית,73,30,43,30,43,5,73,0,1.79%
2017-04,הדרום,50,מ.א. לכיש,מועצה איזורית,154,72,82,18,136,40,154,0,2.76%
2017-04,הדרום,42,מ.א. מרחבים,מועצה איזורית,151,52,99,27,124,23,148,0,2.35%
2017-04,הדרום,68,מ.א. נווה מדבר,מועצה איזורית,114,43,71,0,114,91,112,0,5.93%
2017-04,הדרום,48,מ.א. רמת נגב,מועצה איזורית,256,134,122,17,239,192,253,0,7.61%
2017-04,הדרום,39,מ.א. שדות נגב,מועצה איזורית,102,53,49,14,88,27,98,0,2.02%
2017-04,הדרום,37,מ.א. שער הנגב,מועצה איזורית,93,40,53,43,50,15,90,1,2.25%
2017-04,הדרום,34,מ.א. שפיר,מועצה איזורית,141,64,77,16,125,44,139,0,2.79%
2017-04,הדרום,51,מ.א. תמר,מועצה איזורית,11,6,5,2,9,1,11,0,1.69%
2017-04,הדרום,1268,מיתר,יישוב,67,24,43,31,36,3,66,0,1.34%
2017-04,הדרום,99,מצפה רמון,יישוב,230,89,141,15,215,147,219,8,7.87%
2017-04,הדרום,246,נתיבות,יישוב,829,371,458,44,785,398,774,29,4.73%
2017-04,הדרום,666,עומר,יישוב,60,20,40,27,33,3,59,0,1.40%
2017-04,הדרום,2560,ערד,יישוב,630,289,341,61,569,328,597,19,4.70%
2017-04,הדרום,1192,ערערה-בנגב,יישוב,1068,450,618,4,1064,962,1053,2,20.14%
2017-04,הדרום,2630,קריית גת,יישוב,1459,609,850,80,1379,677,1405,31,4.81%
2017-04,הדרום,1034,קריית מלאכי,יישוב,643,278,365,23,620,281,618,26,5.02%
2017-04,הדרום,1161,רהט,יישוב,2135,845,1290,9,2126,1743,2107,53,9.37%
2017-04,הדרום,1286,שגב-שלום,יישוב,319,126,193,4,315,265,306,4,9.50%
2017-04,הדרום,1031,שדרות,יישוב,880,404,476,61,819,470,817,7,5.51%
2017-04,הדרום,1054,תל שבע,יישוב,690,302,388,1,689,614,655,4,11.40%
2017-04,המרכז,1066,"בני עי""ש",יישוב,121,59,62,19,102,38,119,2,2.97%
2017-04,המרכז,182,אבן יהודה,יישוב,156,70,86,52,104,21,155,0,2.22%
2017-04,המרכז,41,אליכין,יישוב,54,28,26,6,48,16,51,1,2.60%
2017-04,המרכז,1309,אלעד,יישוב,290,118,172,16,274,29,284,0,2.00%
2017-04,המרכז,2530,באר יעקב,יישוב,212,83,129,69,143,36,208,2,1.62%
2017-04,המרכז,466,בית דגן,יישוב,89,47,42,11,78,27,87,1,2.33%
2017-04,המרכז,681,גבעת שמואל,יישוב,241,129,112,81,160,33,237,0,1.90%
2017-04,המרכז,2550,גדרה,יישוב,282,119,163,46,236,71,275,2,2.12%
2017-04,המרכז,627,ג'לג'וליה,יישוב,69,32,37,2,67,37,65,1,1.52%
2017-04,המרכז,166,גן יבנה,יישוב,296,126,170,42,254,61,290,2,2.28%
2017-04,המרכז,229,גני תקווה,יישוב,211,110,101,83,128,26,208,0,2.15%
2017-04,המרכז,9700,הוד השרון,יישוב,618,262,356,302,316,27,612,5,1.88%
2017-04,המרכז,1290,זמר,יישוב,112,39,73,1,111,75,111,2,3.40%
2017-04,המרכז,2730,טייבה,יישוב,984,461,523,29,955,713,836,26,4.31%
2017-04,המרכז,2720,טירה,יישוב,155,81,74,11,144,54,154,4,1.23%
2017-04,המרכז,2660,יבנה,יישוב,644,301,343,129,515,162,630,17,2.50%
2017-04,המרכז,9400,יהוד,יישוב,330,144,186,86,244,32,320,4,1.97%
2017-04,המרכז,1224,כוכב יאיר,יישוב,70,34,36,41,29,0,70,0,1.26%
2017-04,המרכז,633,כפר ברא,יישוב,10,6,4,2,8,5,10,0,0.62%
2017-04,המרכז,168,כפר יונה,יישוב,265,122,143,57,208,45,263,3,2.25%
2017-04,המרכז,6900,כפר סבא,יישוב,981,443,538,418,563,78,969,14,1.83%
2017-04,המרכז,634,כפר קאסם,יישוב,206,81,125,11,195,103,196,2,1.90%
2017-04,המרכז,7000,לוד,יישוב,1549,768,781,130,1419,819,1510,25,4.09%
2017-04,המרכז,28,מ.א. ברנר,מועצה איזורית,62,25,37,35,27,2,62,2,1.53%
2017-04,המרכז,32,מ.א. גדרות,מועצה איזורית,43,17,26,27,16,3,43,0,1.74%
2017-04,המרכז,30,מ.א. גזר,מועצה איזורית,225,108,117,84,141,27,222,0,1.65%
2017-04,המרכז,27,מ.א. גן רווה,מועצה איזורית,50,20,30,21,29,1,50,0,1.67%
2017-04,המרכז,20,מ.א. דרום השרון,מועצה איזורית,321,127,194,149,172,9,318,0,1.97%
2017-04,המרכז,29,מ.א. חבל יבנה,מועצה איזורית,29,17,12,16,13,2,29,0,1.11%
2017-04,המרכז,25,מ.א. חבל מודיעין,מועצה איזורית,188,86,102,58,130,21,184,0,1.67%
2017-04,המרכז,19,מ.א. חוף השרון,מועצה איזורית,82,32,50,31,51,4,80,0,1.44%
2017-04,המרכז,18,מ.א. לב השרון,מועצה איזורית,226,108,118,73,153,28,223,0,2.01%
2017-04,המרכז,31,מ.א. נחל שורק,מועצה איזורית,47,24,23,10,37,6,47,20,1.11%
2017-04,המרכז,16,מ.א. עמק חפר,מועצה איזורית,345,130,215,143,202,15,343,0,1.74%
2017-04,המרכז,40,מ.א. שדות דן,מועצה איזורית,116,52,64,34,82,10,116,0,1.80%
2017-04,המרכז,1200,מודיעין-מכבים-רעות*,יישוב,764,330,434,340,424,41,757,10,1.64%
2017-04,המרכז,28,מזכרת בתיה,יישוב,151,61,90,47,104,16,150,2,1.84%
2017-04,המרכז,7200,נס ציונה,יישוב,623,304,319,171,452,149,612,4,2.47%
2017-04,המרכז,7400,נתניה,יישוב,3579,1756,1823,458,3121,1143,3504,60,3.23%
2017-04,המרכז,587,סביון*,יישוב,15,4,11,8,7,0,15,0,0.72%
2017-04,המרכז,171,פרדסייה,יישוב,74,38,36,26,48,7,74,1,1.97%
2017-04,המרכז,7900,פתח תקווה,יישוב,3334,1521,1813,739,2595,780,3260,26,2.53%
2017-04,המרכז,195,קדימה-צורן,יישוב,233,101,132,70,163,34,231,1,1.97%
2017-04,המרכז,638,קלנסווה,יישוב,337,178,159,12,325,237,305,4,3.14%
2017-04,המרכז,469,קריית עקרון,יישוב,212,94,118,27,185,87,204,7,3.36%
2017-04,המרכז,2640,ראש העין,יישוב,698,335,363,127,571,118,692,6,2.24%
2017-04,המרכז,8300,ראשון לציון,יישוב,3773,1659,2114,792,2981,909,3736,27,2.66%
2017-04,המרכז,8400,רחובות,יישוב,2004,893,1111,520,1484,648,1940,35,2.74%
2017-04,המרכז,8500,רמלה,יישוב,1328,644,684,124,1204,523,1281,37,3.31%
2017-04,המרכז,8700,רעננה,יישוב,641,297,344,278,363,41,628,2,1.66%
2017-04,המרכז,1304,שוהם,יישוב,167,69,98,74,93,9,167,0,1.38%
2017-04,המרכז,154,תל מונד,יישוב,144,78,66,49,95,18,144,1,2.08%
2017-04,הצפון,473,אבו סנאן,יישוב,524,217,307,3,521,423,515,7,8.13%
2017-04,הצפון,478,אכסאל,יישוב,422,182,240,12,410,364,418,4,6.54%
2017-04,הצפון,529,אעבלין,יישוב,411,173,238,9,402,337,407,12,6.52%
2017-04,הצפון,482,בועיינה-נוג'ידאת,יישוב,269,127,142,8,261,198,265,5,6.08%
2017-04,הצפון,4001,בוקעאתא,יישוב,398,152,246,7,391,303,380,4,12.31%
2017-04,הצפון,998,ביר אל-מכסור,יישוב,288,125,163,2,286,219,283,1,6.75%
2017-04,הצפון,480,בית ג'ן,יישוב,366,93,273,3,363,243,348,1,5.80%
2017-04,הצפון,9200,בית שאן,יישוב,635,266,369,26,609,305,613,37,5.83%
2017-04,הצפון,944,בסמת טבעון,יישוב,150,67,83,1,149,104,143,1,3.96%
2017-04,הצפון,483,בענה,יישוב,321,143,178,5,316,269,314,7,8.04%
2017-04,הצפון,1292,ג'דיידה-מכר,יישוב,1020,473,547,4,1016,817,1004,8,9.73%
2017-04,הצפון,485,ג'ולס,יישוב,162,45,117,3,159,109,162,0,4.95%
2017-04,הצפון,487,ג'ש (גוש חלב),יישוב,47,23,24,4,43,20,47,0,2.75%
2017-04,הצפון,489,דבורייה,יישוב,279,117,162,15,264,199,276,3,5.78%
2017-04,הצפון,490,דייר אל-אסד,יישוב,312,136,176,16,296,260,303,8,5.27%
2017-04,הצפון,492,דייר חנא,יישוב,572,246,326,14,558,426,566,6,10.52%
2017-04,הצפון,975,זרזיר,יישוב,180,73,107,4,176,123,179,3,5.00%
2017-04,הצפון,496,חורפיש,יישוב,79,36,43,5,74,46,76,0,2.50%
2017-04,הצפון,2034,חצור הגלילית,יישוב,206,84,122,14,192,108,193,1,3.97%
2017-04,הצפון,6700,טבריה,יישוב,1250,614,636,66,1184,669,1087,40,4.88%
2017-04,הצפון,962,טובא-זנגרייה,יישוב,300,133,167,4,296,208,291,3,8.51%
2017-04,הצפון,498,טורעאן,יישוב,353,158,195,5,348,291,344,7,5.41%
2017-04,הצפון,8900,טמרה,יישוב,1241,581,660,18,1223,1054,1210,9,7.75%
2017-04,הצפון,1295,יאנוח-ג'ת,יישוב,134,48,86,6,128,79,130,1,4.04%
2017-04,הצפון,46,יבנאל,יישוב,109,57,52,7,102,68,86,3,5.37%
2017-04,הצפון,29,יסוד המעלה,יישוב,19,12,7,7,12,4,19,0,2.16%
2017-04,הצפון,499,יפיע,יישוב,524,235,289,26,498,383,520,3,5.97%
2017-04,הצפון,240,יקנעם עילית,יישוב,365,157,208,66,299,97,361,16,2.81%
2017-04,הצפון,502,ירכא,יישוב,383,145,238,3,380,294,380,2,5.39%
2017-04,הצפון,504,כאבול,יישוב,430,212,218,4,426,362,423,1,7.75%
2017-04,הצפון,505,כאוכב אבו אל-היג'א,יישוב,204,91,113,2,202,155,203,1,10.57%
2017-04,הצפון,1296,כסרא-סמיע,יישוב,195,66,129,7,188,118,185,7,4.73%
2017-04,הצפון,978,כעביה-טבאש-חג'אג'רה,יישוב,150,63,87,0,150,106,148,1,5.73%
2017-04,הצפון,1263,כפר ורדים,יישוב,56,23,33,28,28,4,54,0,1.74%
2017-04,הצפון,507,כפר יאסיף,יישוב,343,146,197,7,336,239,335,3,6.18%
2017-04,הצפון,508,כפר כמא,יישוב,41,16,25,2,39,19,41,0,2.37%
2017-04,הצפון,509,כפר כנא,יישוב,729,358,371,20,709,598,701,7,7.19%
2017-04,הצפון,510,כפר מנדא,יישוב,653,336,317,9,644,491,647,5,7.98%
2017-04,הצפון,47,כפר תבור,יישוב,41,16,25,18,23,2,39,0,1.65%
2017-04,הצפון,1139,כרמיאל,יישוב,1325,565,760,263,1062,655,1227,34,4.73%
2017-04,הצפון,65,מ.א. אל-בטוף,מועצה איזורית,240,95,145,7,233,197,234,1,7.19%
2017-04,הצפון,66,מ.א. בוסתן אל-מרג,מועצה איזורית,37,10,27,0,37,30,35,0,0.99%
2017-04,הצפון,71,מ.א. גולן,מועצה איזורית,179,78,101,51,128,18,177,0,2.02%
2017-04,הצפון,8,מ.א. הגלבוע,מועצה איזורית,577,242,335,50,527,319,564,0,3.99%
2017-04,הצפון,1,מ.א. הגליל העליון,מועצה איזורית,182,81,101,59,123,15,178,0,1.99%
2017-04,הצפון,3,מ.א. הגליל התחתון,מועצה איזורית,87,38,49,24,63,9,87,0,1.44%
2017-04,הצפון,55,מ.א. מבואות החרמון,מועצה איזורית,93,35,58,28,65,14,93,1,2.32%
2017-04,הצפון,13,מ.א. מגידו,מועצה איזורית,76,28,48,28,48,8,75,0,1.33%
2017-04,הצפון,4,מ.א. מטה אשר,מועצה איזורית,421,175,246,75,346,169,406,0,2.86%
2017-04,הצפון,52,מ.א. מעלה יוסף,מועצה איזורית,181,89,92,26,155,48,176,0,3.07%
2017-04,הצפון,2,מ.א. מרום הגליל,מועצה איזורית,232,101,131,32,200,91,219,0,3.07%
2017-04,הצפון,56,מ.א. משגב,מועצה איזורית,524,202,322,117,407,272,511,0,3.61%
2017-04,הצפון,6,מ.א. עמק הירדן,מועצה איזורית,150,78,72,29,121,34,142,0,2.09%
2017-04,הצפון,7,מ.א. עמק המעיינות,מועצה איזורית,148,67,81,27,121,38,144,0,2.20%
2017-04,הצפון,9,מ.א. עמק יזרעאל,מועצה איזורית,292,131,161,136,156,40,284,0,1.45%
2017-04,הצפון,481,מגאר,יישוב,1159,483,676,19,1140,932,1126,5,10.43%
2017-04,הצפון,516,מג'ד אל-כרום,יישוב,433,201,232,9,424,325,415,7,5.63%
2017-04,הצפון,65,מגדל,יישוב,32,16,16,1,31,14,29,1,2.92%
2017-04,הצפון,874,מגדל העמק,יישוב,679,310,369,64,615,287,626,37,4.59%
2017-04,הצפון,4201,מג'דל שמס,יישוב,410,167,243,9,401,299,394,1,7.41%
2017-04,הצפון,517,מזרעה,יישוב,147,63,84,1,146,112,140,2,6.49%
2017-04,הצפון,43,מטולה,יישוב,17,11,6,5,12,3,16,0,1.60%
2017-04,הצפון,4203,מסעדה,יישוב,180,68,112,3,177,138,173,2,9.48%
2017-04,הצפון,518,מעיליא,יישוב,58,33,25,9,49,21,54,1,3.14%
2017-04,הצפון,1063,מעלות-תרשיחא,יישוב,686,348,338,83,603,356,655,19,5.37%
2017-04,הצפון,520,משהד,יישוב,182,82,100,5,177,145,172,3,4.78%
2017-04,הצפון,9100,נהרייה,יישוב,1588,778,810,159,1429,889,1493,38,4.72%
2017-04,הצפון,522,נחף,יישוב,371,170,201,16,355,279,354,7,6.29%
2017-04,הצפון,7300,נצרת,יישוב,2556,1128,1428,107,2449,1924,2526,18,6.83%
2017-04,הצפון,1061,נצרת עילית,יישוב,1239,555,684,132,1107,622,1102,57,4.70%
2017-04,הצפון,525,סאג'ור,יישוב,95,34,61,7,88,63,94,0,4.34%
2017-04,הצפון,7500,סח'נין,יישוב,1748,784,964,40,1708,1435,1731,29,11.04%
2017-04,הצפון,4501,ע'ג'ר,יישוב,86,23,63,1,85,59,85,0,7.05%
2017-04,הצפון,530,עיילבון,יישוב,152,68,84,11,141,94,148,0,5.08%
2017-04,הצפון,511,עילוט,יישוב,255,106,149,3,252,204,253,2,7.84%
2017-04,הצפון,532,עין מאהל,יישוב,363,186,177,11,352,274,352,2,5.98%
2017-04,הצפון,4502,עין קנייא,יישוב,120,40,80,3,117,98,114,1,10.19%
2017-04,הצפון,7600,עכו,יישוב,2634,1195,1439,148,2486,1912,2549,20,9.35%
2017-04,הצפון,7700,עפולה,יישוב,1280,534,746,162,1118,518,1224,35,4.48%
2017-04,הצפון,531,עראבה,יישוב,1262,538,724,33,1229,1083,1243,11,10.89%
2017-04,הצפון,535,פסוטה,יישוב,77,34,43,9,68,42,74,1,4.12%
2017-04,הצפון,536,פקיעין (בוקייעה),יישוב,113,63,50,6,107,73,107,1,3.57%
2017-04,הצפון,8000,צפת,יישוב,910,478,432,98,812,618,849,8,6.10%
2017-04,הצפון,4100,קצרין,יישוב,182,80,102,22,160,89,178,3,4.43%
2017-04,הצפון,2800,קריית שמונה,יישוב,642,328,314,70,572,286,619,21,4.77%
2017-04,הצפון,543,ראמה,יישוב,232,89,143,16,216,163,224,0,5.44%
2017-04,הצפון,26,ראש פינה,יישוב,41,18,23,9,32,18,40,1,2.43%
2017-04,הצפון,542,ריינה,יישוב,426,197,229,7,419,326,413,2,5.57%
2017-04,הצפון,122,רמת ישי,יישוב,79,30,49,37,42,12,75,1,1.82%
2017-04,הצפון,913,שבלי - אום אל-גנם,יישוב,170,67,103,7,163,116,167,0,5.85%
2017-04,הצפון,812,שלומי,יישוב,205,79,126,22,183,102,198,4,5.40%
2017-04,הצפון,538,שעב,יישוב,432,191,241,2,430,357,428,2,12.47%
2017-04,הצפון,8800,שפרעם,יישוב,1328,564,764,50,1278,1050,1295,18,6.59%
2017-04,חיפה,1326,"בסמ""ה",יישוב,328,150,178,5,323,260,321,5,7.14%
2017-04,חיפה,2710,אום אל-פחם,יישוב,2553,1070,1483,21,2532,2099,2514,26,10.70%
2017-04,חיפה,1020,אור עקיבא,יישוב,377,162,215,40,337,105,364,17,3.48%
2017-04,חיפה,6000,באקה אל-גרביה,יישוב,487,239,248,8,479,319,485,10,3.73%
2017-04,חיפה,9800,בנימינה-גבעת עדה*,יישוב,166,74,92,61,105,35,163,2,2.17%
2017-04,חיפה,541,ג'סר א-זרקא,יישוב,204,120,84,1,203,112,202,9,3.15%
2017-04,חיפה,628,ג'ת,יישוב,191,106,85,11,180,112,188,3,3.25%
2017-04,חיפה,494,דאלית אל-כרמל,יישוב,415,169,246,20,395,227,384,5,4.38%
2017-04,חיפה,9300,זכרון יעקב,יישוב,236,111,125,94,142,31,231,6,2.03%
2017-04,חיפה,6500,חדרה,יישוב,1899,866,1033,234,1665,641,1788,21,3.45%
2017-04,חיפה,4000,חיפה,יישוב,5026,2438,2588,1092,3934,2426,4725,104,3.35%
2017-04,חיפה,1247,חריש,יישוב,49,16,33,9,40,8,44,1,1.05%
2017-04,חיפה,2100,טירת כרמל,יישוב,597,294,303,36,561,305,584,13,4.77%
2017-04,חיפה,654,כפר קרע,יישוב,379,168,211,16,363,233,373,10,3.97%
2017-04,חיפה,45,מ.א. אלונה,מועצה איזורית,22,4,18,8,14,1,22,0,2.06%
2017-04,חיפה,12,מ.א. זבולון,מועצה איזורית,231,110,121,34,197,126,225,0,3.79%
2017-04,חיפה,15,מ.א. חוף הכרמל,מועצה איזורית,286,137,149,103,183,45,281,0,1.90%
2017-04,חיפה,14,מ.א. מנשה,מועצה איזורית,223,97,126,64,159,52,222,0,2.58%
2017-04,חיפה,1327,מעלה עירון,יישוב,621,245,376,5,616,500,610,7,9.28%
2017-04,חיפה,2500,נשר,יישוב,372,180,192,73,299,132,357,7,2.82%
2017-04,חיפה,534,עספיא,יישוב,274,117,157,15,259,144,257,4,4.20%
2017-04,חיפה,637,ערערה,יישוב,468,207,261,9,459,320,457,2,5.07%
2017-04,חיפה,537,פוריידיס,יישוב,192,114,78,5,187,105,191,8,3.15%
2017-04,חיפה,7800,פרדס חנה-כרכור,יישוב,669,308,361,167,502,125,661,13,3.08%
2017-04,חיפה,6800,קריית אתא,יישוב,1253,584,669,96,1157,606,1223,18,3.95%
2017-04,חיפה,9500,קריית ביאליק,יישוב,836,364,472,110,726,351,815,19,3.81%
2017-04,חיפה,2300,קריית טבעון,יישוב,151,61,90,75,76,27,150,0,1.79%
2017-04,חיפה,9600,קריית ים,יישוב,1176,552,624,114,1062,639,1128,19,5.31%
2017-04,חיפה,8200,קריית מוצקין,יישוב,785,322,463,122,663,337,758,13,3.26%
2017-04,חיפה,922,רכסים,יישוב,118,59,59,8,110,61,107,0,2.87%
2017-04,ירושלים,472,אבו גוש,יישוב,211,106,105,8,203,167,209,0,6.02%
2017-04,ירושלים,2610,בית שמש,יישוב,969,420,549,87,882,376,933,15,2.50%
2017-04,ירושלים,3000,ירושלים,יישוב,10500,4696,5804,1218,9282,6577,10229,89,3.20%
2017-04,ירושלים,26,מ.א. מטה יהודה,מועצה איזורית,506,231,275,160,346,104,495,1,1.91%
2017-04,ירושלים,1015,מבשרת ציון,יישוב,280,135,145,61,219,106,273,2,2.14%
2017-04,ירושלים,1137,קריית יערים,יישוב,37,19,18,7,30,12,37,0,2.08%
2017-04,תל אביב,2400,אור יהודה,יישוב,538,260,278,57,481,128,520,17,2.71%
2017-04,תל אביב,565,אזור,יישוב,154,84,70,23,131,25,152,2,2.27%
2017-04,תל אביב,6100,בני ברק,יישוב,1467,729,738,83,1384,614,1347,9,2.23%
2017-04,תל אביב,6200,בת ים,יישוב,2307,1131,1176,359,1948,792,2190,40,3.11%
2017-04,תל אביב,6300,גבעתיים,יישוב,659,313,346,334,325,60,655,4,2.06%
2017-04,תל אביב,6400,הרצלייה,יישוב,980,438,542,383,597,31,973,3,1.98%
2017-04,תל אביב,6600,חולון,יישוב,2626,1177,1449,455,2171,572,2564,40,2.55%
2017-04,תל אביב,267,כפר שמריהו,יישוב,5,2,3,4,1,0,5,0,0.60%
2017-04,תל אביב,2620,קריית אונו,יישוב,388,176,212,182,206,30,384,1,1.96%
2017-04,תל אביב,8600,רמת גן,יישוב,1885,903,982,685,1200,273,1856,15,2.27%
2017-04,תל אביב,2650,רמת השרון,יישוב,373,156,217,180,193,5,373,2,1.63%
2017-04,תל אביב,5000,תל אביב -יפו,יישוב,6659,3396,3263,2538,4121,1452,6537,56,2.48%
2017-05,אזור יהודה והשומרון,3760,אורנית,יישוב,87,42,45,33,54,3,87,0,1.74%
2017-05,אזור יהודה והשומרון,3750,אלפי מנשה,יישוב,88,35,53,27,61,0,88,2,1.98%
2017-05,אזור יהודה והשומרון,3560,אלקנה,יישוב,31,14,17,19,12,0,31,1,1.68%
2017-05,אזור יהודה והשומרון,3650,אפרת,יישוב,54,30,24,31,23,1,53,1,1.08%
2017-05,אזור יהודה והשומרון,3570,אריאל,יישוב,275,128,147,67,208,21,274,13,2.49%
2017-05,אזור יהודה והשומרון,3574,בית אל,יישוב,45,18,27,17,28,10,45,1,1.80%
2017-05,אזור יהודה והשומרון,3652,בית אריה,יישוב,57,29,28,15,42,1,57,1,1.98%
2017-05,אזור יהודה והשומרון,3780,ביתר עילית,יישוב,441,205,236,11,430,164,439,4,2.83%
2017-05,אזור יהודה והשומרון,3730,גבעת זאב,יישוב,162,79,83,38,124,27,161,3,1.99%
2017-05,אזור יהודה והשומרון,3769,הר אדר,יישוב,35,15,20,19,16,3,35,0,1.60%
2017-05,אזור יהודה והשומרון,76,מ.א. גוש עציון,מועצה איזורית,143,57,86,52,91,14,142,0,1.40%
2017-05,אזור יהודה והשומרון,78,מ.א. הר חברון,מועצה איזורית,61,31,30,25,36,4,61,0,1.54%
2017-05,אזור יהודה והשומרון,74,מ.א. מגילות ים המלח,מועצה איזורית,13,5,8,3,10,0,13,0,1.41%
2017-05,אזור יהודה והשומרון,73,מ.א. מטה בנימין,מועצה איזורית,565,302,263,193,372,100,555,0,1.96%
2017-05,אזור יהודה והשומרון,75,מ.א. ערבות הירדן,מועצה איזורית,45,23,22,13,32,5,45,0,1.75%
2017-05,אזור יהודה והשומרון,72,מ.א. שומרון,מועצה איזורית,351,168,183,109,242,33,347,0,1.83%
2017-05,אזור יהודה והשומרון,3797,מודיעין עילית,יישוב,354,110,244,23,331,27,351,9,2.20%
2017-05,אזור יהודה והשומרון,3616,מעלה אדומים,יישוב,571,249,322,86,485,150,562,17,2.69%
2017-05,אזור יהודה והשומרון,3608,מעלה אפרים,יישוב,31,11,20,1,30,10,31,2,3.87%
2017-05,אזור יהודה והשומרון,3660,עמנואל,יישוב,47,27,20,2,45,23,46,0,3.39%
2017-05,אזור יהודה והשומרון,3557,קדומים,יישוב,26,14,12,8,18,3,26,1,1.31%
2017-05,אזור יהודה והשומרון,3611,קריית ארבע,יישוב,92,53,39,18,74,46,86,4,2.56%
2017-05,אזור יהודה והשומרון,3640,קרני שומרון,יישוב,60,30,30,20,40,4,60,1,1.48%
2017-05,הדרום,31,אופקים,יישוב,835,380,455,52,783,424,798,52,5.52%
2017-05,הדרום,2600,אילת,יישוב,953,499,454,65,888,352,875,50,2.54%
2017-05,הדרום,70,אשדוד,יישוב,4897,2053,2844,630,4267,2146,4662,124,4.16%
2017-05,הדרום,7100,אשקלון,יישוב,3476,1449,2027,381,3095,1577,3083,78,4.16%
2017-05,הדרום,9000,באר שבע,יישוב,5198,2394,2804,700,4498,2721,4927,120,4.59%
2017-05,הדרום,2200,דימונה,יישוב,1626,760,866,84,1542,1080,1535,41,7.86%
2017-05,הדרום,1303,חורה,יישוב,531,228,303,7,524,442,512,4,10.58%
2017-05,הדרום,831,ירוחם,יישוב,359,176,183,21,338,215,334,25,6.54%
2017-05,הדרום,1059,כסיפה,יישוב,972,368,604,2,970,877,963,11,17.70%
2017-05,הדרום,1271,להבים,יישוב,49,15,34,22,27,3,49,0,1.39%
2017-05,הדרום,1060,לקיה,יישוב,599,265,334,8,591,520,578,6,11.79%
2017-05,הדרום,69,מ.א. אל קסום,מועצה איזורית,589,232,357,4,585,531,569,0,16.69%
2017-05,הדרום,38,מ.א. אשכול,מועצה איזורית,98,41,57,23,75,8,97,0,1.38%
2017-05,הדרום,33,מ.א. באר טוביה,מועצה איזורית,255,112,143,48,207,38,252,0,2.23%
2017-05,הדרום,41,מ.א. בני שמעון,מועצה איזורית,73,36,37,26,47,9,72,0,1.49%
2017-05,הדרום,54,מ.א. הערבה התיכונה,מועצה איזורית,25,11,14,8,17,1,25,0,1.31%
2017-05,הדרום,53,מ.א. חבל אילות,מועצה איזורית,22,3,19,5,17,1,21,0,0.85%
2017-05,הדרום,36,מ.א. חוף אשקלון,מועצה איזורית,182,90,92,30,152,39,175,0,2.01%
2017-05,הדרום,35,מ.א. יואב,מועצה איזורית,80,34,46,31,49,6,80,0,1.96%
2017-05,הדרום,50,מ.א. לכיש,מועצה איזורית,148,72,76,19,129,38,147,0,2.64%
2017-05,הדרום,42,מ.א. מרחבים,מועצה איזורית,152,51,101,30,122,26,151,0,2.40%
2017-05,הדרום,68,מ.א. נווה מדבר,מועצה איזורית,123,49,74,0,123,97,122,0,6.46%
2017-05,הדרום,48,מ.א. רמת נגב,מועצה איזורית,251,131,120,17,234,189,245,1,7.36%
2017-05,הדרום,39,מ.א. שדות נגב,מועצה איזורית,116,58,58,18,98,30,109,0,2.24%
2017-05,הדרום,37,מ.א. שער הנגב,מועצה איזורית,90,37,53,44,46,16,87,0,2.18%
2017-05,הדרום,34,מ.א. שפיר,מועצה איזורית,148,70,78,17,131,47,144,0,2.89%
2017-05,הדרום,51,מ.א. תמר,מועצה איזורית,11,5,6,1,10,1,11,0,1.69%
2017-05,הדרום,1268,מיתר,יישוב,58,21,37,23,35,3,57,1,1.16%
2017-05,הדרום,99,מצפה רמון,יישוב,226,84,142,16,210,146,214,15,7.70%
2017-05,הדרום,246,נתיבות,יישוב,884,386,498,50,834,403,815,61,4.97%
2017-05,הדרום,666,עומר,יישוב,60,24,36,22,38,2,60,0,1.42%
2017-05,הדרום,2560,ערד,יישוב,608,271,337,55,553,320,579,33,4.56%
2017-05,הדרום,1192,ערערה-בנגב,יישוב,1063,440,623,5,1058,959,1046,25,20.03%
2017-05,הדרום,2630,קריית גת,יישוב,1515,646,869,100,1415,666,1455,52,4.97%
2017-05,הדרום,1034,קריית מלאכי,יישוב,683,307,376,19,664,281,654,41,5.30%
2017-05,הדרום,1161,רהט,יישוב,2180,857,1323,8,2172,1714,2157,66,9.57%
2017-05,הדרום,1286,שגב-שלום,יישוב,327,123,204,3,324,265,314,3,9.72%
2017-05,הדרום,1031,שדרות,יישוב,888,402,486,61,827,467,825,20,5.56%
2017-05,הדרום,1054,תל שבע,יישוב,687,297,390,0,687,614,646,6,11.26%
2017-05,המרכז,1066,"בני עי""ש",יישוב,117,55,62,16,101,40,116,1,2.90%
2017-05,המרכז,182,אבן יהודה,יישוב,158,72,86,50,108,22,156,3,2.23%
2017-05,המרכז,41,אליכין,יישוב,58,28,30,9,49,16,55,0,2.80%
2017-05,המרכז,1309,אלעד,יישוב,288,120,168,17,271,32,280,1,1.98%
2017-05,המרכז,2530,באר יעקב,יישוב,229,87,142,70,159,39,223,7,1.74%
2017-05,המרכז,466,בית דגן,יישוב,86,47,39,10,76,25,84,1,2.25%
2017-05,המרכז,681,גבעת שמואל,יישוב,247,132,115,89,158,37,241,2,1.93%
2017-05,המרכז,2550,גדרה,יישוב,287,137,150,48,239,73,277,7,2.14%
2017-05,המרכז,627,ג'לג'וליה,יישוב,75,38,37,2,73,42,71,1,1.65%
2017-05,המרכז,166,גן יבנה,יישוב,294,120,174,43,251,62,289,4,2.28%
2017-05,המרכז,229,גני תקווה,יישוב,206,114,92,79,127,22,206,1,2.13%
2017-05,המרכז,9700,הוד השרון,יישוב,634,276,358,314,320,28,628,8,1.92%
2017-05,המרכז,1290,זמר,יישוב,111,39,72,2,109,76,110,3,3.37%
2017-05,המרכז,2730,טייבה,יישוב,951,437,514,27,924,691,813,32,4.19%
2017-05,המרכז,2720,טירה,יישוב,155,81,74,13,142,51,150,8,1.20%
2017-05,המרכז,2660,יבנה,יישוב,670,308,362,142,528,158,662,32,2.63%
2017-05,המרכז,9400,יהוד,יישוב,338,151,187,84,254,32,329,5,2.02%
2017-05,המרכז,1224,כוכב יאיר,יישוב,66,26,40,43,23,0,66,0,1.19%
2017-05,המרכז,633,כפר ברא,יישוב,17,11,6,2,15,8,15,0,0.93%
2017-05,המרכז,168,כפר יונה,יישוב,273,120,153,52,221,45,271,3,2.31%
2017-05,המרכז,6900,כפר סבא,יישוב,1024,462,562,441,583,76,1009,23,1.91%
2017-05,המרכז,634,כפר קאסם,יישוב,212,79,133,12,200,105,205,2,1.98%
2017-05,המרכז,7000,לוד,יישוב,1572,781,791,126,1446,815,1535,41,4.16%
2017-05,המרכז,28,מ.א. ברנר,מועצה איזורית,65,27,38,36,29,2,64,2,1.58%
2017-05,המרכז,32,מ.א. גדרות,מועצה איזורית,44,20,24,27,17,2,44,0,1.78%
2017-05,המרכז,30,מ.א. גזר,מועצה איזורית,232,111,121,84,148,30,227,0,1.69%
2017-05,המרכז,27,מ.א. גן רווה,מועצה איזורית,54,21,33,25,29,1,54,1,1.80%
2017-05,המרכז,20,מ.א. דרום השרון,מועצה איזורית,336,134,202,158,178,14,333,0,2.06%
2017-05,המרכז,29,מ.א. חבל יבנה,מועצה איזורית,33,18,15,15,18,3,33,0,1.26%
2017-05,המרכז,25,מ.א. חבל מודיעין,מועצה איזורית,205,87,118,60,145,22,201,0,1.83%
2017-05,המרכז,19,מ.א. חוף השרון,מועצה איזורית,83,29,54,38,45,2,83,0,1.49%
2017-05,המרכז,18,מ.א. לב השרון,מועצה איזורית,222,110,112,72,150,29,219,0,1.97%
2017-05,המרכז,31,מ.א. נחל שורק,מועצה איזורית,51,24,27,11,40,7,48,52,1.12%
2017-05,המרכז,16,מ.א. עמק חפר,מועצה איזורית,350,138,212,157,193,10,349,0,1.77%
2017-05,המרכז,40,מ.א. שדות דן,מועצה איזורית,120,53,67,37,83,12,120,0,1.86%
2017-05,המרכז,1200,מודיעין-מכבים-רעות*,יישוב,820,361,459,362,458,39,811,28,1.76%
2017-05,המרכז,28,מזכרת בתיה,יישוב,143,60,83,40,103,15,142,2,1.75%
2017-05,המרכז,7200,נס ציונה,יישוב,644,315,329,177,467,152,630,6,2.54%
2017-05,המרכז,7400,נתניה,יישוב,3689,1785,1904,467,3222,1139,3613,111,3.33%
2017-05,המרכז,587,סביון*,יישוב,16,4,12,9,7,0,16,0,0.77%
2017-05,המרכז,171,פרדסייה,יישוב,77,38,39,27,50,9,75,0,1.99%
2017-05,המרכז,7900,פתח תקווה,יישוב,3472,1574,1898,747,2725,776,3387,51,2.62%
2017-05,המרכז,195,קדימה-צורן,יישוב,235,98,137,74,161,30,234,3,2.00%
2017-05,המרכז,638,קלנסווה,יישוב,338,181,157,13,325,228,307,9,3.16%
2017-05,המרכז,469,קריית עקרון,יישוב,199,100,99,22,177,94,194,5,3.20%
2017-05,המרכז,2640,ראש העין,יישוב,746,364,382,136,610,117,738,10,2.39%
2017-05,המרכז,8300,ראשון לציון,יישוב,3918,1726,2192,817,3101,902,3871,60,2.75%
2017-05,המרכז,8400,רחובות,יישוב,2005,899,1106,537,1468,635,1938,38,2.73%
2017-05,המרכז,8500,רמלה,יישוב,1347,655,692,123,1224,530,1299,51,3.35%
2017-05,המרכז,8700,רעננה,יישוב,668,310,358,301,367,38,656,19,1.73%
2017-05,המרכז,1304,שוהם,יישוב,175,68,107,91,84,11,175,1,1.45%
2017-05,המרכז,154,תל מונד,יישוב,132,71,61,45,87,15,132,1,1.91%
2017-05,הצפון,473,אבו סנאן,יישוב,528,215,313,4,524,418,521,9,8.22%
2017-05,הצפון,478,אכסאל,יישוב,406,174,232,11,395,354,404,5,6.33%
2017-05,הצפון,529,אעבלין,יישוב,418,178,240,10,408,329,411,7,6.58%
2017-05,הצפון,482,בועיינה-נוג'ידאת,יישוב,252,122,130,7,245,195,249,3,5.73%
2017-05,הצפון,4001,בוקעאתא,יישוב,386,144,242,4,382,293,369,3,11.99%
2017-05,הצפון,998,ביר אל-מכסור,יישוב,283,123,160,1,282,215,280,3,6.68%
2017-05,הצפון,480,בית ג'ן,יישוב,361,94,267,6,355,238,343,1,5.72%
2017-05,הצפון,9200,בית שאן,יישוב,655,279,376,24,631,285,631,56,5.99%
2017-05,הצפון,944,בסמת טבעון,יישוב,153,67,86,2,151,105,142,2,3.93%
2017-05,הצפון,483,בענה,יישוב,318,140,178,5,313,263,309,10,7.92%
2017-05,הצפון,1292,ג'דיידה-מכר,יישוב,1024,468,556,6,1018,813,1008,9,9.76%
2017-05,הצפון,485,ג'ולס,יישוב,174,48,126,3,171,117,173,2,5.27%
2017-05,הצפון,487,ג'ש (גוש חלב),יישוב,55,27,28,4,51,23,55,4,3.20%
2017-05,הצפון,489,דבורייה,יישוב,273,112,161,11,262,192,271,3,5.68%
2017-05,הצפון,490,דייר אל-אסד,יישוב,307,131,176,13,294,252,297,10,5.17%
2017-05,הצפון,492,דייר חנא,יישוב,571,248,323,16,555,425,564,9,10.49%
2017-05,הצפון,975,זרזיר,יישוב,195,79,116,2,193,127,190,4,5.29%
2017-05,הצפון,496,חורפיש,יישוב,92,41,51,3,89,57,88,1,2.89%
2017-05,הצפון,2034,חצור הגלילית,יישוב,217,89,128,15,202,114,205,7,4.20%
2017-05,הצפון,6700,טבריה,יישוב,1283,613,670,67,1216,661,1098,73,4.93%
2017-05,הצפון,962,טובא-זנגרייה,יישוב,320,134,186,3,317,203,311,4,9.04%
2017-05,הצפון,498,טורעאן,יישוב,360,156,204,6,354,298,353,9,5.54%
2017-05,הצפון,8900,טמרה,יישוב,1228,583,645,17,1211,1035,1202,14,7.70%
2017-05,הצפון,1295,יאנוח-ג'ת,יישוב,129,42,87,6,123,79,125,4,3.89%
2017-05,הצפון,46,יבנאל,יישוב,111,55,56,7,104,70,85,3,5.31%
2017-05,הצפון,29,יסוד המעלה,יישוב,14,9,5,4,10,3,14,0,1.60%
2017-05,הצפון,499,יפיע,יישוב,508,226,282,23,485,377,502,4,5.78%
2017-05,הצפון,240,יקנעם עילית,יישוב,387,177,210,79,308,88,381,28,2.96%
2017-05,הצפון,502,ירכא,יישוב,379,139,240,2,377,292,377,3,5.35%
2017-05,הצפון,504,כאבול,יישוב,426,217,209,4,422,355,415,2,7.61%
2017-05,הצפון,505,כאוכב אבו אל-היג'א,יישוב,199,88,111,2,197,154,198,6,10.34%
2017-05,הצפון,1296,כסרא-סמיע,יישוב,182,57,125,6,176,111,170,4,4.37%
2017-05,הצפון,978,כעביה-טבאש-חג'אג'רה,יישוב,157,63,94,0,157,114,154,2,5.95%
2017-05,הצפון,1263,כפר ורדים,יישוב,52,20,32,22,30,5,49,0,1.58%
2017-05,הצפון,507,כפר יאסיף,יישוב,344,147,197,7,337,240,339,7,6.25%
2017-05,הצפון,508,כפר כמא,יישוב,37,15,22,2,35,15,37,1,2.14%
2017-05,הצפון,509,כפר כנא,יישוב,741,344,397,18,723,602,712,9,7.30%
2017-05,הצפון,510,כפר מנדא,יישוב,630,332,298,9,621,468,623,1,7.71%
2017-05,הצפון,47,כפר תבור,יישוב,43,15,28,16,27,3,42,0,1.77%
2017-05,הצפון,1139,כרמיאל,יישוב,1344,569,775,271,1073,671,1237,43,4.77%
2017-05,הצפון,65,מ.א. אל-בטוף,מועצה איזורית,229,91,138,5,224,192,222,1,6.83%
2017-05,הצפון,66,מ.א. בוסתן אל-מרג,מועצה איזורית,35,10,25,1,34,29,32,0,0.91%
2017-05,הצפון,71,מ.א. גולן,מועצה איזורית,184,79,105,54,130,15,182,0,2.07%
2017-05,הצפון,8,מ.א. הגלבוע,מועצה איזורית,582,249,333,56,526,314,567,0,4.02%
2017-05,הצפון,1,מ.א. הגליל העליון,מועצה איזורית,172,81,91,62,110,20,168,0,1.88%
2017-05,הצפון,3,מ.א. הגליל התחתון,מועצה איזורית,87,38,49,23,64,9,87,0,1.44%
2017-05,הצפון,55,מ.א. מבואות החרמון,מועצה איזורית,88,35,53,27,61,15,88,0,2.20%
2017-05,הצפון,13,מ.א. מגידו,מועצה איזורית,73,30,43,28,45,9,73,0,1.29%
2017-05,הצפון,4,מ.א. מטה אשר,מועצה איזורית,428,184,244,75,353,166,414,0,2.91%
2017-05,הצפון,52,מ.א. מעלה יוסף,מועצה איזורית,177,88,89,24,153,46,175,0,3.05%
2017-05,הצפון,2,מ.א. מרום הגליל,מועצה איזורית,220,98,122,31,189,92,208,0,2.91%
2017-05,הצפון,56,מ.א. משגב,מועצה איזורית,502,191,311,113,389,260,490,0,3.47%
2017-05,הצפון,6,מ.א. עמק הירדן,מועצה איזורית,158,77,81,35,123,33,147,0,2.16%
2017-05,הצפון,7,מ.א. עמק המעיינות,מועצה איזורית,156,73,83,28,128,35,151,0,2.30%
2017-05,הצפון,9,מ.א. עמק יזרעאל,מועצה איזורית,288,120,168,149,139,36,281,0,1.44%
2017-05,הצפון,481,מגאר,יישוב,1179,478,701,16,1163,946,1143,10,10.57%
2017-05,הצפון,516,מג'ד אל-כרום,יישוב,435,204,231,8,427,321,421,11,5.71%
2017-05,הצפון,65,מגדל,יישוב,31,13,18,2,29,13,27,1,2.72%
2017-05,הצפון,874,מגדל העמק,יישוב,698,316,382,73,625,282,641,65,4.69%
2017-05,הצפון,4201,מג'דל שמס,יישוב,407,159,248,10,397,299,389,5,7.32%
2017-05,הצפון,517,מזרעה,יישוב,148,63,85,1,147,111,141,3,6.54%
2017-05,הצפון,43,מטולה,יישוב,18,13,5,7,11,4,17,0,1.70%
2017-05,הצפון,4203,מסעדה,יישוב,182,71,111,4,178,139,173,2,9.48%
2017-05,הצפון,518,מעיליא,יישוב,49,26,23,8,41,19,48,3,2.80%
2017-05,הצפון,1063,מעלות-תרשיחא,יישוב,732,372,360,76,656,359,693,42,5.66%
2017-05,הצפון,520,משהד,יישוב,180,80,100,6,174,144,172,0,4.78%
2017-05,הצפון,9100,נהרייה,יישוב,1620,796,824,161,1459,887,1526,73,4.82%
2017-05,הצפון,522,נחף,יישוב,363,169,194,12,351,270,349,5,6.21%
2017-05,הצפון,7300,נצרת,יישוב,2535,1132,1403,105,2430,1886,2509,30,6.78%
2017-05,הצפון,1061,נצרת עילית,יישוב,1278,568,710,131,1147,597,1132,87,4.82%
2017-05,הצפון,525,סאג'ור,יישוב,100,31,69,10,90,59,96,1,4.42%
2017-05,הצפון,7500,סח'נין,יישוב,1698,766,932,43,1655,1403,1680,22,10.75%
2017-05,הצפון,4501,ע'ג'ר,יישוב,87,24,63,2,85,58,86,0,7.13%
2017-05,הצפון,530,עיילבון,יישוב,150,69,81,11,139,96,146,1,5.02%
2017-05,הצפון,511,עילוט,יישוב,258,111,147,3,255,206,256,3,7.93%
2017-05,הצפון,532,עין מאהל,יישוב,351,180,171,11,340,264,343,3,5.83%
2017-05,הצפון,4502,עין קנייא,יישוב,120,41,79,3,117,100,115,2,10.27%
2017-05,הצפון,7600,עכו,יישוב,2617,1184,1433,138,2479,1912,2526,44,9.27%
2017-05,הצפון,7700,עפולה,יישוב,1370,588,782,172,1198,533,1303,74,4.75%
2017-05,הצפון,531,עראבה,יישוב,1241,534,707,33,1208,1066,1222,23,10.72%
2017-05,הצפון,535,פסוטה,יישוב,80,38,42,9,71,45,78,2,4.34%
2017-05,הצפון,536,פקיעין (בוקייעה),יישוב,115,60,55,8,107,72,108,1,3.60%
2017-05,הצפון,8000,צפת,יישוב,922,492,430,105,817,628,852,26,6.12%
2017-05,הצפון,4100,קצרין,יישוב,172,81,91,21,151,85,168,3,4.19%
2017-05,הצפון,2800,קריית שמונה,יישוב,611,312,299,67,544,269,588,29,4.54%
2017-05,הצפון,543,ראמה,יישוב,233,90,143,19,214,157,223,5,5.42%
2017-05,הצפון,26,ראש פינה,יישוב,47,20,27,10,37,19,46,0,2.79%
2017-05,הצפון,542,ריינה,יישוב,434,197,237,8,426,338,422,6,5.68%
2017-05,הצפון,122,רמת ישי,יישוב,81,32,49,36,45,15,77,2,1.87%
2017-05,הצפון,913,שבלי - אום אל-גנם,יישוב,167,71,96,7,160,105,164,4,5.75%
2017-05,הצפון,812,שלומי,יישוב,216,79,137,18,198,107,209,9,5.69%
2017-05,הצפון,538,שעב,יישוב,417,191,226,2,415,340,410,4,12.01%
2017-05,הצפון,8800,שפרעם,יישוב,1302,545,757,46,1256,1022,1276,22,6.50%
2017-05,חיפה,1326,"בסמ""ה",יישוב,329,151,178,6,323,255,324,4,7.20%
2017-05,חיפה,2710,אום אל-פחם,יישוב,2567,1072,1495,24,2543,2108,2523,40,10.74%
2017-05,חיפה,1020,אור עקיבא,יישוב,404,167,237,43,361,103,390,18,3.72%
2017-05,חיפה,6000,באקה אל-גרביה,יישוב,506,251,255,9,497,326,502,24,3.85%
2017-05,חיפה,9800,בנימינה-גבעת עדה*,יישוב,171,81,90,67,104,33,169,5,2.25%
2017-05,חיפה,541,ג'סר א-זרקא,יישוב,223,127,96,2,221,112,220,9,3.43%
2017-05,חיפה,628,ג'ת,יישוב,181,95,86,9,172,113,179,7,3.10%
2017-05,חיפה,494,דאלית אל-כרמל,יישוב,426,159,267,23,403,229,397,11,4.52%
2017-05,חיפה,9300,זכרון יעקב,יישוב,234,112,122,96,138,29,230,6,2.02%
2017-05,חיפה,6500,חדרה,יישוב,1969,869,1100,237,1732,660,1860,29,3.58%
2017-05,חיפה,4000,חיפה,יישוב,5121,2451,2670,1102,4019,2416,4836,136,3.42%
2017-05,חיפה,1247,חריש,יישוב,46,15,31,10,36,6,42,0,1.00%
2017-05,חיפה,2100,טירת כרמל,יישוב,615,305,310,39,576,310,596,17,4.87%
2017-05,חיפה,654,כפר קרע,יישוב,392,180,212,23,369,231,387,19,4.11%
2017-05,חיפה,45,מ.א. אלונה,מועצה איזורית,27,8,19,10,17,2,27,0,2.53%
2017-05,חיפה,12,מ.א. זבולון,מועצה איזורית,229,111,118,29,200,130,220,0,3.71%
2017-05,חיפה,15,מ.א. חוף הכרמל,מועצה איזורית,268,119,149,94,174,38,265,0,1.79%
2017-05,חיפה,14,מ.א. מנשה,מועצה איזורית,206,88,118,60,146,50,205,0,2.38%
2017-05,חיפה,1327,מעלה עירון,יישוב,640,254,386,4,636,504,627,12,9.51%
2017-05,חיפה,2500,נשר,יישוב,369,186,183,77,292,123,359,7,2.83%
2017-05,חיפה,534,עספיא,יישוב,284,131,153,16,268,148,266,6,4.34%
2017-05,חיפה,637,ערערה,יישוב,478,210,268,10,468,320,468,16,5.19%
2017-05,חיפה,537,פוריידיס,יישוב,199,112,87,4,195,103,195,7,3.21%
2017-05,חיפה,7800,פרדס חנה-כרכור,יישוב,689,320,369,171,518,128,669,23,3.12%
2017-05,חיפה,6800,קריית אתא,יישוב,1266,592,674,106,1160,605,1228,36,3.97%
2017-05,חיפה,9500,קריית ביאליק,יישוב,846,377,469,111,735,356,820,36,3.83%
2017-05,חיפה,2300,קריית טבעון,יישוב,140,61,79,67,73,26,140,3,1.67%
2017-05,חיפה,9600,קריית ים,יישוב,1203,558,645,118,1085,651,1152,37,5.41%
2017-05,חיפה,8200,קריית מוצקין,יישוב,821,360,461,129,692,337,792,15,3.40%
2017-05,חיפה,922,רכסים,יישוב,116,55,61,6,110,58,104,0,2.79%
2017-05,ירושלים,472,אבו גוש,יישוב,203,98,105,6,197,162,201,3,5.80%
2017-05,ירושלים,2610,בית שמש,יישוב,1028,430,598,97,931,385,985,36,2.64%
2017-05,ירושלים,3000,ירושלים,יישוב,10731,4847,5884,1310,9421,6545,10460,157,3.27%
2017-05,ירושלים,26,מ.א. מטה יהודה,מועצה איזורית,518,231,287,158,360,106,507,0,1.96%
2017-05,ירושלים,1015,מבשרת ציון,יישוב,300,142,158,76,224,107,291,6,2.28%
2017-05,ירושלים,1137,קריית יערים,יישוב,42,23,19,7,35,13,42,1,2.36%
2017-05,תל אביב,2400,אור יהודה,יישוב,568,274,294,61,507,133,546,38,2.84%
2017-05,תל אביב,565,אזור,יישוב,164,90,74,28,136,25,163,4,2.43%
2017-05,תל אביב,6100,בני ברק,יישוב,1533,748,785,96,1437,614,1403,18,2.32%
2017-05,תל אביב,6200,בת ים,יישוב,2358,1143,1215,360,1998,825,2223,81,3.16%
2017-05,תל אביב,6300,גבעתיים,יישוב,723,346,377,374,349,65,719,4,2.26%
2017-05,תל אביב,6400,הרצלייה,יישוב,985,430,555,405,580,30,978,7,1.99%
2017-05,תל אביב,6600,חולון,יישוב,2719,1186,1533,484,2235,586,2672,62,2.65%
2017-05,תל אביב,267,כפר שמריהו,יישוב,5,2,3,4,1,0,5,0,0.60%
2017-05,תל אביב,2620,קריית אונו,יישוב,370,164,206,179,191,25,368,3,1.88%
2017-05,תל אביב,8600,רמת גן,יישוב,1937,917,1020,731,1206,274,1898,16,2.32%
2017-05,תל אביב,2650,רמת השרון,יישוב,383,161,222,193,190,9,381,2,1.66%
2017-05,תל אביב,5000,תל אביב -יפו,יישוב,6874,3466,3408,2760,4114,1402,6763,68,2.57%
2017-06,אזור יהודה והשומרון,3760,אורנית,יישוב,82,38,44,31,51,3,82,0,1.64%
2017-06,אזור יהודה והשומרון,3750,אלפי מנשה,יישוב,85,37,48,30,55,1,85,1,1.92%
2017-06,אזור יהודה והשומרון,3560,אלקנה,יישוב,35,16,19,21,14,0,35,0,1.90%
2017-06,אזור יהודה והשומרון,3650,אפרת,יישוב,60,31,29,33,27,2,58,3,1.18%
2017-06,אזור יהודה והשומרון,3570,אריאל,יישוב,275,120,155,61,214,24,273,6,2.48%
2017-06,אזור יהודה והשומרון,3574,בית אל,יישוב,42,19,23,14,28,10,42,1,1.68%
2017-06,אזור יהודה והשומרון,3652,בית אריה,יישוב,60,28,32,18,42,3,60,1,2.08%
2017-06,אזור יהודה והשומרון,3780,ביתר עילית,יישוב,427,197,230,11,416,153,425,4,2.74%
2017-06,אזור יהודה והשומרון,3730,גבעת זאב,יישוב,170,93,77,34,136,32,168,4,2.08%
2017-06,אזור יהודה והשומרון,3769,הר אדר,יישוב,38,18,20,18,20,3,38,0,1.73%
2017-06,אזור יהודה והשומרון,76,מ.א. גוש עציון,מועצה איזורית,155,72,83,56,99,13,155,0,1.53%
2017-06,אזור יהודה והשומרון,78,מ.א. הר חברון,מועצה איזורית,62,32,30,24,38,4,62,0,1.56%
2017-06,אזור יהודה והשומרון,74,מ.א. מגילות ים המלח,מועצה איזורית,13,4,9,3,10,0,13,0,1.41%
2017-06,אזור יהודה והשומרון,73,מ.א. מטה בנימין,מועצה איזורית,555,295,260,191,364,100,547,0,1.93%
2017-06,אזור יהודה והשומרון,75,מ.א. ערבות הירדן,מועצה איזורית,43,22,21,11,32,5,43,0,1.67%
2017-06,אזור יהודה והשומרון,72,מ.א. שומרון,מועצה איזורית,341,159,182,117,224,35,338,0,1.78%
2017-06,אזור יהודה והשומרון,3797,מודיעין עילית,יישוב,392,105,287,20,372,37,390,8,2.44%
2017-06,אזור יהודה והשומרון,3616,מעלה אדומים,יישוב,574,264,310,90,484,147,567,13,2.71%
2017-06,אזור יהודה והשומרון,3608,מעלה אפרים,יישוב,32,15,17,3,29,8,32,0,3.99%
2017-06,אזור יהודה והשומרון,3660,עמנואל,יישוב,47,26,21,1,46,23,46,2,3.39%
2017-06,אזור יהודה והשומרון,3557,קדומים,יישוב,29,17,12,10,19,4,28,0,1.41%
2017-06,אזור יהודה והשומרון,3611,קריית ארבע,יישוב,90,53,37,17,73,40,87,7,2.59%
2017-06,אזור יהודה והשומרון,3640,קרני שומרון,יישוב,69,32,37,25,44,3,69,1,1.70%
2017-06,הדרום,31,אופקים,יישוב,849,397,452,54,795,423,806,39,5.58%
2017-06,הדרום,2600,אילת,יישוב,924,485,439,58,866,325,857,56,2.49%
2017-06,הדרום,70,אשדוד,יישוב,5018,2051,2967,649,4369,2163,4750,141,4.24%
2017-06,הדרום,7100,אשקלון,יישוב,3477,1440,2037,387,3090,1553,3071,78,4.14%
2017-06,הדרום,9000,באר שבע,יישוב,5203,2381,2822,701,4502,2735,4898,91,4.57%
2017-06,הדרום,2200,דימונה,יישוב,1674,784,890,89,1585,1072,1563,60,7.99%
2017-06,הדרום,1303,חורה,יישוב,517,213,304,5,512,445,502,7,10.39%
2017-06,הדרום,831,ירוחם,יישוב,367,182,185,19,348,216,343,33,6.71%
2017-06,הדרום,1059,כסיפה,יישוב,954,360,594,2,952,856,945,11,17.42%
2017-06,הדרום,1271,להבים,יישוב,49,18,31,23,26,4,49,0,1.39%
2017-06,הדרום,1060,לקיה,יישוב,601,271,330,5,596,529,575,9,11.74%
2017-06,הדרום,69,מ.א. אל קסום,מועצה איזורית,577,231,346,4,573,518,557,0,16.33%
2017-06,הדרום,38,מ.א. אשכול,מועצה איזורית,100,44,56,27,73,8,99,0,1.41%
2017-06,הדרום,33,מ.א. באר טוביה,מועצה איזורית,269,112,157,50,219,47,264,0,2.33%
2017-06,הדרום,41,מ.א. בני שמעון,מועצה איזורית,70,33,37,27,43,11,67,1,1.38%
2017-06,הדרום,54,מ.א. הערבה התיכונה,מועצה איזורית,25,12,13,8,17,1,25,0,1.31%
2017-06,הדרום,53,מ.א. חבל אילות,מועצה איזורית,17,1,16,3,14,1,16,4,0.65%
2017-06,הדרום,36,מ.א. חוף אשקלון,מועצה איזורית,167,77,90,35,132,38,159,1,1.83%
2017-06,הדרום,35,מ.א. יואב,מועצה איזורית,78,30,48,30,48,7,78,0,1.91%
2017-06,הדרום,50,מ.א. לכיש,מועצה איזורית,156,79,77,19,137,39,156,0,2.80%
2017-06,הדרום,42,מ.א. מרחבים,מועצה איזורית,166,55,111,30,136,27,164,0,2.61%
2017-06,הדרום,68,מ.א. נווה מדבר,מועצה איזורית,120,44,76,0,120,93,119,0,6.30%
2017-06,הדרום,48,מ.א. רמת נגב,מועצה איזורית,242,127,115,13,229,183,238,0,7.15%
2017-06,הדרום,39,מ.א. שדות נגב,מועצה איזורית,123,65,58,16,107,26,119,0,2.45%
2017-06,הדרום,37,מ.א. שער הנגב,מועצה איזורית,96,41,55,39,57,13,93,1,2.33%
2017-06,הדרום,34,מ.א. שפיר,מועצה איזורית,155,75,80,17,138,44,152,0,3.05%
2017-06,הדרום,51,מ.א. תמר,מועצה איזורית,9,1,8,1,8,2,8,0,1.23%
2017-06,הדרום,1268,מיתר,יישוב,64,25,39,23,41,6,63,0,1.28%
2017-06,הדרום,99,מצפה רמון,יישוב,221,79,142,19,202,133,207,18,7.47%
2017-06,הדרום,246,נתיבות,יישוב,980,443,537,52,928,415,912,53,5.53%
2017-06,הדרום,666,עומר,יישוב,60,21,39,24,36,2,60,1,1.42%
2017-06,הדרום,2560,ערד,יישוב,607,277,330,52,555,313,576,26,4.54%
2017-06,הדרום,1192,ערערה-בנגב,יישוב,1075,448,627,4,1071,973,1050,3,20.09%
2017-06,הדרום,2630,קריית גת,יישוב,1529,658,871,96,1433,657,1456,49,4.97%
2017-06,הדרום,1034,קריית מלאכי,יישוב,672,280,392,15,657,296,635,35,5.15%
2017-06,הדרום,1161,רהט,יישוב,2154,851,1303,8,2146,1686,2116,73,9.41%
2017-06,הדרום,1286,שגב-שלום,יישוב,329,129,200,3,326,275,314,1,9.72%
2017-06,הדרום,1031,שדרות,יישוב,925,423,502,70,855,480,841,24,5.66%
2017-06,הדרום,1054,תל שבע,יישוב,669,288,381,0,669,599,632,2,11.04%
2017-06,המרכז,1066,"בני עי""ש",יישוב,118,56,62,22,96,37,116,4,2.90%
2017-06,המרכז,182,אבן יהודה,יישוב,155,71,84,53,102,20,155,0,2.22%
2017-06,המרכז,41,אליכין,יישוב,59,28,31,8,51,17,56,1,2.85%
2017-06,המרכז,1309,אלעד,יישוב,296,128,168,19,277,35,286,3,2.02%
2017-06,המרכז,2530,באר יעקב,יישוב,210,76,134,66,144,35,206,5,1.61%
2017-06,המרכז,466,בית דגן,יישוב,93,46,47,10,83,24,91,0,2.44%
2017-06,המרכז,681,גבעת שמואל,יישוב,242,135,107,84,158,38,238,3,1.91%
2017-06,המרכז,2550,גדרה,יישוב,281,141,140,52,229,71,274,10,2.12%
2017-06,המרכז,627,ג'לג'וליה,יישוב,65,30,35,2,63,32,64,1,1.49%
2017-06,המרכז,166,גן יבנה,יישוב,297,123,174,44,253,66,285,7,2.24%
2017-06,המרכז,229,גני תקווה,יישוב,211,120,91,73,138,24,208,2,2.15%
2017-06,המרכז,9700,הוד השרון,יישוב,682,294,388,328,354,27,674,14,2.06%
2017-06,המרכז,1290,זמר,יישוב,115,42,73,3,112,78,112,6,3.43%
2017-06,המרכז,2730,טייבה,יישוב,922,423,499,20,902,688,782,27,4.04%
2017-06,המרכז,2720,טירה,יישוב,153,73,80,10,143,50,148,6,1.18%
2017-06,המרכז,2660,יבנה,יישוב,668,316,352,144,524,157,646,28,2.57%
2017-06,המרכז,9400,יהוד,יישוב,356,161,195,97,259,36,341,8,2.09%
2017-06,המרכז,1224,כוכב יאיר,יישוב,68,27,41,43,25,0,68,1,1.23%
2017-06,המרכז,633,כפר ברא,יישוב,15,9,6,2,13,5,14,0,0.87%
2017-06,המרכז,168,כפר יונה,יישוב,284,126,158,55,229,47,283,3,2.41%
2017-06,המרכז,6900,כפר סבא,יישוב,1044,493,551,440,604,81,1027,24,1.94%
2017-06,המרכז,634,כפר קאסם,יישוב,230,81,149,14,216,100,222,2,2.14%
2017-06,המרכז,7000,לוד,יישוב,1585,789,796,133,1452,807,1546,33,4.19%
2017-06,המרכז,28,מ.א. ברנר,מועצה איזורית,69,26,43,36,33,4,68,2,1.68%
2017-06,המרכז,32,מ.א. גדרות,מועצה איזורית,43,16,27,25,18,3,43,0,1.74%
2017-06,המרכז,30,מ.א. גזר,מועצה איזורית,244,111,133,95,149,27,241,0,1.80%
2017-06,המרכז,27,מ.א. גן רווה,מועצה איזורית,58,24,34,30,28,1,58,0,1.93%
2017-06,המרכז,20,מ.א. דרום השרון,מועצה איזורית,325,133,192,153,172,12,322,0,1.99%
2017-06,המרכז,29,מ.א. חבל יבנה,מועצה איזורית,29,15,14,13,16,3,29,0,1.11%
2017-06,המרכז,25,מ.א. חבל מודיעין,מועצה איזורית,213,84,129,61,152,20,207,0,1.88%
2017-06,המרכז,19,מ.א. חוף השרון,מועצה איזורית,83,27,56,38,45,2,83,0,1.49%
2017-06,המרכז,18,מ.א. לב השרון,מועצה איזורית,241,112,129,70,171,30,236,0,2.12%
2017-06,המרכז,31,מ.א. נחל שורק,מועצה איזורית,51,26,25,11,40,7,49,39,1.14%
2017-06,המרכז,16,מ.א. עמק חפר,מועצה איזורית,357,144,213,161,196,14,355,0,1.80%
2017-06,המרכז,40,מ.א. שדות דן,מועצה איזורית,115,55,60,38,77,9,114,0,1.77%
2017-06,המרכז,1200,מודיעין-מכבים-רעות*,יישוב,822,376,446,359,463,33,812,15,1.76%
2017-06,המרכז,28,מזכרת בתיה,יישוב,150,59,91,46,104,17,147,2,1.81%
2017-06,המרכז,7200,נס ציונה,יישוב,664,331,333,183,481,150,652,18,2.63%
2017-06,המרכז,7400,נתניה,יישוב,3756,1820,1936,492,3264,1152,3682,115,3.39%
2017-06,המרכז,587,סביון*,יישוב,17,1,16,9,8,0,17,0,0.82%
2017-06,המרכז,171,פרדסייה,יישוב,70,33,37,25,45,6,70,0,1.86%
2017-06,המרכז,7900,פתח תקווה,יישוב,3480,1602,1878,732,2748,764,3382,53,2.62%
2017-06,המרכז,195,קדימה-צורן,יישוב,246,108,138,81,165,29,246,0,2.10%
2017-06,המרכז,638,קלנסווה,יישוב,328,165,163,13,315,219,299,6,3.08%
2017-06,המרכז,469,קריית עקרון,יישוב,206,99,107,21,185,96,196,5,3.23%
2017-06,המרכז,2640,ראש העין,יישוב,756,367,389,147,609,120,751,16,2.43%
2017-06,המרכז,8300,ראשון לציון,יישוב,3877,1737,2140,810,3067,905,3823,74,2.72%
2017-06,המרכז,8400,רחובות,יישוב,2055,885,1170,542,1513,636,1977,41,2.79%
2017-06,המרכז,8500,רמלה,יישוב,1371,664,707,110,1261,530,1324,56,3.41%
2017-06,המרכז,8700,רעננה,יישוב,676,320,356,297,379,44,664,8,1.76%
2017-06,המרכז,1304,שוהם,יישוב,180,74,106,96,84,9,180,1,1.49%
2017-06,המרכז,154,תל מונד,יישוב,136,66,70,49,87,15,135,0,1.96%
2017-06,הצפון,473,אבו סנאן,יישוב,523,213,310,4,519,415,515,3,8.13%
2017-06,הצפון,478,אכסאל,יישוב,407,176,231,12,395,354,403,2,6.32%
2017-06,הצפון,529,אעבלין,יישוב,405,182,223,15,390,316,395,3,6.34%
2017-06,הצפון,482,בועיינה-נוג'ידאת,יישוב,239,119,120,5,234,186,236,4,5.45%
2017-06,הצפון,4001,בוקעאתא,יישוב,391,148,243,7,384,295,369,3,11.99%
2017-06,הצפון,998,ביר אל-מכסור,יישוב,284,129,155,4,280,213,280,1,6.68%
2017-06,הצפון,480,בית ג'ן,יישוב,363,94,269,6,357,239,341,1,5.69%
2017-06,הצפון,9200,בית שאן,יישוב,633,271,362,25,608,273,610,49,5.80%
2017-06,הצפון,944,בסמת טבעון,יישוב,162,72,90,3,159,112,150,4,4.15%
2017-06,הצפון,483,בענה,יישוב,307,140,167,3,304,257,295,13,7.59%
2017-06,הצפון,1292,ג'דיידה-מכר,יישוב,1051,477,574,5,1046,813,1036,9,10.00%
2017-06,הצפון,485,ג'ולס,יישוב,178,50,128,6,172,113,178,4,5.41%
2017-06,הצפון,487,ג'ש (גוש חלב),יישוב,45,21,24,3,42,24,45,0,2.63%
2017-06,הצפון,489,דבורייה,יישוב,251,106,145,14,237,178,248,3,5.22%
2017-06,הצפון,490,דייר אל-אסד,יישוב,302,132,170,11,291,245,298,5,5.19%
2017-06,הצפון,492,דייר חנא,יישוב,537,226,311,16,521,398,532,6,9.95%
2017-06,הצפון,975,זרזיר,יישוב,194,85,109,0,194,135,190,1,5.29%
2017-06,הצפון,496,חורפיש,יישוב,97,42,55,5,92,52,94,2,3.08%
2017-06,הצפון,2034,חצור הגלילית,יישוב,221,93,128,8,213,111,211,6,4.32%
2017-06,הצפון,6700,טבריה,יישוב,1287,615,672,64,1223,656,1100,60,4.94%
2017-06,הצפון,962,טובא-זנגרייה,יישוב,324,141,183,3,321,210,314,3,9.12%
2017-06,הצפון,498,טורעאן,יישוב,352,157,195,7,345,290,346,6,5.44%
2017-06,הצפון,8900,טמרה,יישוב,1205,573,632,16,1189,1022,1175,5,7.54%
2017-06,הצפון,1295,יאנוח-ג'ת,יישוב,122,36,86,4,118,74,119,1,3.71%
2017-06,הצפון,46,יבנאל,יישוב,102,53,49,8,94,63,80,5,5.02%
2017-06,הצפון,29,יסוד המעלה,יישוב,12,6,6,2,10,3,12,0,1.37%
2017-06,הצפון,499,יפיע,יישוב,502,223,279,20,482,375,493,2,5.68%
2017-06,הצפון,240,יקנעם עילית,יישוב,407,180,227,85,322,87,399,28,3.10%
2017-06,הצפון,502,ירכא,יישוב,368,130,238,2,366,284,363,1,5.16%
2017-06,הצפון,504,כאבול,יישוב,422,213,209,5,417,350,409,3,7.51%
2017-06,הצפון,505,כאוכב אבו אל-היג'א,יישוב,191,78,113,2,189,150,190,4,9.96%
2017-06,הצפון,1296,כסרא-סמיע,יישוב,186,53,133,5,181,112,171,3,4.39%
2017-06,הצפון,978,כעביה-טבאש-חג'אג'רה,יישוב,160,67,93,1,159,115,156,2,6.02%
2017-06,הצפון,1263,כפר ורדים,יישוב,45,20,25,20,25,5,43,0,1.39%
2017-06,הצפון,507,כפר יאסיף,יישוב,326,138,188,5,321,232,319,4,5.90%
2017-06,הצפון,508,כפר כמא,יישוב,40,21,19,2,38,19,40,2,2.31%
2017-06,הצפון,509,כפר כנא,יישוב,702,329,373,18,684,562,681,10,7.00%
2017-06,הצפון,510,כפר מנדא,יישוב,637,343,294,9,628,466,629,21,7.78%
2017-06,הצפון,47,כפר תבור,יישוב,36,11,25,13,23,1,36,2,1.52%
2017-06,הצפון,1139,כרמיאל,יישוב,1351,570,781,274,1077,666,1236,45,4.76%
2017-06,הצפון,65,מ.א. אל-בטוף,מועצה איזורית,224,94,130,7,217,184,219,1,6.74%
2017-06,הצפון,66,מ.א. בוסתן אל-מרג,מועצה איזורית,34,10,24,0,34,28,31,0,0.88%
2017-06,הצפון,71,מ.א. גולן,מועצה איזורית,172,75,97,54,118,14,171,1,1.95%
2017-06,הצפון,8,מ.א. הגלבוע,מועצה איזורית,580,250,330,54,526,304,568,0,4.02%
2017-06,הצפון,1,מ.א. הגליל העליון,מועצה איזורית,178,78,100,56,122,23,177,0,1.98%
2017-06,הצפון,3,מ.א. הגליל התחתון,מועצה איזורית,95,44,51,32,63,10,93,0,1.54%
2017-06,הצפון,55,מ.א. מבואות החרמון,מועצה איזורית,96,40,56,24,72,16,93,0,2.32%
2017-06,הצפון,13,מ.א. מגידו,מועצה איזורית,79,37,42,28,51,10,77,0,1.36%
2017-06,הצפון,4,מ.א. מטה אשר,מועצה איזורית,420,192,228,69,351,160,410,0,2.89%
2017-06,הצפון,52,מ.א. מעלה יוסף,מועצה איזורית,165,80,85,22,143,44,161,0,2.81%
2017-06,הצפון,2,מ.א. מרום הגליל,מועצה איזורית,225,95,130,27,198,93,215,0,3.01%
2017-06,הצפון,56,מ.א. משגב,מועצה איזורית,482,184,298,99,383,260,469,0,3.32%
2017-06,הצפון,6,מ.א. עמק הירדן,מועצה איזורית,157,75,82,32,125,36,146,0,2.15%
2017-06,הצפון,7,מ.א. עמק המעיינות,מועצה איזורית,163,78,85,28,135,37,158,0,2.41%
2017-06,הצפון,9,מ.א. עמק יזרעאל,מועצה איזורית,298,142,156,150,148,35,291,0,1.49%
2017-06,הצפון,481,מגאר,יישוב,1156,477,679,15,1141,925,1121,2,10.39%
2017-06,הצפון,516,מג'ד אל-כרום,יישוב,405,199,206,6,399,304,390,11,5.31%
2017-06,הצפון,65,מגדל,יישוב,29,13,16,1,28,12,26,1,2.63%
2017-06,הצפון,874,מגדל העמק,יישוב,702,313,389,70,632,281,643,70,4.71%
2017-06,הצפון,4201,מג'דל שמס,יישוב,402,150,252,8,394,303,379,2,7.15%
2017-06,הצפון,517,מזרעה,יישוב,149,64,85,1,148,112,142,3,6.58%
2017-06,הצפון,43,מטולה,יישוב,21,13,8,8,13,6,19,0,1.89%
2017-06,הצפון,4203,מסעדה,יישוב,193,76,117,5,188,145,177,4,9.68%
2017-06,הצפון,518,מעיליא,יישוב,44,22,22,9,35,17,44,5,2.57%
2017-06,הצפון,1063,מעלות-תרשיחא,יישוב,706,364,342,76,630,356,671,35,5.49%
2017-06,הצפון,520,משהד,יישוב,176,76,100,7,169,143,168,4,4.67%
2017-06,הצפון,9100,נהרייה,יישוב,1694,839,855,182,1512,885,1585,58,5.00%
2017-06,הצפון,522,נחף,יישוב,340,158,182,11,329,258,332,5,5.93%
2017-06,הצפון,7300,נצרת,יישוב,2478,1109,1369,103,2375,1833,2452,21,6.64%
2017-06,הצפון,1061,נצרת עילית,יישוב,1263,579,684,130,1133,603,1123,84,4.79%
2017-06,הצפון,525,סאג'ור,יישוב,101,32,69,7,94,59,100,0,4.60%
2017-06,הצפון,7500,סח'נין,יישוב,1626,722,904,40,1586,1347,1607,13,10.33%
2017-06,הצפון,4501,ע'ג'ר,יישוב,84,23,61,1,83,61,80,0,6.66%
2017-06,הצפון,530,עיילבון,יישוב,138,67,71,12,126,84,133,1,4.59%
2017-06,הצפון,511,עילוט,יישוב,253,111,142,4,249,200,250,0,7.76%
2017-06,הצפון,532,עין מאהל,יישוב,346,176,170,9,337,272,333,2,5.67%
2017-06,הצפון,4502,עין קנייא,יישוב,118,40,78,3,115,100,114,0,10.19%
2017-06,הצפון,7600,עכו,יישוב,2585,1167,1418,129,2456,1891,2483,32,9.13%
2017-06,הצפון,7700,עפולה,יישוב,1417,589,828,163,1254,523,1339,81,4.88%
2017-06,הצפון,531,עראבה,יישוב,1188,499,689,25,1163,1016,1172,8,10.33%
2017-06,הצפון,535,פסוטה,יישוב,83,43,40,8,75,43,78,2,4.34%
2017-06,הצפון,536,פקיעין (בוקייעה),יישוב,117,62,55,8,109,73,108,1,3.60%
2017-06,הצפון,8000,צפת,יישוב,928,501,427,95,833,610,851,16,6.12%
2017-06,הצפון,4100,קצרין,יישוב,167,78,89,19,148,82,163,8,4.07%
2017-06,הצפון,2800,קריית שמונה,יישוב,603,302,301,63,540,255,575,37,4.45%
2017-06,הצפון,543,ראמה,יישוב,222,86,136,15,207,155,214,1,5.21%
2017-06,הצפון,26,ראש פינה,יישוב,43,18,25,10,33,20,42,0,2.55%
2017-06,הצפון,542,ריינה,יישוב,413,190,223,7,406,316,403,4,5.44%
2017-06,הצפון,122,רמת ישי,יישוב,81,34,47,34,47,14,78,2,1.89%
2017-06,הצפון,913,שבלי - אום אל-גנם,יישוב,169,78,91,8,161,107,167,4,5.85%
2017-06,הצפון,812,שלומי,יישוב,201,78,123,17,184,105,195,8,5.32%
2017-06,הצפון,538,שעב,יישוב,400,187,213,3,397,331,394,3,11.59%
2017-06,הצפון,8800,שפרעם,יישוב,1253,520,733,38,1215,1001,1225,23,6.26%
2017-06,חיפה,1326,"בסמ""ה",יישוב,326,156,170,5,321,253,321,7,7.14%
2017-06,חיפה,2710,אום אל-פחם,יישוב,2522,1065,1457,18,2504,2088,2465,30,10.51%
2017-06,חיפה,1020,אור עקיבא,יישוב,411,175,236,39,372,108,393,11,3.74%
2017-06,חיפה,6000,באקה אל-גרביה,יישוב,519,242,277,10,509,333,516,18,3.96%
2017-06,חיפה,9800,בנימינה-גבעת עדה*,יישוב,172,82,90,73,99,31,172,1,2.29%
2017-06,חיפה,541,ג'סר א-זרקא,יישוב,239,119,120,2,237,107,232,12,3.61%
2017-06,חיפה,628,ג'ת,יישוב,183,98,85,8,175,116,182,4,3.15%
2017-06,חיפה,494,דאלית אל-כרמל,יישוב,425,164,261,21,404,227,397,8,4.52%
2017-06,חיפה,9300,זכרון יעקב,יישוב,230,116,114,96,134,31,225,3,1.98%
2017-06,חיפה,6500,חדרה,יישוב,1951,857,1094,228,1723,657,1839,53,3.54%
2017-06,חיפה,4000,חיפה,יישוב,5062,2400,2662,1100,3962,2403,4755,144,3.37%
2017-06,חיפה,1247,חריש,יישוב,47,16,31,8,39,7,44,0,1.05%
2017-06,חיפה,2100,טירת כרמל,יישוב,624,296,328,39,585,306,602,16,4.91%
2017-06,חיפה,654,כפר קרע,יישוב,391,184,207,20,371,225,386,8,4.10%
2017-06,חיפה,45,מ.א. אלונה,מועצה איזורית,22,9,13,9,13,2,22,0,2.06%
2017-06,חיפה,12,מ.א. זבולון,מועצה איזורית,233,116,117,28,205,129,222,0,3.74%
2017-06,חיפה,15,מ.א. חוף הכרמל,מועצה איזורית,262,112,150,91,171,36,260,0,1.75%
2017-06,חיפה,14,מ.א. מנשה,מועצה איזורית,192,80,112,59,133,47,191,0,2.22%
2017-06,חיפה,1327,מעלה עירון,יישוב,635,251,384,3,632,497,620,5,9.41%
2017-06,חיפה,2500,נשר,יישוב,365,176,189,69,296,131,350,9,2.76%
2017-06,חיפה,534,עספיא,יישוב,291,138,153,13,278,152,267,5,4.36%
2017-06,חיפה,637,ערערה,יישוב,484,212,272,12,472,326,473,15,5.24%
2017-06,חיפה,537,פוריידיס,יישוב,181,98,83,4,177,85,181,2,2.99%
2017-06,חיפה,7800,פרדס חנה-כרכור,יישוב,685,331,354,161,524,120,669,33,3.12%
2017-06,חיפה,6800,קריית אתא,יישוב,1309,607,702,99,1210,614,1270,28,4.10%
2017-06,חיפה,9500,קריית ביאליק,יישוב,860,377,483,108,752,361,830,21,3.88%
2017-06,חיפה,2300,קריית טבעון,יישוב,144,65,79,68,76,28,141,1,1.68%
2017-06,חיפה,9600,קריית ים,יישוב,1186,548,638,113,1073,641,1139,38,5.36%
2017-06,חיפה,8200,קריית מוצקין,יישוב,818,355,463,128,690,329,789,13,3.39%
2017-06,חיפה,922,רכסים,יישוב,130,59,71,4,126,60,118,1,3.16%
2017-06,ירושלים,472,אבו גוש,יישוב,197,94,103,4,193,157,193,1,5.58%
2017-06,ירושלים,2610,בית שמש,יישוב,1075,468,607,84,991,385,1025,44,2.74%
2017-06,ירושלים,3000,ירושלים,יישוב,10808,4868,5940,1330,9478,6427,10516,150,3.28%
2017-06,ירושלים,26,מ.א. מטה יהודה,מועצה איזורית,519,231,288,157,362,104,508,0,1.96%
2017-06,ירושלים,1015,מבשרת ציון,יישוב,305,146,159,83,222,96,299,3,2.34%
2017-06,ירושלים,1137,קריית יערים,יישוב,39,19,20,5,34,12,39,1,2.19%
2017-06,תל אביב,2400,אור יהודה,יישוב,571,291,280,50,521,115,548,38,2.85%
2017-06,תל אביב,565,אזור,יישוב,184,100,84,35,149,26,181,5,2.70%
2017-06,תל אביב,6100,בני ברק,יישוב,1519,727,792,97,1422,598,1396,27,2.31%
2017-06,תל אביב,6200,בת ים,יישוב,2355,1132,1223,375,1980,802,2223,75,3.16%
2017-06,תל אביב,6300,גבעתיים,יישוב,722,344,378,366,356,70,715,1,2.25%
2017-06,תל אביב,6400,הרצלייה,יישוב,995,456,538,398,597,35,983,7,2.00%
2017-06,תל אביב,6600,חולון,יישוב,2729,1216,1513,492,2237,583,2662,65,2.64%
2017-06,תל אביב,267,כפר שמריהו,יישוב,4,1,3,3,1,0,4,0,0.48%
2017-06,תל אביב,2620,קריית אונו,יישוב,368,164,204,183,185,28,364,1,1.86%
2017-06,תל אביב,8600,רמת גן,יישוב,1932,919,1013,722,1210,270,1897,16,2.32%
2017-06,תל אביב,2650,רמת השרון,יישוב,406,166,240,199,207,16,401,0,1.75%
2017-06,תל אביב,5000,תל אביב -יפו,יישוב,6945,3487,3458,2783,4162,1379,6817,47,2.59%
2017-07,אזור יהודה והשומרון,3760,אורנית,יישוב,92,47,45,29,63,2,92,0,1.83%
2017-07,אזור יהודה והשומרון,3750,אלפי מנשה,יישוב,77,32,45,25,52,1,76,2,1.72%
2017-07,אזור יהודה והשומרון,3560,אלקנה,יישוב,36,15,21,21,15,0,36,0,1.95%
2017-07,אזור יהודה והשומרון,3650,אפרת,יישוב,60,32,28,34,26,2,59,1,1.20%
2017-07,אזור יהודה והשומרון,3570,אריאל,יישוב,286,121,165,72,214,27,284,11,2.58%
2017-07,אזור יהודה והשומרון,3574,בית אל,יישוב,57,31,26,18,39,13,55,0,2.19%
2017-07,אזור יהודה והשומרון,3652,בית אריה,יישוב,62,31,31,15,47,3,62,2,2.15%
2017-07,אזור יהודה והשומרון,3780,ביתר עילית,יישוב,786,250,536,17,769,180,779,2,4.91%
2017-07,אזור יהודה והשומרון,3730,גבעת זאב,יישוב,190,92,98,43,147,31,189,0,2.33%
2017-07,אזור יהודה והשומרון,3769,הר אדר,יישוב,34,16,18,16,18,3,34,0,1.55%
2017-07,אזור יהודה והשומרון,76,מ.א. גוש עציון,מועצה איזורית,164,78,86,57,107,14,162,0,1.60%
2017-07,אזור יהודה והשומרון,78,מ.א. הר חברון,מועצה איזורית,64,32,32,18,46,4,64,0,1.61%
2017-07,אזור יהודה והשומרון,74,מ.א. מגילות ים המלח,מועצה איזורית,13,4,9,4,9,0,13,0,1.42%
2017-07,אזור יהודה והשומרון,73,מ.א. מטה בנימין,מועצה איזורית,585,304,281,199,386,98,575,0,2.03%
2017-07,אזור יהודה והשומרון,75,מ.א. ערבות הירדן,מועצה איזורית,45,21,24,14,31,5,45,0,1.75%
2017-07,אזור יהודה והשומרון,72,מ.א. שומרון,מועצה איזורית,382,176,206,129,253,34,377,0,1.99%
2017-07,אזור יהודה והשומרון,3797,מודיעין עילית,יישוב,893,133,760,25,868,40,889,8,5.39%
2017-07,אזור יהודה והשומרון,3616,מעלה אדומים,יישוב,630,265,365,99,531,153,620,10,2.96%
2017-07,אזור יהודה והשומרון,3608,מעלה אפרים,יישוב,27,11,16,4,23,9,27,0,3.38%
2017-07,אזור יהודה והשומרון,3660,עמנואל,יישוב,69,32,37,2,67,23,68,0,4.93%
2017-07,אזור יהודה והשומרון,3557,קדומים,יישוב,28,16,12,9,19,3,27,0,1.36%
2017-07,אזור יהודה והשומרון,3611,קריית ארבע,יישוב,100,65,35,16,84,38,97,5,2.88%
2017-07,אזור יהודה והשומרון,3640,קרני שומרון,יישוב,70,34,36,25,45,4,70,1,1.73%
2017-07,הדרום,31,אופקים,יישוב,979,397,582,57,922,438,945,46,6.48%
2017-07,הדרום,2600,אילת,יישוב,948,490,458,61,887,314,886,49,2.57%
2017-07,הדרום,70,אשדוד,יישוב,5572,2169,3403,683,4889,2173,5333,118,4.73%
2017-07,הדרום,7100,אשקלון,יישוב,3700,1498,2202,417,3283,1543,3319,69,4.46%
2017-07,הדרום,9000,באר שבע,יישוב,5571,2551,3020,768,4803,2711,5276,91,4.90%
2017-07,הדרום,2200,דימונה,יישוב,1809,822,987,91,1718,1077,1707,32,8.66%
2017-07,הדרום,1303,חורה,יישוב,535,228,307,7,528,452,513,3,10.59%
2017-07,הדרום,831,ירוחם,יישוב,431,196,235,18,413,228,400,16,7.74%
2017-07,הדרום,1059,כסיפה,יישוב,996,378,618,3,993,875,982,6,17.98%
2017-07,הדרום,1271,להבים,יישוב,48,21,27,20,28,5,47,1,1.33%
2017-07,הדרום,1060,לקיה,יישוב,650,268,382,4,646,523,626,5,12.65%
2017-07,הדרום,69,מ.א. אל קסום,מועצה איזורית,612,248,364,3,609,528,592,0,17.36%
2017-07,הדרום,38,מ.א. אשכול,מועצה איזורית,126,48,78,34,92,10,121,0,1.73%
2017-07,הדרום,33,מ.א. באר טוביה,מועצה איזורית,273,114,159,55,218,45,271,0,2.39%
2017-07,הדרום,41,מ.א. בני שמעון,מועצה איזורית,87,39,48,35,52,10,85,3,1.75%
2017-07,הדרום,54,מ.א. הערבה התיכונה,מועצה איזורית,32,15,17,8,24,2,31,0,1.63%
2017-07,הדרום,53,מ.א. חבל אילות,מועצה איזורית,18,3,15,3,15,1,17,0,0.69%
2017-07,הדרום,36,מ.א. חוף אשקלון,מועצה איזורית,213,101,112,43,170,38,205,0,2.36%
2017-07,הדרום,35,מ.א. יואב,מועצה איזורית,82,34,48,25,57,12,81,0,1.98%
2017-07,הדרום,50,מ.א. לכיש,מועצה איזורית,174,79,95,28,146,38,171,0,3.07%
2017-07,הדרום,42,מ.א. מרחבים,מועצה איזורית,195,63,132,29,166,35,187,0,2.97%
2017-07,הדרום,68,מ.א. נווה מדבר,מועצה איזורית,131,54,77,0,131,96,130,0,6.88%
2017-07,הדרום,48,מ.א. רמת נגב,מועצה איזורית,266,145,121,14,252,189,260,0,7.81%
2017-07,הדרום,39,מ.א. שדות נגב,מועצה איזורית,122,59,63,13,109,27,119,1,2.45%
2017-07,הדרום,37,מ.א. שער הנגב,מועצה איזורית,111,42,69,46,65,14,108,0,2.71%
2017-07,הדרום,34,מ.א. שפיר,מועצה איזורית,167,73,94,16,151,42,163,0,3.27%
2017-07,הדרום,51,מ.א. תמר,מועצה איזורית,7,2,5,0,7,1,7,0,1.08%
2017-07,הדרום,1268,מיתר,יישוב,56,23,33,18,38,5,54,2,1.10%
2017-07,הדרום,99,מצפה רמון,יישוב,224,82,142,21,203,130,214,16,7.70%
2017-07,הדרום,246,נתיבות,יישוב,1221,470,751,63,1158,413,1159,67,6.92%
2017-07,הדרום,666,עומר,יישוב,61,25,36,24,37,2,61,0,1.44%
2017-07,הדרום,2560,ערד,יישוב,645,286,359,62,583,308,611,28,4.80%
2017-07,הדרום,1192,ערערה-בנגב,יישוב,1115,461,654,5,1110,995,1087,1,20.65%
2017-07,הדרום,2630,קריית גת,יישוב,1588,681,907,110,1478,632,1512,58,5.15%
2017-07,הדרום,1034,קריית מלאכי,יישוב,728,313,415,15,713,297,697,38,5.63%
2017-07,הדרום,1161,רהט,יישוב,2429,971,1458,12,2417,1719,2394,56,10.51%
2017-07,הדרום,1286,שגב-שלום,יישוב,371,143,228,4,367,281,357,2,10.91%
2017-07,הדרום,1031,שדרות,יישוב,1021,465,556,80,941,490,941,31,6.29%
2017-07,הדרום,1054,תל שבע,יישוב,767,328,439,1,766,631,725,5,12.47%
2017-07,המרכז,1066,"בני עי""ש",יישוב,144,66,78,22,122,36,142,3,3.53%
2017-07,המרכז,182,אבן יהודה,יישוב,141,63,78,48,93,19,141,0,2.02%
2017-07,המרכז,41,אליכין,יישוב,65,30,35,7,58,15,61,3,3.10%
2017-07,המרכז,1309,אלעד,יישוב,601,155,446,22,579,32,595,4,4.11%
2017-07,המרכז,2530,באר יעקב,יישוב,260,91,169,70,190,36,256,4,1.99%
2017-07,המרכז,466,בית דגן,יישוב,104,48,56,10,94,29,102,1,2.72%
2017-07,המרכז,681,גבעת שמואל,יישוב,256,138,118,97,159,36,253,1,2.02%
2017-07,המרכז,2550,גדרה,יישוב,308,145,163,62,246,72,302,6,2.33%
2017-07,המרכז,627,ג'לג'וליה,יישוב,73,34,39,2,71,38,72,2,1.68%
2017-07,המרכז,166,גן יבנה,יישוב,321,127,194,54,267,71,313,2,2.46%
2017-07,המרכז,229,גני תקווה,יישוב,221,111,110,78,143,24,219,1,2.26%
2017-07,המרכז,9700,הוד השרון,יישוב,710,298,412,325,385,29,707,6,2.16%
2017-07,המרכז,1290,זמר,יישוב,124,47,77,3,121,83,121,1,3.69%
2017-07,המרכז,2730,טייבה,יישוב,964,438,526,27,937,688,821,30,4.23%
2017-07,המרכז,2720,טירה,יישוב,191,89,102,14,177,55,182,4,1.45%
2017-07,המרכז,2660,יבנה,יישוב,762,323,439,155,607,150,752,33,2.97%
2017-07,המרכז,9400,יהוד,יישוב,356,155,201,95,261,33,349,4,2.14%
2017-07,המרכז,1224,כוכב יאיר,יישוב,77,29,48,48,29,0,77,0,1.39%
2017-07,המרכז,633,כפר ברא,יישוב,15,7,8,0,15,6,15,0,0.93%
2017-07,המרכז,168,כפר יונה,יישוב,289,122,167,58,231,37,288,3,2.46%
2017-07,המרכז,6900,כפר סבא,יישוב,1110,501,609,458,652,86,1090,15,2.06%
2017-07,המרכז,634,כפר קאסם,יישוב,297,102,195,9,288,116,286,3,2.74%
2017-07,המרכז,7000,לוד,יישוב,1714,808,906,141,1573,809,1672,36,4.51%
2017-07,המרכז,28,מ.א. ברנר,מועצה איזורית,59,23,36,28,31,3,59,1,1.45%
2017-07,המרכז,32,מ.א. גדרות,מועצה איזורית,47,20,27,30,17,5,47,0,1.90%
2017-07,המרכז,30,מ.א. גזר,מועצה איזורית,279,115,164,108,171,28,276,0,2.06%
2017-07,המרכז,27,מ.א. גן רווה,מועצה איזורית,62,27,35,28,34,0,62,0,2.07%
2017-07,המרכז,20,מ.א. דרום השרון,מועצה איזורית,330,131,199,159,171,10,329,0,2.03%
2017-07,המרכז,29,מ.א. חבל יבנה,מועצה איזורית,38,18,20,13,25,2,38,0,1.45%
2017-07,המרכז,25,מ.א. חבל מודיעין,מועצה איזורית,222,95,127,62,160,21,214,0,1.95%
2017-07,המרכז,19,מ.א. חוף השרון,מועצה איזורית,82,25,57,34,48,3,82,0,1.47%
2017-07,המרכז,18,מ.א. לב השרון,מועצה איזורית,275,127,148,72,203,32,271,0,2.44%
2017-07,המרכז,31,מ.א. נחל שורק,מועצה איזורית,67,33,34,19,48,7,65,46,1.47%
2017-07,המרכז,16,מ.א. עמק חפר,מועצה איזורית,366,149,217,164,202,16,363,0,1.84%
2017-07,המרכז,40,מ.א. שדות דן,מועצה איזורית,135,58,77,39,96,10,134,0,2.08%
2017-07,המרכז,1200,מודיעין-מכבים-רעות*,יישוב,887,382,505,364,523,40,878,21,1.90%
2017-07,המרכז,28,מזכרת בתיה,יישוב,165,66,99,47,118,16,162,1,1.99%
2017-07,המרכז,7200,נס ציונה,יישוב,683,314,369,182,501,145,673,10,2.71%
2017-07,המרכז,7400,נתניה,יישוב,4041,1836,2205,488,3553,1125,3962,88,3.64%
2017-07,המרכז,587,סביון*,יישוב,19,1,18,8,11,2,19,0,0.91%
2017-07,המרכז,171,פרדסייה,יישוב,73,39,34,23,50,5,73,1,1.94%
2017-07,המרכז,7900,פתח תקווה,יישוב,3696,1646,2050,747,2949,764,3600,54,2.78%
2017-07,המרכז,195,קדימה-צורן,יישוב,262,114,148,75,187,30,261,4,2.22%
2017-07,המרכז,638,קלנסווה,יישוב,331,166,165,10,321,217,302,8,3.11%
2017-07,המרכז,469,קריית עקרון,יישוב,247,104,143,19,228,91,243,5,3.97%
2017-07,המרכז,2640,ראש העין,יישוב,795,372,423,161,634,118,787,17,2.54%
2017-07,המרכז,8300,ראשון לציון,יישוב,4040,1750,2290,841,3199,884,3987,66,2.83%
2017-07,המרכז,8400,רחובות,יישוב,2392,918,1474,565,1827,622,2322,34,3.26%
2017-07,המרכז,8500,רמלה,יישוב,1508,688,820,114,1394,537,1455,39,3.74%
2017-07,המרכז,8700,רעננה,יישוב,697,309,388,309,388,39,690,8,1.82%
2017-07,המרכז,1304,שוהם,יישוב,194,75,119,100,94,8,194,2,1.60%
2017-07,המרכז,154,תל מונד,יישוב,137,59,78,47,90,16,137,1,1.98%
2017-07,הצפון,473,אבו סנאן,יישוב,536,219,317,5,531,413,529,7,8.33%
2017-07,הצפון,478,אכסאל,יישוב,408,173,235,13,395,349,405,1,6.35%
2017-07,הצפון,529,אעבלין,יישוב,417,177,240,22,395,306,410,10,6.57%
2017-07,הצפון,482,בועיינה-נוג'ידאת,יישוב,241,124,117,7,234,179,236,17,5.45%
2017-07,הצפון,4001,בוקעאתא,יישוב,387,143,244,7,380,294,372,3,12.08%
2017-07,הצפון,998,ביר אל-מכסור,יישוב,278,127,151,3,275,205,276,4,6.59%
2017-07,הצפון,480,בית ג'ן,יישוב,361,94,267,9,352,232,346,2,5.77%
2017-07,הצפון,9200,בית שאן,יישוב,682,285,397,23,659,284,659,46,6.24%
2017-07,הצפון,944,בסמת טבעון,יישוב,164,66,98,4,160,108,155,1,4.28%
2017-07,הצפון,483,בענה,יישוב,327,140,187,6,321,258,309,6,7.92%
2017-07,הצפון,1292,ג'דיידה-מכר,יישוב,1041,468,573,6,1035,792,1026,13,9.92%
2017-07,הצפון,485,ג'ולס,יישוב,177,48,129,5,172,113,177,0,5.38%
2017-07,הצפון,487,ג'ש (גוש חלב),יישוב,46,20,26,3,43,23,46,1,2.69%
2017-07,הצפון,489,דבורייה,יישוב,261,113,148,12,249,184,258,4,5.42%
2017-07,הצפון,490,דייר אל-אסד,יישוב,335,137,198,14,321,252,323,4,5.60%
2017-07,הצפון,492,דייר חנא,יישוב,528,223,305,18,510,383,523,4,9.80%
2017-07,הצפון,975,זרזיר,יישוב,220,85,135,2,218,137,217,5,5.99%
2017-07,הצפון,496,חורפיש,יישוב,91,42,49,5,86,50,87,1,2.86%
2017-07,הצפון,2034,חצור הגלילית,יישוב,239,91,148,16,223,109,227,3,4.63%
2017-07,הצפון,6700,טבריה,יישוב,1385,628,757,78,1307,649,1206,54,5.39%
2017-07,הצפון,962,טובא-זנגרייה,יישוב,317,139,178,3,314,207,307,5,8.94%
2017-07,הצפון,498,טורעאן,יישוב,362,153,209,8,354,284,355,2,5.57%
2017-07,הצפון,8900,טמרה,יישוב,1238,567,671,24,1214,1019,1203,9,7.71%
2017-07,הצפון,1295,יאנוח-ג'ת,יישוב,136,42,94,4,132,75,134,2,4.16%
2017-07,הצפון,46,יבנאל,יישוב,110,59,51,7,103,64,90,2,5.61%
2017-07,הצפון,29,יסוד המעלה,יישוב,21,14,7,4,17,4,21,0,2.38%
2017-07,הצפון,499,יפיע,יישוב,500,209,291,19,481,368,493,2,5.68%
2017-07,הצפון,240,יקנעם עילית,יישוב,433,183,250,89,344,89,419,27,3.25%
2017-07,הצפון,502,ירכא,יישוב,379,147,232,2,377,283,377,5,5.35%
2017-07,הצפון,504,כאבול,יישוב,450,220,230,10,440,359,431,3,7.88%
2017-07,הצפון,505,כאוכב אבו אל-היג'א,יישוב,183,70,113,4,179,146,183,1,9.63%
2017-07,הצפון,1296,כסרא-סמיע,יישוב,180,50,130,8,172,104,171,3,4.39%
2017-07,הצפון,978,כעביה-טבאש-חג'אג'רה,יישוב,165,65,100,3,162,116,162,1,6.24%
2017-07,הצפון,1263,כפר ורדים,יישוב,53,22,31,20,33,4,52,1,1.67%
2017-07,הצפון,507,כפר יאסיף,יישוב,334,144,190,6,328,237,324,7,5.99%
2017-07,הצפון,508,כפר כמא,יישוב,40,22,18,2,38,17,40,1,2.31%
2017-07,הצפון,509,כפר כנא,יישוב,729,333,396,20,709,562,705,11,7.23%
2017-07,הצפון,510,כפר מנדא,יישוב,618,322,296,9,609,456,611,9,7.57%
2017-07,הצפון,47,כפר תבור,יישוב,42,14,28,16,26,3,42,0,1.77%
2017-07,הצפון,1139,כרמיאל,יישוב,1347,556,791,287,1060,632,1241,45,4.78%
2017-07,הצפון,65,מ.א. אל-בטוף,מועצה איזורית,235,97,138,6,229,189,229,1,7.04%
2017-07,הצפון,66,מ.א. בוסתן אל-מרג,מועצה איזורית,33,11,22,0,33,29,31,0,0.88%
2017-07,הצפון,71,מ.א. גולן,מועצה איזורית,177,78,99,61,116,15,177,0,2.02%
2017-07,הצפון,8,מ.א. הגלבוע,מועצה איזורית,610,260,350,56,554,311,601,0,4.26%
2017-07,הצפון,1,מ.א. הגליל העליון,מועצה איזורית,194,83,111,66,128,20,194,0,2.17%
2017-07,הצפון,3,מ.א. הגליל התחתון,מועצה איזורית,99,44,55,37,62,9,96,0,1.59%
2017-07,הצפון,55,מ.א. מבואות החרמון,מועצה איזורית,112,49,63,27,85,15,110,0,2.74%
2017-07,הצפון,13,מ.א. מגידו,מועצה איזורית,95,40,55,37,58,13,94,0,1.66%
2017-07,הצפון,4,מ.א. מטה אשר,מועצה איזורית,433,191,242,71,362,165,422,0,2.97%
2017-07,הצפון,52,מ.א. מעלה יוסף,מועצה איזורית,165,80,85,20,145,40,162,0,2.82%
2017-07,הצפון,2,מ.א. מרום הגליל,מועצה איזורית,243,104,139,35,208,95,229,0,3.21%
2017-07,הצפון,56,מ.א. משגב,מועצה איזורית,501,191,310,106,395,261,488,0,3.45%
2017-07,הצפון,6,מ.א. עמק הירדן,מועצה איזורית,173,80,93,40,133,35,160,0,2.36%
2017-07,הצפון,7,מ.א. עמק המעיינות,מועצה איזורית,159,76,83,30,129,35,154,0,2.35%
2017-07,הצפון,9,מ.א. עמק יזרעאל,מועצה איזורית,333,172,161,169,164,39,324,0,1.66%
2017-07,הצפון,481,מגאר,יישוב,1204,492,712,19,1185,950,1156,6,10.68%
2017-07,הצפון,516,מג'ד אל-כרום,יישוב,429,184,245,10,419,306,415,8,5.63%
2017-07,הצפון,65,מגדל,יישוב,34,11,23,2,32,13,30,1,3.02%
2017-07,הצפון,874,מגדל העמק,יישוב,802,336,466,73,729,273,745,67,5.41%
2017-07,הצפון,4201,מג'דל שמס,יישוב,406,144,262,9,397,300,389,3,7.32%
2017-07,הצפון,517,מזרעה,יישוב,144,60,84,1,143,106,138,2,6.41%
2017-07,הצפון,43,מטולה,יישוב,20,9,11,9,11,4,18,0,1.80%
2017-07,הצפון,4203,מסעדה,יישוב,194,75,119,5,189,146,184,9,10.02%
2017-07,הצפון,518,מעיליא,יישוב,38,17,21,7,31,16,37,1,2.17%
2017-07,הצפון,1063,מעלות-תרשיחא,יישוב,748,375,373,84,664,360,699,39,5.71%
2017-07,הצפון,520,משהד,יישוב,195,81,114,7,188,152,184,2,5.10%
2017-07,הצפון,9100,נהרייה,יישוב,1714,841,873,190,1524,874,1610,66,5.07%
2017-07,הצפון,522,נחף,יישוב,350,167,183,13,337,257,337,2,6.01%
2017-07,הצפון,7300,נצרת,יישוב,2605,1114,1491,118,2487,1840,2581,25,6.97%
2017-07,הצפון,1061,נצרת עילית,יישוב,1375,615,760,150,1225,608,1233,73,5.23%
2017-07,הצפון,525,סאג'ור,יישוב,92,30,62,6,86,57,91,0,4.20%
2017-07,הצפון,7500,סח'נין,יישוב,1627,699,928,43,1584,1332,1607,7,10.33%
2017-07,הצפון,4501,ע'ג'ר,יישוב,80,27,53,1,79,55,78,0,6.51%
2017-07,הצפון,530,עיילבון,יישוב,126,65,61,10,116,75,123,1,4.26%
2017-07,הצפון,511,עילוט,יישוב,253,101,152,5,248,187,253,2,7.84%
2017-07,הצפון,532,עין מאהל,יישוב,357,172,185,7,350,279,343,2,5.83%
2017-07,הצפון,4502,עין קנייא,יישוב,120,42,78,3,117,97,115,0,10.27%
2017-07,הצפון,7600,עכו,יישוב,2747,1186,1561,138,2609,1904,2643,38,9.66%
2017-07,הצפון,7700,עפולה,יישוב,1520,612,908,159,1361,500,1435,57,5.21%
2017-07,הצפון,531,עראבה,יישוב,1174,502,672,37,1137,974,1160,11,10.23%
2017-07,הצפון,535,פסוטה,יישוב,95,42,53,9,86,42,90,1,4.97%
2017-07,הצפון,536,פקיעין (בוקייעה),יישוב,115,60,55,9,106,70,109,3,3.63%
2017-07,הצפון,8000,צפת,יישוב,1006,488,518,96,910,596,930,14,6.65%
2017-07,הצפון,4100,קצרין,יישוב,184,84,100,28,156,86,180,6,4.48%
2017-07,הצפון,2800,קריית שמונה,יישוב,619,296,323,71,548,262,595,37,4.59%
2017-07,הצפון,543,ראמה,יישוב,232,85,147,15,217,153,224,2,5.44%
2017-07,הצפון,26,ראש פינה,יישוב,41,17,24,7,34,19,40,0,2.43%
2017-07,הצפון,542,ריינה,יישוב,454,196,258,10,444,341,442,8,5.94%
2017-07,הצפון,122,רמת ישי,יישוב,85,33,52,34,51,12,82,2,1.99%
2017-07,הצפון,913,שבלי - אום אל-גנם,יישוב,184,80,104,8,176,110,182,4,6.35%
2017-07,הצפון,812,שלומי,יישוב,197,73,124,14,183,101,191,3,5.22%
2017-07,הצפון,538,שעב,יישוב,381,172,209,3,378,315,376,3,11.12%
2017-07,הצפון,8800,שפרעם,יישוב,1263,529,734,39,1224,985,1229,22,6.28%
2017-07,חיפה,1326,"בסמ""ה",יישוב,341,161,180,5,336,260,336,5,7.45%
2017-07,חיפה,2710,אום אל-פחם,יישוב,2673,1096,1577,29,2644,2118,2613,22,11.08%
2017-07,חיפה,1020,אור עקיבא,יישוב,436,182,254,40,396,111,421,11,4.00%
2017-07,חיפה,6000,באקה אל-גרביה,יישוב,566,282,284,16,550,332,562,24,4.29%
2017-07,חיפה,9800,בנימינה-גבעת עדה*,יישוב,173,82,91,72,101,31,172,2,2.29%
2017-07,חיפה,541,ג'סר א-זרקא,יישוב,259,135,124,2,257,106,255,12,3.95%
2017-07,חיפה,628,ג'ת,יישוב,204,111,93,11,193,117,203,7,3.50%
2017-07,חיפה,494,דאלית אל-כרמל,יישוב,435,160,275,23,412,225,406,7,4.62%
2017-07,חיפה,9300,זכרון יעקב,יישוב,264,122,142,108,156,29,263,4,2.30%
2017-07,חיפה,6500,חדרה,יישוב,2099,919,1180,246,1853,650,1980,52,3.81%
2017-07,חיפה,4000,חיפה,יישוב,5255,2424,2831,1120,4135,2346,4950,144,3.50%
2017-07,חיפה,1247,חריש,יישוב,58,23,35,12,46,9,55,0,1.31%
2017-07,חיפה,2100,טירת כרמל,יישוב,642,299,343,37,605,299,624,13,5.08%
2017-07,חיפה,654,כפר קרע,יישוב,392,187,205,21,371,222,386,6,4.10%
2017-07,חיפה,45,מ.א. אלונה,מועצה איזורית,31,14,17,11,20,2,31,0,2.91%
2017-07,חיפה,12,מ.א. זבולון,מועצה איזורית,216,106,110,29,187,124,209,0,3.52%
2017-07,חיפה,15,מ.א. חוף הכרמל,מועצה איזורית,247,107,140,74,173,41,244,1,1.65%
2017-07,חיפה,14,מ.א. מנשה,מועצה איזורית,218,86,132,63,155,51,215,0,2.50%
2017-07,חיפה,1327,מעלה עירון,יישוב,658,245,413,2,656,497,641,3,9.70%
2017-07,חיפה,2500,נשר,יישוב,368,184,184,66,302,123,357,11,2.82%
2017-07,חיפה,534,עספיא,יישוב,280,137,143,10,270,149,263,7,4.30%
2017-07,חיפה,637,ערערה,יישוב,526,226,300,14,512,332,515,15,5.68%
2017-07,חיפה,537,פוריידיס,יישוב,207,99,108,8,199,80,207,4,3.40%
2017-07,חיפה,7800,פרדס חנה-כרכור,יישוב,696,318,378,168,528,119,680,26,3.16%
2017-07,חיפה,6800,קריית אתא,יישוב,1457,612,845,110,1347,600,1424,38,4.57%
2017-07,חיפה,9500,קריית ביאליק,יישוב,855,364,491,99,756,360,821,18,3.84%
2017-07,חיפה,2300,קריית טבעון,יישוב,149,72,77,67,82,25,149,2,1.78%
2017-07,חיפה,9600,קריית ים,יישוב,1225,568,657,123,1102,643,1181,30,5.54%
2017-07,חיפה,8200,קריית מוצקין,יישוב,831,359,472,130,701,316,801,19,3.44%
2017-07,חיפה,922,רכסים,יישוב,210,61,149,8,202,62,197,3,5.16%
2017-07,ירושלים,472,אבו גוש,יישוב,196,89,107,3,193,149,193,10,5.58%
2017-07,ירושלים,2610,בית שמש,יישוב,1561,522,1039,110,1451,402,1502,42,3.97%
2017-07,ירושלים,3000,ירושלים,יישוב,11992,5013,6979,1439,10553,6514,11684,156,3.64%
2017-07,ירושלים,26,מ.א. מטה יהודה,מועצה איזורית,574,229,345,158,416,109,563,0,2.18%
2017-07,ירושלים,1015,מבשרת ציון,יישוב,326,156,170,87,239,97,318,2,2.49%
2017-07,ירושלים,1137,קריית יערים,יישוב,55,21,34,6,49,13,55,0,3.07%
2017-07,תל אביב,2400,אור יהודה,יישוב,689,307,382,54,635,125,657,35,3.40%
2017-07,תל אביב,565,אזור,יישוב,184,93,91,33,151,25,182,2,2.71%
2017-07,תל אביב,6100,בני ברק,יישוב,2490,771,1719,96,2394,567,2390,15,3.89%
2017-07,תל אביב,6200,בת ים,יישוב,2464,1173,1291,365,2099,790,2332,81,3.31%
2017-07,תל אביב,6300,גבעתיים,יישוב,768,342,426,381,387,71,761,1,2.39%
2017-07,תל אביב,6400,הרצלייה,יישוב,1080,476,604,416,664,46,1067,12,2.17%
2017-07,תל אביב,6600,חולון,יישוב,2893,1235,1658,513,2380,564,2833,60,2.81%
2017-07,תל אביב,267,כפר שמריהו,יישוב,7,2,5,5,2,0,7,0,0.84%
2017-07,תל אביב,2620,קריית אונו,יישוב,395,169,226,180,215,27,393,3,2.01%
2017-07,תל אביב,8600,רמת גן,יישוב,2064,896,1168,733,1331,270,2035,29,2.49%
2017-07,תל אביב,2650,רמת השרון,יישוב,448,183,265,216,232,14,447,3,1.94%
2017-07,תל אביב,5000,תל אביב -יפו,יישוב,7111,3542,3569,2833,4278,1377,6980,74,2.65%
2017-08,אזור יהודה והשומרון,3760,אורנית,יישוב,99,51,48,34,65,2,98,1,1.95%
2017-08,אזור יהודה והשומרון,3750,אלפי מנשה,יישוב,83,41,42,25,58,0,83,2,1.87%
2017-08,אזור יהודה והשומרון,3560,אלקנה,יישוב,33,17,16,18,15,1,33,0,1.79%
2017-08,אזור יהודה והשומרון,3650,אפרת,יישוב,65,36,29,37,28,2,64,0,1.30%
2017-08,אזור יהודה והשומרון,3570,אריאל,יישוב,276,119,157,70,206,24,275,9,2.50%
2017-08,אזור יהודה והשומרון,3574,בית אל,יישוב,52,31,21,17,35,12,51,0,2.04%
2017-08,אזור יהודה והשומרון,3652,בית אריה,יישוב,54,22,32,11,43,2,54,1,1.88%
2017-08,אזור יהודה והשומרון,3780,ביתר עילית,יישוב,819,234,585,18,801,172,816,1,5.13%
2017-08,אזור יהודה והשומרון,3730,גבעת זאב,יישוב,186,87,99,40,146,32,185,3,2.28%
2017-08,אזור יהודה והשומרון,3769,הר אדר,יישוב,36,17,19,18,18,2,36,0,1.64%
2017-08,אזור יהודה והשומרון,76,מ.א. גוש עציון,מועצה איזורית,176,89,87,68,108,13,174,0,1.72%
2017-08,אזור יהודה והשומרון,78,מ.א. הר חברון,מועצה איזורית,63,33,30,19,44,4,63,0,1.59%
2017-08,אזור יהודה והשומרון,74,מ.א. מגילות ים המלח,מועצה איזורית,18,5,13,8,10,0,18,0,1.96%
2017-08,אזור יהודה והשומרון,73,מ.א. מטה בנימין,מועצה איזורית,631,318,313,213,418,95,622,0,2.19%
2017-08,אזור יהודה והשומרון,75,מ.א. ערבות הירדן,מועצה איזורית,51,26,25,14,37,4,51,0,1.98%
2017-08,אזור יהודה והשומרון,72,מ.א. שומרון,מועצה איזורית,390,181,209,125,265,32,383,0,2.02%
2017-08,אזור יהודה והשומרון,3797,מודיעין עילית,יישוב,1000,141,859,25,975,36,996,4,6.00%
2017-08,אזור יהודה והשומרון,3616,מעלה אדומים,יישוב,656,282,374,99,557,153,647,10,3.08%
2017-08,אזור יהודה והשומרון,3608,מעלה אפרים,יישוב,29,11,18,3,26,9,29,0,3.63%
2017-08,אזור יהודה והשומרון,3660,עמנואל,יישוב,74,32,42,4,70,21,73,2,5.27%
2017-08,אזור יהודה והשומרון,3557,קדומים,יישוב,27,15,12,8,19,3,26,0,1.31%
2017-08,אזור יהודה והשומרון,3611,קריית ארבע,יישוב,98,61,37,18,80,38,95,4,2.82%
2017-08,אזור יהודה והשומרון,3640,קרני שומרון,יישוב,73,36,37,25,48,5,72,1,1.77%
2017-08,הדרום,31,אופקים,יישוב,994,380,614,55,939,401,963,30,6.59%
2017-08,הדרום,2600,אילת,יישוב,923,445,478,61,862,292,861,44,2.50%
2017-08,הדרום,70,אשדוד,יישוב,5631,2139,3492,693,4938,2101,5395,103,4.78%
2017-08,הדרום,7100,אשקלון,יישוב,3795,1496,2299,404,3391,1540,3411,64,4.58%
2017-08,הדרום,9000,באר שבע,יישוב,5667,2547,3120,780,4887,2720,5376,81,4.99%
2017-08,הדרום,2200,דימונה,יישוב,1831,804,1027,95,1736,1061,1739,45,8.81%
2017-08,הדרום,1303,חורה,יישוב,519,223,296,7,512,443,501,3,10.37%
2017-08,הדרום,831,ירוחם,יישוב,448,200,248,19,429,223,420,26,8.09%
2017-08,הדרום,1059,כסיפה,יישוב,1013,386,627,3,1010,880,999,2,18.24%
2017-08,הדרום,1271,להבים,יישוב,41,15,26,16,25,3,40,0,1.14%
2017-08,הדרום,1060,לקיה,יישוב,628,270,358,8,620,507,605,5,12.28%
2017-08,הדרום,69,מ.א. אל קסום,מועצה איזורית,606,240,366,3,603,523,585,0,17.15%
2017-08,הדרום,38,מ.א. אשכול,מועצה איזורית,135,58,77,41,94,10,133,0,1.90%
2017-08,הדרום,33,מ.א. באר טוביה,מועצה איזורית,276,113,163,62,214,49,274,0,2.42%
2017-08,הדרום,41,מ.א. בני שמעון,מועצה איזורית,72,35,37,29,43,12,70,1,1.44%
2017-08,הדרום,54,מ.א. הערבה התיכונה,מועצה איזורית,32,12,20,9,23,3,30,0,1.57%
2017-08,הדרום,53,מ.א. חבל אילות,מועצה איזורית,17,3,14,2,15,1,15,0,0.61%
2017-08,הדרום,36,מ.א. חוף אשקלון,מועצה איזורית,209,91,118,41,168,39,199,0,2.29%
2017-08,הדרום,35,מ.א. יואב,מועצה איזורית,89,33,56,31,58,10,89,0,2.17%
2017-08,הדרום,50,מ.א. לכיש,מועצה איזורית,164,75,89,28,136,36,162,0,2.91%
2017-08,הדרום,42,מ.א. מרחבים,מועצה איזורית,203,58,145,30,173,32,197,0,3.13%
2017-08,הדרום,68,מ.א. נווה מדבר,מועצה איזורית,133,56,77,0,133,99,128,0,6.78%
2017-08,הדרום,48,מ.א. רמת נגב,מועצה איזורית,270,139,131,14,256,199,264,0,7.94%
2017-08,הדרום,39,מ.א. שדות נגב,מועצה איזורית,111,51,60,15,96,29,108,0,2.22%
2017-08,הדרום,37,מ.א. שער הנגב,מועצה איזורית,103,42,61,42,61,13,100,0,2.50%
2017-08,הדרום,34,מ.א. שפיר,מועצה איזורית,175,65,110,12,163,38,173,0,3.47%
2017-08,הדרום,51,מ.א. תמר,מועצה איזורית,7,2,5,0,7,2,6,0,0.92%
2017-08,הדרום,1268,מיתר,יישוב,59,24,35,17,42,5,57,0,1.16%
2017-08,הדרום,99,מצפה רמון,יישוב,233,89,144,18,215,130,225,13,8.06%
2017-08,הדרום,246,נתיבות,יישוב,1217,452,765,75,1142,420,1160,61,6.92%
2017-08,הדרום,666,עומר,יישוב,62,22,40,22,40,2,62,1,1.47%
2017-08,הדרום,2560,ערד,יישוב,653,274,379,66,587,302,617,17,4.85%
2017-08,הדרום,1192,ערערה-בנגב,יישוב,1115,461,654,7,1108,1006,1088,1,20.67%
2017-08,הדרום,2630,קריית גת,יישוב,1585,631,954,93,1492,620,1521,36,5.18%
2017-08,הדרום,1034,קריית מלאכי,יישוב,762,305,457,18,744,295,730,43,5.88%
2017-08,הדרום,1161,רהט,יישוב,2259,908,1351,15,2244,1671,2225,59,9.84%
2017-08,הדרום,1286,שגב-שלום,יישוב,381,134,247,1,380,288,369,2,11.23%
2017-08,הדרום,1031,שדרות,יישוב,992,448,544,79,913,466,915,45,6.13%
2017-08,הדרום,1054,תל שבע,יישוב,749,309,440,1,748,623,715,5,12.31%
2017-08,המרכז,1066,"בני עי""ש",יישוב,156,65,91,20,136,41,150,4,3.72%
2017-08,המרכז,182,אבן יהודה,יישוב,157,67,90,55,102,18,157,0,2.24%
2017-08,המרכז,41,אליכין,יישוב,59,27,32,7,52,14,57,1,2.90%
2017-08,המרכז,1309,אלעד,יישוב,664,189,475,26,638,28,659,3,4.53%
2017-08,המרכז,2530,באר יעקב,יישוב,276,95,181,66,210,35,272,3,2.11%
2017-08,המרכז,466,בית דגן,יישוב,97,43,54,10,87,28,95,0,2.54%
2017-08,המרכז,681,גבעת שמואל,יישוב,250,129,121,85,165,34,247,2,1.98%
2017-08,המרכז,2550,גדרה,יישוב,335,138,197,69,266,73,327,5,2.52%
2017-08,המרכז,627,ג'לג'וליה,יישוב,72,32,40,2,70,40,68,0,1.59%
2017-08,המרכז,166,גן יבנה,יישוב,328,127,201,54,274,68,321,7,2.52%
2017-08,המרכז,229,גני תקווה,יישוב,224,103,121,80,144,26,223,1,2.31%
2017-08,המרכז,9700,הוד השרון,יישוב,740,294,446,328,412,30,736,10,2.25%
2017-08,המרכז,1290,זמר,יישוב,122,49,73,3,119,78,119,2,3.63%
2017-08,המרכז,2730,טייבה,יישוב,941,422,519,28,913,654,782,29,4.04%
2017-08,המרכז,2720,טירה,יישוב,193,83,110,18,175,44,186,6,1.48%
2017-08,המרכז,2660,יבנה,יישוב,774,308,466,159,615,136,766,20,3.03%
2017-08,המרכז,9400,יהוד,יישוב,376,160,216,93,283,31,366,7,2.24%
2017-08,המרכז,1224,כוכב יאיר,יישוב,73,22,51,44,29,0,73,0,1.32%
2017-08,המרכז,633,כפר ברא,יישוב,15,9,6,1,14,5,15,0,0.93%
2017-08,המרכז,168,כפר יונה,יישוב,318,129,189,62,256,37,317,3,2.70%
2017-08,המרכז,6900,כפר סבא,יישוב,1171,504,667,465,706,85,1155,20,2.18%
2017-08,המרכז,634,כפר קאסם,יישוב,265,97,168,8,257,107,255,2,2.45%
2017-08,המרכז,7000,לוד,יישוב,1734,808,926,146,1588,797,1694,34,4.57%
2017-08,המרכז,28,מ.א. ברנר,מועצה איזורית,66,29,37,30,36,4,65,3,1.59%
2017-08,המרכז,32,מ.א. גדרות,מועצה איזורית,43,19,24,22,21,4,43,0,1.75%
2017-08,המרכז,30,מ.א. גזר,מועצה איזורית,291,111,180,101,190,26,289,0,2.15%
2017-08,המרכז,27,מ.א. גן רווה,מועצה איזורית,65,24,41,29,36,1,65,0,2.17%
2017-08,המרכז,20,מ.א. דרום השרון,מועצה איזורית,342,131,211,151,191,11,340,0,2.10%
2017-08,המרכז,29,מ.א. חבל יבנה,מועצה איזורית,43,19,24,15,28,2,42,0,1.60%
2017-08,המרכז,25,מ.א. חבל מודיעין,מועצה איזורית,222,87,135,66,156,18,218,0,1.98%
2017-08,המרכז,19,מ.א. חוף השרון,מועצה איזורית,86,28,58,40,46,4,86,0,1.54%
2017-08,המרכז,18,מ.א. לב השרון,מועצה איזורית,273,121,152,69,204,31,268,0,2.41%
2017-08,המרכז,31,מ.א. נחל שורק,מועצה איזורית,73,31,42,24,49,8,71,30,1.60%
2017-08,המרכז,16,מ.א. עמק חפר,מועצה איזורית,385,156,229,159,226,18,383,0,1.95%
2017-08,המרכז,40,מ.א. שדות דן,מועצה איזורית,169,70,99,40,129,12,165,0,2.56%
2017-08,המרכז,1200,מודיעין-מכבים-רעות*,יישוב,981,399,582,391,590,38,967,22,2.09%
2017-08,המרכז,28,מזכרת בתיה,יישוב,184,71,113,54,130,22,181,3,2.22%
2017-08,המרכז,7200,נס ציונה,יישוב,690,303,387,195,495,140,681,8,2.74%
2017-08,המרכז,7400,נתניה,יישוב,4315,1827,2488,505,3810,1095,4225,103,3.87%
2017-08,המרכז,587,סביון*,יישוב,14,2,12,7,7,1,14,0,0.67%
2017-08,המרכז,171,פרדסייה,יישוב,86,38,48,23,63,4,85,0,2.25%
2017-08,המרכז,7900,פתח תקווה,יישוב,3839,1629,2210,757,3082,751,3747,42,2.89%
2017-08,המרכז,195,קדימה-צורן,יישוב,258,111,147,83,175,33,255,0,2.17%
2017-08,המרכז,638,קלנסווה,יישוב,328,164,164,10,318,212,295,11,3.04%
2017-08,המרכז,469,קריית עקרון,יישוב,254,98,156,18,236,93,248,8,4.05%
2017-08,המרכז,2640,ראש העין,יישוב,884,363,521,188,696,110,877,9,2.82%
2017-08,המרכז,8300,ראשון לציון,יישוב,4002,1720,2282,859,3143,858,3967,70,2.82%
2017-08,המרכז,8400,רחובות,יישוב,2509,926,1583,559,1950,641,2441,48,3.42%
2017-08,המרכז,8500,רמלה,יישוב,1547,687,860,103,1444,520,1502,49,3.85%
2017-08,המרכז,8700,רעננה,יישוב,738,336,402,325,413,33,732,6,1.93%
2017-08,המרכז,1304,שוהם,יישוב,200,78,122,95,105,9,200,1,1.65%
2017-08,המרכז,154,תל מונד,יישוב,143,51,92,50,93,15,143,0,2.07%
2017-08,הצפון,473,אבו סנאן,יישוב,518,216,302,5,513,399,509,4,8.04%
2017-08,הצפון,478,אכסאל,יישוב,411,178,233,17,394,348,407,1,6.38%
2017-08,הצפון,529,אעבלין,יישוב,402,173,229,21,381,296,396,3,6.36%
2017-08,הצפון,482,בועיינה-נוג'ידאת,יישוב,231,117,114,8,223,182,222,2,5.14%
2017-08,הצפון,4001,בוקעאתא,יישוב,376,135,241,9,367,296,363,4,11.82%
2017-08,הצפון,998,ביר אל-מכסור,יישוב,265,116,149,2,263,204,262,3,6.28%
2017-08,הצפון,480,בית ג'ן,יישוב,352,90,262,12,340,223,334,2,5.58%
2017-08,הצפון,9200,בית שאן,יישוב,700,306,394,24,676,296,675,46,6.38%
2017-08,הצפון,944,בסמת טבעון,יישוב,156,64,92,5,151,104,148,1,4.09%
2017-08,הצפון,483,בענה,יישוב,303,130,173,3,300,247,294,1,7.57%
2017-08,הצפון,1292,ג'דיידה-מכר,יישוב,1064,476,588,5,1059,790,1045,10,10.08%
2017-08,הצפון,485,ג'ולס,יישוב,166,48,118,3,163,102,165,0,5.04%
2017-08,הצפון,487,ג'ש (גוש חלב),יישוב,46,22,24,4,42,24,45,0,2.63%
2017-08,הצפון,489,דבורייה,יישוב,256,111,145,11,245,182,252,3,5.30%
2017-08,הצפון,490,דייר אל-אסד,יישוב,336,131,205,10,326,242,324,3,5.61%
2017-08,הצפון,492,דייר חנא,יישוב,510,215,295,16,494,370,506,6,9.51%
2017-08,הצפון,975,זרזיר,יישוב,230,92,138,2,228,135,230,8,6.33%
2017-08,הצפון,496,חורפיש,יישוב,90,42,48,5,85,49,86,1,2.83%
2017-08,הצפון,2034,חצור הגלילית,יישוב,247,90,157,19,228,111,231,2,4.71%
2017-08,הצפון,6700,טבריה,יישוב,1377,612,765,73,1304,650,1191,56,5.33%
2017-08,הצפון,962,טובא-זנגרייה,יישוב,309,132,177,3,306,202,299,3,8.72%
2017-08,הצפון,498,טורעאן,יישוב,364,148,216,7,357,279,353,6,5.54%
2017-08,הצפון,8900,טמרה,יישוב,1237,572,665,24,1213,1007,1205,8,7.72%
2017-08,הצפון,1295,יאנוח-ג'ת,יישוב,123,35,88,3,120,74,120,9,3.74%
2017-08,הצפון,46,יבנאל,יישוב,119,59,60,6,113,59,97,2,6.02%
2017-08,הצפון,29,יסוד המעלה,יישוב,21,12,9,5,16,4,21,0,2.38%
2017-08,הצפון,499,יפיע,יישוב,500,205,295,24,476,366,492,2,5.67%
2017-08,הצפון,240,יקנעם עילית,יישוב,431,173,258,95,336,91,415,26,3.22%
2017-08,הצפון,502,ירכא,יישוב,372,146,226,1,371,274,367,2,5.22%
2017-08,הצפון,504,כאבול,יישוב,431,206,225,11,420,346,419,8,7.68%
2017-08,הצפון,505,כאוכב אבו אל-היג'א,יישוב,186,72,114,6,180,141,186,2,9.77%
2017-08,הצפון,1296,כסרא-סמיע,יישוב,184,54,130,6,178,106,177,2,4.54%
2017-08,הצפון,978,כעביה-טבאש-חג'אג'רה,יישוב,167,65,102,5,162,118,163,3,6.27%
2017-08,הצפון,1263,כפר ורדים,יישוב,51,20,31,19,32,5,50,0,1.61%
2017-08,הצפון,507,כפר יאסיף,יישוב,332,145,187,5,327,232,323,6,5.97%
2017-08,הצפון,508,כפר כמא,יישוב,38,21,17,2,36,16,38,1,2.20%
2017-08,הצפון,509,כפר כנא,יישוב,696,325,371,21,675,549,672,13,6.92%
2017-08,הצפון,510,כפר מנדא,יישוב,658,349,309,7,651,458,647,5,7.98%
2017-08,הצפון,47,כפר תבור,יישוב,44,15,29,17,27,3,43,0,1.82%
2017-08,הצפון,1139,כרמיאל,יישוב,1358,541,817,290,1068,619,1248,48,4.81%
2017-08,הצפון,65,מ.א. אל-בטוף,מועצה איזורית,237,100,137,8,229,192,227,0,6.98%
2017-08,הצפון,66,מ.א. בוסתן אל-מרג,מועצה איזורית,30,7,23,0,30,27,30,0,0.85%
2017-08,הצפון,71,מ.א. גולן,מועצה איזורית,170,72,98,58,112,14,170,0,1.94%
2017-08,הצפון,8,מ.א. הגלבוע,מועצה איזורית,607,252,355,64,543,306,599,0,4.24%
2017-08,הצפון,1,מ.א. הגליל העליון,מועצה איזורית,184,82,102,68,116,16,184,0,2.06%
2017-08,הצפון,3,מ.א. הגליל התחתון,מועצה איזורית,109,54,55,38,71,8,106,0,1.76%
2017-08,הצפון,55,מ.א. מבואות החרמון,מועצה איזורית,106,44,62,25,81,15,105,0,2.62%
2017-08,הצפון,13,מ.א. מגידו,מועצה איזורית,98,40,58,39,59,12,98,0,1.73%
2017-08,הצפון,4,מ.א. מטה אשר,מועצה איזורית,434,197,237,74,360,165,422,0,2.97%
2017-08,הצפון,52,מ.א. מעלה יוסף,מועצה איזורית,178,76,102,22,156,38,175,0,3.05%
2017-08,הצפון,2,מ.א. מרום הגליל,מועצה איזורית,239,105,134,32,207,97,229,0,3.21%
2017-08,הצפון,56,מ.א. משגב,מועצה איזורית,480,183,297,90,390,248,468,0,3.31%
2017-08,הצפון,6,מ.א. עמק הירדן,מועצה איזורית,165,78,87,42,123,31,154,0,2.27%
2017-08,הצפון,7,מ.א. עמק המעיינות,מועצה איזורית,161,74,87,33,128,33,156,0,2.38%
2017-08,הצפון,9,מ.א. עמק יזרעאל,מועצה איזורית,337,163,174,174,163,40,330,0,1.69%
2017-08,הצפון,481,מגאר,יישוב,1158,482,676,20,1138,918,1119,6,10.38%
2017-08,הצפון,516,מג'ד אל-כרום,יישוב,431,189,242,13,418,298,419,4,5.68%
2017-08,הצפון,65,מגדל,יישוב,32,13,19,3,29,13,28,0,2.82%
2017-08,הצפון,874,מגדל העמק,יישוב,818,338,480,84,734,273,757,64,5.50%
2017-08,הצפון,4201,מג'דל שמס,יישוב,394,141,253,10,384,302,373,4,7.04%
2017-08,הצפון,517,מזרעה,יישוב,144,59,85,1,143,107,140,6,6.49%
2017-08,הצפון,43,מטולה,יישוב,25,7,18,12,13,3,22,1,2.19%
2017-08,הצפון,4203,מסעדה,יישוב,190,74,116,5,185,143,179,3,9.78%
2017-08,הצפון,518,מעיליא,יישוב,44,21,23,8,36,19,43,1,2.51%
2017-08,הצפון,1063,מעלות-תרשיחא,יישוב,788,377,411,84,704,364,745,38,6.06%
2017-08,הצפון,520,משהד,יישוב,187,80,107,8,179,145,175,4,4.86%
2017-08,הצפון,9100,נהרייה,יישוב,1712,839,873,187,1525,855,1610,70,5.07%
2017-08,הצפון,522,נחף,יישוב,337,161,176,17,320,258,326,6,5.83%
2017-08,הצפון,7300,נצרת,יישוב,2658,1126,1532,120,2538,1856,2628,17,7.08%
2017-08,הצפון,1061,נצרת עילית,יישוב,1418,656,762,159,1259,617,1273,82,5.39%
2017-08,הצפון,525,סאג'ור,יישוב,95,33,62,7,88,61,93,0,4.29%
2017-08,הצפון,7500,סח'נין,יישוב,1583,667,916,43,1540,1289,1564,15,10.08%
2017-08,הצפון,4501,ע'ג'ר,יישוב,77,25,52,0,77,52,76,0,6.35%
2017-08,הצפון,530,עיילבון,יישוב,124,65,59,8,116,75,121,0,4.20%
2017-08,הצפון,511,עילוט,יישוב,260,107,153,6,254,194,259,1,8.02%
2017-08,הצפון,532,עין מאהל,יישוב,342,161,181,6,336,273,328,4,5.59%
2017-08,הצפון,4502,עין קנייא,יישוב,129,47,82,4,125,100,124,1,10.98%
2017-08,הצפון,7600,עכו,יישוב,2766,1175,1591,138,2628,1870,2656,49,9.70%
2017-08,הצפון,7700,עפולה,יישוב,1522,586,936,166,1356,502,1456,58,5.28%
2017-08,הצפון,531,עראבה,יישוב,1151,495,656,40,1111,949,1138,18,10.06%
2017-08,הצפון,535,פסוטה,יישוב,90,39,51,9,81,41,86,4,4.76%
2017-08,הצפון,536,פקיעין (בוקייעה),יישוב,120,66,54,11,109,69,114,3,3.79%
2017-08,הצפון,8000,צפת,יישוב,1019,475,544,96,923,579,956,20,6.82%
2017-08,הצפון,4100,קצרין,יישוב,183,79,104,29,154,87,176,9,4.38%
2017-08,הצפון,2800,קריית שמונה,יישוב,625,304,321,76,549,254,602,24,4.65%
2017-08,הצפון,543,ראמה,יישוב,231,79,152,16,215,153,222,3,5.40%
2017-08,הצפון,26,ראש פינה,יישוב,47,19,28,8,39,19,46,1,2.79%
2017-08,הצפון,542,ריינה,יישוב,437,189,248,5,432,337,419,7,5.64%
2017-08,הצפון,122,רמת ישי,יישוב,92,36,56,31,61,13,89,1,2.15%
2017-08,הצפון,913,שבלי - אום אל-גנם,יישוב,176,73,103,10,166,105,175,6,6.12%
2017-08,הצפון,812,שלומי,יישוב,207,71,136,15,192,106,195,4,5.32%
2017-08,הצפון,538,שעב,יישוב,364,163,201,3,361,301,361,1,10.72%
2017-08,הצפון,8800,שפרעם,יישוב,1277,515,762,39,1238,974,1243,24,6.34%
2017-08,חיפה,1326,"בסמ""ה",יישוב,328,151,177,4,324,253,325,5,7.22%
2017-08,חיפה,2710,אום אל-פחם,יישוב,2614,1065,1549,30,2584,2058,2566,24,10.90%
2017-08,חיפה,1020,אור עקיבא,יישוב,458,193,265,43,415,119,447,10,4.24%
2017-08,חיפה,6000,באקה אל-גרביה,יישוב,583,279,304,21,562,339,579,26,4.42%
2017-08,חיפה,9800,בנימינה-גבעת עדה*,יישוב,180,87,93,78,102,30,179,0,2.38%
2017-08,חיפה,541,ג'סר א-זרקא,יישוב,247,127,120,3,244,101,243,11,3.77%
2017-08,חיפה,628,ג'ת,יישוב,192,101,91,12,180,116,190,7,3.28%
2017-08,חיפה,494,דאלית אל-כרמל,יישוב,404,146,258,17,387,222,379,4,4.32%
2017-08,חיפה,9300,זכרון יעקב,יישוב,257,120,137,105,152,31,255,3,2.23%
2017-08,חיפה,6500,חדרה,יישוב,2078,913,1165,248,1830,634,1977,48,3.80%
2017-08,חיפה,4000,חיפה,יישוב,5357,2416,2941,1087,4270,2287,5072,131,3.58%
2017-08,חיפה,1247,חריש,יישוב,73,21,52,17,56,10,70,0,1.66%
2017-08,חיפה,2100,טירת כרמל,יישוב,663,291,372,46,617,307,640,15,5.21%
2017-08,חיפה,654,כפר קרע,יישוב,392,185,207,28,364,227,385,8,4.09%
2017-08,חיפה,45,מ.א. אלונה,מועצה איזורית,29,11,18,11,18,2,29,0,2.72%
2017-08,חיפה,12,מ.א. זבולון,מועצה איזורית,214,105,109,29,185,113,209,0,3.52%
2017-08,חיפה,15,מ.א. חוף הכרמל,מועצה איזורית,260,112,148,84,176,39,258,0,1.74%
2017-08,חיפה,14,מ.א. מנשה,מועצה איזורית,206,84,122,59,147,47,202,0,2.35%
2017-08,חיפה,1327,מעלה עירון,יישוב,652,247,405,2,650,491,637,4,9.65%
2017-08,חיפה,2500,נשר,יישוב,376,178,198,66,310,118,364,11,2.87%
2017-08,חיפה,534,עספיא,יישוב,285,132,153,11,274,153,267,7,4.36%
2017-08,חיפה,637,ערערה,יישוב,511,224,287,17,494,313,498,18,5.50%
2017-08,חיפה,537,פוריידיס,יישוב,202,99,103,9,193,72,200,3,3.29%
2017-08,חיפה,7800,פרדס חנה-כרכור,יישוב,720,321,399,182,538,128,702,21,3.26%
2017-08,חיפה,6800,קריית אתא,יישוב,1539,610,929,115,1424,621,1496,39,4.79%
2017-08,חיפה,9500,קריית ביאליק,יישוב,869,369,500,105,764,360,841,27,3.93%
2017-08,חיפה,2300,קריית טבעון,יישוב,172,82,90,77,95,27,169,2,2.01%
2017-08,חיפה,9600,קריית ים,יישוב,1235,579,656,119,1116,633,1188,34,5.57%
2017-08,חיפה,8200,קריית מוצקין,יישוב,851,377,474,137,714,319,828,21,3.55%
2017-08,חיפה,922,רכסים,יישוב,234,51,183,10,224,55,225,1,5.85%
2017-08,ירושלים,472,אבו גוש,יישוב,191,86,105,3,188,147,189,2,5.47%
2017-08,ירושלים,2610,בית שמש,יישוב,1588,520,1068,100,1488,412,1538,28,4.06%
2017-08,ירושלים,3000,ירושלים,יישוב,12383,4979,7404,1500,10883,6357,12094,120,3.76%
2017-08,ירושלים,26,מ.א. מטה יהודה,מועצה איזורית,591,234,357,165,426,110,582,1,2.25%
2017-08,ירושלים,1015,מבשרת ציון,יישוב,331,153,178,90,241,93,326,4,2.55%
2017-08,ירושלים,1137,קריית יערים,יישוב,59,21,38,8,51,12,59,1,3.28%
2017-08,תל אביב,2400,אור יהודה,יישוב,762,285,477,46,716,130,734,33,3.78%
2017-08,תל אביב,565,אזור,יישוב,183,88,95,28,155,24,179,2,2.67%
2017-08,תל אביב,6100,בני ברק,יישוב,2836,818,2018,96,2740,578,2721,12,4.41%
2017-08,תל אביב,6200,בת ים,יישוב,2514,1152,1362,375,2139,781,2380,66,3.37%
2017-08,תל אביב,6300,גבעתיים,יישוב,815,361,454,405,410,75,807,3,2.53%
2017-08,תל אביב,6400,הרצלייה,יישוב,1131,467,664,420,711,43,1120,10,2.27%
2017-08,תל אביב,6600,חולון,יישוב,2914,1226,1688,535,2379,574,2850,41,2.82%
2017-08,תל אביב,267,כפר שמריהו,יישוב,4,0,4,3,1,0,4,0,0.48%
2017-08,תל אביב,2620,קריית אונו,יישוב,423,170,253,184,239,34,417,2,2.13%
2017-08,תל אביב,8600,רמת גן,יישוב,2070,903,1167,732,1338,265,2044,18,2.50%
2017-08,תל אביב,2650,רמת השרון,יישוב,483,188,295,223,260,15,481,4,2.09%
2017-08,תל אביב,5000,תל אביב -יפו,יישוב,7139,3553,3586,2840,4299,1342,7022,64,2.66%
2017-09,אזור יהודה והשומרון,3760,אורנית,יישוב,97,51,46,33,64,1,96,0,1.91%
2017-09,אזור יהודה והשומרון,3750,אלפי מנשה,יישוב,87,44,43,29,58,0,87,1,1.96%
2017-09,אזור יהודה והשומרון,3560,אלקנה,יישוב,28,17,11,15,13,0,28,0,1.52%
2017-09,אזור יהודה והשומרון,3650,אפרת,יישוב,58,31,27,35,23,2,57,1,1.16%
2017-09,אזור יהודה והשומרון,3570,אריאל,יישוב,274,124,150,69,205,22,272,7,2.48%
2017-09,אזור יהודה והשומרון,3574,בית אל,יישוב,48,27,21,16,32,14,47,0,1.88%
2017-09,אזור יהודה והשומרון,3652,בית אריה,יישוב,48,18,30,11,37,1,48,0,1.67%
2017-09,אזור יהודה והשומרון,3780,ביתר עילית,יישוב,570,222,348,17,553,166,567,0,3.62%
2017-09,אזור יהודה והשומרון,3730,גבעת זאב,יישוב,171,86,85,39,132,30,169,2,2.09%
2017-09,אזור יהודה והשומרון,3769,הר אדר,יישוב,35,16,19,13,22,3,35,1,1.60%
2017-09,אזור יהודה והשומרון,76,מ.א. גוש עציון,מועצה איזורית,184,97,87,74,110,19,181,0,1.78%
2017-09,אזור יהודה והשומרון,78,מ.א. הר חברון,מועצה איזורית,61,32,29,21,40,2,61,0,1.54%
2017-09,אזור יהודה והשומרון,74,מ.א. מגילות ים המלח,מועצה איזורית,25,6,19,9,16,0,25,0,2.72%
2017-09,אזור יהודה והשומרון,73,מ.א. מטה בנימין,מועצה איזורית,580,296,284,217,363,92,570,0,2.01%
2017-09,אזור יהודה והשומרון,75,מ.א. ערבות הירדן,מועצה איזורית,51,25,26,11,40,3,51,0,1.98%
2017-09,אזור יהודה והשומרון,72,מ.א. שומרון,מועצה איזורית,406,187,219,137,269,29,403,0,2.13%
2017-09,אזור יהודה והשומרון,3797,מודיעין עילית,יישוב,524,131,393,21,503,34,515,3,3.20%
2017-09,אזור יהודה והשומרון,3616,מעלה אדומים,יישוב,602,265,337,103,499,138,592,13,2.83%
2017-09,אזור יהודה והשומרון,3608,מעלה אפרים,יישוב,32,12,20,3,29,10,31,0,3.87%
2017-09,אזור יהודה והשומרון,3660,עמנואל,יישוב,50,28,22,3,47,21,48,2,3.53%
2017-09,אזור יהודה והשומרון,3557,קדומים,יישוב,36,17,19,14,22,2,36,1,1.80%
2017-09,אזור יהודה והשומרון,3611,קריית ארבע,יישוב,89,51,38,15,74,38,84,6,2.50%
2017-09,אזור יהודה והשומרון,3640,קרני שומרון,יישוב,63,34,29,27,36,3,63,1,1.56%
2017-09,הדרום,31,אופקים,יישוב,857,348,509,49,808,394,828,35,5.72%
2017-09,הדרום,2600,אילת,יישוב,904,444,460,62,842,297,840,51,2.44%
2017-09,הדרום,70,אשדוד,יישוב,4983,2016,2967,651,4332,2049,4759,101,4.24%
2017-09,הדרום,7100,אשקלון,יישוב,3570,1453,2117,408,3162,1516,3209,67,4.32%
2017-09,הדרום,9000,באר שבע,יישוב,5384,2432,2952,780,4604,2599,5098,94,4.75%
2017-09,הדרום,2200,דימונה,יישוב,1699,773,926,89,1610,1048,1608,25,8.20%
2017-09,הדרום,1303,חורה,יישוב,501,208,293,3,498,428,480,3,9.98%
2017-09,הדרום,831,ירוחם,יישוב,403,197,206,19,384,209,374,13,7.27%
2017-09,הדרום,1059,כסיפה,יישוב,980,370,610,3,977,866,966,2,17.74%
2017-09,הדרום,1271,להבים,יישוב,43,20,23,17,26,2,42,0,1.19%
2017-09,הדרום,1060,לקיה,יישוב,564,251,313,8,556,484,548,7,11.25%
2017-09,הדרום,69,מ.א. אל קסום,מועצה איזורית,591,237,354,6,585,505,573,0,16.80%
2017-09,הדרום,38,מ.א. אשכול,מועצה איזורית,125,62,63,32,93,11,123,0,1.75%
2017-09,הדרום,33,מ.א. באר טוביה,מועצה איזורית,252,106,146,53,199,50,249,0,2.20%
2017-09,הדרום,41,מ.א. בני שמעון,מועצה איזורית,83,33,50,31,52,14,80,1,1.65%
2017-09,הדרום,54,מ.א. הערבה התיכונה,מועצה איזורית,27,10,17,7,20,1,27,0,1.42%
2017-09,הדרום,53,מ.א. חבל אילות,מועצה איזורית,19,3,16,4,15,2,17,1,0.69%
2017-09,הדרום,36,מ.א. חוף אשקלון,מועצה איזורית,183,79,104,40,143,38,176,0,2.02%
2017-09,הדרום,35,מ.א. יואב,מועצה איזורית,84,30,54,31,53,10,83,0,2.03%
2017-09,הדרום,50,מ.א. לכיש,מועצה איזורית,152,62,90,29,123,32,151,0,2.71%
2017-09,הדרום,42,מ.א. מרחבים,מועצה איזורית,188,60,128,27,161,36,180,0,2.86%
2017-09,הדרום,68,מ.א. נווה מדבר,מועצה איזורית,128,51,77,0,128,94,127,0,6.72%
2017-09,הדרום,48,מ.א. רמת נגב,מועצה איזורית,266,137,129,15,251,193,262,1,7.87%
2017-09,הדרום,39,מ.א. שדות נגב,מועצה איזורית,121,53,68,24,97,31,118,0,2.43%
2017-09,הדרום,37,מ.א. שער הנגב,מועצה איזורית,95,37,58,43,52,16,90,0,2.25%
2017-09,הדרום,34,מ.א. שפיר,מועצה איזורית,165,67,98,20,145,41,161,0,3.23%
2017-09,הדרום,51,מ.א. תמר,מועצה איזורית,6,3,3,1,5,2,5,0,0.77%
2017-09,הדרום,1268,מיתר,יישוב,66,25,41,21,45,3,64,1,1.30%
2017-09,הדרום,99,מצפה רמון,יישוב,227,88,139,16,211,125,215,16,7.73%
2017-09,הדרום,246,נתיבות,יישוב,1014,416,598,69,945,417,953,53,5.76%
2017-09,הדרום,666,עומר,יישוב,58,21,37,21,37,2,58,0,1.37%
2017-09,הדרום,2560,ערד,יישוב,623,258,365,76,547,306,593,20,4.67%
2017-09,הדרום,1192,ערערה-בנגב,יישוב,1091,451,640,7,1084,982,1062,2,20.27%
2017-09,הדרום,2630,קריית גת,יישוב,1512,628,884,104,1408,600,1446,46,4.94%
2017-09,הדרום,1034,קריית מלאכי,יישוב,695,290,405,11,684,281,666,38,5.39%
2017-09,הדרום,1161,רהט,יישוב,2181,887,1294,11,2170,1623,2152,49,9.55%
2017-09,הדרום,1286,שגב-שלום,יישוב,354,133,221,2,352,273,341,3,10.47%
2017-09,הדרום,1031,שדרות,יישוב,930,428,502,72,858,451,860,26,5.78%
2017-09,הדרום,1054,תל שבע,יישוב,709,307,402,2,707,602,672,6,11.66%
2017-09,המרכז,1066,"בני עי""ש",יישוב,131,56,75,19,112,33,128,1,3.19%
2017-09,המרכז,182,אבן יהודה,יישוב,143,60,83,43,100,17,143,0,2.05%
2017-09,המרכז,41,אליכין,יישוב,57,28,29,7,50,13,55,1,2.80%
2017-09,המרכז,1309,אלעד,יישוב,388,131,257,21,367,25,382,4,2.68%
2017-09,המרכז,2530,באר יעקב,יישוב,257,96,161,72,185,28,254,5,1.97%
2017-09,המרכז,466,בית דגן,יישוב,89,39,50,10,79,29,86,1,2.31%
2017-09,המרכז,681,גבעת שמואל,יישוב,227,117,110,86,141,34,225,0,1.80%
2017-09,המרכז,2550,גדרה,יישוב,310,133,177,67,243,67,302,4,2.33%
2017-09,המרכז,627,ג'לג'וליה,יישוב,80,35,45,3,77,41,74,0,1.72%
2017-09,המרכז,166,גן יבנה,יישוב,298,118,180,50,248,66,293,4,2.31%
2017-09,המרכז,229,גני תקווה,יישוב,213,101,112,90,123,26,212,2,2.19%
2017-09,המרכז,9700,הוד השרון,יישוב,631,265,366,302,329,22,630,7,1.93%
2017-09,המרכז,1290,זמר,יישוב,126,51,75,5,121,73,123,4,3.75%
2017-09,המרכז,2730,טייבה,יישוב,895,398,497,25,870,629,754,23,3.90%
2017-09,המרכז,2720,טירה,יישוב,172,78,94,19,153,40,168,11,1.34%
2017-09,המרכז,2660,יבנה,יישוב,710,296,414,155,555,135,708,19,2.81%
2017-09,המרכז,9400,יהוד,יישוב,347,159,188,101,246,34,338,5,2.07%
2017-09,המרכז,1224,כוכב יאיר,יישוב,68,27,41,46,22,0,68,0,1.23%
2017-09,המרכז,633,כפר ברא,יישוב,12,8,4,2,10,4,12,1,0.75%
2017-09,המרכז,168,כפר יונה,יישוב,280,122,158,56,224,43,279,2,2.38%
2017-09,המרכז,6900,כפר סבא,יישוב,1089,484,605,437,652,77,1072,21,2.03%
2017-09,המרכז,634,כפר קאסם,יישוב,180,83,97,6,174,94,175,5,1.70%
2017-09,המרכז,7000,לוד,יישוב,1597,757,840,154,1443,775,1555,26,4.21%
2017-09,המרכז,28,מ.א. ברנר,מועצה איזורית,59,23,36,30,29,2,58,3,1.43%
2017-09,המרכז,32,מ.א. גדרות,מועצה איזורית,43,22,21,24,19,4,42,0,1.71%
2017-09,המרכז,30,מ.א. גזר,מועצה איזורית,262,97,165,100,162,27,260,0,1.94%
2017-09,המרכז,27,מ.א. גן רווה,מועצה איזורית,54,20,34,23,31,0,54,0,1.80%
2017-09,המרכז,20,מ.א. דרום השרון,מועצה איזורית,312,125,187,149,163,11,308,0,1.90%
2017-09,המרכז,29,מ.א. חבל יבנה,מועצה איזורית,39,14,25,15,24,2,39,0,1.49%
2017-09,המרכז,25,מ.א. חבל מודיעין,מועצה איזורית,213,93,120,78,135,17,210,0,1.91%
2017-09,המרכז,19,מ.א. חוף השרון,מועצה איזורית,90,24,66,40,50,5,90,0,1.62%
2017-09,המרכז,18,מ.א. לב השרון,מועצה איזורית,244,110,134,66,178,26,239,0,2.15%
2017-09,המרכז,31,מ.א. נחל שורק,מועצה איזורית,62,30,32,19,43,6,61,35,1.41%
2017-09,המרכז,16,מ.א. עמק חפר,מועצה איזורית,383,148,235,168,215,15,379,0,1.93%
2017-09,המרכז,40,מ.א. שדות דן,מועצה איזורית,151,72,79,32,119,11,149,0,2.31%
2017-09,המרכז,1200,מודיעין-מכבים-רעות*,יישוב,918,401,517,417,501,41,907,17,1.96%
2017-09,המרכז,28,מזכרת בתיה,יישוב,141,63,78,56,85,23,138,3,1.70%
2017-09,המרכז,7200,נס ציונה,יישוב,644,296,348,194,450,130,636,7,2.56%
2017-09,המרכז,7400,נתניה,יישוב,3820,1739,2081,502,3318,1079,3749,63,3.45%
2017-09,המרכז,587,סביון*,יישוב,21,6,15,11,10,0,21,0,1.01%
2017-09,המרכז,171,פרדסייה,יישוב,79,34,45,26,53,3,78,1,2.07%
2017-09,המרכז,7900,פתח תקווה,יישוב,3496,1567,1929,726,2770,766,3392,28,2.63%
2017-09,המרכז,195,קדימה-צורן,יישוב,237,108,129,77,160,26,235,0,2.01%
2017-09,המרכז,638,קלנסווה,יישוב,319,160,159,9,310,202,288,11,2.97%
2017-09,המרכז,469,קריית עקרון,יישוב,203,95,108,20,183,80,196,3,3.23%
2017-09,המרכז,2640,ראש העין,יישוב,753,344,409,191,562,104,745,11,2.41%
2017-09,המרכז,8300,ראשון לציון,יישוב,3668,1632,2036,796,2872,830,3632,48,2.59%
2017-09,המרכז,8400,רחובות,יישוב,2114,877,1237,532,1582,596,2048,46,2.88%
2017-09,המרכז,8500,רמלה,יישוב,1376,629,747,96,1280,514,1323,65,3.41%
2017-09,המרכז,8700,רעננה,יישוב,705,315,390,330,375,32,697,11,1.84%
2017-09,המרכז,1304,שוהם,יישוב,187,69,118,89,98,7,186,1,1.54%
2017-09,המרכז,154,תל מונד,יישוב,143,57,86,47,96,19,143,0,2.07%
2017-09,הצפון,473,אבו סנאן,יישוב,516,215,301,6,510,393,508,2,8.03%
2017-09,הצפון,478,אכסאל,יישוב,404,177,227,12,392,349,400,3,6.28%
2017-09,הצפון,529,אעבלין,יישוב,405,181,224,18,387,299,395,9,6.34%
2017-09,הצפון,482,בועיינה-נוג'ידאת,יישוב,220,105,115,7,213,177,217,3,5.03%
2017-09,הצפון,4001,בוקעאתא,יישוב,360,121,239,9,351,288,345,2,11.30%
2017-09,הצפון,998,ביר אל-מכסור,יישוב,252,106,146,2,250,194,247,2,5.94%
2017-09,הצפון,480,בית ג'ן,יישוב,350,93,257,12,338,225,336,1,5.61%
2017-09,הצפון,9200,בית שאן,יישוב,679,283,396,24,655,292,663,45,6.27%
2017-09,הצפון,944,בסמת טבעון,יישוב,154,64,90,6,148,98,144,2,3.99%
2017-09,הצפון,483,בענה,יישוב,291,122,169,3,288,241,283,7,7.30%
2017-09,הצפון,1292,ג'דיידה-מכר,יישוב,989,438,551,5,984,752,973,15,9.45%
2017-09,הצפון,485,ג'ולס,יישוב,157,46,111,2,155,100,157,1,4.80%
2017-09,הצפון,487,ג'ש (גוש חלב),יישוב,46,17,29,6,40,20,45,2,2.63%
2017-09,הצפון,489,דבורייה,יישוב,234,98,136,12,222,173,232,0,4.90%
2017-09,הצפון,490,דייר אל-אסד,יישוב,308,135,173,10,298,230,300,2,5.22%
2017-09,הצפון,492,דייר חנא,יישוב,492,214,278,17,475,362,487,3,9.19%
2017-09,הצפון,975,זרזיר,יישוב,202,82,120,2,200,124,200,6,5.55%
2017-09,הצפון,496,חורפיש,יישוב,85,39,46,6,79,45,82,1,2.70%
2017-09,הצפון,2034,חצור הגלילית,יישוב,258,91,167,20,238,110,239,6,4.87%
2017-09,הצפון,6700,טבריה,יישוב,1311,580,731,78,1233,638,1122,63,5.03%
2017-09,הצפון,962,טובא-זנגרייה,יישוב,277,124,153,3,274,196,267,0,7.86%
2017-09,הצפון,498,טורעאן,יישוב,342,146,196,8,334,270,333,1,5.25%
2017-09,הצפון,8900,טמרה,יישוב,1170,548,622,16,1154,961,1147,8,7.38%
2017-09,הצפון,1295,יאנוח-ג'ת,יישוב,112,32,80,2,110,65,110,0,3.44%
2017-09,הצפון,46,יבנאל,יישוב,91,48,43,6,85,55,73,2,4.60%
2017-09,הצפון,29,יסוד המעלה,יישוב,20,10,10,4,16,4,20,0,2.27%
2017-09,הצפון,499,יפיע,יישוב,497,204,293,23,474,355,489,4,5.64%
2017-09,הצפון,240,יקנעם עילית,יישוב,379,150,229,87,292,91,369,25,2.87%
2017-09,הצפון,502,ירכא,יישוב,354,141,213,1,353,255,347,1,4.95%
2017-09,הצפון,504,כאבול,יישוב,392,195,197,7,385,318,380,4,7.01%
2017-09,הצפון,505,כאוכב אבו אל-היג'א,יישוב,188,75,113,7,181,138,188,2,9.87%
2017-09,הצפון,1296,כסרא-סמיע,יישוב,184,52,132,5,179,107,175,5,4.49%
2017-09,הצפון,978,כעביה-טבאש-חג'אג'רה,יישוב,162,69,93,5,157,111,157,2,6.05%
2017-09,הצפון,1263,כפר ורדים,יישוב,50,18,32,21,29,4,49,0,1.58%
2017-09,הצפון,507,כפר יאסיף,יישוב,330,147,183,3,327,234,320,7,5.92%
2017-09,הצפון,508,כפר כמא,יישוב,35,16,19,1,34,16,35,0,2.03%
2017-09,הצפון,509,כפר כנא,יישוב,665,318,347,22,643,537,640,8,6.61%
2017-09,הצפון,510,כפר מנדא,יישוב,621,339,282,13,608,442,617,2,7.64%
2017-09,הצפון,47,כפר תבור,יישוב,38,11,27,14,24,1,38,0,1.61%
2017-09,הצפון,1139,כרמיאל,יישוב,1378,544,834,283,1095,613,1277,45,4.92%
2017-09,הצפון,65,מ.א. אל-בטוף,מועצה איזורית,218,87,131,9,209,179,209,1,6.41%
2017-09,הצפון,66,מ.א. בוסתן אל-מרג,מועצה איזורית,31,8,23,0,31,27,31,0,0.88%
2017-09,הצפון,71,מ.א. גולן,מועצה איזורית,186,80,106,62,124,14,186,0,2.12%
2017-09,הצפון,8,מ.א. הגלבוע,מועצה איזורית,587,254,333,62,525,295,576,0,4.08%
2017-09,הצפון,1,מ.א. הגליל העליון,מועצה איזורית,183,66,117,71,112,15,179,0,2.00%
2017-09,הצפון,3,מ.א. הגליל התחתון,מועצה איזורית,117,57,60,38,79,9,117,0,1.94%
2017-09,הצפון,55,מ.א. מבואות החרמון,מועצה איזורית,101,45,56,22,79,18,101,0,2.52%
2017-09,הצפון,13,מ.א. מגידו,מועצה איזורית,97,42,55,36,61,9,96,0,1.70%
2017-09,הצפון,4,מ.א. מטה אשר,מועצה איזורית,450,200,250,84,366,165,436,0,3.07%
2017-09,הצפון,52,מ.א. מעלה יוסף,מועצה איזורית,174,80,94,23,151,42,171,0,2.98%
2017-09,הצפון,2,מ.א. מרום הגליל,מועצה איזורית,236,104,132,30,206,98,228,0,3.19%
2017-09,הצפון,56,מ.א. משגב,מועצה איזורית,494,189,305,105,389,247,484,0,3.42%
2017-09,הצפון,6,מ.א. עמק הירדן,מועצה איזורית,173,83,90,44,129,34,162,0,2.38%
2017-09,הצפון,7,מ.א. עמק המעיינות,מועצה איזורית,152,61,91,36,116,30,148,0,2.26%
2017-09,הצפון,9,מ.א. עמק יזרעאל,מועצה איזורית,346,151,195,179,167,35,340,0,1.74%
2017-09,הצפון,481,מגאר,יישוב,1107,457,650,17,1090,879,1078,9,10.03%
2017-09,הצפון,516,מג'ד אל-כרום,יישוב,414,183,231,11,403,286,403,10,5.48%
2017-09,הצפון,65,מגדל,יישוב,38,16,22,5,33,13,35,1,3.50%
2017-09,הצפון,874,מגדל העמק,יישוב,761,304,457,89,672,281,716,52,5.21%
2017-09,הצפון,4201,מג'דל שמס,יישוב,391,134,257,9,382,301,365,3,6.90%
2017-09,הצפון,517,מזרעה,יישוב,151,64,87,2,149,103,145,1,6.71%
2017-09,הצפון,43,מטולה,יישוב,27,9,18,13,14,5,24,0,2.38%
2017-09,הצפון,4203,מסעדה,יישוב,179,65,114,6,173,143,169,2,9.28%
2017-09,הצפון,518,מעיליא,יישוב,34,19,15,5,29,16,33,0,1.94%
2017-09,הצפון,1063,מעלות-תרשיחא,יישוב,702,342,360,76,626,342,669,38,5.48%
2017-09,הצפון,520,משהד,יישוב,169,68,101,8,161,132,164,2,4.57%
2017-09,הצפון,9100,נהרייה,יישוב,1655,794,861,201,1454,820,1566,65,4.94%
2017-09,הצפון,522,נחף,יישוב,330,153,177,14,316,246,323,4,5.78%
2017-09,הצפון,7300,נצרת,יישוב,2518,1092,1426,124,2394,1855,2492,22,6.74%
2017-09,הצפון,1061,נצרת עילית,יישוב,1339,620,719,158,1181,608,1198,70,5.09%
2017-09,הצפון,525,סאג'ור,יישוב,93,35,58,6,87,60,91,0,4.20%
2017-09,הצפון,7500,סח'נין,יישוב,1544,656,888,38,1506,1263,1529,11,9.88%
2017-09,הצפון,4501,ע'ג'ר,יישוב,75,26,49,0,75,50,73,0,6.11%
2017-09,הצפון,530,עיילבון,יישוב,121,59,62,5,116,78,117,0,4.06%
2017-09,הצפון,511,עילוט,יישוב,251,103,148,4,247,195,250,1,7.76%
2017-09,הצפון,532,עין מאהל,יישוב,332,158,174,4,328,262,321,1,5.48%
2017-09,הצפון,4502,עין קנייא,יישוב,126,47,79,6,120,97,122,0,10.83%
2017-09,הצפון,7600,עכו,יישוב,2501,1113,1388,136,2365,1797,2403,42,8.86%
2017-09,הצפון,7700,עפולה,יישוב,1426,557,869,168,1258,505,1363,54,4.96%
2017-09,הצפון,531,עראבה,יישוב,1140,489,651,33,1107,940,1129,8,9.99%
2017-09,הצפון,535,פסוטה,יישוב,76,34,42,9,67,39,73,2,4.07%
2017-09,הצפון,536,פקיעין (בוקייעה),יישוב,114,62,52,7,107,68,110,2,3.66%
2017-09,הצפון,8000,צפת,יישוב,962,466,496,92,870,550,904,15,6.47%
2017-09,הצפון,4100,קצרין,יישוב,179,77,102,28,151,78,174,6,4.33%
2017-09,הצפון,2800,קריית שמונה,יישוב,612,295,317,85,527,253,591,24,4.56%
2017-09,הצפון,543,ראמה,יישוב,229,87,142,13,216,161,220,4,5.35%
2017-09,הצפון,26,ראש פינה,יישוב,52,17,35,8,44,19,51,0,3.08%
2017-09,הצפון,542,ריינה,יישוב,413,181,232,7,406,321,399,3,5.39%
2017-09,הצפון,122,רמת ישי,יישוב,92,31,61,33,59,14,89,0,2.15%
2017-09,הצפון,913,שבלי - אום אל-גנם,יישוב,165,64,101,10,155,102,163,2,5.72%
2017-09,הצפון,812,שלומי,יישוב,191,77,114,14,177,94,183,2,5.01%
2017-09,הצפון,538,שעב,יישוב,354,158,196,3,351,293,352,0,10.49%
2017-09,הצפון,8800,שפרעם,יישוב,1212,508,704,37,1175,926,1184,20,6.06%
2017-09,חיפה,1326,"בסמ""ה",יישוב,321,152,169,4,317,251,318,3,7.08%
2017-09,חיפה,2710,אום אל-פחם,יישוב,2518,1021,1497,33,2485,2024,2476,30,10.56%
2017-09,חיפה,1020,אור עקיבא,יישוב,427,163,264,44,383,111,408,13,3.88%
2017-09,חיפה,6000,באקה אל-גרביה,יישוב,569,274,295,23,546,329,559,12,4.27%
2017-09,חיפה,9800,בנימינה-גבעת עדה*,יישוב,171,79,92,74,97,29,168,2,2.23%
2017-09,חיפה,541,ג'סר א-זרקא,יישוב,222,123,99,1,221,87,221,12,3.44%
2017-09,חיפה,628,ג'ת,יישוב,188,97,91,14,174,107,186,4,3.22%
2017-09,חיפה,494,דאלית אל-כרמל,יישוב,387,136,251,15,372,213,364,10,4.16%
2017-09,חיפה,9300,זכרון יעקב,יישוב,261,123,138,114,147,30,259,5,2.27%
2017-09,חיפה,6500,חדרה,יישוב,2051,897,1154,258,1793,620,1950,47,3.75%
2017-09,חיפה,4000,חיפה,יישוב,4979,2357,2622,1061,3918,2198,4723,106,3.35%
2017-09,חיפה,1247,חריש,יישוב,89,26,63,24,65,11,87,0,2.06%
2017-09,חיפה,2100,טירת כרמל,יישוב,649,289,360,47,602,306,630,12,5.13%
2017-09,חיפה,654,כפר קרע,יישוב,395,188,207,28,367,227,388,11,4.12%
2017-09,חיפה,45,מ.א. אלונה,מועצה איזורית,24,10,14,9,15,2,24,0,2.25%
2017-09,חיפה,12,מ.א. זבולון,מועצה איזורית,192,100,92,20,172,107,189,0,3.19%
2017-09,חיפה,15,מ.א. חוף הכרמל,מועצה איזורית,285,119,166,96,189,41,281,1,1.90%
2017-09,חיפה,14,מ.א. מנשה,מועצה איזורית,217,87,130,69,148,47,212,0,2.47%
2017-09,חיפה,1327,מעלה עירון,יישוב,622,250,372,6,616,477,610,5,9.28%
2017-09,חיפה,2500,נשר,יישוב,363,177,186,67,296,110,353,9,2.79%
2017-09,חיפה,534,עספיא,יישוב,296,127,169,12,284,151,279,5,4.55%
2017-09,חיפה,637,ערערה,יישוב,500,210,290,19,481,314,491,10,5.43%
2017-09,חיפה,537,פוריידיס,יישוב,192,105,87,10,182,70,191,3,3.15%
2017-09,חיפה,7800,פרדס חנה-כרכור,יישוב,719,294,425,196,523,122,699,13,3.25%
2017-09,חיפה,6800,קריית אתא,יישוב,1335,598,737,110,1225,596,1297,38,4.18%
2017-09,חיפה,9500,קריית ביאליק,יישוב,833,356,477,94,739,345,809,20,3.79%
2017-09,חיפה,2300,קריית טבעון,יישוב,172,75,97,76,96,24,166,1,1.98%
2017-09,חיפה,9600,קריית ים,יישוב,1203,574,629,113,1090,629,1152,25,5.41%
2017-09,חיפה,8200,קריית מוצקין,יישוב,832,374,458,142,690,305,809,20,3.47%
2017-09,חיפה,922,רכסים,יישוב,153,54,99,10,143,56,142,1,3.77%
2017-09,ירושלים,472,אבו גוש,יישוב,198,92,106,6,192,148,197,3,5.69%
2017-09,ירושלים,2610,בית שמש,יישוב,1308,502,806,101,1207,402,1263,18,3.36%
2017-09,ירושלים,3000,ירושלים,יישוב,10923,4761,6162,1446,9477,6254,10663,123,3.33%
2017-09,ירושלים,26,מ.א. מטה יהודה,מועצה איזורית,547,250,297,156,391,112,535,0,2.07%
2017-09,ירושלים,1015,מבשרת ציון,יישוב,307,152,155,81,226,93,302,7,2.36%
2017-09,ירושלים,1137,קריית יערים,יישוב,53,21,32,10,43,13,53,0,2.96%
2017-09,תל אביב,2400,אור יהודה,יישוב,638,275,363,52,586,123,616,42,3.19%
2017-09,תל אביב,565,אזור,יישוב,155,75,80,29,126,23,153,1,2.29%
2017-09,תל אביב,6100,בני ברק,יישוב,1764,761,1003,98,1666,560,1661,20,2.74%
2017-09,תל אביב,6200,בת ים,יישוב,2397,1115,1282,358,2039,800,2268,74,3.22%
2017-09,תל אביב,6300,גבעתיים,יישוב,769,343,426,389,380,71,763,4,2.39%
2017-09,תל אביב,6400,הרצלייה,יישוב,1040,443,597,415,625,44,1030,7,2.09%
2017-09,תל אביב,6600,חולון,יישוב,2821,1201,1620,544,2277,545,2760,33,2.74%
2017-09,תל אביב,267,כפר שמריהו,יישוב,3,0,3,1,2,0,3,0,0.36%
2017-09,תל אביב,2620,קריית אונו,יישוב,411,170,241,190,221,32,401,2,2.05%
2017-09,תל אביב,8600,רמת גן,יישוב,1897,843,1054,706,1191,272,1869,8,2.29%
2017-09,תל אביב,2650,רמת השרון,יישוב,439,170,269,219,220,16,432,2,1.88%
2017-09,תל אביב,5000,תל אביב -יפו,יישוב,6874,3382,3492,2858,4016,1255,6774,40,2.57%
2017-10,אזור יהודה והשומרון,3760,אורנית,יישוב,89,49,40,32,57,1,88,0,1.76%
2017-10,אזור יהודה והשומרון,3750,אלפי מנשה,יישוב,78,39,39,26,52,1,78,0,1.76%
2017-10,אזור יהודה והשומרון,3560,אלקנה,יישוב,30,18,12,20,10,0,30,0,1.63%
2017-10,אזור יהודה והשומרון,3650,אפרת,יישוב,60,31,29,32,28,2,59,0,1.20%
2017-10,אזור יהודה והשומרון,3570,אריאל,יישוב,265,111,154,65,200,24,264,9,2.40%
2017-10,אזור יהודה והשומרון,3574,בית אל,יישוב,38,26,12,12,26,7,37,0,1.49%
2017-10,אזור יהודה והשומרון,3652,בית אריה,יישוב,49,20,29,11,38,0,49,1,1.71%
2017-10,אזור יהודה והשומרון,3780,ביתר עילית,יישוב,476,216,260,12,464,151,471,3,3.03%
2017-10,אזור יהודה והשומרון,3730,גבעת זאב,יישוב,169,82,87,36,133,27,168,1,2.08%
2017-10,אזור יהודה והשומרון,3769,הר אדר,יישוב,42,19,23,15,27,3,42,0,1.91%
2017-10,אזור יהודה והשומרון,76,מ.א. גוש עציון,מועצה איזורית,186,93,93,80,106,15,181,0,1.78%
2017-10,אזור יהודה והשומרון,78,מ.א. הר חברון,מועצה איזורית,57,32,25,23,34,4,57,0,1.44%
2017-10,אזור יהודה והשומרון,74,מ.א. מגילות ים המלח,מועצה איזורית,24,4,20,9,15,0,24,0,2.62%
2017-10,אזור יהודה והשומרון,73,מ.א. מטה בנימין,מועצה איזורית,576,293,283,208,368,87,566,0,1.99%
2017-10,אזור יהודה והשומרון,75,מ.א. ערבות הירדן,מועצה איזורית,54,26,28,13,41,4,54,0,2.10%
2017-10,אזור יהודה והשומרון,72,מ.א. שומרון,מועצה איזורית,409,200,209,143,266,27,407,0,2.15%
2017-10,אזור יהודה והשומרון,3797,מודיעין עילית,יישוב,464,138,326,27,437,32,461,1,2.87%
2017-10,אזור יהודה והשומרון,3616,מעלה אדומים,יישוב,561,251,310,104,457,129,552,10,2.64%
2017-10,אזור יהודה והשומרון,3608,מעלה אפרים,יישוב,27,9,18,3,24,7,27,0,3.38%
2017-10,אזור יהודה והשומרון,3660,עמנואל,יישוב,49,27,22,3,46,21,47,1,3.46%
2017-10,אזור יהודה והשומרון,3557,קדומים,יישוב,37,18,19,14,23,2,37,0,1.85%
2017-10,אזור יהודה והשומרון,3611,קריית ארבע,יישוב,84,44,40,14,70,35,83,2,2.47%
2017-10,אזור יהודה והשומרון,3640,קרני שומרון,יישוב,60,32,28,23,37,3,59,0,1.46%
2017-10,הדרום,31,אופקים,יישוב,815,355,460,45,770,375,784,28,5.43%
2017-10,הדרום,2600,אילת,יישוב,901,471,430,52,849,282,841,44,2.44%
2017-10,הדרום,70,אשדוד,יישוב,4873,2004,2869,630,4243,2014,4633,116,4.14%
2017-10,הדרום,7100,אשקלון,יישוב,3366,1418,1948,398,2968,1401,3047,63,4.11%
2017-10,הדרום,9000,באר שבע,יישוב,5365,2461,2904,761,4604,2593,5075,80,4.72%
2017-10,הדרום,2200,דימונה,יישוב,1676,751,925,86,1590,1046,1586,39,8.10%
2017-10,הדרום,1303,חורה,יישוב,490,196,294,3,487,424,474,3,9.87%
2017-10,הדרום,831,ירוחם,יישוב,411,200,211,17,394,210,383,15,7.43%
2017-10,הדרום,1059,כסיפה,יישוב,985,371,614,3,982,875,968,10,17.77%
2017-10,הדרום,1271,להבים,יישוב,39,18,21,15,24,0,38,0,1.08%
2017-10,הדרום,1060,לקיה,יישוב,544,237,307,5,539,477,523,1,10.79%
2017-10,הדרום,69,מ.א. אל קסום,מועצה איזורית,578,228,350,2,576,504,563,0,16.51%
2017-10,הדרום,38,מ.א. אשכול,מועצה איזורית,126,63,63,34,92,11,124,0,1.77%
2017-10,הדרום,33,מ.א. באר טוביה,מועצה איזורית,254,98,156,52,202,51,249,0,2.20%
2017-10,הדרום,41,מ.א. בני שמעון,מועצה איזורית,81,34,47,30,51,12,79,1,1.63%
2017-10,הדרום,54,מ.א. הערבה התיכונה,מועצה איזורית,29,12,17,10,19,1,29,0,1.52%
2017-10,הדרום,53,מ.א. חבל אילות,מועצה איזורית,20,5,15,5,15,2,18,3,0.73%
2017-10,הדרום,36,מ.א. חוף אשקלון,מועצה איזורית,193,82,111,41,152,39,184,0,2.12%
2017-10,הדרום,35,מ.א. יואב,מועצה איזורית,72,26,46,27,45,9,72,0,1.76%
2017-10,הדרום,50,מ.א. לכיש,מועצה איזורית,145,62,83,25,120,29,144,0,2.58%
2017-10,הדרום,42,מ.א. מרחבים,מועצה איזורית,183,61,122,30,153,34,177,0,2.81%
2017-10,הדרום,68,מ.א. נווה מדבר,מועצה איזורית,122,46,76,0,122,91,121,0,6.41%
2017-10,הדרום,48,מ.א. רמת נגב,מועצה איזורית,263,129,134,15,248,195,254,0,7.64%
2017-10,הדרום,39,מ.א. שדות נגב,מועצה איזורית,114,52,62,21,93,29,110,0,2.26%
2017-10,הדרום,37,מ.א. שער הנגב,מועצה איזורית,96,47,49,38,58,16,92,0,2.30%
2017-10,הדרום,34,מ.א. שפיר,מועצה איזורית,141,62,79,15,126,41,137,0,2.75%
2017-10,הדרום,51,מ.א. תמר,מועצה איזורית,7,4,3,3,4,2,6,0,0.92%
2017-10,הדרום,1268,מיתר,יישוב,60,22,38,21,39,4,58,0,1.18%
2017-10,הדרום,99,מצפה רמון,יישוב,214,78,136,19,195,134,204,12,7.37%
2017-10,הדרום,246,נתיבות,יישוב,951,410,541,64,887,401,894,36,5.42%
2017-10,הדרום,666,עומר,יישוב,55,18,37,17,38,2,54,1,1.28%
2017-10,הדרום,2560,ערד,יישוב,624,269,355,75,549,304,590,22,4.65%
2017-10,הדרום,1192,ערערה-בנגב,יישוב,1071,444,627,9,1062,954,1046,23,20.03%
2017-10,הדרום,2630,קריית גת,יישוב,1458,634,824,93,1365,592,1402,46,4.80%
2017-10,הדרום,1034,קריית מלאכי,יישוב,703,300,403,12,691,284,669,46,5.41%
2017-10,הדרום,1161,רהט,יישוב,2182,900,1282,8,2174,1608,2154,47,9.56%
2017-10,הדרום,1286,שגב-שלום,יישוב,339,124,215,2,337,267,327,5,10.08%
2017-10,הדרום,1031,שדרות,יישוב,910,413,497,69,841,441,849,44,5.71%
2017-10,הדרום,1054,תל שבע,יישוב,691,306,385,4,687,595,654,5,11.38%
2017-10,המרכז,1066,"בני עי""ש",יישוב,133,55,78,21,112,34,128,4,3.19%
2017-10,המרכז,182,אבן יהודה,יישוב,144,61,83,50,94,18,143,0,2.05%
2017-10,המרכז,41,אליכין,יישוב,53,25,28,6,47,12,51,1,2.60%
2017-10,המרכז,1309,אלעד,יישוב,351,131,220,20,331,32,343,1,2.41%
2017-10,המרכז,2530,באר יעקב,יישוב,266,101,165,70,196,31,259,2,2.01%
2017-10,המרכז,466,בית דגן,יישוב,93,39,54,13,80,26,90,0,2.41%
2017-10,המרכז,681,גבעת שמואל,יישוב,230,112,118,89,141,32,225,1,1.80%
2017-10,המרכז,2550,גדרה,יישוב,305,138,167,70,235,66,298,7,2.30%
2017-10,המרכז,627,ג'לג'וליה,יישוב,71,34,37,3,68,33,71,0,1.65%
2017-10,המרכז,166,גן יבנה,יישוב,272,107,165,44,228,56,267,9,2.11%
2017-10,המרכז,229,גני תקווה,יישוב,201,98,103,78,123,26,201,0,2.08%
2017-10,המרכז,9700,הוד השרון,יישוב,647,255,392,292,355,30,640,5,1.96%
2017-10,המרכז,1290,זמר,יישוב,128,51,77,5,123,75,124,1,3.78%
2017-10,המרכז,2730,טייבה,יישוב,877,398,479,20,857,628,743,20,3.85%
2017-10,המרכז,2720,טירה,יישוב,169,75,94,15,154,44,167,9,1.33%
2017-10,המרכז,2660,יבנה,יישוב,695,318,377,156,539,135,684,22,2.71%
2017-10,המרכז,9400,יהוד,יישוב,348,155,193,96,252,42,336,7,2.06%
2017-10,המרכז,1224,כוכב יאיר,יישוב,75,25,50,46,29,0,75,1,1.35%
2017-10,המרכז,633,כפר ברא,יישוב,13,7,6,2,11,3,13,0,0.81%
2017-10,המרכז,168,כפר יונה,יישוב,289,121,168,54,235,45,286,2,2.44%
2017-10,המרכז,6900,כפר סבא,יישוב,1056,463,593,388,668,85,1041,10,1.97%
2017-10,המרכז,634,כפר קאסם,יישוב,170,87,83,5,165,86,165,3,1.60%
2017-10,המרכז,7000,לוד,יישוב,1550,764,786,139,1411,747,1509,17,4.09%
2017-10,המרכז,28,מ.א. ברנר,מועצה איזורית,55,24,31,30,25,2,55,4,1.36%
2017-10,המרכז,32,מ.א. גדרות,מועצה איזורית,45,23,22,21,24,4,45,0,1.83%
2017-10,המרכז,30,מ.א. גזר,מועצה איזורית,252,100,152,101,151,22,250,0,1.86%
2017-10,המרכז,27,מ.א. גן רווה,מועצה איזורית,47,19,28,22,25,0,47,0,1.57%
2017-10,המרכז,20,מ.א. דרום השרון,מועצה איזורית,305,121,184,147,158,9,303,0,1.87%
2017-10,המרכז,29,מ.א. חבל יבנה,מועצה איזורית,40,12,28,18,22,3,40,0,1.53%
2017-10,המרכז,25,מ.א. חבל מודיעין,מועצה איזורית,204,87,117,64,140,21,200,0,1.82%
2017-10,המרכז,19,מ.א. חוף השרון,מועצה איזורית,97,25,72,45,52,5,96,0,1.72%
2017-10,המרכז,18,מ.א. לב השרון,מועצה איזורית,233,100,133,58,175,23,226,0,2.03%
2017-10,המרכז,31,מ.א. נחל שורק,מועצה איזורית,51,24,27,18,33,6,50,28,1.17%
2017-10,המרכז,16,מ.א. עמק חפר,מועצה איזורית,402,157,245,170,232,20,398,0,2.02%
2017-10,המרכז,40,מ.א. שדות דן,מועצה איזורית,139,60,79,30,109,10,137,0,2.13%
2017-10,המרכז,1200,מודיעין-מכבים-רעות*,יישוב,861,367,494,398,463,35,851,6,1.84%
2017-10,המרכז,28,מזכרת בתיה,יישוב,137,53,84,50,87,21,133,4,1.64%
2017-10,המרכז,7200,נס ציונה,יישוב,612,290,322,188,424,127,606,3,2.44%
2017-10,המרכז,7400,נתניה,יישוב,3784,1761,2023,474,3310,1071,3701,61,3.41%
2017-10,המרכז,587,סביון*,יישוב,22,5,17,12,10,0,22,0,1.05%
2017-10,המרכז,171,פרדסייה,יישוב,71,31,40,23,48,4,70,0,1.86%
2017-10,המרכז,7900,פתח תקווה,יישוב,3527,1589,1938,724,2803,776,3434,31,2.66%
2017-10,המרכז,195,קדימה-צורן,יישוב,241,116,125,77,164,27,239,0,2.04%
2017-10,המרכז,638,קלנסווה,יישוב,324,167,157,8,316,208,294,10,3.03%
2017-10,המרכז,469,קריית עקרון,יישוב,202,96,106,18,184,77,198,2,3.26%
2017-10,המרכז,2640,ראש העין,יישוב,732,332,400,175,557,107,724,6,2.34%
2017-10,המרכז,8300,ראשון לציון,יישוב,3648,1585,2063,793,2855,810,3610,40,2.57%
2017-10,המרכז,8400,רחובות,יישוב,2095,907,1188,530,1565,581,2030,45,2.86%
2017-10,המרכז,8500,רמלה,יישוב,1392,667,725,93,1299,505,1335,37,3.44%
2017-10,המרכז,8700,רעננה,יישוב,690,308,382,312,378,36,681,1,1.80%
2017-10,המרכז,1304,שוהם,יישוב,173,72,101,82,91,7,172,0,1.42%
2017-10,המרכז,154,תל מונד,יישוב,150,62,88,47,103,16,150,1,2.17%
2017-10,הצפון,473,אבו סנאן,יישוב,512,209,303,7,505,383,504,8,7.97%
2017-10,הצפון,478,אכסאל,יישוב,399,182,217,11,388,337,397,1,6.23%
2017-10,הצפון,529,אעבלין,יישוב,378,169,209,10,368,285,372,4,5.99%
2017-10,הצפון,482,בועיינה-נוג'ידאת,יישוב,213,108,105,6,207,168,209,2,4.85%
2017-10,הצפון,4001,בוקעאתא,יישוב,349,117,232,8,341,283,332,2,10.92%
2017-10,הצפון,998,ביר אל-מכסור,יישוב,244,107,137,1,243,189,239,3,5.76%
2017-10,הצפון,480,בית ג'ן,יישוב,357,98,259,10,347,232,342,1,5.71%
2017-10,הצפון,9200,בית שאן,יישוב,643,275,368,19,624,281,627,31,5.95%
2017-10,הצפון,944,בסמת טבעון,יישוב,143,62,81,3,140,100,135,3,3.75%
2017-10,הצפון,483,בענה,יישוב,294,126,168,4,290,247,280,2,7.23%
2017-10,הצפון,1292,ג'דיידה-מכר,יישוב,986,435,551,3,983,746,966,9,9.39%
2017-10,הצפון,485,ג'ולס,יישוב,157,47,110,3,154,102,157,2,4.80%
2017-10,הצפון,487,ג'ש (גוש חלב),יישוב,45,18,27,7,38,20,44,0,2.58%
2017-10,הצפון,489,דבורייה,יישוב,244,110,134,13,231,172,239,3,5.04%
2017-10,הצפון,490,דייר אל-אסד,יישוב,304,137,167,10,294,232,299,0,5.20%
2017-10,הצפון,492,דייר חנא,יישוב,487,215,272,15,472,353,486,3,9.17%
2017-10,הצפון,975,זרזיר,יישוב,186,73,113,2,184,125,183,4,5.10%
2017-10,הצפון,496,חורפיש,יישוב,87,37,50,5,82,47,82,1,2.70%
2017-10,הצפון,2034,חצור הגלילית,יישוב,248,99,149,17,231,114,226,4,4.62%
2017-10,הצפון,6700,טבריה,יישוב,1316,627,689,83,1233,620,1143,39,5.12%
2017-10,הצפון,962,טובא-זנגרייה,יישוב,285,126,159,6,279,201,275,3,8.08%
2017-10,הצפון,498,טורעאן,יישוב,307,132,175,8,299,256,303,2,4.80%
2017-10,הצפון,8900,טמרה,יישוב,1164,532,632,16,1148,942,1137,10,7.32%
2017-10,הצפון,1295,יאנוח-ג'ת,יישוב,109,29,80,2,107,65,105,0,3.29%
2017-10,הצפון,46,יבנאל,יישוב,85,46,39,6,79,52,70,3,4.42%
2017-10,הצפון,29,יסוד המעלה,יישוב,16,7,9,2,14,4,16,0,1.82%
2017-10,הצפון,499,יפיע,יישוב,483,200,283,22,461,354,473,7,5.46%
2017-10,הצפון,240,יקנעם עילית,יישוב,378,161,217,88,290,88,365,16,2.84%
2017-10,הצפון,502,ירכא,יישוב,358,142,216,0,358,253,351,2,5.00%
2017-10,הצפון,504,כאבול,יישוב,386,193,193,6,380,318,378,2,6.98%
2017-10,הצפון,505,כאוכב אבו אל-היג'א,יישוב,178,65,113,7,171,137,177,2,9.35%
2017-10,הצפון,1296,כסרא-סמיע,יישוב,159,47,112,5,154,97,155,2,4.00%
2017-10,הצפון,978,כעביה-טבאש-חג'אג'רה,יישוב,156,66,90,6,150,109,154,0,5.95%
2017-10,הצפון,1263,כפר ורדים,יישוב,53,15,38,23,30,4,52,0,1.67%
2017-10,הצפון,507,כפר יאסיף,יישוב,331,144,187,2,329,232,318,5,5.88%
2017-10,הצפון,508,כפר כמא,יישוב,35,14,21,2,33,17,35,0,2.03%
2017-10,הצפון,509,כפר כנא,יישוב,633,308,325,15,618,512,611,5,6.33%
2017-10,הצפון,510,כפר מנדא,יישוב,574,327,247,10,564,413,567,2,7.07%
2017-10,הצפון,47,כפר תבור,יישוב,40,12,28,13,27,1,40,0,1.69%
2017-10,הצפון,1139,כרמיאל,יישוב,1361,540,821,288,1073,608,1247,32,4.81%
2017-10,הצפון,65,מ.א. אל-בטוף,מועצה איזורית,226,99,127,11,215,174,218,0,6.69%
2017-10,הצפון,66,מ.א. בוסתן אל-מרג,מועצה איזורית,29,6,23,0,29,27,27,0,0.77%
2017-10,הצפון,71,מ.א. גולן,מועצה איזורית,182,73,109,61,121,14,182,0,2.07%
2017-10,הצפון,8,מ.א. הגלבוע,מועצה איזורית,569,242,327,58,511,287,560,0,3.97%
2017-10,הצפון,1,מ.א. הגליל העליון,מועצה איזורית,183,69,114,67,116,18,181,0,2.02%
2017-10,הצפון,3,מ.א. הגליל התחתון,מועצה איזורית,124,56,68,40,84,8,124,0,2.06%
2017-10,הצפון,55,מ.א. מבואות החרמון,מועצה איזורית,114,49,65,25,89,18,113,0,2.82%
2017-10,הצפון,13,מ.א. מגידו,מועצה איזורית,90,42,48,33,57,8,89,0,1.57%
2017-10,הצפון,4,מ.א. מטה אשר,מועצה איזורית,450,188,262,94,356,162,436,0,3.07%
2017-10,הצפון,52,מ.א. מעלה יוסף,מועצה איזורית,168,78,90,26,142,37,164,0,2.86%
2017-10,הצפון,2,מ.א. מרום הגליל,מועצה איזורית,220,94,126,23,197,85,217,0,3.04%
2017-10,הצפון,56,מ.א. משגב,מועצה איזורית,487,188,299,98,389,245,474,0,3.35%
2017-10,הצפון,6,מ.א. עמק הירדן,מועצה איזורית,179,89,90,46,133,29,170,0,2.50%
2017-10,הצפון,7,מ.א. עמק המעיינות,מועצה איזורית,151,57,94,38,113,32,147,0,2.24%
2017-10,הצפון,9,מ.א. עמק יזרעאל,מועצה איזורית,354,157,197,178,176,30,350,0,1.79%
2017-10,הצפון,481,מגאר,יישוב,1082,459,623,13,1069,876,1049,11,9.79%
2017-10,הצפון,516,מג'ד אל-כרום,יישוב,397,180,217,12,385,275,387,8,5.27%
2017-10,הצפון,65,מגדל,יישוב,34,16,18,2,32,11,33,0,3.31%
2017-10,הצפון,874,מגדל העמק,יישוב,755,316,439,88,667,284,704,43,5.13%
2017-10,הצפון,4201,מג'דל שמס,יישוב,373,137,236,9,364,294,353,1,6.69%
2017-10,הצפון,517,מזרעה,יישוב,156,66,90,3,153,105,147,5,6.80%
2017-10,הצפון,43,מטולה,יישוב,27,10,17,11,16,7,23,1,2.28%
2017-10,הצפון,4203,מסעדה,יישוב,186,65,121,6,180,143,178,0,9.73%
2017-10,הצפון,518,מעיליא,יישוב,38,19,19,5,33,18,35,1,2.06%
2017-10,הצפון,1063,מעלות-תרשיחא,יישוב,683,332,351,78,605,331,645,29,5.29%
2017-10,הצפון,520,משהד,יישוב,161,70,91,8,153,123,155,2,4.33%
2017-10,הצפון,9100,נהרייה,יישוב,1632,760,872,198,1434,807,1553,36,4.90%
2017-10,הצפון,522,נחף,יישוב,330,155,175,14,316,243,324,5,5.79%
2017-10,הצפון,7300,נצרת,יישוב,2416,1072,1344,95,2321,1812,2389,10,6.48%
2017-10,הצפון,1061,נצרת עילית,יישוב,1264,602,662,126,1138,573,1130,74,4.81%
2017-10,הצפון,525,סאג'ור,יישוב,86,34,52,5,81,59,85,0,3.94%
2017-10,הצפון,7500,סח'נין,יישוב,1508,650,858,33,1475,1235,1494,17,9.67%
2017-10,הצפון,4501,ע'ג'ר,יישוב,77,31,46,1,76,51,75,2,6.27%
2017-10,הצפון,530,עיילבון,יישוב,130,64,66,7,123,73,127,1,4.39%
2017-10,הצפון,511,עילוט,יישוב,238,100,138,4,234,184,238,2,7.41%
2017-10,הצפון,532,עין מאהל,יישוב,331,162,169,6,325,267,319,0,5.45%
2017-10,הצפון,4502,עין קנייא,יישוב,141,55,86,6,135,103,138,1,12.07%
2017-10,הצפון,7600,עכו,יישוב,2424,1098,1326,127,2297,1747,2338,31,8.64%
2017-10,הצפון,7700,עפולה,יישוב,1380,557,823,164,1216,502,1304,54,4.76%
2017-10,הצפון,531,עראבה,יישוב,1101,472,629,25,1076,910,1089,10,9.67%
2017-10,הצפון,535,פסוטה,יישוב,78,39,39,8,70,41,75,2,4.18%
2017-10,הצפון,536,פקיעין (בוקייעה),יישוב,117,62,55,6,111,72,111,4,3.70%
2017-10,הצפון,8000,צפת,יישוב,926,459,467,90,836,564,865,9,6.21%
2017-10,הצפון,4100,קצרין,יישוב,177,80,97,27,150,77,171,1,4.26%
2017-10,הצפון,2800,קריית שמונה,יישוב,636,299,337,80,556,257,613,20,4.73%
2017-10,הצפון,543,ראמה,יישוב,213,87,126,10,203,154,204,2,4.98%
2017-10,הצפון,26,ראש פינה,יישוב,50,16,34,11,39,20,48,0,2.91%
2017-10,הצפון,542,ריינה,יישוב,378,173,205,5,373,308,365,4,4.95%
2017-10,הצפון,122,רמת ישי,יישוב,86,30,56,30,56,11,85,0,2.06%
2017-10,הצפון,913,שבלי - אום אל-גנם,יישוב,156,65,91,6,150,96,153,2,5.39%
2017-10,הצפון,812,שלומי,יישוב,193,79,114,16,177,99,184,5,5.04%
2017-10,הצפון,538,שעב,יישוב,355,163,192,1,354,284,353,3,10.51%
2017-10,הצפון,8800,שפרעם,יישוב,1201,500,701,41,1160,895,1170,14,5.99%
2017-10,חיפה,1326,"בסמ""ה",יישוב,313,146,167,4,309,245,310,2,6.91%
2017-10,חיפה,2710,אום אל-פחם,יישוב,2477,1008,1469,31,2446,2016,2431,24,10.38%
2017-10,חיפה,1020,אור עקיבא,יישוב,410,171,239,38,372,106,398,12,3.79%
2017-10,חיפה,6000,באקה אל-גרביה,יישוב,539,252,287,19,520,321,529,15,4.05%
2017-10,חיפה,9800,בנימינה-גבעת עדה*,יישוב,169,81,88,71,98,25,167,1,2.22%
2017-10,חיפה,541,ג'סר א-זרקא,יישוב,228,122,106,1,227,91,224,6,3.49%
2017-10,חיפה,628,ג'ת,יישוב,189,99,90,15,174,104,188,5,3.25%
2017-10,חיפה,494,דאלית אל-כרמל,יישוב,377,143,234,16,361,214,357,6,4.08%
2017-10,חיפה,9300,זכרון יעקב,יישוב,246,116,130,110,136,28,245,4,2.15%
2017-10,חיפה,6500,חדרה,יישוב,1960,875,1085,242,1718,591,1857,34,3.58%
2017-10,חיפה,4000,חיפה,יישוב,4989,2347,2642,1071,3918,2240,4720,114,3.34%
2017-10,חיפה,1247,חריש,יישוב,97,29,68,27,70,12,94,4,2.22%
2017-10,חיפה,2100,טירת כרמל,יישוב,628,289,339,41,587,300,610,7,4.98%
2017-10,חיפה,654,כפר קרע,יישוב,379,173,206,26,353,228,371,5,3.95%
2017-10,חיפה,45,מ.א. אלונה,מועצה איזורית,23,10,13,10,13,2,23,0,2.16%
2017-10,חיפה,12,מ.א. זבולון,מועצה איזורית,203,105,98,21,182,105,197,0,3.32%
2017-10,חיפה,15,מ.א. חוף הכרמל,מועצה איזורית,285,118,167,102,183,42,280,0,1.89%
2017-10,חיפה,14,מ.א. מנשה,מועצה איזורית,211,82,129,64,147,48,208,0,2.42%
2017-10,חיפה,1327,מעלה עירון,יישוב,603,242,361,7,596,473,588,0,8.97%
2017-10,חיפה,2500,נשר,יישוב,359,176,183,67,292,122,347,3,2.74%
2017-10,חיפה,534,עספיא,יישוב,318,140,178,14,304,155,300,5,4.87%
2017-10,חיפה,637,ערערה,יישוב,503,210,293,20,483,313,492,8,5.44%
2017-10,חיפה,537,פוריידיס,יישוב,203,116,87,8,195,68,201,2,3.31%
2017-10,חיפה,7800,פרדס חנה-כרכור,יישוב,686,297,389,179,507,119,668,16,3.11%
2017-10,חיפה,6800,קריית אתא,יישוב,1273,568,705,105,1168,548,1240,37,4.01%
2017-10,חיפה,9500,קריית ביאליק,יישוב,799,341,458,98,701,322,777,22,3.64%
2017-10,חיפה,2300,קריית טבעון,יישוב,174,81,93,80,94,19,172,1,2.05%
2017-10,חיפה,9600,קריית ים,יישוב,1177,555,622,117,1060,609,1133,29,5.33%
2017-10,חיפה,8200,קריית מוצקין,יישוב,797,359,438,134,663,297,777,13,3.34%
2017-10,חיפה,922,רכסים,יישוב,129,50,79,9,120,49,121,1,3.23%
2017-10,ירושלים,472,אבו גוש,יישוב,198,96,102,5,193,153,194,0,5.61%
2017-10,ירושלים,2610,בית שמש,יישוב,1184,488,696,101,1083,378,1146,13,3.06%
2017-10,ירושלים,3000,ירושלים,יישוב,10675,4722,5953,1381,9294,6148,10393,72,3.25%
2017-10,ירושלים,26,מ.א. מטה יהודה,מועצה איזורית,518,249,269,136,382,104,511,0,1.97%
2017-10,ירושלים,1015,מבשרת ציון,יישוב,290,148,142,71,219,84,284,0,2.23%
2017-10,ירושלים,1137,קריית יערים,יישוב,46,20,26,11,35,13,46,0,2.58%
2017-10,תל אביב,2400,אור יהודה,יישוב,603,278,325,44,559,121,580,14,3.01%
2017-10,תל אביב,565,אזור,יישוב,169,84,85,32,137,24,166,2,2.48%
2017-10,תל אביב,6100,בני ברק,יישוב,1647,776,871,100,1547,544,1554,11,2.57%
2017-10,תל אביב,6200,בת ים,יישוב,2406,1165,1241,353,2053,790,2281,45,3.24%
2017-10,תל אביב,6300,גבעתיים,יישוב,759,333,426,368,391,69,752,2,2.36%
2017-10,תל אביב,6400,הרצלייה,יישוב,999,447,552,374,625,47,989,7,2.01%
2017-10,תל אביב,6600,חולון,יישוב,2797,1231,1566,521,2276,528,2736,39,2.71%
2017-10,תל אביב,267,כפר שמריהו,יישוב,3,0,3,2,1,0,3,0,0.36%
2017-10,תל אביב,2620,קריית אונו,יישוב,405,167,238,187,218,30,399,1,2.04%
2017-10,תל אביב,8600,רמת גן,יישוב,1874,829,1045,681,1193,258,1847,12,2.26%
2017-10,תל אביב,2650,רמת השרון,יישוב,407,161,246,205,202,14,406,0,1.77%
2017-10,תל אביב,5000,תל אביב -יפו,יישוב,6901,3433,3468,2766,4135,1243,6789,53,2.58%
2017-11,אזור יהודה והשומרון,3760,אורנית,יישוב,87,44,43,31,56,2,86,2,1.72%
2017-11,אזור יהודה והשומרון,3750,אלפי מנשה,יישוב,87,41,46,30,57,1,87,0,1.96%
2017-11,אזור יהודה והשומרון,3560,אלקנה,יישוב,32,17,15,19,13,1,32,0,1.74%
2017-11,אזור יהודה והשומרון,3650,אפרת,יישוב,56,37,19,26,30,2,56,1,1.14%
2017-11,אזור יהודה והשומרון,3570,אריאל,יישוב,262,109,153,49,213,22,258,9,2.35%
2017-11,אזור יהודה והשומרון,3574,בית אל,יישוב,41,26,15,11,30,9,41,1,1.64%
2017-11,אזור יהודה והשומרון,3652,בית אריה,יישוב,48,18,30,13,35,0,48,1,1.67%
2017-11,אזור יהודה והשומרון,3780,ביתר עילית,יישוב,502,233,269,17,485,157,493,1,3.16%
2017-11,אזור יהודה והשומרון,3730,גבעת זאב,יישוב,164,85,79,31,133,30,162,2,2.00%
2017-11,אזור יהודה והשומרון,3769,הר אדר,יישוב,42,20,22,17,25,1,42,0,1.91%
2017-11,אזור יהודה והשומרון,76,מ.א. גוש עציון,מועצה איזורית,182,87,95,70,112,13,177,0,1.74%
2017-11,אזור יהודה והשומרון,78,מ.א. הר חברון,מועצה איזורית,65,36,29,26,39,4,65,0,1.64%
2017-11,אזור יהודה והשומרון,74,מ.א. מגילות ים המלח,מועצה איזורית,25,6,19,11,14,0,25,0,2.73%
2017-11,אזור יהודה והשומרון,73,מ.א. מטה בנימין,מועצה איזורית,555,285,270,187,368,90,547,0,1.93%
2017-11,אזור יהודה והשומרון,75,מ.א. ערבות הירדן,מועצה איזורית,53,21,32,15,38,5,52,0,2.02%
2017-11,אזור יהודה והשומרון,72,מ.א. שומרון,מועצה איזורית,410,198,212,149,261,27,408,0,2.15%
2017-11,אזור יהודה והשומרון,3797,מודיעין עילית,יישוב,437,144,293,30,407,38,428,3,2.67%
2017-11,אזור יהודה והשומרון,3616,מעלה אדומים,יישוב,559,259,300,89,470,138,547,8,2.62%
2017-11,אזור יהודה והשומרון,3608,מעלה אפרים,יישוב,26,11,15,2,24,7,26,1,3.26%
2017-11,אזור יהודה והשומרון,3660,עמנואל,יישוב,45,26,19,2,43,21,42,1,3.10%
2017-11,אזור יהודה והשומרון,3557,קדומים,יישוב,36,16,20,17,19,2,36,0,1.80%
2017-11,אזור יהודה והשומרון,3611,קריית ארבע,יישוב,76,41,35,12,64,38,74,5,2.21%
2017-11,אזור יהודה והשומרון,3640,קרני שומרון,יישוב,65,34,31,22,43,2,65,1,1.60%
2017-11,הדרום,31,אופקים,יישוב,785,356,429,43,742,382,759,35,5.27%
2017-11,הדרום,2600,אילת,יישוב,939,498,441,46,893,297,868,38,2.52%
2017-11,הדרום,70,אשדוד,יישוב,4826,2055,2771,638,4188,2055,4602,97,4.11%
2017-11,הדרום,7100,אשקלון,יישוב,3401,1447,1954,391,3010,1426,3051,54,4.12%
2017-11,הדרום,9000,באר שבע,יישוב,5454,2543,2911,775,4679,2656,5140,98,4.78%
2017-11,הדרום,2200,דימונה,יישוב,1689,782,907,84,1605,1061,1597,40,8.15%
2017-11,הדרום,1303,חורה,יישוב,504,196,308,4,500,433,482,4,10.02%
2017-11,הדרום,831,ירוחם,יישוב,400,201,199,19,381,207,373,16,7.25%
2017-11,הדרום,1059,כסיפה,יישוב,974,371,603,3,971,876,958,4,17.62%
2017-11,הדרום,1271,להבים,יישוב,37,15,22,16,21,1,37,0,1.05%
2017-11,הדרום,1060,לקיה,יישוב,564,253,311,7,557,492,542,9,11.14%
2017-11,הדרום,69,מ.א. אל קסום,מועצה איזורית,590,236,354,2,588,509,573,0,16.80%
2017-11,הדרום,38,מ.א. אשכול,מועצה איזורית,119,60,59,36,83,9,119,0,1.70%
2017-11,הדרום,33,מ.א. באר טוביה,מועצה איזורית,273,118,155,52,221,48,271,0,2.39%
2017-11,הדרום,41,מ.א. בני שמעון,מועצה איזורית,79,31,48,28,51,13,75,0,1.55%
2017-11,הדרום,54,מ.א. הערבה התיכונה,מועצה איזורית,25,10,15,10,15,0,25,0,1.31%
2017-11,הדרום,53,מ.א. חבל אילות,מועצה איזורית,18,5,13,3,15,1,17,2,0.69%
2017-11,הדרום,36,מ.א. חוף אשקלון,מועצה איזורית,201,89,112,34,167,41,190,0,2.19%
2017-11,הדרום,35,מ.א. יואב,מועצה איזורית,76,26,50,28,48,9,76,0,1.86%
2017-11,הדרום,50,מ.א. לכיש,מועצה איזורית,149,74,75,27,122,34,147,0,2.64%
2017-11,הדרום,42,מ.א. מרחבים,מועצה איזורית,168,58,110,31,137,35,162,0,2.57%
2017-11,הדרום,68,מ.א. נווה מדבר,מועצה איזורית,125,47,78,0,125,97,122,0,6.46%
2017-11,הדרום,48,מ.א. רמת נגב,מועצה איזורית,271,126,145,20,251,204,263,0,7.91%
2017-11,הדרום,39,מ.א. שדות נגב,מועצה איזורית,110,55,55,25,85,30,108,0,2.22%
2017-11,הדרום,37,מ.א. שער הנגב,מועצה איזורית,85,35,50,36,49,15,80,1,2.00%
2017-11,הדרום,34,מ.א. שפיר,מועצה איזורית,140,66,74,16,124,44,137,0,2.75%
2017-11,הדרום,51,מ.א. תמר,מועצה איזורית,7,1,6,2,5,2,6,0,0.92%
2017-11,הדרום,1268,מיתר,יישוב,62,27,35,21,41,6,58,0,1.18%
2017-11,הדרום,99,מצפה רמון,יישוב,218,78,140,17,201,133,206,13,7.43%
2017-11,הדרום,246,נתיבות,יישוב,908,412,496,63,845,399,843,36,5.13%
2017-11,הדרום,666,עומר,יישוב,54,21,33,18,36,4,52,0,1.23%
2017-11,הדרום,2560,ערד,יישוב,653,276,377,74,579,314,615,26,4.83%
2017-11,הדרום,1192,ערערה-בנגב,יישוב,1037,443,594,6,1031,936,1016,17,19.57%
2017-11,הדרום,2630,קריית גת,יישוב,1519,680,839,106,1413,613,1460,44,4.99%
2017-11,הדרום,1034,קריית מלאכי,יישוב,730,324,406,15,715,277,700,49,5.65%
2017-11,הדרום,1161,רהט,יישוב,2139,897,1242,10,2129,1609,2111,42,9.39%
2017-11,הדרום,1286,שגב-שלום,יישוב,338,131,207,1,337,265,328,6,10.11%
2017-11,הדרום,1031,שדרות,יישוב,908,423,485,60,848,455,834,33,5.62%
2017-11,הדרום,1054,תל שבע,יישוב,715,323,392,2,713,614,678,7,11.75%
2017-11,המרכז,1066,"בני עי""ש",יישוב,142,62,80,23,119,38,137,3,3.41%
2017-11,המרכז,182,אבן יהודה,יישוב,139,56,83,43,96,20,137,1,1.96%
2017-11,המרכז,41,אליכין,יישוב,56,24,32,10,46,12,54,0,2.75%
2017-11,המרכז,1309,אלעד,יישוב,346,138,208,23,323,31,337,2,2.37%
2017-11,המרכז,2530,באר יעקב,יישוב,280,118,162,69,211,28,276,4,2.14%
2017-11,המרכז,466,בית דגן,יישוב,87,39,48,12,75,24,84,1,2.25%
2017-11,המרכז,681,גבעת שמואל,יישוב,236,118,118,89,147,32,231,2,1.85%
2017-11,המרכז,2550,גדרה,יישוב,318,133,185,73,245,61,312,4,2.40%
2017-11,המרכז,627,ג'לג'וליה,יישוב,81,39,42,3,78,38,77,1,1.79%
2017-11,המרכז,166,גן יבנה,יישוב,279,111,168,45,234,58,272,2,2.14%
2017-11,המרכז,229,גני תקווה,יישוב,185,88,97,78,107,28,184,0,1.91%
2017-11,המרכז,9700,הוד השרון,יישוב,669,293,376,308,361,25,664,10,2.03%
2017-11,המרכז,1290,זמר,יישוב,125,47,78,5,120,77,121,5,3.69%
2017-11,המרכז,2730,טייבה,יישוב,884,410,474,20,864,629,738,15,3.82%
2017-11,המרכז,2720,טירה,יישוב,179,84,95,17,162,50,169,12,1.35%
2017-11,המרכז,2660,יבנה,יישוב,706,334,372,145,561,135,696,29,2.76%
2017-11,המרכז,9400,יהוד,יישוב,355,159,196,98,257,36,346,9,2.12%
2017-11,המרכז,1224,כוכב יאיר,יישוב,64,24,40,44,20,0,64,0,1.16%
2017-11,המרכז,633,כפר ברא,יישוב,17,9,8,2,15,4,16,2,0.99%
2017-11,המרכז,168,כפר יונה,יישוב,308,132,176,61,247,41,303,4,2.58%
2017-11,המרכז,6900,כפר סבא,יישוב,1073,470,603,411,662,87,1055,22,1.99%
2017-11,המרכז,634,כפר קאסם,יישוב,184,92,92,3,181,95,179,6,1.74%
2017-11,המרכז,7000,לוד,יישוב,1596,792,804,119,1477,784,1558,35,4.22%
2017-11,המרכז,28,מ.א. ברנר,מועצה איזורית,49,17,32,30,19,3,49,2,1.21%
2017-11,המרכז,32,מ.א. גדרות,מועצה איזורית,42,19,23,18,24,3,41,0,1.66%
2017-11,המרכז,30,מ.א. גזר,מועצה איזורית,265,113,152,98,167,20,263,0,1.96%
2017-11,המרכז,27,מ.א. גן רווה,מועצה איזורית,45,16,29,24,21,0,45,1,1.50%
2017-11,המרכז,20,מ.א. דרום השרון,מועצה איזורית,311,133,178,156,155,10,309,0,1.91%
2017-11,המרכז,29,מ.א. חבל יבנה,מועצה איזורית,38,13,25,16,22,3,38,0,1.45%
2017-11,המרכז,25,מ.א. חבל מודיעין,מועצה איזורית,206,97,109,66,140,19,203,0,1.85%
2017-11,המרכז,19,מ.א. חוף השרון,מועצה איזורית,100,31,69,47,53,5,98,0,1.76%
2017-11,המרכז,18,מ.א. לב השרון,מועצה איזורית,250,110,140,63,187,25,244,0,2.20%
2017-11,המרכז,31,מ.א. נחל שורק,מועצה איזורית,58,24,34,19,39,5,57,35,1.34%
2017-11,המרכז,16,מ.א. עמק חפר,מועצה איזורית,419,170,249,168,251,18,417,0,2.12%
2017-11,המרכז,40,מ.א. שדות דן,מועצה איזורית,146,67,79,30,116,13,144,0,2.23%
2017-11,המרכז,1200,מודיעין-מכבים-רעות*,יישוב,862,371,491,387,475,38,850,13,1.84%
2017-11,המרכז,28,מזכרת בתיה,יישוב,147,65,82,52,95,21,143,2,1.76%
2017-11,המרכז,7200,נס ציונה,יישוב,611,290,321,173,438,124,600,8,2.42%
2017-11,המרכז,7400,נתניה,יישוב,3800,1814,1986,468,3332,1071,3711,84,3.42%
2017-11,המרכז,587,סביון*,יישוב,26,9,17,16,10,0,26,0,1.24%
2017-11,המרכז,171,פרדסייה,יישוב,79,33,46,22,57,5,78,1,2.07%
2017-11,המרכז,7900,פתח תקווה,יישוב,3556,1640,1916,694,2862,779,3461,50,2.68%
2017-11,המרכז,195,קדימה-צורן,יישוב,244,125,119,77,167,25,240,2,2.05%
2017-11,המרכז,638,קלנסווה,יישוב,323,169,154,7,316,211,282,12,2.91%
2017-11,המרכז,469,קריית עקרון,יישוב,200,97,103,25,175,79,192,6,3.16%
2017-11,המרכז,2640,ראש העין,יישוב,796,363,433,176,620,112,778,11,2.51%
2017-11,המרכז,8300,ראשון לציון,יישוב,3667,1610,2057,769,2898,835,3621,42,2.58%
2017-11,המרכז,8400,רחובות,יישוב,2058,910,1148,539,1519,580,1989,53,2.80%
2017-11,המרכז,8500,רמלה,יישוב,1407,667,740,93,1314,511,1353,61,3.48%
2017-11,המרכז,8700,רעננה,יישוב,667,301,366,314,353,42,661,5,1.75%
2017-11,המרכז,1304,שוהם,יישוב,169,72,97,80,89,7,168,1,1.39%
2017-11,המרכז,154,תל מונד,יישוב,153,64,89,46,107,18,153,0,2.21%
2017-11,הצפון,473,אבו סנאן,יישוב,501,216,285,5,496,375,494,8,7.82%
2017-11,הצפון,478,אכסאל,יישוב,409,185,224,14,395,344,405,2,6.35%
2017-11,הצפון,529,אעבלין,יישוב,394,184,210,10,384,299,388,4,6.24%
2017-11,הצפון,482,בועיינה-נוג'ידאת,יישוב,216,112,104,7,209,163,212,3,4.92%
2017-11,הצפון,4001,בוקעאתא,יישוב,347,117,230,6,341,287,330,0,10.86%
2017-11,הצפון,998,ביר אל-מכסור,יישוב,246,107,139,1,245,191,241,2,5.80%
2017-11,הצפון,480,בית ג'ן,יישוב,374,102,272,10,364,237,360,0,5.99%
2017-11,הצפון,9200,בית שאן,יישוב,670,306,364,21,649,281,645,41,6.11%
2017-11,הצפון,944,בסמת טבעון,יישוב,138,60,78,2,136,96,129,3,3.59%
2017-11,הצפון,483,בענה,יישוב,299,132,167,5,294,251,285,2,7.35%
2017-11,הצפון,1292,ג'דיידה-מכר,יישוב,1009,449,560,3,1006,763,990,16,9.60%
2017-11,הצפון,485,ג'ולס,יישוב,161,46,115,4,157,97,161,2,4.92%
2017-11,הצפון,487,ג'ש (גוש חלב),יישוב,48,19,29,8,40,24,47,2,2.75%
2017-11,הצפון,489,דבורייה,יישוב,250,113,137,16,234,176,244,3,5.14%
2017-11,הצפון,490,דייר אל-אסד,יישוב,310,143,167,10,300,230,305,2,5.30%
2017-11,הצפון,492,דייר חנא,יישוב,483,217,266,15,468,352,481,6,9.08%
2017-11,הצפון,975,זרזיר,יישוב,196,78,118,3,193,121,194,6,5.39%
2017-11,הצפון,496,חורפיש,יישוב,85,31,54,4,81,46,79,1,2.60%
2017-11,הצפון,2034,חצור הגלילית,יישוב,251,100,151,17,234,110,236,3,4.81%
2017-11,הצפון,6700,טבריה,יישוב,1378,652,726,84,1294,616,1203,66,5.38%
2017-11,הצפון,962,טובא-זנגרייה,יישוב,302,133,169,5,297,211,291,4,8.51%
2017-11,הצפון,498,טורעאן,יישוב,305,145,160,8,297,250,294,7,4.66%
2017-11,הצפון,8900,טמרה,יישוב,1168,555,613,14,1154,932,1147,12,7.38%
2017-11,הצפון,1295,יאנוח-ג'ת,יישוב,106,36,70,1,105,64,103,2,3.23%
2017-11,הצפון,46,יבנאל,יישוב,83,47,36,5,78,52,69,0,4.36%
2017-11,הצפון,29,יסוד המעלה,יישוב,22,8,14,4,18,5,22,0,2.49%
2017-11,הצפון,499,יפיע,יישוב,478,201,277,19,459,347,470,5,5.43%
2017-11,הצפון,240,יקנעם עילית,יישוב,403,174,229,91,312,93,393,18,3.05%
2017-11,הצפון,502,ירכא,יישוב,352,139,213,0,352,242,347,1,4.95%
2017-11,הצפון,504,כאבול,יישוב,399,198,201,6,393,324,387,3,7.13%
2017-11,הצפון,505,כאוכב אבו אל-היג'א,יישוב,176,68,108,7,169,138,176,0,9.30%
2017-11,הצפון,1296,כסרא-סמיע,יישוב,171,50,121,5,166,105,163,6,4.19%
2017-11,הצפון,978,כעביה-טבאש-חג'אג'רה,יישוב,156,69,87,6,150,108,153,3,5.91%
2017-11,הצפון,1263,כפר ורדים,יישוב,54,19,35,25,29,5,53,3,1.71%
2017-11,הצפון,507,כפר יאסיף,יישוב,337,153,184,3,334,236,325,3,6.01%
2017-11,הצפון,508,כפר כמא,יישוב,40,14,26,3,37,17,40,0,2.31%
2017-11,הצפון,509,כפר כנא,יישוב,647,317,330,14,633,524,621,13,6.42%
2017-11,הצפון,510,כפר מנדא,יישוב,564,318,246,9,555,413,554,3,6.91%
2017-11,הצפון,47,כפר תבור,יישוב,51,20,31,17,34,3,51,1,2.15%
2017-11,הצפון,1139,כרמיאל,יישוב,1385,564,821,280,1105,636,1269,35,4.89%
2017-11,הצפון,65,מ.א. אל-בטוף,מועצה איזורית,237,107,130,15,222,177,227,0,6.97%
2017-11,הצפון,66,מ.א. בוסתן אל-מרג,מועצה איזורית,30,7,23,0,30,29,30,1,0.85%
2017-11,הצפון,71,מ.א. גולן,מועצה איזורית,182,78,104,61,121,17,179,0,2.04%
2017-11,הצפון,8,מ.א. הגלבוע,מועצה איזורית,573,253,320,57,516,284,565,0,4.00%
2017-11,הצפון,1,מ.א. הגליל העליון,מועצה איזורית,206,80,126,71,135,20,203,0,2.27%
2017-11,הצפון,3,מ.א. הגליל התחתון,מועצה איזורית,118,50,68,42,76,7,116,0,1.93%
2017-11,הצפון,55,מ.א. מבואות החרמון,מועצה איזורית,114,48,66,26,88,21,113,0,2.82%
2017-11,הצפון,13,מ.א. מגידו,מועצה איזורית,86,37,49,35,51,7,85,0,1.50%
2017-11,הצפון,4,מ.א. מטה אשר,מועצה איזורית,481,208,273,103,378,155,469,0,3.30%
2017-11,הצפון,52,מ.א. מעלה יוסף,מועצה איזורית,178,77,101,23,155,35,172,0,3.00%
2017-11,הצפון,2,מ.א. מרום הגליל,מועצה איזורית,227,104,123,28,199,88,221,0,3.10%
2017-11,הצפון,56,מ.א. משגב,מועצה איזורית,497,195,302,92,405,257,486,0,3.44%
2017-11,הצפון,6,מ.א. עמק הירדן,מועצה איזורית,189,101,88,48,141,33,180,0,2.65%
2017-11,הצפון,7,מ.א. עמק המעיינות,מועצה איזורית,158,62,96,35,123,36,150,0,2.29%
2017-11,הצפון,9,מ.א. עמק יזרעאל,מועצה איזורית,374,170,204,192,182,30,366,0,1.87%
2017-11,הצפון,481,מגאר,יישוב,1082,456,626,17,1065,864,1048,4,9.78%
2017-11,הצפון,516,מג'ד אל-כרום,יישוב,412,191,221,11,401,282,402,8,5.46%
2017-11,הצפון,65,מגדל,יישוב,34,17,17,1,33,13,32,0,3.21%
2017-11,הצפון,874,מגדל העמק,יישוב,790,344,446,86,704,281,731,59,5.32%
2017-11,הצפון,4201,מג'דל שמס,יישוב,378,144,234,12,366,289,359,3,6.80%
2017-11,הצפון,517,מזרעה,יישוב,152,71,81,3,149,101,147,2,6.80%
2017-11,הצפון,43,מטולה,יישוב,28,8,20,9,19,5,25,0,2.48%
2017-11,הצפון,4203,מסעדה,יישוב,200,71,129,6,194,160,189,2,10.27%
2017-11,הצפון,518,מעיליא,יישוב,46,25,21,6,40,19,44,4,2.57%
2017-11,הצפון,1063,מעלות-תרשיחא,יישוב,696,335,361,81,615,331,653,38,5.35%
2017-11,הצפון,520,משהד,יישוב,169,84,85,11,158,127,161,2,4.49%
2017-11,הצפון,9100,נהרייה,יישוב,1659,776,883,200,1459,821,1568,43,4.95%
2017-11,הצפון,522,נחף,יישוב,325,153,172,12,313,249,317,2,5.67%
2017-11,הצפון,7300,נצרת,יישוב,2433,1095,1338,96,2337,1810,2407,21,6.53%
2017-11,הצפון,1061,נצרת עילית,יישוב,1287,609,678,125,1162,596,1134,93,4.83%
2017-11,הצפון,525,סאג'ור,יישוב,98,37,61,7,91,67,95,1,4.38%
2017-11,הצפון,7500,סח'נין,יישוב,1497,651,846,30,1467,1223,1483,12,9.61%
2017-11,הצפון,4501,ע'ג'ר,יישוב,75,33,42,1,74,52,73,0,6.11%
2017-11,הצפון,530,עיילבון,יישוב,130,67,63,3,127,71,125,0,4.33%
2017-11,הצפון,511,עילוט,יישוב,238,101,137,4,234,189,235,0,7.33%
2017-11,הצפון,532,עין מאהל,יישוב,334,171,163,7,327,266,324,3,5.53%
2017-11,הצפון,4502,עין קנייא,יישוב,147,61,86,6,141,104,143,0,12.46%
2017-11,הצפון,7600,עכו,יישוב,2507,1139,1368,134,2373,1825,2406,38,8.87%
2017-11,הצפון,7700,עפולה,יישוב,1411,576,835,167,1244,505,1329,68,4.84%
2017-11,הצפון,531,עראבה,יישוב,1078,460,618,24,1054,894,1066,4,9.48%
2017-11,הצפון,535,פסוטה,יישוב,82,39,43,9,73,38,79,2,4.39%
2017-11,הצפון,536,פקיעין (בוקייעה),יישוב,117,57,60,7,110,69,111,0,3.70%
2017-11,הצפון,8000,צפת,יישוב,955,489,466,95,860,578,892,21,6.39%
2017-11,הצפון,4100,קצרין,יישוב,173,76,97,28,145,71,164,5,4.10%
2017-11,הצפון,2800,קריית שמונה,יישוב,661,327,334,78,583,258,641,29,4.93%
2017-11,הצפון,543,ראמה,יישוב,223,95,128,10,213,156,216,2,5.26%
2017-11,הצפון,26,ראש פינה,יישוב,52,17,35,9,43,20,51,0,3.08%
2017-11,הצפון,542,ריינה,יישוב,387,187,200,6,381,305,376,6,5.09%
2017-11,הצפון,122,רמת ישי,יישוב,101,43,58,36,65,12,100,1,2.41%
2017-11,הצפון,913,שבלי - אום אל-גנם,יישוב,167,74,93,4,163,99,165,2,5.79%
2017-11,הצפון,812,שלומי,יישוב,207,81,126,21,186,99,199,3,5.43%
2017-11,הצפון,538,שעב,יישוב,353,161,192,1,352,285,350,4,10.43%
2017-11,הצפון,8800,שפרעם,יישוב,1198,509,689,37,1161,896,1175,21,6.02%
2017-11,חיפה,1326,"בסמ""ה",יישוב,328,150,178,4,324,251,321,6,7.14%
2017-11,חיפה,2710,אום אל-פחם,יישוב,2454,999,1455,27,2427,2006,2404,28,10.28%
2017-11,חיפה,1020,אור עקיבא,יישוב,443,180,263,37,406,119,422,14,4.01%
2017-11,חיפה,6000,באקה אל-גרביה,יישוב,533,254,279,15,518,320,523,22,4.01%
2017-11,חיפה,9800,בנימינה-גבעת עדה*,יישוב,166,79,87,68,98,29,163,5,2.17%
2017-11,חיפה,541,ג'סר א-זרקא,יישוב,233,133,100,1,232,100,230,12,3.58%
2017-11,חיפה,628,ג'ת,יישוב,196,103,93,14,182,111,193,6,3.33%
2017-11,חיפה,494,דאלית אל-כרמל,יישוב,392,151,241,15,377,209,369,4,4.21%
2017-11,חיפה,9300,זכרון יעקב,יישוב,258,120,138,110,148,30,255,3,2.23%
2017-11,חיפה,6500,חדרה,יישוב,1973,905,1068,237,1736,607,1867,41,3.60%
2017-11,חיפה,4000,חיפה,יישוב,5099,2473,2626,1074,4025,2338,4782,107,3.39%
2017-11,חיפה,1247,חריש,יישוב,117,46,71,33,84,17,115,3,2.70%
2017-11,חיפה,2100,טירת כרמל,יישוב,659,312,347,44,615,314,634,12,5.16%
2017-11,חיפה,654,כפר קרע,יישוב,367,168,199,27,340,221,359,4,3.82%
2017-11,חיפה,45,מ.א. אלונה,מועצה איזורית,26,9,17,11,15,2,26,0,2.44%
2017-11,חיפה,12,מ.א. זבולון,מועצה איזורית,209,110,99,18,191,107,203,0,3.42%
2017-11,חיפה,15,מ.א. חוף הכרמל,מועצה איזורית,310,126,184,118,192,43,301,1,2.03%
2017-11,חיפה,14,מ.א. מנשה,מועצה איזורית,226,86,140,68,158,48,222,0,2.58%
2017-11,חיפה,1327,מעלה עירון,יישוב,608,250,358,9,599,473,595,2,9.07%
2017-11,חיפה,2500,נשר,יישוב,384,201,183,69,315,129,371,7,2.92%
2017-11,חיפה,534,עספיא,יישוב,340,150,190,14,326,163,317,9,5.14%
2017-11,חיפה,637,ערערה,יישוב,482,204,278,16,466,308,472,13,5.23%
2017-11,חיפה,537,פוריידיס,יישוב,217,129,88,7,210,67,216,3,3.55%
2017-11,חיפה,7800,פרדס חנה-כרכור,יישוב,712,317,395,174,538,118,697,18,3.24%
2017-11,חיפה,6800,קריית אתא,יישוב,1300,608,692,105,1195,576,1262,31,4.08%
2017-11,חיפה,9500,קריית ביאליק,יישוב,836,355,481,100,736,322,811,19,3.79%
2017-11,חיפה,2300,קריית טבעון,יישוב,180,84,96,81,99,21,175,0,2.08%
2017-11,חיפה,9600,קריית ים,יישוב,1221,565,656,101,1120,615,1176,31,5.52%
2017-11,חיפה,8200,קריית מוצקין,יישוב,811,370,441,124,687,309,788,19,3.39%
2017-11,חיפה,922,רכסים,יישוב,147,62,85,10,137,60,127,1,3.39%
2017-11,ירושלים,472,אבו גוש,יישוב,209,105,104,7,202,155,207,1,5.96%
2017-11,ירושלים,2610,בית שמש,יישוב,1149,505,644,91,1058,366,1095,34,2.93%
2017-11,ירושלים,3000,ירושלים,יישוב,10760,4792,5968,1311,9449,6191,10456,112,3.27%
2017-11,ירושלים,26,מ.א. מטה יהודה,מועצה איזורית,502,239,263,136,366,94,491,0,1.90%
2017-11,ירושלים,1015,מבשרת ציון,יישוב,293,149,144,61,232,87,287,2,2.25%
2017-11,ירושלים,1137,קריית יערים,יישוב,42,16,26,11,31,13,42,0,2.36%
2017-11,תל אביב,2400,אור יהודה,יישוב,634,292,342,46,588,125,607,30,3.15%
2017-11,תל אביב,565,אזור,יישוב,181,88,93,29,152,23,177,0,2.64%
2017-11,תל אביב,6100,בני ברק,יישוב,1663,802,861,99,1564,558,1554,19,2.57%
2017-11,תל אביב,6200,בת ים,יישוב,2527,1228,1299,362,2165,818,2387,85,3.38%
2017-11,תל אביב,6300,גבעתיים,יישוב,758,329,429,352,406,74,750,6,2.35%
2017-11,תל אביב,6400,הרצלייה,יישוב,1008,472,536,343,665,54,1001,13,2.04%
2017-11,תל אביב,6600,חולון,יישוב,2826,1252,1574,503,2323,543,2749,64,2.73%
2017-11,תל אביב,267,כפר שמריהו,יישוב,5,1,4,3,2,0,5,0,0.60%
2017-11,תל אביב,2620,קריית אונו,יישוב,403,173,230,188,215,31,400,7,2.04%
2017-11,תל אביב,8600,רמת גן,יישוב,1931,869,1062,678,1253,282,1892,25,2.32%
2017-11,תל אביב,2650,רמת השרון,יישוב,383,150,233,185,198,15,380,3,1.66%
2017-11,תל אביב,5000,תל אביב -יפו,יישוב,6842,3433,3409,2661,4181,1292,6731,66,2.56%
2017-12,אזור יהודה והשומרון,3760,אורנית,יישוב,94,43,51,36,58,1,93,0,1.85%
2017-12,אזור יהודה והשומרון,3750,אלפי מנשה,יישוב,64,26,38,21,43,0,64,1,1.45%
2017-12,אזור יהודה והשומרון,3560,אלקנה,יישוב,29,16,13,15,14,2,28,0,1.52%
2017-12,אזור יהודה והשומרון,3650,אפרת,יישוב,56,37,19,27,29,3,56,0,1.14%
2017-12,אזור יהודה והשומרון,3570,אריאל,יישוב,259,121,138,50,209,27,254,7,2.32%
2017-12,אזור יהודה והשומרון,3574,בית אל,יישוב,42,28,14,11,31,10,42,1,1.68%
2017-12,אזור יהודה והשומרון,3652,בית אריה,יישוב,55,21,34,15,40,1,55,0,1.91%
2017-12,אזור יהודה והשומרון,3780,ביתר עילית,יישוב,465,208,257,15,450,139,457,2,2.94%
2017-12,אזור יהודה והשומרון,3730,גבעת זאב,יישוב,161,84,77,36,125,26,160,3,1.98%
2017-12,אזור יהודה והשומרון,3769,הר אדר,יישוב,37,16,21,17,20,2,37,0,1.69%
2017-12,אזור יהודה והשומרון,76,מ.א. גוש עציון,מועצה איזורית,189,94,95,71,118,14,184,0,1.81%
2017-12,אזור יהודה והשומרון,78,מ.א. הר חברון,מועצה איזורית,72,39,33,33,39,2,72,0,1.82%
2017-12,אזור יהודה והשומרון,74,מ.א. מגילות ים המלח,מועצה איזורית,29,8,21,12,17,0,29,0,3.16%
2017-12,אזור יהודה והשומרון,73,מ.א. מטה בנימין,מועצה איזורית,535,281,254,180,355,81,529,0,1.86%
2017-12,אזור יהודה והשומרון,75,מ.א. ערבות הירדן,מועצה איזורית,49,20,29,13,36,5,48,0,1.87%
2017-12,אזור יהודה והשומרון,72,מ.א. שומרון,מועצה איזורית,393,190,203,148,245,24,390,0,2.06%
2017-12,אזור יהודה והשומרון,3797,מודיעין עילית,יישוב,415,133,282,31,384,33,407,4,2.54%
2017-12,אזור יהודה והשומרון,3616,מעלה אדומים,יישוב,528,254,274,88,440,129,517,14,2.48%
2017-12,אזור יהודה והשומרון,3608,מעלה אפרים,יישוב,29,13,16,2,27,6,29,1,3.63%
2017-12,אזור יהודה והשומרון,3660,עמנואל,יישוב,48,26,22,3,45,24,45,2,3.32%
2017-12,אזור יהודה והשומרון,3557,קדומים,יישוב,34,18,16,15,19,2,34,1,1.70%
2017-12,אזור יהודה והשומרון,3611,קריית ארבע,יישוב,72,38,34,12,60,34,70,5,2.09%
2017-12,אזור יהודה והשומרון,3640,קרני שומרון,יישוב,69,35,34,27,42,3,68,2,1.68%
2017-12,הדרום,31,אופקים,יישוב,758,344,414,51,707,370,733,34,5.10%
2017-12,הדרום,2600,אילת,יישוב,922,494,428,47,875,281,864,49,2.51%
2017-12,הדרום,70,אשדוד,יישוב,4802,2071,2731,650,4152,2048,4560,99,4.07%
2017-12,הדרום,7100,אשקלון,יישוב,3220,1425,1795,369,2851,1371,2909,66,3.93%
2017-12,הדרום,9000,באר שבע,יישוב,5318,2492,2826,768,4550,2585,5004,86,4.66%
2017-12,הדרום,2200,דימונה,יישוב,1613,761,852,82,1531,1029,1525,27,7.81%
2017-12,הדרום,1303,חורה,יישוב,478,191,287,2,476,410,463,3,9.66%
2017-12,הדרום,831,ירוחם,יישוב,357,181,176,13,344,199,326,18,6.40%
2017-12,הדרום,1059,כסיפה,יישוב,968,371,597,3,965,878,951,6,17.51%
2017-12,הדרום,1271,להבים,יישוב,36,15,21,20,16,3,36,0,1.02%
2017-12,הדרום,1060,לקיה,יישוב,567,264,303,5,562,487,537,4,11.05%
2017-12,הדרום,69,מ.א. אל קסום,מועצה איזורית,578,232,346,4,574,498,563,0,16.52%
2017-12,הדרום,38,מ.א. אשכול,מועצה איזורית,118,58,60,32,86,9,117,0,1.67%
2017-12,הדרום,33,מ.א. באר טוביה,מועצה איזורית,275,114,161,53,222,48,269,0,2.37%
2017-12,הדרום,41,מ.א. בני שמעון,מועצה איזורית,78,31,47,28,50,13,76,0,1.57%
2017-12,הדרום,54,מ.א. הערבה התיכונה,מועצה איזורית,25,12,13,10,15,0,25,0,1.31%
2017-12,הדרום,53,מ.א. חבל אילות,מועצה איזורית,19,8,11,3,16,0,18,1,0.73%
2017-12,הדרום,36,מ.א. חוף אשקלון,מועצה איזורית,205,87,118,36,169,39,200,0,2.30%
2017-12,הדרום,35,מ.א. יואב,מועצה איזורית,77,29,48,26,51,8,77,0,1.88%
2017-12,הדרום,50,מ.א. לכיש,מועצה איזורית,143,68,75,25,118,34,141,0,2.53%
2017-12,הדרום,42,מ.א. מרחבים,מועצה איזורית,165,64,101,29,136,31,160,0,2.54%
2017-12,הדרום,68,מ.א. נווה מדבר,מועצה איזורית,124,45,79,1,123,97,120,0,6.35%
2017-12,הדרום,48,מ.א. רמת נגב,מועצה איזורית,280,136,144,21,259,207,270,0,8.12%
2017-12,הדרום,39,מ.א. שדות נגב,מועצה איזורית,111,58,53,23,88,32,108,0,2.22%
2017-12,הדרום,37,מ.א. שער הנגב,מועצה איזורית,85,33,52,36,49,14,81,1,2.03%
2017-12,הדרום,34,מ.א. שפיר,מועצה איזורית,124,62,62,13,111,40,123,0,2.47%
2017-12,הדרום,51,מ.א. תמר,מועצה איזורית,9,2,7,1,8,3,8,0,1.23%
2017-12,הדרום,1268,מיתר,יישוב,59,31,28,26,33,5,56,0,1.14%
2017-12,הדרום,99,מצפה רמון,יישוב,213,77,136,15,198,138,206,12,7.43%
2017-12,הדרום,246,נתיבות,יישוב,880,419,461,53,827,377,818,50,4.99%
2017-12,הדרום,666,עומר,יישוב,54,26,28,21,33,3,53,0,1.26%
2017-12,הדרום,2560,ערד,יישוב,632,282,350,73,559,309,600,20,4.72%
2017-12,הדרום,1192,ערערה-בנגב,יישוב,1022,445,577,6,1016,926,998,14,19.29%
2017-12,הדרום,2630,קריית גת,יישוב,1487,673,814,101,1386,591,1424,40,4.87%
2017-12,הדרום,1034,קריית מלאכי,יישוב,682,293,389,13,669,269,652,52,5.28%
2017-12,הדרום,1161,רהט,יישוב,2081,886,1195,10,2071,1563,2058,59,9.17%
2017-12,הדרום,1286,שגב-שלום,יישוב,332,136,196,2,330,262,320,2,9.89%
2017-12,הדרום,1031,שדרות,יישוב,886,417,469,46,840,451,810,32,5.46%
2017-12,הדרום,1054,תל שבע,יישוב,712,320,392,4,708,611,672,8,11.66%
2017-12,המרכז,1066,"בני עי""ש",יישוב,138,61,77,21,117,39,133,5,3.31%
2017-12,המרכז,182,אבן יהודה,יישוב,138,56,82,48,90,20,136,2,1.95%
2017-12,המרכז,41,אליכין,יישוב,56,25,31,9,47,12,54,0,2.75%
2017-12,המרכז,1309,אלעד,יישוב,317,124,193,24,293,25,307,5,2.16%
2017-12,המרכז,2530,באר יעקב,יישוב,286,121,165,66,220,31,281,4,2.18%
2017-12,המרכז,466,בית דגן,יישוב,90,44,46,8,82,24,87,1,2.33%
2017-12,המרכז,681,גבעת שמואל,יישוב,231,119,112,89,142,32,226,2,1.81%
2017-12,המרכז,2550,גדרה,יישוב,305,126,179,80,225,59,298,6,2.30%
2017-12,המרכז,627,ג'לג'וליה,יישוב,81,37,44,3,78,38,79,1,1.84%
2017-12,המרכז,166,גן יבנה,יישוב,274,112,162,37,237,58,268,1,2.11%
2017-12,המרכז,229,גני תקווה,יישוב,189,90,99,74,115,25,187,1,1.94%
2017-12,המרכז,9700,הוד השרון,יישוב,658,278,380,309,349,21,655,9,2.00%
2017-12,המרכז,1290,זמר,יישוב,129,46,83,4,125,83,124,2,3.78%
2017-12,המרכז,2730,טייבה,יישוב,875,405,470,23,852,601,729,34,3.78%
2017-12,המרכז,2720,טירה,יישוב,178,94,84,19,159,48,172,14,1.37%
2017-12,המרכז,2660,יבנה,יישוב,700,320,380,138,562,130,685,33,2.72%
2017-12,המרכז,9400,יהוד,יישוב,363,161,202,95,268,37,353,6,2.16%
2017-12,המרכז,1224,כוכב יאיר,יישוב,56,18,38,37,19,0,56,1,1.01%
2017-12,המרכז,633,כפר ברא,יישוב,20,11,9,2,18,5,20,1,1.24%
2017-12,המרכז,168,כפר יונה,יישוב,310,135,175,59,251,39,306,3,2.60%
2017-12,המרכז,6900,כפר סבא,יישוב,1058,479,579,402,656,68,1038,19,1.96%
2017-12,המרכז,634,כפר קאסם,יישוב,180,91,89,2,178,94,176,1,1.71%
2017-12,המרכז,7000,לוד,יישוב,1587,800,787,131,1456,772,1543,28,4.18%
2017-12,המרכז,28,מ.א. ברנר,מועצה איזורית,50,22,28,31,19,0,50,2,1.23%
2017-12,המרכז,32,מ.א. גדרות,מועצה איזורית,43,20,23,20,23,3,42,0,1.71%
2017-12,המרכז,30,מ.א. גזר,מועצה איזורית,266,110,156,95,171,20,261,0,1.94%
2017-12,המרכז,27,מ.א. גן רווה,מועצה איזורית,48,19,29,26,22,2,48,0,1.60%
2017-12,המרכז,20,מ.א. דרום השרון,מועצה איזורית,322,138,184,146,176,10,318,0,1.97%
2017-12,המרכז,29,מ.א. חבל יבנה,מועצה איזורית,38,11,27,18,20,3,38,0,1.45%
2017-12,המרכז,25,מ.א. חבל מודיעין,מועצה איזורית,209,100,109,79,130,20,201,0,1.83%
2017-12,המרכז,19,מ.א. חוף השרון,מועצה איזורית,102,33,69,46,56,4,102,0,1.83%
2017-12,המרכז,18,מ.א. לב השרון,מועצה איזורית,236,98,138,62,174,22,230,0,2.07%
2017-12,המרכז,31,מ.א. נחל שורק,מועצה איזורית,49,22,27,18,31,5,47,34,1.11%
2017-12,המרכז,16,מ.א. עמק חפר,מועצה איזורית,404,172,232,167,237,18,402,0,2.04%
2017-12,המרכז,40,מ.א. שדות דן,מועצה איזורית,146,68,78,27,119,14,145,0,2.25%
2017-12,המרכז,1200,מודיעין-מכבים-רעות*,יישוב,846,376,470,383,463,38,834,12,1.81%
2017-12,המרכז,28,מזכרת בתיה,יישוב,151,62,89,51,100,24,146,2,1.80%
2017-12,המרכז,7200,נס ציונה,יישוב,617,298,319,173,444,126,604,6,2.44%
2017-12,המרכז,7400,נתניה,יישוב,3768,1807,1961,469,3299,1015,3674,102,3.39%
2017-12,המרכז,587,סביון*,יישוב,26,8,18,15,11,0,26,0,1.24%
2017-12,המרכז,171,פרדסייה,יישוב,80,38,42,18,62,5,79,2,2.10%
2017-12,המרכז,7900,פתח תקווה,יישוב,3449,1577,1872,717,2732,784,3354,60,2.60%
2017-12,המרכז,195,קדימה-צורן,יישוב,250,126,124,85,165,26,246,4,2.10%
2017-12,המרכז,638,קלנסווה,יישוב,316,164,152,12,304,212,276,5,2.85%
2017-12,המרכז,469,קריית עקרון,יישוב,206,98,108,29,177,84,198,8,3.26%
2017-12,המרכז,2640,ראש העין,יישוב,766,354,412,171,595,110,752,4,2.43%
2017-12,המרכז,8300,ראשון לציון,יישוב,3602,1603,1999,775,2827,823,3552,49,2.53%
2017-12,המרכז,8400,רחובות,יישוב,2019,902,1117,553,1466,587,1952,40,2.75%
2017-12,המרכז,8500,רמלה,יישוב,1341,637,704,92,1249,504,1287,45,3.32%
2017-12,המרכז,8700,רעננה,יישוב,646,302,344,307,339,29,643,4,1.70%
2017-12,המרכז,1304,שוהם,יישוב,183,77,106,83,100,6,182,2,1.50%
2017-12,המרכז,154,תל מונד,יישוב,148,66,82,42,106,14,148,1,2.14%
2017-12,הצפון,473,אבו סנאן,יישוב,532,233,299,4,528,385,523,4,8.25%
2017-12,הצפון,478,אכסאל,יישוב,402,184,218,15,387,330,398,1,6.25%
2017-12,הצפון,529,אעבלין,יישוב,399,183,216,12,387,294,391,3,6.28%
2017-12,הצפון,482,בועיינה-נוג'ידאת,יישוב,208,108,100,7,201,156,206,2,4.79%
2017-12,הצפון,4001,בוקעאתא,יישוב,348,119,229,4,344,287,333,0,10.95%
2017-12,הצפון,998,ביר אל-מכסור,יישוב,250,107,143,1,249,186,246,4,5.92%
2017-12,הצפון,480,בית ג'ן,יישוב,372,106,266,8,364,231,361,1,6.00%
2017-12,הצפון,9200,בית שאן,יישוב,641,291,350,24,617,278,615,36,5.85%
2017-12,הצפון,944,בסמת טבעון,יישוב,149,72,77,2,147,101,138,2,3.83%
2017-12,הצפון,483,בענה,יישוב,296,135,161,6,290,250,284,1,7.33%
2017-12,הצפון,1292,ג'דיידה-מכר,יישוב,1007,444,563,4,1003,764,984,5,9.55%
2017-12,הצפון,485,ג'ולס,יישוב,155,42,113,3,152,90,155,2,4.75%
2017-12,הצפון,487,ג'ש (גוש חלב),יישוב,47,21,26,5,42,25,46,3,2.69%
2017-12,הצפון,489,דבורייה,יישוב,251,115,136,16,235,178,246,4,5.18%
2017-12,הצפון,490,דייר אל-אסד,יישוב,310,143,167,11,299,226,304,3,5.29%
2017-12,הצפון,492,דייר חנא,יישוב,482,219,263,14,468,347,480,3,9.07%
2017-12,הצפון,975,זרזיר,יישוב,189,77,112,2,187,121,187,1,5.21%
2017-12,הצפון,496,חורפיש,יישוב,83,31,52,4,79,46,75,1,2.47%
2017-12,הצפון,2034,חצור הגלילית,יישוב,237,100,137,16,221,112,221,1,4.52%
2017-12,הצפון,6700,טבריה,יישוב,1306,640,666,80,1226,614,1141,60,5.11%
2017-12,הצפון,962,טובא-זנגרייה,יישוב,297,134,163,3,294,209,284,3,8.32%
2017-12,הצפון,498,טורעאן,יישוב,293,142,151,9,284,233,283,6,4.49%
2017-12,הצפון,8900,טמרה,יישוב,1163,552,611,12,1151,931,1141,16,7.34%
2017-12,הצפון,1295,יאנוח-ג'ת,יישוב,106,34,72,1,105,61,102,3,3.20%
2017-12,הצפון,46,יבנאל,יישוב,80,45,35,6,74,49,65,3,4.11%
2017-12,הצפון,29,יסוד המעלה,יישוב,22,6,16,6,16,5,22,0,2.49%
2017-12,הצפון,499,יפיע,יישוב,466,199,267,24,442,334,462,5,5.34%
2017-12,הצפון,240,יקנעם עילית,יישוב,385,178,207,90,295,88,375,25,2.91%
2017-12,הצפון,502,ירכא,יישוב,348,138,210,0,348,224,342,3,4.88%
2017-12,הצפון,504,כאבול,יישוב,396,202,194,7,389,320,385,3,7.10%
2017-12,הצפון,505,כאוכב אבו אל-היג'א,יישוב,186,75,111,6,180,140,186,2,9.77%
2017-12,הצפון,1296,כסרא-סמיע,יישוב,171,56,115,4,167,104,163,7,4.19%
2017-12,הצפון,978,כעביה-טבאש-חג'אג'רה,יישוב,165,61,104,5,160,100,160,5,6.16%
2017-12,הצפון,1263,כפר ורדים,יישוב,53,18,35,18,35,5,51,0,1.64%
2017-12,הצפון,507,כפר יאסיף,יישוב,324,151,173,1,323,225,317,4,5.87%
2017-12,הצפון,508,כפר כמא,יישוב,39,13,26,3,36,16,39,0,2.26%
2017-12,הצפון,509,כפר כנא,יישוב,638,318,320,18,620,516,612,14,6.34%
2017-12,הצפון,510,כפר מנדא,יישוב,555,308,247,11,544,403,547,1,6.83%
2017-12,הצפון,47,כפר תבור,יישוב,49,23,26,17,32,2,49,0,2.06%
2017-12,הצפון,1139,כרמיאל,יישוב,1351,567,784,267,1084,625,1238,36,4.77%
2017-12,הצפון,65,מ.א. אל-בטוף,מועצה איזורית,233,110,123,16,217,166,223,1,6.85%
2017-12,הצפון,66,מ.א. בוסתן אל-מרג,מועצה איזורית,25,6,19,0,25,23,25,0,0.71%
2017-12,הצפון,71,מ.א. גולן,מועצה איזורית,184,80,104,60,124,15,181,0,2.06%
2017-12,הצפון,8,מ.א. הגלבוע,מועצה איזורית,545,236,309,57,488,279,538,0,3.81%
2017-12,הצפון,1,מ.א. הגליל העליון,מועצה איזורית,192,81,111,64,128,13,191,0,2.13%
2017-12,הצפון,3,מ.א. הגליל התחתון,מועצה איזורית,110,49,61,36,74,5,109,0,1.81%
2017-12,הצפון,55,מ.א. מבואות החרמון,מועצה איזורית,117,53,64,28,89,18,114,0,2.85%
2017-12,הצפון,13,מ.א. מגידו,מועצה איזורית,83,39,44,36,47,6,83,0,1.47%
2017-12,הצפון,4,מ.א. מטה אשר,מועצה איזורית,470,211,259,112,358,134,461,0,3.25%
2017-12,הצפון,52,מ.א. מעלה יוסף,מועצה איזורית,177,88,89,22,155,35,172,1,3.00%
2017-12,הצפון,2,מ.א. מרום הגליל,מועצה איזורית,218,98,120,30,188,78,214,0,3.00%
2017-12,הצפון,56,מ.א. משגב,מועצה איזורית,506,201,305,101,405,253,492,0,3.48%
2017-12,הצפון,6,מ.א. עמק הירדן,מועצה איזורית,188,95,93,48,140,31,178,0,2.62%
2017-12,הצפון,7,מ.א. עמק המעיינות,מועצה איזורית,160,64,96,38,122,36,155,0,2.37%
2017-12,הצפון,9,מ.א. עמק יזרעאל,מועצה איזורית,355,168,187,176,179,30,347,0,1.77%
2017-12,הצפון,481,מגאר,יישוב,1059,459,600,14,1045,833,1025,9,9.59%
2017-12,הצפון,516,מג'ד אל-כרום,יישוב,402,191,211,12,390,276,389,6,5.30%
2017-12,הצפון,65,מגדל,יישוב,33,16,17,2,31,11,30,1,3.02%
2017-12,הצפון,874,מגדל העמק,יישוב,766,332,434,80,686,250,711,56,5.18%
2017-12,הצפון,4201,מג'דל שמס,יישוב,380,141,239,12,368,287,361,1,6.83%
2017-12,הצפון,517,מזרעה,יישוב,149,70,79,2,147,100,142,1,6.58%
2017-12,הצפון,43,מטולה,יישוב,27,11,16,8,19,5,24,0,2.38%
2017-12,הצפון,4203,מסעדה,יישוב,204,79,125,6,198,158,193,1,10.46%
2017-12,הצפון,518,מעיליא,יישוב,36,20,16,6,30,15,36,4,2.11%
2017-12,הצפון,1063,מעלות-תרשיחא,יישוב,654,327,327,78,576,332,617,31,5.07%
2017-12,הצפון,520,משהד,יישוב,162,79,83,9,153,124,156,3,4.35%
2017-12,הצפון,9100,נהרייה,יישוב,1622,768,854,189,1433,769,1532,49,4.84%
2017-12,הצפון,522,נחף,יישוב,340,159,181,15,325,252,333,6,5.94%
2017-12,הצפון,7300,נצרת,יישוב,2393,1090,1303,95,2298,1771,2364,10,6.42%
2017-12,הצפון,1061,נצרת עילית,יישוב,1204,576,628,125,1079,552,1079,64,4.61%
2017-12,הצפון,525,סאג'ור,יישוב,111,45,66,6,105,74,108,1,4.95%
2017-12,הצפון,7500,סח'נין,יישוב,1481,654,827,33,1448,1204,1468,17,9.52%
2017-12,הצפון,4501,ע'ג'ר,יישוב,74,33,41,2,72,49,73,0,6.11%
2017-12,הצפון,530,עיילבון,יישוב,130,65,65,3,127,71,126,1,4.36%
2017-12,הצפון,511,עילוט,יישוב,234,101,133,4,230,186,233,0,7.27%
2017-12,הצפון,532,עין מאהל,יישוב,338,174,164,4,334,264,326,2,5.56%
2017-12,הצפון,4502,עין קנייא,יישוב,134,55,79,4,130,100,131,0,11.53%
2017-12,הצפון,7600,עכו,יישוב,2476,1135,1341,135,2341,1767,2373,31,8.76%
2017-12,הצפון,7700,עפולה,יישוב,1396,566,830,163,1233,503,1312,66,4.78%
2017-12,הצפון,531,עראבה,יישוב,1054,449,605,22,1032,871,1045,9,9.31%
2017-12,הצפון,535,פסוטה,יישוב,77,36,41,8,69,39,73,2,4.07%
2017-12,הצפון,536,פקיעין (בוקייעה),יישוב,112,50,62,7,105,67,107,2,3.57%
2017-12,הצפון,8000,צפת,יישוב,918,486,432,96,822,550,860,25,6.18%
2017-12,הצפון,4100,קצרין,יישוב,172,74,98,28,144,68,164,4,4.10%
2017-12,הצפון,2800,קריית שמונה,יישוב,640,319,321,72,568,261,616,22,4.75%
2017-12,הצפון,543,ראמה,יישוב,208,89,119,12,196,147,201,3,4.91%
2017-12,הצפון,26,ראש פינה,יישוב,54,16,38,13,41,18,53,0,3.20%
2017-12,הצפון,542,ריינה,יישוב,368,176,192,8,360,289,353,3,4.80%
2017-12,הצפון,122,רמת ישי,יישוב,96,36,60,34,62,10,95,0,2.30%
2017-12,הצפון,913,שבלי - אום אל-גנם,יישוב,159,70,89,6,153,102,157,5,5.52%
2017-12,הצפון,812,שלומי,יישוב,197,76,121,19,178,89,189,9,5.17%
2017-12,הצפון,538,שעב,יישוב,351,159,192,1,350,286,349,5,10.41%
2017-12,הצפון,8800,שפרעם,יישוב,1167,501,666,26,1141,884,1140,11,5.85%
2017-12,חיפה,1326,"בסמ""ה",יישוב,309,134,175,3,306,236,306,8,6.83%
2017-12,חיפה,2710,אום אל-פחם,יישוב,2401,991,1410,24,2377,1953,2351,18,10.08%
2017-12,חיפה,1020,אור עקיבא,יישוב,410,169,241,36,374,109,395,19,3.76%
2017-12,חיפה,6000,באקה אל-גרביה,יישוב,539,268,271,14,525,311,531,26,4.07%
2017-12,חיפה,9800,בנימינה-גבעת עדה*,יישוב,168,80,88,71,97,26,165,2,2.19%
2017-12,חיפה,541,ג'סר א-זרקא,יישוב,205,119,86,0,205,78,201,17,3.14%
2017-12,חיפה,628,ג'ת,יישוב,187,94,93,14,173,105,186,6,3.22%
2017-12,חיפה,494,דאלית אל-כרמל,יישוב,381,149,232,13,368,207,357,5,4.08%
2017-12,חיפה,9300,זכרון יעקב,יישוב,247,112,135,108,139,22,245,4,2.15%
2017-12,חיפה,6500,חדרה,יישוב,1932,880,1052,248,1684,580,1821,36,3.51%
2017-12,חיפה,4000,חיפה,יישוב,5024,2436,2588,1080,3944,2297,4730,115,3.35%
2017-12,חיפה,1247,חריש,יישוב,119,47,72,35,84,15,116,0,2.72%
2017-12,חיפה,2100,טירת כרמל,יישוב,658,320,338,54,604,309,637,14,5.18%
2017-12,חיפה,654,כפר קרע,יישוב,359,169,190,23,336,214,353,4,3.76%
2017-12,חיפה,45,מ.א. אלונה,מועצה איזורית,30,12,18,13,17,2,30,0,2.81%
2017-12,חיפה,12,מ.א. זבולון,מועצה איזורית,213,111,102,23,190,109,201,0,3.39%
2017-12,חיפה,15,מ.א. חוף הכרמל,מועצה איזורית,309,135,174,123,186,46,305,0,2.06%
2017-12,חיפה,14,מ.א. מנשה,מועצה איזורית,209,79,130,61,148,46,207,0,2.41%
2017-12,חיפה,1327,מעלה עירון,יישוב,598,250,348,9,589,466,588,3,8.97%
2017-12,חיפה,2500,נשר,יישוב,356,188,168,73,283,125,344,7,2.72%
2017-12,חיפה,534,עספיא,יישוב,326,145,181,13,313,155,302,2,4.90%
2017-12,חיפה,637,ערערה,יישוב,462,199,263,12,450,301,450,7,5.00%
2017-12,חיפה,537,פוריידיס,יישוב,194,121,73,7,187,49,192,4,3.16%
2017-12,חיפה,7800,פרדס חנה-כרכור,יישוב,698,304,394,179,519,106,682,16,3.17%
2017-12,חיפה,6800,קריית אתא,יישוב,1293,586,707,115,1178,559,1248,19,4.03%
2017-12,חיפה,9500,קריית ביאליק,יישוב,811,367,444,95,716,306,790,19,3.70%
2017-12,חיפה,2300,קריית טבעון,יישוב,179,82,97,74,105,26,176,0,2.09%
2017-12,חיפה,9600,קריית ים,יישוב,1164,545,619,89,1075,597,1110,29,5.23%
2017-12,חיפה,8200,קריית מוצקין,יישוב,771,340,431,125,646,288,746,18,3.21%
2017-12,חיפה,922,רכסים,יישוב,126,53,73,12,114,52,115,1,3.08%
2017-12,ירושלים,472,אבו גוש,יישוב,201,102,99,5,196,152,199,3,5.75%
2017-12,ירושלים,2610,בית שמש,יישוב,1080,489,591,93,987,328,1032,23,2.76%
2017-12,ירושלים,3000,ירושלים,יישוב,10757,4865,5892,1323,9434,6184,10465,147,3.27%
2017-12,ירושלים,26,מ.א. מטה יהודה,מועצה איזורית,500,234,266,140,360,97,491,0,1.90%
2017-12,ירושלים,1015,מבשרת ציון,יישוב,293,150,143,60,233,88,287,2,2.25%
2017-12,ירושלים,1137,קריית יערים,יישוב,48,15,33,12,36,12,48,0,2.69%
2017-12,תל אביב,2400,אור יהודה,יישוב,597,288,309,45,552,122,567,20,2.95%
2017-12,תל אביב,565,אזור,יישוב,175,85,90,32,143,25,172,5,2.57%
2017-12,תל אביב,6100,בני ברק,יישוב,1588,805,783,96,1492,551,1494,20,2.47%
2017-12,תל אביב,6200,בת ים,יישוב,2440,1204,1236,378,2062,795,2292,56,3.25%
2017-12,תל אביב,6300,גבעתיים,יישוב,765,342,423,376,389,63,760,4,2.39%
2017-12,תל אביב,6400,הרצלייה,יישוב,969,447,522,334,635,44,955,14,1.94%
2017-12,תל אביב,6600,חולון,יישוב,2712,1202,1510,496,2216,545,2644,45,2.63%
2017-12,תל אביב,267,כפר שמריהו,יישוב,9,2,7,5,4,0,9,0,1.08%
2017-12,תל אביב,2620,קריית אונו,יישוב,418,182,236,206,212,31,413,4,2.11%
2017-12,תל אביב,8600,רמת גן,יישוב,1900,853,1047,711,1189,263,1869,13,2.29%
2017-12,תל אביב,2650,רמת השרון,יישוב,387,156,231,186,201,16,384,2,1.67%
2017-12,תל אביב,5000,תל אביב -יפו,יישוב,6844,3447,3397,2787,4057,1292,6711,57,2.55%
2018-01,אזור יהודה והשומרון,3760,אורנית,יישוב,98,41,57,38,60,0,98,1,1.95%
2018-01,אזור יהודה והשומרון,3750,אלפי מנשה,יישוב,72,26,46,28,44,0,71,1,1.61%
2018-01,אזור יהודה והשומרון,3560,אלקנה,יישוב,27,15,12,13,14,0,27,0,1.47%
2018-01,אזור יהודה והשומרון,3650,אפרת,יישוב,62,38,24,31,31,2,62,1,1.26%
2018-01,אזור יהודה והשומרון,3570,אריאל,יישוב,272,120,152,56,216,25,267,8,2.43%
2018-01,אזור יהודה והשומרון,3574,בית אל,יישוב,44,28,16,8,36,10,44,0,1.76%
2018-01,אזור יהודה והשומרון,3652,בית אריה,יישוב,55,22,33,15,40,0,55,0,1.91%
2018-01,אזור יהודה והשומרון,3780,ביתר עילית,יישוב,457,225,232,11,446,143,447,7,2.88%
2018-01,אזור יהודה והשומרון,3730,גבעת זאב,יישוב,166,87,79,43,123,32,166,1,2.05%
2018-01,אזור יהודה והשומרון,3769,הר אדר,יישוב,38,17,21,18,20,1,38,0,1.73%
2018-01,אזור יהודה והשומרון,76,מ.א. גוש עציון,מועצה איזורית,174,87,87,72,102,14,171,0,1.69%
2018-01,אזור יהודה והשומרון,78,מ.א. הר חברון,מועצה איזורית,75,40,35,35,40,1,74,0,1.87%
2018-01,אזור יהודה והשומרון,74,מ.א. מגילות ים המלח,מועצה איזורית,30,9,21,14,16,0,30,0,3.26%
2018-01,אזור יהודה והשומרון,73,מ.א. מטה בנימין,מועצה איזורית,566,301,265,187,379,82,560,0,1.97%
2018-01,אזור יהודה והשומרון,75,מ.א. ערבות הירדן,מועצה איזורית,49,20,29,16,33,4,48,0,1.87%
2018-01,אזור יהודה והשומרון,72,מ.א. שומרון,מועצה איזורית,398,196,202,147,251,19,395,0,2.09%
2018-01,אזור יהודה והשומרון,3797,מודיעין עילית,יישוב,446,139,307,32,414,35,440,2,2.74%
2018-01,אזור יהודה והשומרון,3616,מעלה אדומים,יישוב,560,273,287,92,468,128,548,24,2.62%
2018-01,אזור יהודה והשומרון,3608,מעלה אפרים,יישוב,29,13,16,1,28,6,29,0,3.63%
2018-01,אזור יהודה והשומרון,3660,עמנואל,יישוב,41,23,18,3,38,16,40,1,2.96%
2018-01,אזור יהודה והשומרון,3557,קדומים,יישוב,42,21,21,22,20,2,41,1,2.05%
2018-01,אזור יהודה והשומרון,3611,קריית ארבע,יישוב,73,40,33,12,61,35,69,7,2.06%
2018-01,אזור יהודה והשומרון,3640,קרני שומרון,יישוב,69,33,36,23,46,1,67,3,1.65%
2018-01,הדרום,31,אופקים,יישוב,843,395,448,55,788,381,810,41,5.60%
2018-01,הדרום,2600,אילת,יישוב,1131,575,556,56,1075,290,1065,52,3.08%
2018-01,הדרום,70,אשדוד,יישוב,4828,2086,2742,655,4173,2004,4579,150,4.09%
2018-01,הדרום,7100,אשקלון,יישוב,3266,1478,1788,369,2897,1365,2964,50,4.00%
2018-01,הדרום,9000,באר שבע,יישוב,5432,2553,2879,763,4669,2602,5104,118,4.75%
2018-01,הדרום,2200,דימונה,יישוב,1644,782,862,92,1552,1042,1550,45,7.93%
2018-01,הדרום,1303,חורה,יישוב,507,207,300,1,506,427,483,8,10.04%
2018-01,הדרום,831,ירוחם,יישוב,372,192,180,11,361,204,344,35,6.73%
2018-01,הדרום,1059,כסיפה,יישוב,954,370,584,3,951,854,940,9,17.35%
2018-01,הדרום,1271,להבים,יישוב,33,15,18,19,14,3,32,0,0.91%
2018-01,הדרום,1060,לקיה,יישוב,588,267,321,4,584,508,550,6,11.29%
2018-01,הדרום,69,מ.א. אל קסום,מועצה איזורית,603,248,355,6,597,499,587,0,17.21%
2018-01,הדרום,38,מ.א. אשכול,מועצה איזורית,128,61,67,33,95,10,126,0,1.80%
2018-01,הדרום,33,מ.א. באר טוביה,מועצה איזורית,275,114,161,56,219,43,269,1,2.37%
2018-01,הדרום,41,מ.א. בני שמעון,מועצה איזורית,88,36,52,30,58,15,86,1,1.77%
2018-01,הדרום,54,מ.א. הערבה התיכונה,מועצה איזורית,18,7,11,8,10,0,18,0,0.94%
2018-01,הדרום,53,מ.א. חבל אילות,מועצה איזורית,24,11,13,6,18,0,23,0,0.92%
2018-01,הדרום,36,מ.א. חוף אשקלון,מועצה איזורית,205,92,113,31,174,40,198,0,2.28%
2018-01,הדרום,35,מ.א. יואב,מועצה איזורית,82,32,50,27,55,7,81,0,1.98%
2018-01,הדרום,50,מ.א. לכיש,מועצה איזורית,151,74,77,25,126,35,149,0,2.67%
2018-01,הדרום,42,מ.א. מרחבים,מועצה איזורית,166,70,96,26,140,31,162,0,2.57%
2018-01,הדרום,68,מ.א. נווה מדבר,מועצה איזורית,121,46,75,0,121,96,118,0,6.25%
2018-01,הדרום,48,מ.א. רמת נגב,מועצה איזורית,282,139,143,19,263,209,275,0,8.25%
2018-01,הדרום,39,מ.א. שדות נגב,מועצה איזורית,127,62,65,28,99,30,124,0,2.55%
2018-01,הדרום,37,מ.א. שער הנגב,מועצה איזורית,86,31,55,37,49,13,83,0,2.08%
2018-01,הדרום,34,מ.א. שפיר,מועצה איזורית,132,67,65,14,118,42,130,0,2.61%
2018-01,הדרום,51,מ.א. תמר,מועצה איזורית,11,3,8,2,9,3,10,0,1.54%
2018-01,הדרום,1268,מיתר,יישוב,59,31,28,27,32,4,59,1,1.20%
2018-01,הדרום,99,מצפה רמון,יישוב,227,83,144,14,213,142,217,16,7.80%
2018-01,הדרום,246,נתיבות,יישוב,903,438,465,60,843,379,838,48,5.10%
2018-01,הדרום,666,עומר,יישוב,56,27,29,22,34,4,54,1,1.28%
2018-01,הדרום,2560,ערד,יישוב,654,284,370,66,588,312,616,31,4.84%
2018-01,הדרום,1192,ערערה-בנגב,יישוב,1014,432,582,4,1010,915,993,40,19.21%
2018-01,הדרום,2630,קריית גת,יישוב,1587,708,879,113,1474,600,1516,54,5.17%
2018-01,הדרום,1034,קריית מלאכי,יישוב,719,317,402,24,695,255,687,37,5.55%
2018-01,הדרום,1161,רהט,יישוב,2115,906,1209,11,2104,1561,2087,50,9.29%
2018-01,הדרום,1286,שגב-שלום,יישוב,336,138,198,2,334,264,320,2,9.89%
2018-01,הדרום,1031,שדרות,יישוב,915,441,474,52,863,445,834,36,5.62%
2018-01,הדרום,1054,תל שבע,יישוב,722,326,396,4,718,611,670,10,11.63%
2018-01,המרכז,1066,"בני עי""ש",יישוב,148,59,89,24,124,42,140,4,3.48%
2018-01,המרכז,182,אבן יהודה,יישוב,143,59,84,50,93,15,142,1,2.03%
2018-01,המרכז,41,אליכין,יישוב,61,31,30,14,47,12,60,1,3.05%
2018-01,המרכז,1309,אלעד,יישוב,320,130,190,23,297,33,306,6,2.15%
2018-01,המרכז,2530,באר יעקב,יישוב,287,118,169,68,219,28,277,3,2.15%
2018-01,המרכז,466,בית דגן,יישוב,95,48,47,10,85,24,93,2,2.49%
2018-01,המרכז,681,גבעת שמואל,יישוב,242,127,115,89,153,34,239,1,1.91%
2018-01,המרכז,2550,גדרה,יישוב,291,119,172,75,216,55,284,6,2.19%
2018-01,המרכז,627,ג'לג'וליה,יישוב,76,38,38,3,73,33,73,2,1.70%
2018-01,המרכז,166,גן יבנה,יישוב,302,121,181,51,251,62,294,5,2.31%
2018-01,המרכז,229,גני תקווה,יישוב,195,91,104,75,120,25,192,0,1.99%
2018-01,המרכז,9700,הוד השרון,יישוב,696,294,402,318,378,28,687,12,2.10%
2018-01,המרכז,1290,זמר,יישוב,133,49,84,2,131,81,127,8,3.87%
2018-01,המרכז,2730,טייבה,יישוב,878,407,471,24,854,590,731,21,3.79%
2018-01,המרכז,2720,טירה,יישוב,185,107,78,18,167,42,175,13,1.40%
2018-01,המרכז,2660,יבנה,יישוב,725,340,385,151,574,140,713,32,2.82%
2018-01,המרכז,9400,יהוד,יישוב,381,173,208,101,280,37,370,9,2.27%
2018-01,המרכז,1224,כוכב יאיר,יישוב,65,23,42,46,19,0,65,0,1.17%
2018-01,המרכז,633,כפר ברא,יישוב,11,4,7,1,10,4,11,1,0.68%
2018-01,המרכז,168,כפר יונה,יישוב,304,133,171,56,248,45,302,2,2.57%
2018-01,המרכז,6900,כפר סבא,יישוב,1148,527,621,430,718,80,1122,21,2.12%
2018-01,המרכז,634,כפר קאסם,יישוב,184,92,92,4,180,98,178,5,1.73%
2018-01,המרכז,7000,לוד,יישוב,1620,809,811,149,1471,759,1564,36,4.23%
2018-01,המרכז,28,מ.א. ברנר,מועצה איזורית,53,26,27,28,25,4,51,3,1.25%
2018-01,המרכז,32,מ.א. גדרות,מועצה איזורית,37,19,18,13,24,3,37,0,1.50%
2018-01,המרכז,30,מ.א. גזר,מועצה איזורית,286,123,163,99,187,22,281,0,2.09%
2018-01,המרכז,27,מ.א. גן רווה,מועצה איזורית,49,22,27,24,25,2,49,0,1.64%
2018-01,המרכז,20,מ.א. דרום השרון,מועצה איזורית,332,139,193,149,183,11,327,0,2.02%
2018-01,המרכז,29,מ.א. חבל יבנה,מועצה איזורית,41,13,28,20,21,2,41,0,1.56%
2018-01,המרכז,25,מ.א. חבל מודיעין,מועצה איזורית,214,93,121,83,131,21,210,0,1.91%
2018-01,המרכז,19,מ.א. חוף השרון,מועצה איזורית,100,32,68,42,58,3,100,0,1.80%
2018-01,המרכז,18,מ.א. לב השרון,מועצה איזורית,250,117,133,65,185,25,244,0,2.20%
2018-01,המרכז,31,מ.א. נחל שורק,מועצה איזורית,49,21,28,19,30,5,47,41,1.09%
2018-01,המרכז,16,מ.א. עמק חפר,מועצה איזורית,409,167,242,155,254,15,408,0,2.07%
2018-01,המרכז,40,מ.א. שדות דן,מועצה איזורית,154,74,80,33,121,14,152,0,2.36%
2018-01,המרכז,1200,מודיעין-מכבים-רעות*,יישוב,884,382,502,411,473,41,874,9,1.89%
2018-01,המרכז,28,מזכרת בתיה,יישוב,166,68,98,52,114,26,163,3,2.00%
2018-01,המרכז,7200,נס ציונה,יישוב,625,289,336,178,447,125,613,3,2.47%
2018-01,המרכז,7400,נתניה,יישוב,3803,1844,1959,462,3341,1004,3705,92,3.41%
2018-01,המרכז,587,סביון*,יישוב,25,9,16,13,12,0,25,1,1.20%
2018-01,המרכז,171,פרדסייה,יישוב,75,35,40,17,58,4,74,0,1.97%
2018-01,המרכז,7900,פתח תקווה,יישוב,3531,1606,1925,738,2793,759,3437,58,2.66%
2018-01,המרכז,195,קדימה-צורן,יישוב,261,122,139,88,173,28,257,4,2.19%
2018-01,המרכז,638,קלנסווה,יישוב,322,165,157,12,310,204,281,15,2.90%
2018-01,המרכז,469,קריית עקרון,יישוב,220,101,119,28,192,82,214,7,3.51%
2018-01,המרכז,2640,ראש העין,יישוב,797,379,418,170,627,109,783,8,2.53%
2018-01,המרכז,8300,ראשון לציון,יישוב,3757,1686,2071,792,2965,817,3702,69,2.64%
2018-01,המרכז,8400,רחובות,יישוב,2042,931,1111,554,1488,576,1970,45,2.78%
2018-01,המרכז,8500,רמלה,יישוב,1401,674,727,88,1313,495,1347,41,3.47%
2018-01,המרכז,8700,רעננה,יישוב,689,323,366,319,370,31,684,8,1.81%
2018-01,המרכז,1304,שוהם,יישוב,194,86,108,93,101,7,193,2,1.59%
2018-01,המרכז,154,תל מונד,יישוב,147,67,80,49,98,14,145,2,2.10%
2018-01,הצפון,473,אבו סנאן,יישוב,534,240,294,4,530,384,521,3,8.22%
2018-01,הצפון,478,אכסאל,יישוב,415,191,224,15,400,324,413,6,6.47%
2018-01,הצפון,529,אעבלין,יישוב,402,182,220,11,391,293,396,7,6.36%
2018-01,הצפון,482,בועיינה-נוג'ידאת,יישוב,222,110,112,7,215,156,218,2,5.05%
2018-01,הצפון,4001,בוקעאתא,יישוב,356,126,230,4,352,272,343,1,11.24%
2018-01,הצפון,998,ביר אל-מכסור,יישוב,253,111,142,1,252,188,247,1,5.94%
2018-01,הצפון,480,בית ג'ן,יישוב,373,101,272,7,366,236,365,3,6.07%
2018-01,הצפון,9200,בית שאן,יישוב,668,306,362,24,644,279,641,42,6.08%
2018-01,הצפון,944,בסמת טבעון,יישוב,163,79,84,2,161,102,151,4,4.17%
2018-01,הצפון,483,בענה,יישוב,305,133,172,7,298,252,293,5,7.54%
2018-01,הצפון,1292,ג'דיידה-מכר,יישוב,1010,450,560,4,1006,759,989,13,9.59%
2018-01,הצפון,485,ג'ולס,יישוב,163,46,117,4,159,91,163,0,4.98%
2018-01,הצפון,487,ג'ש (גוש חלב),יישוב,46,20,26,5,41,19,45,5,2.63%
2018-01,הצפון,489,דבורייה,יישוב,246,107,139,13,233,184,240,5,5.06%
2018-01,הצפון,490,דייר אל-אסד,יישוב,315,138,177,8,307,226,305,7,5.30%
2018-01,הצפון,492,דייר חנא,יישוב,502,230,272,14,488,347,501,5,9.43%
2018-01,הצפון,975,זרזיר,יישוב,191,85,106,1,190,110,187,6,5.21%
2018-01,הצפון,496,חורפיש,יישוב,92,40,52,6,86,47,83,2,2.73%
2018-01,הצפון,2034,חצור הגלילית,יישוב,248,112,136,18,230,115,229,2,4.67%
2018-01,הצפון,6700,טבריה,יישוב,1381,693,688,87,1294,612,1213,51,5.42%
2018-01,הצפון,962,טובא-זנגרייה,יישוב,302,142,160,2,300,202,290,3,8.48%
2018-01,הצפון,498,טורעאן,יישוב,313,154,159,12,301,228,305,5,4.83%
2018-01,הצפון,8900,טמרה,יישוב,1176,568,608,15,1161,931,1145,15,7.36%
2018-01,הצפון,1295,יאנוח-ג'ת,יישוב,113,37,76,1,112,62,108,4,3.38%
2018-01,הצפון,46,יבנאל,יישוב,83,47,36,8,75,48,67,1,4.24%
2018-01,הצפון,29,יסוד המעלה,יישוב,23,8,15,6,17,6,23,0,2.60%
2018-01,הצפון,499,יפיע,יישוב,485,214,271,30,455,334,477,8,5.51%
2018-01,הצפון,240,יקנעם עילית,יישוב,430,200,230,102,328,94,417,26,3.23%
2018-01,הצפון,502,ירכא,יישוב,353,141,212,1,352,230,350,4,4.99%
2018-01,הצפון,504,כאבול,יישוב,395,202,193,6,389,317,386,4,7.12%
2018-01,הצפון,505,כאוכב אבו אל-היג'א,יישוב,176,69,107,6,170,134,176,3,9.30%
2018-01,הצפון,1296,כסרא-סמיע,יישוב,169,49,120,1,168,104,167,4,4.29%
2018-01,הצפון,978,כעביה-טבאש-חג'אג'רה,יישוב,169,62,107,6,163,103,164,1,6.31%
2018-01,הצפון,1263,כפר ורדים,יישוב,64,26,38,25,39,5,61,1,1.96%
2018-01,הצפון,507,כפר יאסיף,יישוב,352,168,184,3,349,236,342,2,6.30%
2018-01,הצפון,508,כפר כמא,יישוב,37,13,24,3,34,15,36,0,2.09%
2018-01,הצפון,509,כפר כנא,יישוב,660,326,334,22,638,516,630,13,6.51%
2018-01,הצפון,510,כפר מנדא,יישוב,572,318,254,13,559,402,563,1,7.02%
2018-01,הצפון,47,כפר תבור,יישוב,49,23,26,16,33,2,49,1,2.06%
2018-01,הצפון,1139,כרמיאל,יישוב,1378,574,804,259,1119,633,1265,32,4.87%
2018-01,הצפון,65,מ.א. אל-בטוף,מועצה איזורית,230,113,117,11,219,160,221,1,6.79%
2018-01,הצפון,66,מ.א. בוסתן אל-מרג,מועצה איזורית,28,6,22,0,28,27,28,0,0.79%
2018-01,הצפון,71,מ.א. גולן,מועצה איזורית,190,83,107,68,122,16,189,1,2.15%
2018-01,הצפון,8,מ.א. הגלבוע,מועצה איזורית,580,257,323,65,515,286,572,0,4.05%
2018-01,הצפון,1,מ.א. הגליל העליון,מועצה איזורית,200,84,116,67,133,11,199,0,2.22%
2018-01,הצפון,3,מ.א. הגליל התחתון,מועצה איזורית,103,42,61,29,74,6,102,0,1.69%
2018-01,הצפון,55,מ.א. מבואות החרמון,מועצה איזורית,114,50,64,25,89,20,113,1,2.82%
2018-01,הצפון,13,מ.א. מגידו,מועצה איזורית,94,46,48,35,59,10,94,0,1.66%
2018-01,הצפון,4,מ.א. מטה אשר,מועצה איזורית,480,223,257,104,376,137,470,0,3.31%
2018-01,הצפון,52,מ.א. מעלה יוסף,מועצה איזורית,167,77,90,22,145,37,163,0,2.84%
2018-01,הצפון,2,מ.א. מרום הגליל,מועצה איזורית,247,116,131,35,212,87,239,0,3.35%
2018-01,הצפון,56,מ.א. משגב,מועצה איזורית,520,207,313,109,411,252,504,0,3.56%
2018-01,הצפון,6,מ.א. עמק הירדן,מועצה איזורית,190,93,97,51,139,28,180,0,2.65%
2018-01,הצפון,7,מ.א. עמק המעיינות,מועצה איזורית,179,77,102,39,140,32,174,1,2.66%
2018-01,הצפון,9,מ.א. עמק יזרעאל,מועצה איזורית,367,172,195,181,186,26,362,0,1.85%
2018-01,הצפון,481,מגאר,יישוב,1051,458,593,12,1039,811,1022,13,9.56%
2018-01,הצפון,516,מג'ד אל-כרום,יישוב,417,198,219,12,405,278,402,12,5.46%
2018-01,הצפון,65,מגדל,יישוב,38,19,19,2,36,10,32,1,3.21%
2018-01,הצפון,874,מגדל העמק,יישוב,827,388,439,78,749,258,771,56,5.59%
2018-01,הצפון,4201,מג'דל שמס,יישוב,395,149,246,15,380,281,377,5,7.11%
2018-01,הצפון,517,מזרעה,יישוב,142,65,77,3,139,95,134,3,6.23%
2018-01,הצפון,43,מטולה,יישוב,27,14,13,9,18,5,25,0,2.48%
2018-01,הצפון,4203,מסעדה,יישוב,206,85,121,6,200,150,198,4,10.70%
2018-01,הצפון,518,מעיליא,יישוב,47,23,24,7,40,16,45,2,2.63%
2018-01,הצפון,1063,מעלות-תרשיחא,יישוב,671,335,336,75,596,323,629,31,5.17%
2018-01,הצפון,520,משהד,יישוב,155,75,80,8,147,113,151,4,4.22%
2018-01,הצפון,9100,נהרייה,יישוב,1715,824,891,193,1522,793,1606,53,5.06%
2018-01,הצפון,522,נחף,יישוב,338,160,178,16,322,247,327,6,5.84%
2018-01,הצפון,7300,נצרת,יישוב,2422,1117,1305,100,2322,1764,2390,29,6.48%
2018-01,הצפון,1061,נצרת עילית,יישוב,1316,630,686,141,1175,558,1171,84,4.98%
2018-01,הצפון,525,סאג'ור,יישוב,106,38,68,6,100,69,103,0,4.73%
2018-01,הצפון,7500,סח'נין,יישוב,1532,691,841,31,1501,1219,1518,24,9.81%
2018-01,הצפון,4501,ע'ג'ר,יישוב,81,37,44,3,78,51,77,0,6.43%
2018-01,הצפון,530,עיילבון,יישוב,136,70,66,4,132,74,133,4,4.59%
2018-01,הצפון,511,עילוט,יישוב,234,103,131,3,231,182,232,0,7.24%
2018-01,הצפון,532,עין מאהל,יישוב,343,179,164,5,338,258,332,5,5.66%
2018-01,הצפון,4502,עין קנייא,יישוב,141,59,82,4,137,97,139,0,12.15%
2018-01,הצפון,7600,עכו,יישוב,2537,1185,1352,131,2406,1750,2428,36,8.94%
2018-01,הצפון,7700,עפולה,יישוב,1403,579,824,165,1238,502,1314,73,4.79%
2018-01,הצפון,531,עראבה,יישוב,1066,463,603,25,1041,877,1054,15,9.39%
2018-01,הצפון,535,פסוטה,יישוב,84,42,42,6,78,40,78,4,4.34%
2018-01,הצפון,536,פקיעין (בוקייעה),יישוב,105,47,58,5,100,65,101,2,3.37%
2018-01,הצפון,8000,צפת,יישוב,909,484,425,94,815,539,855,27,6.14%
2018-01,הצפון,4100,קצרין,יישוב,173,75,98,31,142,69,165,7,4.12%
2018-01,הצפון,2800,קריית שמונה,יישוב,654,329,325,66,588,273,629,27,4.84%
2018-01,הצפון,543,ראמה,יישוב,227,95,132,13,214,144,221,3,5.38%
2018-01,הצפון,26,ראש פינה,יישוב,53,15,38,14,39,20,52,0,3.14%
2018-01,הצפון,542,ריינה,יישוב,390,187,203,9,381,288,379,6,5.13%
2018-01,הצפון,122,רמת ישי,יישוב,93,36,57,32,61,16,89,0,2.15%
2018-01,הצפון,913,שבלי - אום אל-גנם,יישוב,168,60,108,8,160,101,164,5,5.75%
2018-01,הצפון,812,שלומי,יישוב,209,87,122,20,189,90,201,7,5.48%
2018-01,הצפון,538,שעב,יישוב,359,163,196,2,357,293,356,2,10.59%
2018-01,הצפון,8800,שפרעם,יישוב,1185,512,673,29,1156,890,1161,17,5.95%
2018-01,חיפה,1326,"בסמ""ה",יישוב,304,141,163,2,302,220,301,2,6.72%
2018-01,חיפה,2710,אום אל-פחם,יישוב,2428,1018,1410,29,2399,1950,2371,35,10.15%
2018-01,חיפה,1020,אור עקיבא,יישוב,425,184,241,41,384,105,403,20,3.84%
2018-01,חיפה,6000,באקה אל-גרביה,יישוב,529,257,272,13,516,299,518,21,3.97%
2018-01,חיפה,9800,בנימינה-גבעת עדה*,יישוב,160,81,79,72,88,26,157,3,2.09%
2018-01,חיפה,541,ג'סר א-זרקא,יישוב,202,121,81,0,202,75,197,12,3.08%
2018-01,חיפה,628,ג'ת,יישוב,200,102,98,13,187,105,198,5,3.42%
2018-01,חיפה,494,דאלית אל-כרמל,יישוב,407,164,243,14,393,205,382,8,4.36%
2018-01,חיפה,9300,זכרון יעקב,יישוב,231,94,137,101,130,24,229,4,2.01%
2018-01,חיפה,6500,חדרה,יישוב,2011,920,1091,254,1757,577,1906,47,3.67%
2018-01,חיפה,4000,חיפה,יישוב,5200,2518,2682,1124,4076,2323,4870,138,3.45%
2018-01,חיפה,1247,חריש,יישוב,122,46,76,38,84,12,117,0,2.75%
2018-01,חיפה,2100,טירת כרמל,יישוב,673,339,334,51,622,322,648,21,5.27%
2018-01,חיפה,654,כפר קרע,יישוב,378,177,201,19,359,218,370,13,3.94%
2018-01,חיפה,45,מ.א. אלונה,מועצה איזורית,26,10,16,12,14,2,26,0,2.44%
2018-01,חיפה,12,מ.א. זבולון,מועצה איזורית,201,108,93,22,179,104,192,0,3.24%
2018-01,חיפה,15,מ.א. חוף הכרמל,מועצה איזורית,363,169,194,140,223,57,358,0,2.42%
2018-01,חיפה,14,מ.א. מנשה,מועצה איזורית,221,88,133,65,156,46,219,0,2.55%
2018-01,חיפה,1327,מעלה עירון,יישוב,588,252,336,12,576,452,580,10,8.86%
2018-01,חיפה,2500,נשר,יישוב,390,210,180,83,307,124,376,8,2.96%
2018-01,חיפה,534,עספיא,יישוב,339,153,186,12,327,150,317,4,5.14%
2018-01,חיפה,637,ערערה,יישוב,466,200,266,13,453,285,450,11,5.00%
2018-01,חיפה,537,פוריידיס,יישוב,204,130,74,8,196,44,201,2,3.31%
2018-01,חיפה,7800,פרדס חנה-כרכור,יישוב,725,315,410,181,544,111,710,29,3.30%
2018-01,חיפה,6800,קריית אתא,יישוב,1320,595,725,126,1194,554,1273,44,4.11%
2018-01,חיפה,9500,קריית ביאליק,יישוב,854,389,465,110,744,298,828,17,3.87%
2018-01,חיפה,2300,קריית טבעון,יישוב,178,86,92,83,95,18,178,2,2.12%
2018-01,חיפה,9600,קריית ים,יישוב,1156,547,609,91,1065,583,1106,42,5.21%
2018-01,חיפה,8200,קריית מוצקין,יישוב,802,366,436,127,675,288,775,19,3.33%
2018-01,חיפה,922,רכסים,יישוב,121,52,69,8,113,48,112,1,3.00%
2018-01,ירושלים,472,אבו גוש,יישוב,202,103,99,6,196,145,200,2,5.77%
2018-01,ירושלים,2610,בית שמש,יישוב,1118,514,604,88,1030,337,1064,67,2.85%
2018-01,ירושלים,3000,ירושלים,יישוב,10889,4936,5953,1393,9496,6112,10588,126,3.31%
2018-01,ירושלים,26,מ.א. מטה יהודה,מועצה איזורית,519,252,267,158,361,92,509,0,1.97%
2018-01,ירושלים,1015,מבשרת ציון,יישוב,303,161,142,68,235,89,300,6,2.35%
2018-01,ירושלים,1137,קריית יערים,יישוב,39,12,27,9,30,10,39,0,2.19%
2018-01,תל אביב,2400,אור יהודה,יישוב,621,307,314,43,578,125,588,21,3.05%
2018-01,תל אביב,565,אזור,יישוב,167,84,83,33,134,21,166,4,2.48%
2018-01,תל אביב,6100,בני ברק,יישוב,1598,799,799,98,1500,551,1499,20,2.48%
2018-01,תל אביב,6200,בת ים,יישוב,2584,1293,1291,403,2181,795,2429,73,3.44%
2018-01,תל אביב,6300,גבעתיים,יישוב,788,352,436,380,408,69,780,8,2.45%
2018-01,תל אביב,6400,הרצלייה,יישוב,1050,472,578,358,692,43,1039,9,2.11%
2018-01,תל אביב,6600,חולון,יישוב,2841,1276,1565,525,2316,521,2756,47,2.73%
2018-01,תל אביב,267,כפר שמריהו,יישוב,7,1,6,5,2,0,7,0,0.84%
2018-01,תל אביב,2620,קריית אונו,יישוב,406,173,233,198,208,34,402,5,2.05%
2018-01,תל אביב,8600,רמת גן,יישוב,1978,917,1061,749,1229,263,1943,13,2.38%
2018-01,תל אביב,2650,רמת השרון,יישוב,406,175,231,193,213,15,401,2,1.75%
2018-01,תל אביב,5000,תל אביב -יפו,יישוב,7144,3627,3517,2949,4195,1314,6991,75,2.65%
2018-02,אזור יהודה והשומרון,3760,אורנית,יישוב,103,45,58,41,62,1,103,0,2.05%
2018-02,אזור יהודה והשומרון,3750,אלפי מנשה,יישוב,85,32,53,34,51,0,85,1,1.92%
2018-02,אזור יהודה והשומרון,3560,אלקנה,יישוב,24,13,11,13,11,0,24,0,1.31%
2018-02,אזור יהודה והשומרון,3650,אפרת,יישוב,56,33,23,32,24,2,56,3,1.14%
2018-02,אזור יהודה והשומרון,3570,אריאל,יישוב,244,97,147,50,194,19,239,14,2.18%
2018-02,אזור יהודה והשומרון,3574,בית אל,יישוב,41,27,14,9,32,11,40,0,1.60%
2018-02,אזור יהודה והשומרון,3652,בית אריה,יישוב,57,21,36,16,41,0,57,0,1.98%
2018-02,אזור יהודה והשומרון,3780,ביתר עילית,יישוב,432,207,225,9,423,137,425,7,2.74%
2018-02,אזור יהודה והשומרון,3730,גבעת זאב,יישוב,159,75,84,41,118,30,158,1,1.95%
2018-02,אזור יהודה והשומרון,3769,הר אדר,יישוב,35,16,19,12,23,4,35,1,1.60%
2018-02,אזור יהודה והשומרון,76,מ.א. גוש עציון,מועצה איזורית,169,84,85,66,103,13,167,0,1.65%
2018-02,אזור יהודה והשומרון,78,מ.א. הר חברון,מועצה איזורית,74,42,32,29,45,1,72,0,1.81%
2018-02,אזור יהודה והשומרון,74,מ.א. מגילות ים המלח,מועצה איזורית,27,6,21,12,15,0,27,0,2.93%
2018-02,אזור יהודה והשומרון,73,מ.א. מטה בנימין,מועצה איזורית,543,293,250,181,362,78,538,0,1.90%
2018-02,אזור יהודה והשומרון,75,מ.א. ערבות הירדן,מועצה איזורית,54,20,34,16,38,4,53,0,2.06%
2018-02,אזור יהודה והשומרון,72,מ.א. שומרון,מועצה איזורית,356,176,180,127,229,18,354,0,1.87%
2018-02,אזור יהודה והשומרון,3797,מודיעין עילית,יישוב,402,136,266,23,379,31,399,5,2.49%
2018-02,אזור יהודה והשומרון,3616,מעלה אדומים,יישוב,545,268,277,90,455,124,531,17,2.54%
2018-02,אזור יהודה והשומרון,3608,מעלה אפרים,יישוב,28,13,15,0,28,10,28,2,3.50%
2018-02,אזור יהודה והשומרון,3660,עמנואל,יישוב,40,24,16,3,37,14,40,2,2.96%
2018-02,אזור יהודה והשומרון,3557,קדומים,יישוב,32,19,13,14,18,1,32,0,1.60%
2018-02,אזור יהודה והשומרון,3611,קריית ארבע,יישוב,73,40,33,11,62,37,70,1,2.09%
2018-02,אזור יהודה והשומרון,3640,קרני שומרון,יישוב,71,33,38,24,47,1,70,2,1.73%
2018-02,הדרום,31,אופקים,יישוב,773,360,413,47,726,353,749,40,5.20%
2018-02,הדרום,2600,אילת,יישוב,1113,566,547,51,1062,296,1052,48,3.04%
2018-02,הדרום,70,אשדוד,יישוב,4742,2063,2679,641,4101,1974,4507,106,4.03%
2018-02,הדרום,7100,אשקלון,יישוב,3249,1447,1802,365,2884,1329,2967,61,4.01%
2018-02,הדרום,9000,באר שבע,יישוב,5299,2504,2795,722,4577,2533,5002,94,4.66%
2018-02,הדרום,2200,דימונה,יישוב,1600,771,829,88,1512,998,1514,31,7.76%
2018-02,הדרום,1303,חורה,יישוב,472,192,280,4,468,405,456,6,9.53%
2018-02,הדרום,831,ירוחם,יישוב,355,182,173,11,344,195,333,22,6.52%
2018-02,הדרום,1059,כסיפה,יישוב,976,379,597,3,973,861,961,18,17.67%
2018-02,הדרום,1271,להבים,יישוב,40,18,22,21,19,1,40,0,1.14%
2018-02,הדרום,1060,לקיה,יישוב,561,244,317,7,554,490,535,1,11.01%
2018-02,הדרום,69,מ.א. אל קסום,מועצה איזורית,595,240,355,4,591,499,579,0,16.97%
2018-02,הדרום,38,מ.א. אשכול,מועצה איזורית,118,57,61,28,90,9,118,1,1.68%
2018-02,הדרום,33,מ.א. באר טוביה,מועצה איזורית,272,108,164,56,216,40,269,0,2.38%
2018-02,הדרום,41,מ.א. בני שמעון,מועצה איזורית,84,34,50,35,49,16,81,0,1.67%
2018-02,הדרום,54,מ.א. הערבה התיכונה,מועצה איזורית,20,9,11,11,9,0,20,0,1.05%
2018-02,הדרום,53,מ.א. חבל אילות,מועצה איזורית,21,8,13,6,15,0,19,2,0.76%
2018-02,הדרום,36,מ.א. חוף אשקלון,מועצה איזורית,204,94,110,32,172,42,197,0,2.27%
2018-02,הדרום,35,מ.א. יואב,מועצה איזורית,85,34,51,28,57,10,85,0,2.08%
2018-02,הדרום,50,מ.א. לכיש,מועצה איזורית,142,71,71,24,118,35,140,0,2.51%
2018-02,הדרום,42,מ.א. מרחבים,מועצה איזורית,167,72,95,28,139,32,161,0,2.56%
2018-02,הדרום,68,מ.א. נווה מדבר,מועצה איזורית,126,43,83,1,125,100,121,0,6.41%
2018-02,הדרום,48,מ.א. רמת נגב,מועצה איזורית,282,140,142,16,266,214,274,0,8.23%
2018-02,הדרום,39,מ.א. שדות נגב,מועצה איזורית,123,62,61,24,99,29,117,0,2.41%
2018-02,הדרום,37,מ.א. שער הנגב,מועצה איזורית,85,30,55,40,45,13,83,0,2.08%
2018-02,הדרום,34,מ.א. שפיר,מועצה איזורית,121,60,61,13,108,41,118,0,2.37%
2018-02,הדרום,51,מ.א. תמר,מועצה איזורית,12,3,9,2,10,3,11,0,1.69%
2018-02,הדרום,1268,מיתר,יישוב,63,34,29,29,34,2,63,0,1.28%
2018-02,הדרום,99,מצפה רמון,יישוב,224,85,139,17,207,140,212,8,7.63%
2018-02,הדרום,246,נתיבות,יישוב,890,433,457,62,828,373,819,66,4.99%
2018-02,הדרום,666,עומר,יישוב,52,24,28,21,31,3,52,0,1.23%
2018-02,הדרום,2560,ערד,יישוב,615,270,345,66,549,300,581,27,4.58%
2018-02,הדרום,1192,ערערה-בנגב,יישוב,1008,435,573,4,1004,905,981,12,19.02%
2018-02,הדרום,2630,קריית גת,יישוב,1646,714,932,114,1532,588,1581,37,5.38%
2018-02,הדרום,1034,קריית מלאכי,יישוב,726,308,418,23,703,273,695,31,5.61%
2018-02,הדרום,1161,רהט,יישוב,2020,857,1163,14,2006,1515,1993,53,8.91%
2018-02,הדרום,1286,שגב-שלום,יישוב,320,128,192,1,319,255,309,5,9.58%
2018-02,הדרום,1031,שדרות,יישוב,919,439,480,52,867,436,837,38,5.64%
2018-02,הדרום,1054,תל שבע,יישוב,701,312,389,2,699,601,657,12,11.43%
2018-02,המרכז,1066,"בני עי""ש",יישוב,142,65,77,21,121,40,136,4,3.38%
2018-02,המרכז,182,אבן יהודה,יישוב,139,53,86,51,88,16,138,3,1.98%
2018-02,המרכז,41,אליכין,יישוב,61,31,30,13,48,12,60,0,3.05%
2018-02,המרכז,1309,אלעד,יישוב,308,129,179,21,287,28,298,3,2.10%
2018-02,המרכז,2530,באר יעקב,יישוב,281,115,166,63,218,30,272,3,2.11%
2018-02,המרכז,466,בית דגן,יישוב,101,56,45,14,87,24,98,0,2.62%
2018-02,המרכז,681,גבעת שמואל,יישוב,231,117,114,91,140,34,229,2,1.83%
2018-02,המרכז,2550,גדרה,יישוב,283,123,160,70,213,51,280,7,2.16%
2018-02,המרכז,627,ג'לג'וליה,יישוב,78,37,41,2,76,33,77,1,1.79%
2018-02,המרכז,166,גן יבנה,יישוב,291,118,173,46,245,59,284,2,2.24%
2018-02,המרכז,229,גני תקווה,יישוב,191,87,104,66,125,24,190,1,1.97%
2018-02,המרכז,9700,הוד השרון,יישוב,667,278,389,319,348,27,657,6,2.01%
2018-02,המרכז,1290,זמר,יישוב,132,49,83,4,128,78,125,2,3.81%
2018-02,המרכז,2730,טייבה,יישוב,862,408,454,25,837,566,732,32,3.79%
2018-02,המרכז,2720,טירה,יישוב,168,96,72,10,158,34,162,10,1.29%
2018-02,המרכז,2660,יבנה,יישוב,696,320,376,141,555,138,683,28,2.71%
2018-02,המרכז,9400,יהוד,יישוב,358,160,198,103,255,42,348,5,2.13%
2018-02,המרכז,1224,כוכב יאיר,יישוב,70,27,43,48,22,1,70,1,1.26%
2018-02,המרכז,633,כפר ברא,יישוב,14,9,5,1,13,4,13,1,0.81%
2018-02,המרכז,168,כפר יונה,יישוב,304,130,174,56,248,37,303,3,2.58%
2018-02,המרכז,6900,כפר סבא,יישוב,1119,524,595,420,699,68,1098,18,2.07%
2018-02,המרכז,634,כפר קאסם,יישוב,168,81,87,3,165,89,166,1,1.61%
2018-02,המרכז,7000,לוד,יישוב,1548,770,778,140,1408,720,1512,30,4.10%
2018-02,המרכז,28,מ.א. ברנר,מועצה איזורית,54,25,29,32,22,1,54,2,1.33%
2018-02,המרכז,32,מ.א. גדרות,מועצה איזורית,39,18,21,16,23,3,38,0,1.54%
2018-02,המרכז,30,מ.א. גזר,מועצה איזורית,276,121,155,101,175,22,274,0,2.04%
2018-02,המרכז,27,מ.א. גן רווה,מועצה איזורית,56,25,31,23,33,3,56,0,1.87%
2018-02,המרכז,20,מ.א. דרום השרון,מועצה איזורית,325,144,181,151,174,10,321,0,1.98%
2018-02,המרכז,29,מ.א. חבל יבנה,מועצה איזורית,35,12,23,19,16,2,35,0,1.33%
2018-02,המרכז,25,מ.א. חבל מודיעין,מועצה איזורית,208,94,114,74,134,23,204,0,1.86%
2018-02,המרכז,19,מ.א. חוף השרון,מועצה איזורית,96,35,61,43,53,2,96,0,1.72%
2018-02,המרכז,18,מ.א. לב השרון,מועצה איזורית,240,109,131,66,174,24,232,0,2.09%
2018-02,המרכז,31,מ.א. נחל שורק,מועצה איזורית,46,18,28,17,29,5,45,40,1.06%
2018-02,המרכז,16,מ.א. עמק חפר,מועצה איזורית,392,159,233,142,250,12,388,0,1.97%
2018-02,המרכז,40,מ.א. שדות דן,מועצה איזורית,149,65,84,33,116,13,148,0,2.30%
2018-02,המרכז,1200,מודיעין-מכבים-רעות*,יישוב,827,348,479,407,420,37,820,14,1.78%
2018-02,המרכז,28,מזכרת בתיה,יישוב,155,66,89,52,103,20,152,2,1.87%
2018-02,המרכז,7200,נס ציונה,יישוב,575,261,314,175,400,116,567,7,2.29%
2018-02,המרכז,7400,נתניה,יישוב,3732,1783,1949,454,3278,994,3653,79,3.37%
2018-02,המרכז,587,סביון*,יישוב,25,7,18,12,13,0,25,0,1.20%
2018-02,המרכז,171,פרדסייה,יישוב,79,36,43,17,62,4,79,0,2.10%
2018-02,המרכז,7900,פתח תקווה,יישוב,3490,1586,1904,754,2736,743,3396,45,2.63%
2018-02,המרכז,195,קדימה-צורן,יישוב,272,126,146,92,180,29,268,1,2.28%
2018-02,המרכז,638,קלנסווה,יישוב,322,167,155,15,307,199,285,14,2.94%
2018-02,המרכז,469,קריית עקרון,יישוב,214,107,107,26,188,83,208,7,3.42%
2018-02,המרכז,2640,ראש העין,יישוב,786,356,430,168,618,108,768,11,2.48%
2018-02,המרכז,8300,ראשון לציון,יישוב,3666,1643,2023,767,2899,789,3624,43,2.58%
2018-02,המרכז,8400,רחובות,יישוב,2015,919,1096,540,1475,555,1950,49,2.75%
2018-02,המרכז,8500,רמלה,יישוב,1377,646,731,88,1289,476,1323,38,3.41%
2018-02,המרכז,8700,רעננה,יישוב,695,326,369,334,361,29,688,11,1.82%
2018-02,המרכז,1304,שוהם,יישוב,186,88,98,97,89,4,185,0,1.53%
2018-02,המרכז,154,תל מונד,יישוב,149,70,79,48,101,16,149,0,2.15%
2018-02,הצפון,473,אבו סנאן,יישוב,529,239,290,6,523,381,518,6,8.17%
2018-02,הצפון,478,אכסאל,יישוב,399,177,222,12,387,319,395,3,6.20%
2018-02,הצפון,529,אעבלין,יישוב,387,171,216,10,377,290,379,7,6.10%
2018-02,הצפון,482,בועיינה-נוג'ידאת,יישוב,241,121,120,12,229,160,237,4,5.47%
2018-02,הצפון,4001,בוקעאתא,יישוב,346,133,213,4,342,265,332,1,10.92%
2018-02,הצפון,998,ביר אל-מכסור,יישוב,264,119,145,2,262,185,263,2,6.30%
2018-02,הצפון,480,בית ג'ן,יישוב,377,103,274,3,374,236,361,1,6.00%
2018-02,הצפון,9200,בית שאן,יישוב,637,301,336,24,613,268,616,38,5.86%
2018-02,הצפון,944,בסמת טבעון,יישוב,159,77,82,6,153,95,144,5,3.99%
2018-02,הצפון,483,בענה,יישוב,309,136,173,7,302,253,295,3,7.59%
2018-02,הצפון,1292,ג'דיידה-מכר,יישוב,1005,455,550,7,998,759,988,10,9.59%
2018-02,הצפון,485,ג'ולס,יישוב,167,42,125,3,164,85,167,1,5.09%
2018-02,הצפון,487,ג'ש (גוש חלב),יישוב,41,19,22,5,36,20,40,1,2.35%
2018-02,הצפון,489,דבורייה,יישוב,242,106,136,13,229,175,237,4,5.00%
2018-02,הצפון,490,דייר אל-אסד,יישוב,312,143,169,9,303,219,306,5,5.32%
2018-02,הצפון,492,דייר חנא,יישוב,495,234,261,13,482,338,494,4,9.31%
2018-02,הצפון,975,זרזיר,יישוב,178,82,96,3,175,106,177,8,4.94%
2018-02,הצפון,496,חורפיש,יישוב,97,40,57,5,92,46,87,4,2.86%
2018-02,הצפון,2034,חצור הגלילית,יישוב,223,105,118,15,208,105,203,7,4.16%
2018-02,הצפון,6700,טבריה,יישוב,1293,648,645,78,1215,585,1146,48,5.14%
2018-02,הצפון,962,טובא-זנגרייה,יישוב,289,126,163,2,287,193,274,1,8.05%
2018-02,הצפון,498,טורעאן,יישוב,315,152,163,12,303,228,305,5,4.83%
2018-02,הצפון,8900,טמרה,יישוב,1164,559,605,20,1144,916,1141,10,7.34%
2018-02,הצפון,1295,יאנוח-ג'ת,יישוב,124,45,79,1,123,67,119,6,3.71%
2018-02,הצפון,46,יבנאל,יישוב,80,45,35,10,70,39,67,0,4.24%
2018-02,הצפון,29,יסוד המעלה,יישוב,20,6,14,6,14,5,20,0,2.27%
2018-02,הצפון,499,יפיע,יישוב,469,207,262,29,440,334,464,4,5.36%
2018-02,הצפון,240,יקנעם עילית,יישוב,413,192,221,93,320,95,398,27,3.09%
2018-02,הצפון,502,ירכא,יישוב,340,140,200,2,338,221,339,1,4.84%
2018-02,הצפון,504,כאבול,יישוב,391,205,186,9,382,310,381,2,7.03%
2018-02,הצפון,505,כאוכב אבו אל-היג'א,יישוב,177,71,106,4,173,139,177,1,9.35%
2018-02,הצפון,1296,כסרא-סמיע,יישוב,180,62,118,1,179,112,172,4,4.42%
2018-02,הצפון,978,כעביה-טבאש-חג'אג'רה,יישוב,161,54,107,4,157,102,157,1,6.05%
2018-02,הצפון,1263,כפר ורדים,יישוב,56,23,33,20,36,5,53,0,1.71%
2018-02,הצפון,507,כפר יאסיף,יישוב,348,167,181,3,345,233,338,5,6.23%
2018-02,הצפון,508,כפר כמא,יישוב,33,13,20,3,30,14,30,0,1.74%
2018-02,הצפון,509,כפר כנא,יישוב,656,329,327,25,631,508,630,8,6.51%
2018-02,הצפון,510,כפר מנדא,יישוב,589,320,269,11,578,406,585,2,7.27%
2018-02,הצפון,47,כפר תבור,יישוב,47,23,24,16,31,3,46,0,1.94%
2018-02,הצפון,1139,כרמיאל,יישוב,1349,571,778,262,1087,631,1242,39,4.79%
2018-02,הצפון,65,מ.א. אל-בטוף,מועצה איזורית,225,108,117,10,215,159,217,1,6.67%
2018-02,הצפון,66,מ.א. בוסתן אל-מרג,מועצה איזורית,28,7,21,0,28,24,28,4,0.80%
2018-02,הצפון,71,מ.א. גולן,מועצה איזורית,206,89,117,75,131,13,205,0,2.33%
2018-02,הצפון,8,מ.א. הגלבוע,מועצה איזורית,555,247,308,62,493,273,550,0,3.89%
2018-02,הצפון,1,מ.א. הגליל העליון,מועצה איזורית,194,85,109,65,129,8,192,0,2.15%
2018-02,הצפון,3,מ.א. הגליל התחתון,מועצה איזורית,98,40,58,26,72,6,96,0,1.59%
2018-02,הצפון,55,מ.א. מבואות החרמון,מועצה איזורית,98,38,60,25,73,17,97,0,2.42%
2018-02,הצפון,13,מ.א. מגידו,מועצה איזורית,78,39,39,27,51,8,78,0,1.38%
2018-02,הצפון,4,מ.א. מטה אשר,מועצה איזורית,476,220,256,99,377,139,464,0,3.27%
2018-02,הצפון,52,מ.א. מעלה יוסף,מועצה איזורית,166,73,93,22,144,37,162,0,2.83%
2018-02,הצפון,2,מ.א. מרום הגליל,מועצה איזורית,252,122,130,34,218,85,247,0,3.46%
2018-02,הצפון,56,מ.א. משגב,מועצה איזורית,513,200,313,117,396,251,497,0,3.51%
2018-02,הצפון,6,מ.א. עמק הירדן,מועצה איזורית,183,85,98,50,133,28,167,0,2.46%
2018-02,הצפון,7,מ.א. עמק המעיינות,מועצה איזורית,157,71,86,30,127,30,153,0,2.34%
2018-02,הצפון,9,מ.א. עמק יזרעאל,מועצה איזורית,348,161,187,171,177,27,344,0,1.76%
2018-02,הצפון,481,מגאר,יישוב,1012,439,573,16,996,777,982,5,9.22%
2018-02,הצפון,516,מג'ד אל-כרום,יישוב,411,200,211,13,398,269,400,6,5.44%
2018-02,הצפון,65,מגדל,יישוב,34,19,15,1,33,11,28,1,2.82%
2018-02,הצפון,874,מגדל העמק,יישוב,758,341,417,83,675,247,709,48,5.16%
2018-02,הצפון,4201,מג'דל שמס,יישוב,384,142,242,15,369,265,367,4,6.94%
2018-02,הצפון,517,מזרעה,יישוב,128,60,68,0,128,85,123,4,5.75%
2018-02,הצפון,43,מטולה,יישוב,23,12,11,8,15,5,21,0,2.09%
2018-02,הצפון,4203,מסעדה,יישוב,207,89,118,7,200,145,198,3,10.70%
2018-02,הצפון,518,מעיליא,יישוב,50,25,25,6,44,19,47,0,2.74%
2018-02,הצפון,1063,מעלות-תרשיחא,יישוב,632,305,327,68,564,313,586,32,4.83%
2018-02,הצפון,520,משהד,יישוב,162,71,91,5,157,117,159,1,4.43%
2018-02,הצפון,9100,נהרייה,יישוב,1656,807,849,171,1485,769,1549,51,4.89%
2018-02,הצפון,522,נחף,יישוב,327,151,176,11,316,241,319,1,5.71%
2018-02,הצפון,7300,נצרת,יישוב,2436,1139,1297,109,2327,1756,2414,18,6.54%
2018-02,הצפון,1061,נצרת עילית,יישוב,1278,612,666,143,1135,527,1134,89,4.83%
2018-02,הצפון,525,סאג'ור,יישוב,107,40,67,7,100,67,105,1,4.82%
2018-02,הצפון,7500,סח'נין,יישוב,1565,723,842,34,1531,1215,1549,14,9.99%
2018-02,הצפון,4501,ע'ג'ר,יישוב,86,39,47,4,82,48,84,0,6.97%
2018-02,הצפון,530,עיילבון,יישוב,144,74,70,5,139,79,140,1,4.82%
2018-02,הצפון,511,עילוט,יישוב,227,96,131,2,225,183,225,0,7.04%
2018-02,הצפון,532,עין מאהל,יישוב,321,173,148,6,315,226,311,3,5.32%
2018-02,הצפון,4502,עין קנייא,יישוב,125,50,75,3,122,91,123,0,10.90%
2018-02,הצפון,7600,עכו,יישוב,2506,1153,1353,137,2369,1729,2393,39,8.82%
2018-02,הצפון,7700,עפולה,יישוב,1369,569,800,173,1196,482,1291,51,4.71%
2018-02,הצפון,531,עראבה,יישוב,1059,458,601,30,1029,868,1048,11,9.34%
2018-02,הצפון,535,פסוטה,יישוב,77,42,35,6,71,38,73,1,4.07%
2018-02,הצפון,536,פקיעין (בוקייעה),יישוב,102,46,56,3,99,64,99,3,3.31%
2018-02,הצפון,8000,צפת,יישוב,895,486,409,91,804,512,842,18,6.06%
2018-02,הצפון,4100,קצרין,יישוב,172,78,94,37,135,65,165,5,4.12%
2018-02,הצפון,2800,קריית שמונה,יישוב,608,307,301,68,540,245,587,27,4.54%
2018-02,הצפון,543,ראמה,יישוב,223,100,123,11,212,148,218,2,5.31%
2018-02,הצפון,26,ראש פינה,יישוב,48,14,34,15,33,18,47,0,2.85%
2018-02,הצפון,542,ריינה,יישוב,397,200,197,11,386,288,387,9,5.24%
2018-02,הצפון,122,רמת ישי,יישוב,82,31,51,31,51,11,82,0,1.99%
2018-02,הצפון,913,שבלי - אום אל-גנם,יישוב,155,59,96,6,149,89,153,1,5.39%
2018-02,הצפון,812,שלומי,יישוב,198,88,110,16,182,82,189,3,5.17%
2018-02,הצפון,538,שעב,יישוב,342,153,189,1,341,278,339,4,10.14%
2018-02,הצפון,8800,שפרעם,יישוב,1193,528,665,32,1161,884,1166,21,5.97%
2018-02,חיפה,1326,"בסמ""ה",יישוב,295,139,156,2,293,218,288,9,6.45%
2018-02,חיפה,2710,אום אל-פחם,יישוב,2349,999,1350,28,2321,1884,2303,36,9.89%
2018-02,חיפה,1020,אור עקיבא,יישוב,396,183,213,38,358,96,378,19,3.61%
2018-02,חיפה,6000,באקה אל-גרביה,יישוב,530,260,270,16,514,299,519,21,3.98%
2018-02,חיפה,9800,בנימינה-גבעת עדה*,יישוב,155,74,81,62,93,19,153,3,2.04%
2018-02,חיפה,541,ג'סר א-זרקא,יישוב,187,106,81,0,187,66,180,8,2.82%
2018-02,חיפה,628,ג'ת,יישוב,198,95,103,12,186,99,197,3,3.40%
2018-02,חיפה,494,דאלית אל-כרמל,יישוב,406,161,245,16,390,201,383,5,4.37%
2018-02,חיפה,9300,זכרון יעקב,יישוב,224,91,133,88,136,22,223,1,1.96%
2018-02,חיפה,6500,חדרה,יישוב,2004,923,1081,263,1741,561,1898,39,3.65%
2018-02,חיפה,4000,חיפה,יישוב,5101,2496,2605,1093,4008,2177,4781,132,3.39%
2018-02,חיפה,1247,חריש,יישוב,120,44,76,37,83,9,116,0,2.72%
2018-02,חיפה,2100,טירת כרמל,יישוב,643,334,309,56,587,321,611,16,4.98%
2018-02,חיפה,654,כפר קרע,יישוב,382,175,207,22,360,207,372,7,3.96%
2018-02,חיפה,45,מ.א. אלונה,מועצה איזורית,25,9,16,12,13,1,25,0,2.34%
2018-02,חיפה,12,מ.א. זבולון,מועצה איזורית,195,106,89,22,173,105,187,0,3.15%
2018-02,חיפה,15,מ.א. חוף הכרמל,מועצה איזורית,332,150,182,130,202,52,325,0,2.19%
2018-02,חיפה,14,מ.א. מנשה,מועצה איזורית,229,91,138,70,159,48,228,0,2.65%
2018-02,חיפה,1327,מעלה עירון,יישוב,590,257,333,10,580,452,578,6,8.83%
2018-02,חיפה,2500,נשר,יישוב,388,211,177,84,304,125,372,14,2.93%
2018-02,חיפה,534,עספיא,יישוב,323,141,182,16,307,143,304,6,4.94%
2018-02,חיפה,637,ערערה,יישוב,453,207,246,14,439,270,431,16,4.80%
2018-02,חיפה,537,פוריידיס,יישוב,212,130,82,9,203,48,210,2,3.45%
2018-02,חיפה,7800,פרדס חנה-כרכור,יישוב,704,311,393,184,520,108,686,17,3.19%
2018-02,חיפה,6800,קריית אתא,יישוב,1307,594,713,128,1179,528,1264,39,4.08%
2018-02,חיפה,9500,קריית ביאליק,יישוב,854,389,465,101,753,293,827,17,3.87%
2018-02,חיפה,2300,קריית טבעון,יישוב,173,82,91,77,96,16,173,1,2.06%
2018-02,חיפה,9600,קריית ים,יישוב,1101,523,578,85,1016,563,1057,31,4.99%
2018-02,חיפה,8200,קריית מוצקין,יישוב,804,365,439,128,676,282,766,18,3.29%
2018-02,חיפה,922,רכסים,יישוב,119,54,65,8,111,51,109,1,2.92%
2018-02,ירושלים,472,אבו גוש,יישוב,195,100,95,6,189,150,193,0,5.58%
2018-02,ירושלים,2610,בית שמש,יישוב,1057,492,565,94,963,320,1023,37,2.74%
2018-02,ירושלים,3000,ירושלים,יישוב,10616,4808,5808,1367,9249,6028,10335,125,3.23%
2018-02,ירושלים,26,מ.א. מטה יהודה,מועצה איזורית,503,245,258,149,354,89,492,0,1.90%
2018-02,ירושלים,1015,מבשרת ציון,יישוב,293,154,139,68,225,82,287,4,2.25%
2018-02,ירושלים,1137,קריית יערים,יישוב,41,12,29,8,33,11,41,0,2.30%
2018-02,תל אביב,2400,אור יהודה,יישוב,592,281,311,50,542,110,569,35,2.96%
2018-02,תל אביב,565,אזור,יישוב,163,81,82,32,131,21,161,3,2.41%
2018-02,תל אביב,6100,בני ברק,יישוב,1520,764,756,89,1431,524,1427,21,2.36%
2018-02,תל אביב,6200,בת ים,יישוב,2516,1254,1262,378,2138,771,2385,94,3.38%
2018-02,תל אביב,6300,גבעתיים,יישוב,760,337,423,366,394,63,749,6,2.35%
2018-02,תל אביב,6400,הרצלייה,יישוב,1025,461,564,369,656,40,1011,8,2.06%
2018-02,תל אביב,6600,חולון,יישוב,2805,1271,1534,513,2292,498,2729,42,2.71%
2018-02,תל אביב,267,כפר שמריהו,יישוב,7,2,5,5,2,0,7,0,0.84%
2018-02,תל אביב,2620,קריית אונו,יישוב,398,172,226,188,210,29,393,3,2.01%
2018-02,תל אביב,8600,רמת גן,יישוב,1934,912,1022,723,1211,265,1899,18,2.32%
2018-02,תל אביב,2650,רמת השרון,יישוב,392,162,230,182,210,15,390,5,1.70%
2018-02,תל אביב,5000,תל אביב -יפו,יישוב,6940,3469,3471,2918,4022,1237,6801,78,2.58%
2018-03,אזור יהודה והשומרון,3760,אורנית,יישוב,105,45,60,41,64,1,105,1,2.09%
2018-03,אזור יהודה והשומרון,3750,אלפי מנשה,יישוב,86,34,52,35,51,0,86,0,1.94%
2018-03,אזור יהודה והשומרון,3560,אלקנה,יישוב,32,19,13,16,16,0,32,0,1.74%
2018-03,אזור יהודה והשומרון,3650,אפרת,יישוב,64,34,30,35,29,3,63,1,1.28%
2018-03,אזור יהודה והשומרון,3570,אריאל,יישוב,249,102,147,54,195,19,246,7,2.24%
2018-03,אזור יהודה והשומרון,3574,בית אל,יישוב,40,21,19,8,32,10,39,1,1.57%
2018-03,אזור יהודה והשומרון,3652,בית אריה,יישוב,56,23,33,12,44,0,56,0,1.95%
2018-03,אזור יהודה והשומרון,3780,ביתר עילית,יישוב,403,192,211,10,393,124,397,5,2.56%
2018-03,אזור יהודה והשומרון,3730,גבעת זאב,יישוב,172,88,84,42,130,31,172,1,2.12%
2018-03,אזור יהודה והשומרון,3769,הר אדר,יישוב,35,17,18,13,22,4,35,0,1.60%
2018-03,אזור יהודה והשומרון,76,מ.א. גוש עציון,מועצה איזורית,171,85,86,66,105,16,170,0,1.68%
2018-03,אזור יהודה והשומרון,78,מ.א. הר חברון,מועצה איזורית,75,43,32,38,37,1,73,0,1.84%
2018-03,אזור יהודה והשומרון,74,מ.א. מגילות ים המלח,מועצה איזורית,28,9,19,12,16,1,28,0,3.04%
2018-03,אזור יהודה והשומרון,73,מ.א. מטה בנימין,מועצה איזורית,560,298,262,186,374,72,551,0,1.94%
2018-03,אזור יהודה והשומרון,75,מ.א. ערבות הירדן,מועצה איזורית,52,22,30,16,36,4,51,0,1.98%
2018-03,אזור יהודה והשומרון,72,מ.א. שומרון,מועצה איזורית,355,167,188,142,213,16,354,0,1.87%
2018-03,אזור יהודה והשומרון,3797,מודיעין עילית,יישוב,385,131,254,25,360,22,383,1,2.40%
2018-03,אזור יהודה והשומרון,3616,מעלה אדומים,יישוב,538,260,278,87,451,117,529,16,2.53%
2018-03,אזור יהודה והשומרון,3608,מעלה אפרים,יישוב,30,13,17,0,30,8,30,0,3.75%
2018-03,אזור יהודה והשומרון,3660,עמנואל,יישוב,40,22,18,3,37,15,40,0,2.96%
2018-03,אזור יהודה והשומרון,3557,קדומים,יישוב,32,19,13,13,19,1,32,1,1.60%
2018-03,אזור יהודה והשומרון,3611,קריית ארבע,יישוב,78,43,35,10,68,34,75,5,2.24%
2018-03,אזור יהודה והשומרון,3640,קרני שומרון,יישוב,66,32,34,24,42,1,64,1,1.58%
2018-03,הדרום,31,אופקים,יישוב,742,339,403,39,703,350,716,42,4.99%
2018-03,הדרום,2600,אילת,יישוב,1012,529,483,49,963,284,955,49,2.77%
2018-03,הדרום,70,אשדוד,יישוב,4657,2058,2599,655,4002,1907,4444,89,3.97%
2018-03,הדרום,7100,אשקלון,יישוב,3184,1408,1776,360,2824,1315,2907,64,3.93%
2018-03,הדרום,9000,באר שבע,יישוב,5194,2457,2737,746,4448,2493,4914,99,4.58%
2018-03,הדרום,2200,דימונה,יישוב,1594,778,816,84,1510,995,1503,22,7.71%
2018-03,הדרום,1303,חורה,יישוב,475,193,282,4,471,400,461,3,9.62%
2018-03,הדרום,831,ירוחם,יישוב,360,186,174,10,350,194,336,27,6.58%
2018-03,הדרום,1059,כסיפה,יישוב,986,382,604,2,984,882,968,26,17.77%
2018-03,הדרום,1271,להבים,יישוב,39,17,22,20,19,1,39,0,1.11%
2018-03,הדרום,1060,לקיה,יישוב,560,247,313,8,552,483,537,2,11.05%
2018-03,הדרום,69,מ.א. אל קסום,מועצה איזורית,604,233,371,4,600,517,584,0,17.12%
2018-03,הדרום,38,מ.א. אשכול,מועצה איזורית,118,60,58,24,94,12,116,0,1.65%
2018-03,הדרום,33,מ.א. באר טוביה,מועצה איזורית,280,111,169,63,217,39,276,0,2.44%
2018-03,הדרום,41,מ.א. בני שמעון,מועצה איזורית,84,30,54,32,52,17,80,0,1.65%
2018-03,הדרום,54,מ.א. הערבה התיכונה,מועצה איזורית,22,11,11,13,9,1,22,0,1.15%
2018-03,הדרום,53,מ.א. חבל אילות,מועצה איזורית,21,9,12,4,17,0,18,1,0.72%
2018-03,הדרום,36,מ.א. חוף אשקלון,מועצה איזורית,227,108,119,39,188,37,220,0,2.53%
2018-03,הדרום,35,מ.א. יואב,מועצה איזורית,78,33,45,26,52,10,78,0,1.91%
2018-03,הדרום,50,מ.א. לכיש,מועצה איזורית,137,75,62,20,117,36,135,0,2.42%
2018-03,הדרום,42,מ.א. מרחבים,מועצה איזורית,160,67,93,23,137,31,156,0,2.48%
2018-03,הדרום,68,מ.א. נווה מדבר,מועצה איזורית,129,48,81,2,127,102,126,0,6.67%
2018-03,הדרום,48,מ.א. רמת נגב,מועצה איזורית,277,130,147,21,256,212,272,0,8.16%
2018-03,הדרום,39,מ.א. שדות נגב,מועצה איזורית,113,58,55,24,89,27,109,0,2.24%
2018-03,הדרום,37,מ.א. שער הנגב,מועצה איזורית,88,33,55,38,50,14,83,0,2.08%
2018-03,הדרום,34,מ.א. שפיר,מועצה איזורית,127,66,61,10,117,41,124,0,2.49%
2018-03,הדרום,51,מ.א. תמר,מועצה איזורית,12,4,8,1,11,3,11,0,1.69%
2018-03,הדרום,1268,מיתר,יישוב,65,30,35,31,34,5,64,1,1.30%
2018-03,הדרום,99,מצפה רמון,יישוב,208,78,130,15,193,138,200,18,7.23%
2018-03,הדרום,246,נתיבות,יישוב,837,420,417,56,781,362,781,54,4.77%
2018-03,הדרום,666,עומר,יישוב,48,21,27,21,27,3,48,0,1.14%
2018-03,הדרום,2560,ערד,יישוב,613,277,336,59,554,299,579,27,4.56%
2018-03,הדרום,1192,ערערה-בנגב,יישוב,995,441,554,7,988,883,976,10,18.94%
2018-03,הדרום,2630,קריית גת,יישוב,1657,708,949,119,1538,592,1589,43,5.40%
2018-03,הדרום,1034,קריית מלאכי,יישוב,686,294,392,24,662,272,658,35,5.33%
2018-03,הדרום,1161,רהט,יישוב,1973,830,1143,10,1963,1480,1948,57,8.72%
2018-03,הדרום,1286,שגב-שלום,יישוב,316,130,186,2,314,253,305,5,9.47%
2018-03,הדרום,1031,שדרות,יישוב,871,418,453,60,811,420,800,29,5.40%
2018-03,הדרום,1054,תל שבע,יישוב,686,307,379,5,681,593,645,9,11.24%
2018-03,המרכז,1066,"בני עי""ש",יישוב,133,60,73,20,113,35,130,5,3.24%
2018-03,המרכז,182,אבן יהודה,יישוב,142,62,80,49,93,16,142,0,2.03%
2018-03,המרכז,41,אליכין,יישוב,53,29,24,13,40,10,51,0,2.60%
2018-03,המרכז,1309,אלעד,יישוב,313,137,176,16,297,31,300,2,2.11%
2018-03,המרכז,2530,באר יעקב,יישוב,273,110,163,67,206,31,263,2,2.04%
2018-03,המרכז,466,בית דגן,יישוב,98,52,46,15,83,23,96,0,2.57%
2018-03,המרכז,681,גבעת שמואל,יישוב,226,112,114,87,139,30,224,1,1.80%
2018-03,המרכז,2550,גדרה,יישוב,298,129,169,70,228,57,292,7,2.25%
2018-03,המרכז,627,ג'לג'וליה,יישוב,69,33,36,0,69,28,66,1,1.54%
2018-03,המרכז,166,גן יבנה,יישוב,273,113,160,50,223,49,268,4,2.11%
2018-03,המרכז,229,גני תקווה,יישוב,190,83,107,66,124,21,190,0,1.97%
2018-03,המרכז,9700,הוד השרון,יישוב,706,289,417,341,365,24,697,4,2.13%
2018-03,המרכז,1290,זמר,יישוב,131,49,82,4,127,74,126,2,3.84%
2018-03,המרכז,2730,טייבה,יישוב,864,416,448,22,842,555,730,23,3.78%
2018-03,המרכז,2720,טירה,יישוב,166,91,75,15,151,34,158,10,1.26%
2018-03,המרכז,2660,יבנה,יישוב,683,317,366,150,533,126,674,18,2.67%
2018-03,המרכז,9400,יהוד,יישוב,369,165,204,112,257,38,360,10,2.21%
2018-03,המרכז,1224,כוכב יאיר,יישוב,73,24,49,49,24,0,73,1,1.32%
2018-03,המרכז,633,כפר ברא,יישוב,19,11,8,2,17,5,17,1,1.05%
2018-03,המרכז,168,כפר יונה,יישוב,305,131,174,60,245,39,304,5,2.59%
2018-03,המרכז,6900,כפר סבא,יישוב,1133,520,613,446,687,68,1118,17,2.11%
2018-03,המרכז,634,כפר קאסם,יישוב,169,82,87,3,166,81,164,1,1.59%
2018-03,המרכז,7000,לוד,יישוב,1552,771,781,144,1408,732,1507,34,4.08%
2018-03,המרכז,28,מ.א. ברנר,מועצה איזורית,57,25,32,32,25,1,57,0,1.40%
2018-03,המרכז,32,מ.א. גדרות,מועצה איזורית,36,20,16,15,21,2,36,0,1.46%
2018-03,המרכז,30,מ.א. גזר,מועצה איזורית,272,125,147,101,171,22,267,0,1.99%
2018-03,המרכז,27,מ.א. גן רווה,מועצה איזורית,57,27,30,19,38,1,57,1,1.90%
2018-03,המרכז,20,מ.א. דרום השרון,מועצה איזורית,332,155,177,148,184,11,328,0,2.03%
2018-03,המרכז,29,מ.א. חבל יבנה,מועצה איזורית,41,15,26,27,14,2,41,0,1.57%
2018-03,המרכז,25,מ.א. חבל מודיעין,מועצה איזורית,214,104,110,81,133,24,210,0,1.91%
2018-03,המרכז,19,מ.א. חוף השרון,מועצה איזורית,99,34,65,43,56,3,99,0,1.78%
2018-03,המרכז,18,מ.א. לב השרון,מועצה איזורית,227,99,128,68,159,20,223,0,2.01%
2018-03,המרכז,31,מ.א. נחל שורק,מועצה איזורית,42,15,27,15,27,5,41,42,0.98%
2018-03,המרכז,16,מ.א. עמק חפר,מועצה איזורית,383,168,215,139,244,13,382,0,1.94%
2018-03,המרכז,40,מ.א. שדות דן,מועצה איזורית,135,64,71,35,100,12,132,0,2.05%
2018-03,המרכז,1200,מודיעין-מכבים-רעות*,יישוב,796,329,467,398,398,29,792,11,1.72%
2018-03,המרכז,28,מזכרת בתיה,יישוב,155,70,85,53,102,20,153,0,1.88%
2018-03,המרכז,7200,נס ציונה,יישוב,576,258,318,175,401,121,567,4,2.29%
2018-03,המרכז,7400,נתניה,יישוב,3684,1764,1920,471,3213,952,3602,83,3.32%
2018-03,המרכז,587,סביון*,יישוב,23,5,18,12,11,0,23,0,1.10%
2018-03,המרכז,171,פרדסייה,יישוב,84,37,47,20,64,4,82,0,2.18%
2018-03,המרכז,7900,פתח תקווה,יישוב,3504,1617,1887,777,2727,720,3407,33,2.64%
2018-03,המרכז,195,קדימה-צורן,יישוב,257,110,147,94,163,23,251,0,2.14%
2018-03,המרכז,638,קלנסווה,יישוב,321,164,157,13,308,191,283,19,2.92%
2018-03,המרכז,469,קריית עקרון,יישוב,205,103,102,27,178,82,200,7,3.29%
2018-03,המרכז,2640,ראש העין,יישוב,778,348,430,171,607,112,771,14,2.49%
2018-03,המרכז,8300,ראשון לציון,יישוב,3708,1653,2055,815,2893,799,3665,30,2.61%
2018-03,המרכז,8400,רחובות,יישוב,1976,917,1059,532,1444,549,1923,39,2.71%
2018-03,המרכז,8500,רמלה,יישוב,1336,628,708,93,1243,472,1279,44,3.30%
2018-03,המרכז,8700,רעננה,יישוב,689,319,370,345,344,25,682,4,1.80%
2018-03,המרכז,1304,שוהם,יישוב,185,88,97,102,83,6,183,2,1.51%
2018-03,המרכז,154,תל מונד,יישוב,146,68,78,52,94,15,145,0,2.10%
2018-03,הצפון,473,אבו סנאן,יישוב,524,234,290,8,516,375,509,5,8.04%
2018-03,הצפון,478,אכסאל,יישוב,393,174,219,11,382,311,390,5,6.13%
2018-03,הצפון,529,אעבלין,יישוב,375,166,209,12,363,280,369,4,5.95%
2018-03,הצפון,482,בועיינה-נוג'ידאת,יישוב,236,113,123,13,223,158,231,3,5.34%
2018-03,הצפון,4001,בוקעאתא,יישוב,334,131,203,6,328,250,325,2,10.72%
2018-03,הצפון,998,ביר אל-מכסור,יישוב,255,116,139,4,251,178,252,1,6.05%
2018-03,הצפון,480,בית ג'ן,יישוב,371,101,270,6,365,234,361,2,6.00%
2018-03,הצפון,9200,בית שאן,יישוב,597,276,321,24,573,270,577,30,5.51%
2018-03,הצפון,944,בסמת טבעון,יישוב,152,75,77,5,147,89,140,5,3.88%
2018-03,הצפון,483,בענה,יישוב,318,133,185,10,308,261,299,1,7.68%
2018-03,הצפון,1292,ג'דיידה-מכר,יישוב,1017,469,548,8,1009,755,995,15,9.65%
2018-03,הצפון,485,ג'ולס,יישוב,158,39,119,2,156,83,156,2,4.78%
2018-03,הצפון,487,ג'ש (גוש חלב),יישוב,38,17,21,4,34,20,38,1,2.23%
2018-03,הצפון,489,דבורייה,יישוב,230,99,131,14,216,165,225,4,4.76%
2018-03,הצפון,490,דייר אל-אסד,יישוב,320,135,185,11,309,224,306,5,5.32%
2018-03,הצפון,492,דייר חנא,יישוב,480,223,257,13,467,335,478,5,9.03%
2018-03,הצפון,975,זרזיר,יישוב,180,78,102,3,177,109,177,4,4.94%
2018-03,הצפון,496,חורפיש,יישוב,99,45,54,8,91,45,90,5,2.95%
2018-03,הצפון,2034,חצור הגלילית,יישוב,220,100,120,20,200,99,206,3,4.22%
2018-03,הצפון,6700,טבריה,יישוב,1270,629,641,83,1187,591,1126,50,5.05%
2018-03,הצפון,962,טובא-זנגרייה,יישוב,284,127,157,3,281,187,269,1,7.92%
2018-03,הצפון,498,טורעאן,יישוב,304,141,163,13,291,219,300,12,4.75%
2018-03,הצפון,8900,טמרה,יישוב,1169,562,607,22,1147,913,1143,12,7.35%
2018-03,הצפון,1295,יאנוח-ג'ת,יישוב,120,43,77,1,119,65,113,5,3.53%
2018-03,הצפון,46,יבנאל,יישוב,72,40,32,7,65,34,60,3,3.81%
2018-03,הצפון,29,יסוד המעלה,יישוב,17,4,13,7,10,5,16,0,1.82%
2018-03,הצפון,499,יפיע,יישוב,454,202,252,26,428,329,451,6,5.22%
2018-03,הצפון,240,יקנעם עילית,יישוב,402,188,214,98,304,88,392,27,3.04%
2018-03,הצפון,502,ירכא,יישוב,350,151,199,2,348,238,347,1,4.95%
2018-03,הצפון,504,כאבול,יישוב,387,210,177,9,378,302,376,4,6.95%
2018-03,הצפון,505,כאוכב אבו אל-היג'א,יישוב,172,67,105,7,165,137,172,2,9.11%
2018-03,הצפון,1296,כסרא-סמיע,יישוב,181,64,117,1,180,106,170,4,4.37%
2018-03,הצפון,978,כעביה-טבאש-חג'אג'רה,יישוב,168,58,110,5,163,105,161,3,6.20%
2018-03,הצפון,1263,כפר ורדים,יישוב,60,20,40,20,40,6,57,0,1.83%
2018-03,הצפון,507,כפר יאסיף,יישוב,353,166,187,4,349,240,339,1,6.25%
2018-03,הצפון,508,כפר כמא,יישוב,34,14,20,7,27,13,33,1,1.92%
2018-03,הצפון,509,כפר כנא,יישוב,661,335,326,28,633,509,633,10,6.54%
2018-03,הצפון,510,כפר מנדא,יישוב,587,314,273,13,574,414,582,3,7.24%
2018-03,הצפון,47,כפר תבור,יישוב,42,20,22,16,26,3,42,0,1.77%
2018-03,הצפון,1139,כרמיאל,יישוב,1328,560,768,258,1070,619,1219,28,4.70%
2018-03,הצפון,65,מ.א. אל-בטוף,מועצה איזורית,237,118,119,10,227,164,226,2,6.95%
2018-03,הצפון,66,מ.א. בוסתן אל-מרג,מועצה איזורית,28,7,21,0,28,24,28,0,0.80%
2018-03,הצפון,71,מ.א. גולן,מועצה איזורית,204,86,118,71,133,14,203,0,2.31%
2018-03,הצפון,8,מ.א. הגלבוע,מועצה איזורית,541,241,300,57,484,275,533,0,3.77%
2018-03,הצפון,1,מ.א. הגליל העליון,מועצה איזורית,183,74,109,62,121,8,182,0,2.03%
2018-03,הצפון,3,מ.א. הגליל התחתון,מועצה איזורית,99,39,60,28,71,7,95,0,1.58%
2018-03,הצפון,55,מ.א. מבואות החרמון,מועצה איזורית,106,41,65,25,81,23,104,0,2.60%
2018-03,הצפון,13,מ.א. מגידו,מועצה איזורית,84,38,46,31,53,9,84,0,1.49%
2018-03,הצפון,4,מ.א. מטה אשר,מועצה איזורית,444,193,251,99,345,140,435,0,3.06%
2018-03,הצפון,52,מ.א. מעלה יוסף,מועצה איזורית,153,72,81,21,132,36,151,0,2.63%
2018-03,הצפון,2,מ.א. מרום הגליל,מועצה איזורית,242,110,132,31,211,81,233,0,3.26%
2018-03,הצפון,56,מ.א. משגב,מועצה איזורית,498,191,307,110,388,243,485,0,3.43%
2018-03,הצפון,6,מ.א. עמק הירדן,מועצה איזורית,186,80,106,48,138,30,173,0,2.55%
2018-03,הצפון,7,מ.א. עמק המעיינות,מועצה איזורית,160,74,86,29,131,30,156,0,2.38%
2018-03,הצפון,9,מ.א. עמק יזרעאל,מועצה איזורית,348,156,192,169,179,29,344,0,1.76%
2018-03,הצפון,481,מגאר,יישוב,1004,433,571,15,989,768,976,7,9.17%
2018-03,הצפון,516,מג'ד אל-כרום,יישוב,425,200,225,13,412,288,410,13,5.57%
2018-03,הצפון,65,מגדל,יישוב,33,17,16,1,32,10,29,2,2.92%
2018-03,הצפון,874,מגדל העמק,יישוב,708,319,389,71,637,223,667,59,4.87%
2018-03,הצפון,4201,מג'דל שמס,יישוב,372,135,237,13,359,261,359,2,6.80%
2018-03,הצפון,517,מזרעה,יישוב,123,56,67,0,123,83,116,0,5.44%
2018-03,הצפון,43,מטולה,יישוב,24,12,12,10,14,5,22,1,2.19%
2018-03,הצפון,4203,מסעדה,יישוב,203,84,119,7,196,137,194,1,10.51%
2018-03,הצפון,518,מעיליא,יישוב,49,26,23,6,43,18,48,2,2.80%
2018-03,הצפון,1063,מעלות-תרשיחא,יישוב,634,306,328,70,564,307,596,29,4.91%
2018-03,הצפון,520,משהד,יישוב,162,69,93,3,159,118,158,4,4.41%
2018-03,הצפון,9100,נהרייה,יישוב,1592,777,815,163,1429,763,1490,58,4.71%
2018-03,הצפון,522,נחף,יישוב,334,153,181,10,324,250,327,4,5.84%
2018-03,הצפון,7300,נצרת,יישוב,2415,1134,1281,110,2305,1743,2388,31,6.48%
2018-03,הצפון,1061,נצרת עילית,יישוב,1238,592,646,131,1107,529,1112,86,4.74%
2018-03,הצפון,525,סאג'ור,יישוב,107,41,66,7,100,62,106,1,4.86%
2018-03,הצפון,7500,סח'נין,יישוב,1561,717,844,36,1525,1195,1545,8,9.97%
2018-03,הצפון,4501,ע'ג'ר,יישוב,78,33,45,2,76,45,76,1,6.35%
2018-03,הצפון,530,עיילבון,יישוב,151,72,79,5,146,81,146,1,5.02%
2018-03,הצפון,511,עילוט,יישוב,230,94,136,2,228,181,230,1,7.18%
2018-03,הצפון,532,עין מאהל,יישוב,312,174,138,5,307,216,304,2,5.20%
2018-03,הצפון,4502,עין קנייא,יישוב,118,49,69,2,116,87,114,0,10.19%
2018-03,הצפון,7600,עכו,יישוב,2476,1114,1362,137,2339,1685,2372,36,8.75%
2018-03,הצפון,7700,עפולה,יישוב,1353,570,783,170,1183,467,1284,61,4.69%
2018-03,הצפון,531,עראבה,יישוב,1049,453,596,27,1022,861,1040,7,9.27%
2018-03,הצפון,535,פסוטה,יישוב,82,43,39,9,73,38,77,4,4.28%
2018-03,הצפון,536,פקיעין (בוקייעה),יישוב,109,53,56,6,103,67,105,5,3.50%
2018-03,הצפון,8000,צפת,יישוב,865,456,409,89,776,512,816,19,5.88%
2018-03,הצפון,4100,קצרין,יישוב,162,73,89,32,130,61,156,6,3.90%
2018-03,הצפון,2800,קריית שמונה,יישוב,612,301,311,66,546,242,588,29,4.54%
2018-03,הצפון,543,ראמה,יישוב,224,103,121,10,214,151,215,1,5.24%
2018-03,הצפון,26,ראש פינה,יישוב,46,15,31,15,31,18,45,0,2.73%
2018-03,הצפון,542,ריינה,יישוב,400,196,204,11,389,293,388,5,5.25%
2018-03,הצפון,122,רמת ישי,יישוב,81,25,56,30,51,15,80,1,1.94%
2018-03,הצפון,913,שבלי - אום אל-גנם,יישוב,148,56,92,5,143,93,145,8,5.12%
2018-03,הצפון,812,שלומי,יישוב,184,77,107,15,169,78,175,4,4.81%
2018-03,הצפון,538,שעב,יישוב,341,156,185,1,340,279,338,1,10.11%
2018-03,הצפון,8800,שפרעם,יישוב,1186,531,655,36,1150,874,1153,18,5.91%
2018-03,חיפה,1326,"בסמ""ה",יישוב,301,138,163,4,297,225,297,4,6.64%
2018-03,חיפה,2710,אום אל-פחם,יישוב,2314,998,1316,29,2285,1856,2258,38,9.72%
2018-03,חיפה,1020,אור עקיבא,יישוב,431,197,234,48,383,95,414,11,3.94%
2018-03,חיפה,6000,באקה אל-גרביה,יישוב,524,259,265,17,507,301,512,20,3.93%
2018-03,חיפה,9800,בנימינה-גבעת עדה*,יישוב,156,73,83,67,89,16,153,1,2.04%
2018-03,חיפה,541,ג'סר א-זרקא,יישוב,180,103,77,0,180,70,173,11,2.71%
2018-03,חיפה,628,ג'ת,יישוב,192,93,99,10,182,94,191,2,3.30%
2018-03,חיפה,494,דאלית אל-כרמל,יישוב,399,161,238,16,383,201,375,6,4.28%
2018-03,חיפה,9300,זכרון יעקב,יישוב,210,80,130,86,124,17,209,0,1.84%
2018-03,חיפה,6500,חדרה,יישוב,1976,926,1050,276,1700,547,1879,31,3.62%
2018-03,חיפה,4000,חיפה,יישוב,5070,2448,2622,1122,3948,2160,4756,122,3.37%
2018-03,חיפה,1247,חריש,יישוב,115,37,78,34,81,8,112,1,2.63%
2018-03,חיפה,2100,טירת כרמל,יישוב,625,304,321,56,569,314,601,17,4.91%
2018-03,חיפה,654,כפר קרע,יישוב,366,171,195,20,346,202,359,11,3.82%
2018-03,חיפה,45,מ.א. אלונה,מועצה איזורית,19,5,14,10,9,2,19,0,1.78%
2018-03,חיפה,12,מ.א. זבולון,מועצה איזורית,199,104,95,23,176,106,188,0,3.17%
2018-03,חיפה,15,מ.א. חוף הכרמל,מועצה איזורית,329,151,178,126,203,50,325,0,2.19%
2018-03,חיפה,14,מ.א. מנשה,מועצה איזורית,242,99,143,71,171,51,240,0,2.79%
2018-03,חיפה,1327,מעלה עירון,יישוב,577,247,330,10,567,442,567,3,8.68%
2018-03,חיפה,2500,נשר,יישוב,360,184,176,80,280,122,345,8,2.72%
2018-03,חיפה,534,עספיא,יישוב,321,139,182,16,305,139,303,2,4.92%
2018-03,חיפה,637,ערערה,יישוב,459,213,246,14,445,267,435,14,4.84%
2018-03,חיפה,537,פוריידיס,יישוב,197,120,77,10,187,46,194,2,3.20%
2018-03,חיפה,7800,פרדס חנה-כרכור,יישוב,679,294,385,197,482,96,666,15,3.10%
2018-03,חיפה,6800,קריית אתא,יישוב,1278,577,701,127,1151,520,1227,36,3.97%
2018-03,חיפה,9500,קריית ביאליק,יישוב,845,376,469,106,739,299,825,23,3.86%
2018-03,חיפה,2300,קריית טבעון,יישוב,182,86,96,73,109,19,180,1,2.14%
2018-03,חיפה,9600,קריית ים,יישוב,1100,522,578,103,997,564,1047,34,4.94%
2018-03,חיפה,8200,קריית מוצקין,יישוב,797,361,436,139,658,259,770,12,3.31%
2018-03,חיפה,922,רכסים,יישוב,118,56,62,10,108,50,110,1,2.95%
2018-03,ירושלים,472,אבו גוש,יישוב,189,93,96,8,181,142,187,1,5.42%
2018-03,ירושלים,2610,בית שמש,יישוב,1023,490,533,90,933,311,982,35,2.63%
2018-03,ירושלים,3000,ירושלים,יישוב,10523,4816,5707,1395,9128,5974,10235,106,3.20%
2018-03,ירושלים,26,מ.א. מטה יהודה,מועצה איזורית,509,240,269,151,358,88,501,0,1.94%
2018-03,ירושלים,1015,מבשרת ציון,יישוב,296,145,151,70,226,85,293,2,2.30%
2018-03,ירושלים,1137,קריית יערים,יישוב,43,15,28,7,36,10,42,0,2.36%
2018-03,תל אביב,2400,אור יהודה,יישוב,598,314,284,54,544,108,572,22,2.97%
2018-03,תל אביב,565,אזור,יישוב,160,71,89,31,129,19,156,5,2.33%
2018-03,תל אביב,6100,בני ברק,יישוב,1519,767,752,84,1435,538,1429,14,2.36%
2018-03,תל אביב,6200,בת ים,יישוב,2391,1199,1192,362,2029,754,2277,58,3.23%
2018-03,תל אביב,6300,גבעתיים,יישוב,755,336,419,384,371,69,745,3,2.34%
2018-03,תל אביב,6400,הרצלייה,יישוב,1025,475,550,384,641,39,1016,13,2.07%
2018-03,תל אביב,6600,חולון,יישוב,2757,1258,1499,498,2259,502,2691,43,2.67%
2018-03,תל אביב,267,כפר שמריהו,יישוב,7,2,5,5,2,0,7,0,0.84%
2018-03,תל אביב,2620,קריית אונו,יישוב,396,173,223,181,215,27,391,2,2.00%
2018-03,תל אביב,8600,רמת גן,יישוב,1961,881,1080,741,1220,252,1923,21,2.35%
2018-03,תל אביב,2650,רמת השרון,יישוב,406,174,232,196,210,17,398,2,1.73%
2018-03,תל אביב,5000,תל אביב -יפו,יישוב,7049,3495,3554,3027,4022,1257,6903,78,2.62%
2018-04,אזור יהודה והשומרון,3760,אורנית,יישוב,108,44,64,41,67,1,108,1,2.15%
2018-04,אזור יהודה והשומרון,3750,אלפי מנשה,יישוב,86,31,55,32,54,0,86,0,1.94%
2018-04,אזור יהודה והשומרון,3560,אלקנה,יישוב,34,19,15,17,17,0,34,0,1.84%
2018-04,אזור יהודה והשומרון,3650,אפרת,יישוב,66,38,28,37,29,2,66,2,1.34%
2018-04,אזור יהודה והשומרון,3570,אריאל,יישוב,234,103,131,49,185,17,228,6,2.08%
2018-04,אזור יהודה והשומרון,3574,בית אל,יישוב,43,22,21,12,31,8,42,3,1.68%
2018-04,אזור יהודה והשומרון,3652,בית אריה,יישוב,51,21,30,10,41,0,51,0,1.78%
2018-04,אזור יהודה והשומרון,3780,ביתר עילית,יישוב,388,188,200,16,372,118,380,3,2.46%
2018-04,אזור יהודה והשומרון,3730,גבעת זאב,יישוב,167,74,93,33,134,32,167,1,2.06%
2018-04,אזור יהודה והשומרון,3769,הר אדר,יישוב,36,17,19,14,22,3,36,0,1.64%
2018-04,אזור יהודה והשומרון,76,מ.א. גוש עציון,מועצה איזורית,164,77,87,67,97,11,163,0,1.61%
2018-04,אזור יהודה והשומרון,78,מ.א. הר חברון,מועצה איזורית,66,40,26,34,32,2,65,0,1.64%
2018-04,אזור יהודה והשומרון,74,מ.א. מגילות ים המלח,מועצה איזורית,25,8,17,8,17,1,25,0,2.72%
2018-04,אזור יהודה והשומרון,73,מ.א. מטה בנימין,מועצה איזורית,539,275,264,180,359,74,534,0,1.88%
2018-04,אזור יהודה והשומרון,75,מ.א. ערבות הירדן,מועצה איזורית,49,17,32,22,27,3,49,0,1.90%
2018-04,אזור יהודה והשומרון,72,מ.א. שומרון,מועצה איזורית,366,181,185,145,221,17,364,0,1.92%
2018-04,אזור יהודה והשומרון,3797,מודיעין עילית,יישוב,379,125,254,25,354,28,375,3,2.35%
2018-04,אזור יהודה והשומרון,3616,מעלה אדומים,יישוב,507,229,278,88,419,112,499,11,2.39%
2018-04,אזור יהודה והשומרון,3608,מעלה אפרים,יישוב,30,13,17,0,30,8,30,0,3.75%
2018-04,אזור יהודה והשומרון,3660,עמנואל,יישוב,44,23,21,3,41,14,44,1,3.24%
2018-04,אזור יהודה והשומרון,3557,קדומים,יישוב,32,15,17,15,17,0,32,0,1.60%
2018-04,אזור יהודה והשומרון,3611,קריית ארבע,יישוב,79,45,34,12,67,32,75,4,2.24%
2018-04,אזור יהודה והשומרון,3640,קרני שומרון,יישוב,64,28,36,22,42,1,63,1,1.56%
2018-04,הדרום,31,אופקים,יישוב,747,343,404,43,704,334,728,19,5.06%
2018-04,הדרום,2600,אילת,יישוב,820,427,393,42,778,254,778,32,2.27%
2018-04,הדרום,70,אשדוד,יישוב,4539,1993,2546,643,3896,1853,4340,73,3.88%
2018-04,הדרום,7100,אשקלון,יישוב,3180,1367,1813,379,2801,1261,2927,49,3.96%
2018-04,הדרום,9000,באר שבע,יישוב,5081,2377,2704,736,4345,2418,4803,76,4.48%
2018-04,הדרום,2200,דימונה,יישוב,1517,759,758,76,1441,953,1437,13,7.39%
2018-04,הדרום,1303,חורה,יישוב,459,193,266,5,454,394,442,4,9.26%
2018-04,הדרום,831,ירוחם,יישוב,364,192,172,10,354,194,332,9,6.51%
2018-04,הדרום,1059,כסיפה,יישוב,944,359,585,1,943,852,932,3,17.22%
2018-04,הדרום,1271,להבים,יישוב,44,20,24,24,20,0,43,0,1.22%
2018-04,הדרום,1060,לקיה,יישוב,546,237,309,7,539,473,524,3,10.81%
2018-04,הדרום,69,מ.א. אל קסום,מועצה איזורית,661,265,396,5,656,563,644,0,18.88%
2018-04,הדרום,38,מ.א. אשכול,מועצה איזורית,119,59,60,29,90,9,117,0,1.67%
2018-04,הדרום,33,מ.א. באר טוביה,מועצה איזורית,276,120,156,57,219,38,273,0,2.41%
2018-04,הדרום,41,מ.א. בני שמעון,מועצה איזורית,82,31,51,34,48,17,82,0,1.69%
2018-04,הדרום,54,מ.א. הערבה התיכונה,מועצה איזורית,25,14,11,14,11,0,25,0,1.31%
2018-04,הדרום,53,מ.א. חבל אילות,מועצה איזורית,26,11,15,4,22,0,24,3,0.97%
2018-04,הדרום,36,מ.א. חוף אשקלון,מועצה איזורית,208,90,118,40,168,31,200,0,2.30%
2018-04,הדרום,35,מ.א. יואב,מועצה איזורית,76,29,47,25,51,12,75,0,1.83%
2018-04,הדרום,50,מ.א. לכיש,מועצה איזורית,149,76,73,23,126,32,148,0,2.66%
2018-04,הדרום,42,מ.א. מרחבים,מועצה איזורית,155,62,93,25,130,32,153,0,2.43%
2018-04,הדרום,68,מ.א. נווה מדבר,מועצה איזורית,128,52,76,2,126,101,124,0,6.56%
2018-04,הדרום,48,מ.א. רמת נגב,מועצה איזורית,277,130,147,21,256,215,273,0,8.20%
2018-04,הדרום,39,מ.א. שדות נגב,מועצה איזורית,114,55,59,20,94,27,108,0,2.22%
2018-04,הדרום,37,מ.א. שער הנגב,מועצה איזורית,84,35,49,34,50,14,82,0,2.06%
2018-04,הדרום,34,מ.א. שפיר,מועצה איזורית,143,69,74,14,129,42,140,0,2.81%
2018-04,הדרום,51,מ.א. תמר,מועצה איזורית,11,3,8,2,9,3,10,0,1.54%
2018-04,הדרום,1268,מיתר,יישוב,65,33,32,33,32,4,64,0,1.30%
2018-04,הדרום,99,מצפה רמון,יישוב,203,83,120,12,191,139,193,10,7.00%
2018-04,הדרום,246,נתיבות,יישוב,876,407,469,66,810,359,823,32,5.01%
2018-04,הדרום,666,עומר,יישוב,38,16,22,14,24,3,38,0,0.90%
2018-04,הדרום,2560,ערד,יישוב,589,271,318,53,536,286,561,31,4.43%
2018-04,הדרום,1192,ערערה-בנגב,יישוב,943,411,532,6,937,845,930,12,18.21%
2018-04,הדרום,2630,קריית גת,יישוב,1670,688,982,130,1540,582,1595,31,5.42%
2018-04,הדרום,1034,קריית מלאכי,יישוב,723,324,399,23,700,276,691,24,5.58%
2018-04,הדרום,1161,רהט,יישוב,1912,770,1142,7,1905,1427,1883,42,8.46%
2018-04,הדרום,1286,שגב-שלום,יישוב,307,122,185,3,304,261,296,3,9.22%
2018-04,הדרום,1031,שדרות,יישוב,864,408,456,57,807,406,783,27,5.29%
2018-04,הדרום,1054,תל שבע,יישוב,647,285,362,4,643,571,608,3,10.67%
2018-04,המרכז,1066,"בני עי""ש",יישוב,120,55,65,16,104,29,117,2,2.92%
2018-04,המרכז,182,אבן יהודה,יישוב,135,60,75,57,78,14,134,3,1.92%
2018-04,המרכז,41,אליכין,יישוב,53,29,24,14,39,9,51,0,2.60%
2018-04,המרכז,1309,אלעד,יישוב,302,133,169,17,285,21,288,2,2.03%
2018-04,המרכז,2530,באר יעקב,יישוב,279,112,167,70,209,26,270,2,2.10%
2018-04,המרכז,466,בית דגן,יישוב,97,51,46,17,80,22,93,0,2.49%
2018-04,המרכז,681,גבעת שמואל,יישוב,234,119,115,91,143,27,230,2,1.84%
2018-04,המרכז,2550,גדרה,יישוב,298,133,165,65,233,59,291,8,2.24%
2018-04,המרכז,627,ג'לג'וליה,יישוב,61,28,33,0,61,29,59,0,1.38%
2018-04,המרכז,166,גן יבנה,יישוב,268,112,156,50,218,50,263,1,2.07%
2018-04,המרכז,229,גני תקווה,יישוב,194,79,115,69,125,21,193,1,2.00%
2018-04,המרכז,9700,הוד השרון,יישוב,674,269,405,333,341,27,667,7,2.04%
2018-04,המרכז,1290,זמר,יישוב,132,46,86,4,128,77,127,0,3.87%
2018-04,המרכז,2730,טייבה,יישוב,835,405,430,20,815,533,701,21,3.64%
2018-04,המרכז,2720,טירה,יישוב,130,73,57,16,114,22,125,10,1.00%
2018-04,המרכז,2660,יבנה,יישוב,663,300,363,141,522,128,652,28,2.59%
2018-04,המרכז,9400,יהוד,יישוב,352,155,197,110,242,39,342,8,2.10%
2018-04,המרכז,1224,כוכב יאיר,יישוב,73,26,47,52,21,0,73,0,1.32%
2018-04,המרכז,633,כפר ברא,יישוב,17,9,8,2,15,5,16,1,0.99%
2018-04,המרכז,168,כפר יונה,יישוב,276,117,159,57,219,40,274,4,2.34%
2018-04,המרכז,6900,כפר סבא,יישוב,1131,493,638,468,663,66,1119,14,2.11%
2018-04,המרכז,634,כפר קאסם,יישוב,170,84,86,3,167,86,164,1,1.59%
2018-04,המרכז,7000,לוד,יישוב,1484,739,745,138,1346,702,1445,26,3.92%
2018-04,המרכז,28,מ.א. ברנר,מועצה איזורית,57,21,36,36,21,1,57,0,1.40%
2018-04,המרכז,32,מ.א. גדרות,מועצה איזורית,32,17,15,13,19,2,32,0,1.30%
2018-04,המרכז,30,מ.א. גזר,מועצה איזורית,267,132,135,106,161,21,265,0,1.97%
2018-04,המרכז,27,מ.א. גן רווה,מועצה איזורית,46,20,26,16,30,2,46,0,1.54%
2018-04,המרכז,20,מ.א. דרום השרון,מועצה איזורית,328,147,181,149,179,10,325,0,2.01%
2018-04,המרכז,29,מ.א. חבל יבנה,מועצה איזורית,42,15,27,25,17,1,41,0,1.56%
2018-04,המרכז,25,מ.א. חבל מודיעין,מועצה איזורית,222,98,124,89,133,25,217,0,1.97%
2018-04,המרכז,19,מ.א. חוף השרון,מועצה איזורית,93,33,60,34,59,3,92,0,1.65%
2018-04,המרכז,18,מ.א. לב השרון,מועצה איזורית,235,100,135,75,160,21,229,0,2.06%
2018-04,המרכז,31,מ.א. נחל שורק,מועצה איזורית,43,14,29,14,29,5,42,19,1.00%
2018-04,המרכז,16,מ.א. עמק חפר,מועצה איזורית,361,167,194,132,229,13,358,0,1.82%
2018-04,המרכז,40,מ.א. שדות דן,מועצה איזורית,125,58,67,39,86,10,124,0,1.92%
2018-04,המרכז,1200,מודיעין-מכבים-רעות*,יישוב,812,341,471,407,405,25,804,5,1.74%
2018-04,המרכז,28,מזכרת בתיה,יישוב,157,72,85,53,104,21,154,0,1.89%
2018-04,המרכז,7200,נס ציונה,יישוב,562,244,318,181,381,119,550,3,2.22%
2018-04,המרכז,7400,נתניה,יישוב,3610,1703,1907,508,3102,926,3533,61,3.26%
2018-04,המרכז,587,סביון*,יישוב,22,6,16,12,10,0,22,0,1.05%
2018-04,המרכז,171,פרדסייה,יישוב,85,36,49,20,65,3,84,1,2.23%
2018-04,המרכז,7900,פתח תקווה,יישוב,3483,1602,1881,778,2705,709,3408,35,2.64%
2018-04,המרכז,195,קדימה-צורן,יישוב,254,111,143,99,155,24,251,0,2.14%
2018-04,המרכז,638,קלנסווה,יישוב,297,145,152,12,285,178,255,8,2.64%
2018-04,המרכז,469,קריית עקרון,יישוב,214,109,105,26,188,86,209,7,3.43%
2018-04,המרכז,2640,ראש העין,יישוב,759,336,423,175,584,92,742,7,2.40%
2018-04,המרכז,8300,ראשון לציון,יישוב,3647,1633,2014,813,2834,773,3608,28,2.57%
2018-04,המרכז,8400,רחובות,יישוב,2013,921,1092,554,1459,546,1956,32,2.76%
2018-04,המרכז,8500,רמלה,יישוב,1276,610,666,95,1181,432,1214,45,3.14%
2018-04,המרכז,8700,רעננה,יישוב,675,306,369,356,319,23,669,7,1.77%
2018-04,המרכז,1304,שוהם,יישוב,181,88,93,97,84,5,180,1,1.49%
2018-04,המרכז,154,תל מונד,יישוב,136,59,77,50,86,13,135,2,1.96%
2018-04,הצפון,473,אבו סנאן,יישוב,520,227,293,7,513,366,510,5,8.06%
2018-04,הצפון,478,אכסאל,יישוב,386,174,212,10,376,303,381,0,6.00%
2018-04,הצפון,529,אעבלין,יישוב,348,153,195,11,337,261,342,7,5.54%
2018-04,הצפון,482,בועיינה-נוג'ידאת,יישוב,219,107,112,7,212,154,217,6,5.03%
2018-04,הצפון,4001,בוקעאתא,יישוב,317,120,197,7,310,237,309,4,10.24%
2018-04,הצפון,998,ביר אל-מכסור,יישוב,245,118,127,4,241,166,243,4,5.85%
2018-04,הצפון,480,בית ג'ן,יישוב,377,96,281,8,369,227,366,1,6.08%
2018-04,הצפון,9200,בית שאן,יישוב,604,286,318,16,588,264,576,23,5.50%
2018-04,הצפון,944,בסמת טבעון,יישוב,137,67,70,5,132,87,125,3,3.48%
2018-04,הצפון,483,בענה,יישוב,294,128,166,8,286,239,281,4,7.26%
2018-04,הצפון,1292,ג'דיידה-מכר,יישוב,989,453,536,7,982,725,976,9,9.48%
2018-04,הצפון,485,ג'ולס,יישוב,141,33,108,1,140,77,141,0,4.34%
2018-04,הצפון,487,ג'ש (גוש חלב),יישוב,44,18,26,6,38,18,43,2,2.52%
2018-04,הצפון,489,דבורייה,יישוב,227,92,135,12,215,161,221,1,4.68%
2018-04,הצפון,490,דייר אל-אסד,יישוב,307,137,170,8,299,216,297,6,5.17%
2018-04,הצפון,492,דייר חנא,יישוב,466,210,256,9,457,338,465,4,8.81%
2018-04,הצפון,975,זרזיר,יישוב,171,71,100,4,167,112,168,1,4.70%
2018-04,הצפון,496,חורפיש,יישוב,104,51,53,9,95,50,93,2,3.05%
2018-04,הצפון,2034,חצור הגלילית,יישוב,225,101,124,21,204,94,208,4,4.26%
2018-04,הצפון,6700,טבריה,יישוב,1228,585,643,83,1145,550,1096,55,4.92%
2018-04,הצפון,962,טובא-זנגרייה,יישוב,288,121,167,5,283,181,277,6,8.14%
2018-04,הצפון,498,טורעאן,יישוב,290,132,158,13,277,214,283,2,4.49%
2018-04,הצפון,8900,טמרה,יישוב,1130,539,591,18,1112,886,1107,11,7.14%
2018-04,הצפון,1295,יאנוח-ג'ת,יישוב,117,43,74,1,116,65,110,5,3.44%
2018-04,הצפון,46,יבנאל,יישוב,67,41,26,6,61,31,59,1,3.75%
2018-04,הצפון,29,יסוד המעלה,יישוב,18,5,13,6,12,6,17,0,1.93%
2018-04,הצפון,499,יפיע,יישוב,423,187,236,25,398,310,419,7,4.87%
2018-04,הצפון,240,יקנעם עילית,יישוב,392,181,211,101,291,81,380,17,2.95%
2018-04,הצפון,502,ירכא,יישוב,310,127,183,2,308,219,308,2,4.41%
2018-04,הצפון,504,כאבול,יישוב,371,204,167,8,363,288,365,2,6.76%
2018-04,הצפון,505,כאוכב אבו אל-היג'א,יישוב,170,65,105,6,164,141,169,1,8.96%
2018-04,הצפון,1296,כסרא-סמיע,יישוב,165,56,109,1,164,100,155,3,4.00%
2018-04,הצפון,978,כעביה-טבאש-חג'אג'רה,יישוב,146,52,94,5,141,100,140,2,5.43%
2018-04,הצפון,1263,כפר ורדים,יישוב,53,19,34,23,30,7,49,1,1.58%
2018-04,הצפון,507,כפר יאסיף,יישוב,335,155,180,4,331,229,323,3,5.97%
2018-04,הצפון,508,כפר כמא,יישוב,31,13,18,5,26,14,30,0,1.74%
2018-04,הצפון,509,כפר כנא,יישוב,644,321,323,25,619,495,617,4,6.39%
2018-04,הצפון,510,כפר מנדא,יישוב,563,305,258,11,552,398,558,4,6.96%
2018-04,הצפון,47,כפר תבור,יישוב,38,16,22,17,21,2,38,0,1.61%
2018-04,הצפון,1139,כרמיאל,יישוב,1280,536,744,259,1021,611,1177,21,4.55%
2018-04,הצפון,65,מ.א. אל-בטוף,מועצה איזורית,210,102,108,9,201,153,199,2,6.10%
2018-04,הצפון,66,מ.א. בוסתן אל-מרג,מועצה איזורית,30,8,22,0,30,25,30,0,0.85%
2018-04,הצפון,71,מ.א. גולן,מועצה איזורית,194,84,110,64,130,15,191,0,2.18%
2018-04,הצפון,8,מ.א. הגלבוע,מועצה איזורית,524,225,299,61,463,251,514,0,3.64%
2018-04,הצפון,1,מ.א. הגליל העליון,מועצה איזורית,175,65,110,64,111,8,175,0,1.96%
2018-04,הצפון,3,מ.א. הגליל התחתון,מועצה איזורית,98,40,58,31,67,5,93,0,1.54%
2018-04,הצפון,55,מ.א. מבואות החרמון,מועצה איזורית,94,34,60,21,73,19,92,0,2.30%
2018-04,הצפון,13,מ.א. מגידו,מועצה איזורית,85,37,48,34,51,8,84,0,1.49%
2018-04,הצפון,4,מ.א. מטה אשר,מועצה איזורית,411,172,239,81,330,142,398,0,2.80%
2018-04,הצפון,52,מ.א. מעלה יוסף,מועצה איזורית,149,66,83,24,125,30,144,0,2.51%
2018-04,הצפון,2,מ.א. מרום הגליל,מועצה איזורית,257,112,145,29,228,89,250,0,3.50%
2018-04,הצפון,56,מ.א. משגב,מועצה איזורית,500,194,306,109,391,243,486,0,3.44%
2018-04,הצפון,6,מ.א. עמק הירדן,מועצה איזורית,149,68,81,43,106,27,142,0,2.09%
2018-04,הצפון,7,מ.א. עמק המעיינות,מועצה איזורית,166,67,99,36,130,31,161,0,2.46%
2018-04,הצפון,9,מ.א. עמק יזרעאל,מועצה איזורית,335,149,186,163,172,27,332,0,1.70%
2018-04,הצפון,481,מגאר,יישוב,958,403,555,16,942,710,937,7,8.84%
2018-04,הצפון,516,מג'ד אל-כרום,יישוב,398,180,218,10,388,283,387,8,5.27%
2018-04,הצפון,65,מגדל,יישוב,40,20,20,3,37,10,38,2,3.79%
2018-04,הצפון,874,מגדל העמק,יישוב,707,327,380,75,632,213,660,44,4.82%
2018-04,הצפון,4201,מג'דל שמס,יישוב,358,128,230,12,346,246,346,4,6.57%
2018-04,הצפון,517,מזרעה,יישוב,119,51,68,0,119,84,111,1,5.22%
2018-04,הצפון,43,מטולה,יישוב,23,15,8,9,14,5,22,0,2.19%
2018-04,הצפון,4203,מסעדה,יישוב,184,74,110,9,175,123,177,2,9.68%
2018-04,הצפון,518,מעיליא,יישוב,45,24,21,5,40,17,43,0,2.51%
2018-04,הצפון,1063,מעלות-תרשיחא,יישוב,616,299,317,71,545,312,573,34,4.73%
2018-04,הצפון,520,משהד,יישוב,155,65,90,2,153,113,150,3,4.19%
2018-04,הצפון,9100,נהרייה,יישוב,1589,770,819,166,1423,737,1481,38,4.68%
2018-04,הצפון,522,נחף,יישוב,334,145,189,7,327,246,325,2,5.81%
2018-04,הצפון,7300,נצרת,יישוב,2345,1103,1242,106,2239,1680,2322,17,6.31%
2018-04,הצפון,1061,נצרת עילית,יישוב,1151,557,594,125,1026,494,1027,55,4.40%
2018-04,הצפון,525,סאג'ור,יישוב,108,37,71,5,103,61,107,1,4.91%
2018-04,הצפון,7500,סח'נין,יישוב,1503,694,809,27,1476,1165,1487,5,9.63%
2018-04,הצפון,4501,ע'ג'ר,יישוב,74,34,40,2,72,42,73,0,6.11%
2018-04,הצפון,530,עיילבון,יישוב,132,63,69,5,127,73,127,2,4.39%
2018-04,הצפון,511,עילוט,יישוב,227,92,135,5,222,175,225,0,7.04%
2018-04,הצפון,532,עין מאהל,יישוב,299,167,132,5,294,213,286,1,4.91%
2018-04,הצפון,4502,עין קנייא,יישוב,107,41,66,2,105,79,105,0,9.46%
2018-04,הצפון,7600,עכו,יישוב,2380,1063,1317,134,2246,1631,2275,16,8.43%
2018-04,הצפון,7700,עפולה,יישוב,1343,569,774,168,1175,456,1267,55,4.63%
2018-04,הצפון,531,עראבה,יישוב,1025,437,588,26,999,851,1013,5,9.06%
2018-04,הצפון,535,פסוטה,יישוב,80,41,39,8,72,39,75,0,4.18%
2018-04,הצפון,536,פקיעין (בוקייעה),יישוב,97,50,47,5,92,64,92,2,3.08%
2018-04,הצפון,8000,צפת,יישוב,870,463,407,85,785,511,820,18,5.91%
2018-04,הצפון,4100,קצרין,יישוב,158,80,78,31,127,64,152,4,3.81%
2018-04,הצפון,2800,קריית שמונה,יישוב,600,296,304,61,539,227,574,27,4.44%
2018-04,הצפון,543,ראמה,יישוב,213,98,115,10,203,147,204,2,4.98%
2018-04,הצפון,26,ראש פינה,יישוב,47,14,33,11,36,18,46,0,2.79%
2018-04,הצפון,542,ריינה,יישוב,405,199,206,10,395,293,394,5,5.33%
2018-04,הצפון,122,רמת ישי,יישוב,78,22,56,29,49,14,77,0,1.87%
2018-04,הצפון,913,שבלי - אום אל-גנם,יישוב,150,54,96,5,145,86,147,3,5.19%
2018-04,הצפון,812,שלומי,יישוב,191,84,107,13,178,86,183,1,5.01%
2018-04,הצפון,538,שעב,יישוב,329,148,181,2,327,265,327,1,9.81%
2018-04,הצפון,8800,שפרעם,יישוב,1126,504,622,29,1097,818,1101,16,5.66%
2018-04,חיפה,1326,"בסמ""ה",יישוב,277,122,155,6,271,212,274,2,6.16%
2018-04,חיפה,2710,אום אל-פחם,יישוב,2177,925,1252,23,2154,1765,2126,28,9.20%
2018-04,חיפה,1020,אור עקיבא,יישוב,408,187,221,47,361,88,391,13,3.73%
2018-04,חיפה,6000,באקה אל-גרביה,יישוב,522,262,260,17,505,296,513,15,3.93%
2018-04,חיפה,9800,בנימינה-גבעת עדה*,יישוב,149,66,83,67,82,14,149,3,1.99%
2018-04,חיפה,541,ג'סר א-זרקא,יישוב,168,88,80,1,167,59,162,5,2.55%
2018-04,חיפה,628,ג'ת,יישוב,186,90,96,8,178,93,185,6,3.20%
2018-04,חיפה,494,דאלית אל-כרמל,יישוב,382,152,230,16,366,190,361,2,4.13%
2018-04,חיפה,9300,זכרון יעקב,יישוב,207,84,123,91,116,12,206,0,1.81%
2018-04,חיפה,6500,חדרה,יישוב,1893,862,1031,275,1618,513,1783,46,3.44%
2018-04,חיפה,4000,חיפה,יישוב,4855,2352,2503,1118,3737,1993,4570,74,3.24%
2018-04,חיפה,1247,חריש,יישוב,119,43,76,37,82,9,117,1,2.75%
2018-04,חיפה,2100,טירת כרמל,יישוב,600,307,293,49,551,296,572,11,4.68%
2018-04,חיפה,654,כפר קרע,יישוב,340,153,187,20,320,184,334,4,3.57%
2018-04,חיפה,45,מ.א. אלונה,מועצה איזורית,16,6,10,8,8,1,16,0,1.50%
2018-04,חיפה,12,מ.א. זבולון,מועצה איזורית,178,86,92,27,151,97,171,0,2.88%
2018-04,חיפה,15,מ.א. חוף הכרמל,מועצה איזורית,309,144,165,108,201,48,302,1,2.04%
2018-04,חיפה,14,מ.א. מנשה,מועצה איזורית,225,91,134,69,156,48,223,0,2.59%
2018-04,חיפה,1327,מעלה עירון,יישוב,571,243,328,8,563,428,562,3,8.61%
2018-04,חיפה,2500,נשר,יישוב,334,174,160,73,261,105,323,4,2.56%
2018-04,חיפה,534,עספיא,יישוב,308,131,177,18,290,136,287,4,4.67%
2018-04,חיפה,637,ערערה,יישוב,470,212,258,15,455,278,451,13,5.01%
2018-04,חיפה,537,פוריידיס,יישוב,180,105,75,9,171,42,177,3,2.92%
2018-04,חיפה,7800,פרדס חנה-כרכור,יישוב,686,293,393,198,488,87,667,9,3.11%
2018-04,חיפה,6800,קריית אתא,יישוב,1220,561,659,120,1100,499,1171,25,3.79%
2018-04,חיפה,9500,קריית ביאליק,יישוב,797,347,450,103,694,277,774,10,3.63%
2018-04,חיפה,2300,קריית טבעון,יישוב,168,83,85,70,98,19,166,0,1.98%
2018-04,חיפה,9600,קריית ים,יישוב,1017,505,512,91,926,511,978,26,4.63%
2018-04,חיפה,8200,קריית מוצקין,יישוב,749,324,425,141,608,256,727,11,3.13%
2018-04,חיפה,922,רכסים,יישוב,116,51,65,8,108,47,107,0,2.87%
2018-04,ירושלים,472,אבו גוש,יישוב,186,96,90,7,179,140,185,2,5.36%
2018-04,ירושלים,2610,בית שמש,יישוב,1047,493,554,95,952,304,1005,26,2.69%
2018-04,ירושלים,3000,ירושלים,יישוב,10276,4686,5590,1362,8914,5787,10013,95,3.13%
2018-04,ירושלים,26,מ.א. מטה יהודה,מועצה איזורית,473,229,244,140,333,80,465,0,1.80%
2018-04,ירושלים,1015,מבשרת ציון,יישוב,276,139,137,65,211,80,272,2,2.13%
2018-04,ירושלים,1137,קריית יערים,יישוב,44,19,25,9,35,9,44,0,2.47%
2018-04,תל אביב,2400,אור יהודה,יישוב,599,305,294,54,545,113,575,19,2.99%
2018-04,תל אביב,565,אזור,יישוב,157,66,91,30,127,13,156,2,2.33%
2018-04,תל אביב,6100,בני ברק,יישוב,1504,764,740,86,1418,512,1418,14,2.35%
2018-04,תל אביב,6200,בת ים,יישוב,2331,1147,1184,356,1975,726,2204,62,3.13%
2018-04,תל אביב,6300,גבעתיים,יישוב,739,327,412,385,354,59,733,2,2.30%
2018-04,תל אביב,6400,הרצלייה,יישוב,1015,474,541,375,640,44,998,10,2.03%
2018-04,תל אביב,6600,חולון,יישוב,2697,1211,1486,495,2202,481,2634,37,2.62%
2018-04,תל אביב,267,כפר שמריהו,יישוב,5,1,4,4,1,0,5,0,0.60%
2018-04,תל אביב,2620,קריית אונו,יישוב,397,177,220,191,206,29,393,1,2.01%
2018-04,תל אביב,8600,רמת גן,יישוב,1897,851,1046,710,1187,250,1866,16,2.28%
2018-04,תל אביב,2650,רמת השרון,יישוב,396,171,225,207,189,8,395,1,1.72%
2018-04,תל אביב,5000,תל אביב -יפו,יישוב,6849,3366,3483,2960,3889,1210,6722,56,2.55%
2018-05,אזור יהודה והשומרון,3760,אורנית,יישוב,103,41,62,38,65,1,103,0,2.05%
2018-05,אזור יהודה והשומרון,3750,אלפי מנשה,יישוב,84,32,52,31,53,0,84,3,1.90%
2018-05,אזור יהודה והשומרון,3560,אלקנה,יישוב,29,17,12,15,14,1,29,0,1.58%
2018-05,אזור יהודה והשומרון,3650,אפרת,יישוב,65,37,28,33,32,2,65,1,1.32%
2018-05,אזור יהודה והשומרון,3570,אריאל,יישוב,239,109,130,52,187,14,237,11,2.16%
2018-05,אזור יהודה והשומרון,3574,בית אל,יישוב,41,19,22,10,31,10,40,2,1.60%
2018-05,אזור יהודה והשומרון,3652,בית אריה,יישוב,53,24,29,10,43,0,53,1,1.85%
2018-05,אזור יהודה והשומרון,3780,ביתר עילית,יישוב,402,194,208,14,388,127,394,3,2.54%
2018-05,אזור יהודה והשומרון,3730,גבעת זאב,יישוב,167,80,87,27,140,34,166,2,2.05%
2018-05,אזור יהודה והשומרון,3769,הר אדר,יישוב,36,18,18,16,20,6,36,1,1.64%
2018-05,אזור יהודה והשומרון,76,מ.א. גוש עציון,מועצה איזורית,160,77,83,62,98,12,156,0,1.54%
2018-05,אזור יהודה והשומרון,78,מ.א. הר חברון,מועצה איזורית,69,41,28,33,36,2,68,0,1.71%
2018-05,אזור יהודה והשומרון,74,מ.א. מגילות ים המלח,מועצה איזורית,24,6,18,4,20,1,24,0,2.60%
2018-05,אזור יהודה והשומרון,73,מ.א. מטה בנימין,מועצה איזורית,552,286,266,192,360,78,543,0,1.91%
2018-05,אזור יהודה והשומרון,75,מ.א. ערבות הירדן,מועצה איזורית,56,22,34,25,31,4,54,0,2.10%
2018-05,אזור יהודה והשומרון,72,מ.א. שומרון,מועצה איזורית,371,175,196,135,236,17,367,0,1.94%
2018-05,אזור יהודה והשומרון,3797,מודיעין עילית,יישוב,357,124,233,25,332,29,352,2,2.21%
2018-05,אזור יהודה והשומרון,3616,מעלה אדומים,יישוב,490,220,270,74,416,115,483,20,2.32%
2018-05,אזור יהודה והשומרון,3608,מעלה אפרים,יישוב,34,15,19,1,33,10,34,1,4.22%
2018-05,אזור יהודה והשומרון,3660,עמנואל,יישוב,47,23,24,4,43,21,46,1,3.39%
2018-05,אזור יהודה והשומרון,3557,קדומים,יישוב,28,13,15,15,13,1,27,0,1.36%
2018-05,אזור יהודה והשומרון,3611,קריית ארבע,יישוב,75,42,33,11,64,31,73,6,2.18%
2018-05,אזור יהודה והשומרון,3640,קרני שומרון,יישוב,68,29,39,26,42,2,65,3,1.60%
2018-05,הדרום,31,אופקים,יישוב,741,335,406,46,695,329,716,39,4.99%
2018-05,הדרום,2600,אילת,יישוב,820,422,398,41,779,202,774,52,2.25%
2018-05,הדרום,70,אשדוד,יישוב,4699,2100,2599,630,4069,1844,4496,141,4.02%
2018-05,הדרום,7100,אשקלון,יישוב,3350,1468,1882,372,2978,1295,3071,66,4.14%
2018-05,הדרום,9000,באר שבע,יישוב,5240,2461,2779,726,4514,2452,4932,119,4.60%
2018-05,הדרום,2200,דימונה,יישוב,1526,754,772,76,1450,964,1446,29,7.44%
2018-05,הדרום,1303,חורה,יישוב,455,187,268,2,453,390,438,4,9.19%
2018-05,הדרום,831,ירוחם,יישוב,354,190,164,11,343,190,328,27,6.43%
2018-05,הדרום,1059,כסיפה,יישוב,972,360,612,2,970,858,960,19,17.65%
2018-05,הדרום,1271,להבים,יישוב,45,25,20,22,23,0,45,0,1.28%
2018-05,הדרום,1060,לקיה,יישוב,547,233,314,6,541,473,522,5,10.77%
2018-05,הדרום,69,מ.א. אל קסום,מועצה איזורית,711,281,430,3,708,603,691,0,20.26%
2018-05,הדרום,38,מ.א. אשכול,מועצה איזורית,127,60,67,32,95,9,125,0,1.78%
2018-05,הדרום,33,מ.א. באר טוביה,מועצה איזורית,278,123,155,51,227,37,272,0,2.40%
2018-05,הדרום,41,מ.א. בני שמעון,מועצה איזורית,82,33,49,31,51,21,82,1,1.69%
2018-05,הדרום,54,מ.א. הערבה התיכונה,מועצה איזורית,28,18,10,10,18,0,28,0,1.47%
2018-05,הדרום,53,מ.א. חבל אילות,מועצה איזורית,27,10,17,6,21,0,25,2,1.01%
2018-05,הדרום,36,מ.א. חוף אשקלון,מועצה איזורית,215,96,119,38,177,33,204,0,2.35%
2018-05,הדרום,35,מ.א. יואב,מועצה איזורית,83,35,48,30,53,13,83,0,2.03%
2018-05,הדרום,50,מ.א. לכיש,מועצה איזורית,145,72,73,26,119,31,143,0,2.57%
2018-05,הדרום,42,מ.א. מרחבים,מועצה איזורית,164,73,91,22,142,33,161,0,2.56%
2018-05,הדרום,68,מ.א. נווה מדבר,מועצה איזורית,126,51,75,1,125,101,122,0,6.46%
2018-05,הדרום,48,מ.א. רמת נגב,מועצה איזורית,282,132,150,19,263,220,275,2,8.25%
2018-05,הדרום,39,מ.א. שדות נגב,מועצה איזורית,110,52,58,19,91,27,107,0,2.20%
2018-05,הדרום,37,מ.א. שער הנגב,מועצה איזורית,83,35,48,33,50,15,78,0,1.95%
2018-05,הדרום,34,מ.א. שפיר,מועצה איזורית,151,79,72,17,134,44,148,0,2.97%
2018-05,הדרום,51,מ.א. תמר,מועצה איזורית,8,2,6,2,6,3,7,0,1.08%
2018-05,הדרום,1268,מיתר,יישוב,61,29,32,34,27,4,61,1,1.24%
2018-05,הדרום,99,מצפה רמון,יישוב,225,96,129,13,212,153,212,15,7.63%
2018-05,הדרום,246,נתיבות,יישוב,876,396,480,66,810,356,817,54,4.98%
2018-05,הדרום,666,עומר,יישוב,36,18,18,13,23,2,36,1,0.86%
2018-05,הדרום,2560,ערד,יישוב,629,301,328,54,575,291,595,42,4.68%
2018-05,הדרום,1192,ערערה-בנגב,יישוב,979,426,553,6,973,872,954,14,18.60%
2018-05,הדרום,2630,קריית גת,יישוב,1708,726,982,125,1583,606,1629,53,5.53%
2018-05,הדרום,1034,קריית מלאכי,יישוב,742,350,392,24,718,280,707,45,5.70%
2018-05,הדרום,1161,רהט,יישוב,1936,781,1155,8,1928,1415,1913,53,8.58%
2018-05,הדרום,1286,שגב-שלום,יישוב,322,127,195,3,319,252,310,8,9.61%
2018-05,הדרום,1031,שדרות,יישוב,879,404,475,61,818,423,788,32,5.32%
2018-05,הדרום,1054,תל שבע,יישוב,692,314,378,4,688,581,639,7,11.15%
2018-05,המרכז,1066,"בני עי""ש",יישוב,118,56,62,13,105,33,114,3,2.85%
2018-05,המרכז,182,אבן יהודה,יישוב,130,59,71,54,76,13,129,1,1.85%
2018-05,המרכז,41,אליכין,יישוב,55,30,25,14,41,9,54,1,2.75%
2018-05,המרכז,1309,אלעד,יישוב,311,141,170,20,291,25,296,3,2.09%
2018-05,המרכז,2530,באר יעקב,יישוב,306,125,181,67,239,29,297,3,2.30%
2018-05,המרכז,466,בית דגן,יישוב,97,54,43,14,83,20,93,3,2.49%
2018-05,המרכז,681,גבעת שמואל,יישוב,230,118,112,88,142,25,226,2,1.81%
2018-05,המרכז,2550,גדרה,יישוב,286,136,150,66,220,54,281,12,2.17%
2018-05,המרכז,627,ג'לג'וליה,יישוב,70,26,44,3,67,35,60,1,1.40%
2018-05,המרכז,166,גן יבנה,יישוב,294,122,172,49,245,56,288,3,2.27%
2018-05,המרכז,229,גני תקווה,יישוב,205,89,116,73,132,22,205,1,2.12%
2018-05,המרכז,9700,הוד השרון,יישוב,676,282,394,328,348,24,670,12,2.05%
2018-05,המרכז,1290,זמר,יישוב,127,42,85,3,124,74,121,5,3.69%
2018-05,המרכז,2730,טייבה,יישוב,862,417,445,26,836,541,722,23,3.74%
2018-05,המרכז,2720,טירה,יישוב,134,69,65,21,113,26,128,13,1.03%
2018-05,המרכז,2660,יבנה,יישוב,691,318,373,135,556,140,678,36,2.69%
2018-05,המרכז,9400,יהוד,יישוב,364,164,200,102,262,37,356,10,2.18%
2018-05,המרכז,1224,כוכב יאיר,יישוב,81,29,52,57,24,0,80,0,1.44%
2018-05,המרכז,633,כפר ברא,יישוב,12,6,6,2,10,4,12,0,0.75%
2018-05,המרכז,168,כפר יונה,יישוב,281,123,158,62,219,40,278,2,2.37%
2018-05,המרכז,6900,כפר סבא,יישוב,1138,487,651,466,672,67,1124,16,2.12%
2018-05,המרכז,634,כפר קאסם,יישוב,169,82,87,5,164,81,165,4,1.60%
2018-05,המרכז,7000,לוד,יישוב,1506,750,756,135,1371,692,1472,27,3.99%
2018-05,המרכז,28,מ.א. ברנר,מועצה איזורית,61,24,37,38,23,1,61,6,1.50%
2018-05,המרכז,32,מ.א. גדרות,מועצה איזורית,31,14,17,14,17,1,31,0,1.26%
2018-05,המרכז,30,מ.א. גזר,מועצה איזורית,271,133,138,100,171,23,268,0,2.00%
2018-05,המרכז,27,מ.א. גן רווה,מועצה איזורית,44,23,21,18,26,0,44,0,1.47%
2018-05,המרכז,20,מ.א. דרום השרון,מועצה איזורית,327,133,194,151,176,7,324,0,2.00%
2018-05,המרכז,29,מ.א. חבל יבנה,מועצה איזורית,40,12,28,22,18,1,40,1,1.53%
2018-05,המרכז,25,מ.א. חבל מודיעין,מועצה איזורית,232,104,128,93,139,25,225,0,2.05%
2018-05,המרכז,19,מ.א. חוף השרון,מועצה איזורית,110,45,65,45,65,2,108,0,1.94%
2018-05,המרכז,18,מ.א. לב השרון,מועצה איזורית,248,108,140,81,167,26,242,0,2.18%
2018-05,המרכז,31,מ.א. נחל שורק,מועצה איזורית,44,15,29,13,31,6,43,39,1.02%
2018-05,המרכז,16,מ.א. עמק חפר,מועצה איזורית,340,147,193,138,202,11,337,0,1.71%
2018-05,המרכז,40,מ.א. שדות דן,מועצה איזורית,113,56,57,35,78,8,113,0,1.75%
2018-05,המרכז,1200,מודיעין-מכבים-רעות*,יישוב,833,347,486,419,414,28,824,15,1.79%
2018-05,המרכז,28,מזכרת בתיה,יישוב,167,77,90,55,112,21,164,6,2.01%
2018-05,המרכז,7200,נס ציונה,יישוב,570,255,315,168,402,122,560,12,2.26%
2018-05,המרכז,7400,נתניה,יישוב,3734,1765,1969,538,3196,953,3645,62,3.36%
2018-05,המרכז,587,סביון*,יישוב,19,5,14,10,9,0,19,0,0.91%
2018-05,המרכז,171,פרדסייה,יישוב,81,40,41,20,61,3,80,1,2.12%
2018-05,המרכז,7900,פתח תקווה,יישוב,3505,1631,1874,739,2766,702,3423,56,2.65%
2018-05,המרכז,195,קדימה-צורן,יישוב,254,110,144,96,158,24,251,4,2.14%
2018-05,המרכז,638,קלנסווה,יישוב,297,148,149,11,286,179,256,9,2.65%
2018-05,המרכז,469,קריית עקרון,יישוב,213,110,103,24,189,86,209,5,3.43%
2018-05,המרכז,2640,ראש העין,יישוב,778,347,431,180,598,82,768,17,2.48%
2018-05,המרכז,8300,ראשון לציון,יישוב,3784,1710,2074,812,2972,786,3737,41,2.66%
2018-05,המרכז,8400,רחובות,יישוב,2099,966,1133,565,1534,538,2031,65,2.86%
2018-05,המרכז,8500,רמלה,יישוב,1343,659,684,97,1246,445,1279,44,3.30%
2018-05,המרכז,8700,רעננה,יישוב,679,306,373,335,344,27,674,9,1.78%
2018-05,המרכז,1304,שוהם,יישוב,174,80,94,90,84,5,173,1,1.43%
2018-05,המרכז,154,תל מונד,יישוב,136,68,68,47,89,17,136,0,1.97%
2018-05,הצפון,473,אבו סנאן,יישוב,508,215,293,7,501,358,498,8,7.88%
2018-05,הצפון,478,אכסאל,יישוב,393,184,209,10,383,315,390,6,6.13%
2018-05,הצפון,529,אעבלין,יישוב,352,156,196,12,340,263,346,5,5.60%
2018-05,הצפון,482,בועיינה-נוג'ידאת,יישוב,208,103,105,6,202,154,203,3,4.72%
2018-05,הצפון,4001,בוקעאתא,יישוב,324,115,209,8,316,246,317,3,10.48%
2018-05,הצפון,998,ביר אל-מכסור,יישוב,252,122,130,4,248,169,249,1,5.99%
2018-05,הצפון,480,בית ג'ן,יישוב,369,96,273,10,359,238,357,3,5.94%
2018-05,הצפון,9200,בית שאן,יישוב,600,299,301,22,578,260,576,25,5.50%
2018-05,הצפון,944,בסמת טבעון,יישוב,149,71,78,2,147,92,136,1,3.77%
2018-05,הצפון,483,בענה,יישוב,315,139,176,7,308,258,297,3,7.64%
2018-05,הצפון,1292,ג'דיידה-מכר,יישוב,980,446,534,6,974,712,967,15,9.40%
2018-05,הצפון,485,ג'ולס,יישוב,142,41,101,0,142,74,142,3,4.37%
2018-05,הצפון,487,ג'ש (גוש חלב),יישוב,47,18,29,8,39,19,44,0,2.58%
2018-05,הצפון,489,דבורייה,יישוב,242,104,138,15,227,164,234,3,4.94%
2018-05,הצפון,490,דייר אל-אסד,יישוב,324,146,178,14,310,234,313,3,5.43%
2018-05,הצפון,492,דייר חנא,יישוב,478,216,262,9,469,341,476,8,9.00%
2018-05,הצפון,975,זרזיר,יישוב,173,67,106,5,168,111,171,5,4.78%
2018-05,הצפון,496,חורפיש,יישוב,109,49,60,9,100,50,97,2,3.18%
2018-05,הצפון,2034,חצור הגלילית,יישוב,217,89,128,16,201,91,202,7,4.15%
2018-05,הצפון,6700,טבריה,יישוב,1261,611,650,81,1180,544,1110,77,4.98%
2018-05,הצפון,962,טובא-זנגרייה,יישוב,298,118,180,4,294,159,290,6,8.48%
2018-05,הצפון,498,טורעאן,יישוב,284,129,155,12,272,210,277,5,4.40%
2018-05,הצפון,8900,טמרה,יישוב,1133,544,589,16,1117,887,1109,9,7.15%
2018-05,הצפון,1295,יאנוח-ג'ת,יישוב,121,36,85,2,119,64,112,5,3.50%
2018-05,הצפון,46,יבנאל,יישוב,70,42,28,9,61,30,58,2,3.69%
2018-05,הצפון,29,יסוד המעלה,יישוב,17,7,10,5,12,5,16,1,1.82%
2018-05,הצפון,499,יפיע,יישוב,434,196,238,22,412,315,431,8,5.00%
2018-05,הצפון,240,יקנעם עילית,יישוב,404,188,216,104,300,83,396,25,3.07%
2018-05,הצפון,502,ירכא,יישוב,328,137,191,1,327,224,327,1,4.67%
2018-05,הצפון,504,כאבול,יישוב,365,196,169,9,356,288,358,7,6.64%
2018-05,הצפון,505,כאוכב אבו אל-היג'א,יישוב,165,66,99,3,162,137,165,1,8.77%
2018-05,הצפון,1296,כסרא-סמיע,יישוב,170,59,111,1,169,110,158,8,4.07%
2018-05,הצפון,978,כעביה-טבאש-חג'אג'רה,יישוב,136,48,88,4,132,92,133,5,5.18%
2018-05,הצפון,1263,כפר ורדים,יישוב,54,21,33,27,27,6,51,1,1.64%
2018-05,הצפון,507,כפר יאסיף,יישוב,345,155,190,4,341,232,336,5,6.20%
2018-05,הצפון,508,כפר כמא,יישוב,30,14,16,4,26,13,28,0,1.63%
2018-05,הצפון,509,כפר כנא,יישוב,641,327,314,24,617,486,621,17,6.42%
2018-05,הצפון,510,כפר מנדא,יישוב,570,310,260,10,560,408,564,5,7.03%
2018-05,הצפון,47,כפר תבור,יישוב,40,17,23,16,24,3,40,1,1.69%
2018-05,הצפון,1139,כרמיאל,יישוב,1309,567,742,262,1047,610,1200,33,4.63%
2018-05,הצפון,65,מ.א. אל-בטוף,מועצה איזורית,215,106,109,13,202,151,205,0,6.30%
2018-05,הצפון,66,מ.א. בוסתן אל-מרג,מועצה איזורית,29,7,22,0,29,24,29,0,0.82%
2018-05,הצפון,71,מ.א. גולן,מועצה איזורית,183,86,97,60,123,16,181,0,2.06%
2018-05,הצפון,8,מ.א. הגלבוע,מועצה איזורית,519,226,293,53,466,253,513,0,3.63%
2018-05,הצפון,1,מ.א. הגליל העליון,מועצה איזורית,184,71,113,63,121,13,184,0,2.06%
2018-05,הצפון,3,מ.א. הגליל התחתון,מועצה איזורית,95,43,52,26,69,5,92,0,1.53%
2018-05,הצפון,55,מ.א. מבואות החרמון,מועצה איזורית,92,36,56,19,73,19,90,0,2.25%
2018-05,הצפון,13,מ.א. מגידו,מועצה איזורית,92,36,56,38,54,8,92,0,1.63%
2018-05,הצפון,4,מ.א. מטה אשר,מועצה איזורית,407,171,236,80,327,144,398,0,2.80%
2018-05,הצפון,52,מ.א. מעלה יוסף,מועצה איזורית,164,72,92,23,141,33,159,0,2.77%
2018-05,הצפון,2,מ.א. מרום הגליל,מועצה איזורית,268,124,144,24,244,91,260,0,3.64%
2018-05,הצפון,56,מ.א. משגב,מועצה איזורית,498,192,306,105,393,243,486,0,3.44%
2018-05,הצפון,6,מ.א. עמק הירדן,מועצה איזורית,144,59,85,43,101,21,136,0,2.00%
2018-05,הצפון,7,מ.א. עמק המעיינות,מועצה איזורית,155,60,95,33,122,30,150,1,2.29%
2018-05,הצפון,9,מ.א. עמק יזרעאל,מועצה איזורית,350,150,200,156,194,33,344,0,1.76%
2018-05,הצפון,481,מגאר,יישוב,933,388,545,15,918,673,912,6,8.62%
2018-05,הצפון,516,מג'ד אל-כרום,יישוב,415,194,221,13,402,280,405,8,5.50%
2018-05,הצפון,65,מגדל,יישוב,29,15,14,3,26,9,27,0,2.72%
2018-05,הצפון,874,מגדל העמק,יישוב,729,354,375,73,656,213,673,54,4.92%
2018-05,הצפון,4201,מג'דל שמס,יישוב,364,130,234,11,353,249,346,3,6.57%
2018-05,הצפון,517,מזרעה,יישוב,114,49,65,1,113,83,107,1,5.04%
2018-05,הצפון,43,מטולה,יישוב,24,16,8,9,15,5,22,2,2.19%
2018-05,הצפון,4203,מסעדה,יישוב,183,73,110,8,175,119,175,1,9.58%
2018-05,הצפון,518,מעיליא,יישוב,56,27,29,7,49,21,53,1,3.08%
2018-05,הצפון,1063,מעלות-תרשיחא,יישוב,637,305,332,69,568,305,595,37,4.90%
2018-05,הצפון,520,משהד,יישוב,151,63,88,3,148,107,146,3,4.09%
2018-05,הצפון,9100,נהרייה,יישוב,1574,760,814,172,1402,739,1472,64,4.66%
2018-05,הצפון,522,נחף,יישוב,328,140,188,6,322,241,319,3,5.71%
2018-05,הצפון,7300,נצרת,יישוב,2375,1101,1274,102,2273,1686,2346,30,6.37%
2018-05,הצפון,1061,נצרת עילית,יישוב,1260,616,644,127,1133,507,1118,94,4.77%
2018-05,הצפון,525,סאג'ור,יישוב,114,46,68,5,109,62,112,0,5.12%
2018-05,הצפון,7500,סח'נין,יישוב,1507,688,819,27,1480,1162,1487,16,9.63%
2018-05,הצפון,4501,ע'ג'ר,יישוב,70,31,39,2,68,42,69,0,5.80%
2018-05,הצפון,530,עיילבון,יישוב,127,53,74,5,122,74,122,3,4.23%
2018-05,הצפון,511,עילוט,יישוב,234,98,136,4,230,178,233,2,7.27%
2018-05,הצפון,532,עין מאהל,יישוב,310,175,135,5,305,216,300,4,5.14%
2018-05,הצפון,4502,עין קנייא,יישוב,105,41,64,2,103,77,103,0,9.30%
2018-05,הצפון,7600,עכו,יישוב,2439,1097,1342,132,2307,1653,2328,39,8.61%
2018-05,הצפון,7700,עפולה,יישוב,1411,598,813,163,1248,464,1331,73,4.85%
2018-05,הצפון,531,עראבה,יישוב,1050,444,606,24,1026,872,1038,9,9.26%
2018-05,הצפון,535,פסוטה,יישוב,84,42,42,8,76,39,81,1,4.50%
2018-05,הצפון,536,פקיעין (בוקייעה),יישוב,102,54,48,4,98,61,96,1,3.21%
2018-05,הצפון,8000,צפת,יישוב,840,448,392,79,761,492,796,30,5.75%
2018-05,הצפון,4100,קצרין,יישוב,155,72,83,31,124,63,148,6,3.71%
2018-05,הצפון,2800,קריית שמונה,יישוב,634,304,330,66,568,231,607,32,4.68%
2018-05,הצפון,543,ראמה,יישוב,216,90,126,13,203,142,207,0,5.05%
2018-05,הצפון,26,ראש פינה,יישוב,41,14,27,7,34,16,40,2,2.43%
2018-05,הצפון,542,ריינה,יישוב,421,204,217,13,408,296,405,6,5.47%
2018-05,הצפון,122,רמת ישי,יישוב,82,27,55,28,54,17,79,2,1.92%
2018-05,הצפון,913,שבלי - אום אל-גנם,יישוב,142,54,88,5,137,85,137,3,4.85%
2018-05,הצפון,812,שלומי,יישוב,194,81,113,16,178,84,188,3,5.14%
2018-05,הצפון,538,שעב,יישוב,349,158,191,3,346,280,347,1,10.35%
2018-05,הצפון,8800,שפרעם,יישוב,1147,519,628,29,1118,819,1125,17,5.78%
2018-05,חיפה,1326,"בסמ""ה",יישוב,282,130,152,5,277,219,278,3,6.24%
2018-05,חיפה,2710,אום אל-פחם,יישוב,2236,952,1284,25,2211,1768,2187,39,9.44%
2018-05,חיפה,1020,אור עקיבא,יישוב,422,201,221,47,375,92,406,12,3.86%
2018-05,חיפה,6000,באקה אל-גרביה,יישוב,541,275,266,18,523,299,527,21,4.04%
2018-05,חיפה,9800,בנימינה-גבעת עדה*,יישוב,154,71,83,65,89,18,152,1,2.03%
2018-05,חיפה,541,ג'סר א-זרקא,יישוב,216,102,114,1,215,62,208,6,3.24%
2018-05,חיפה,628,ג'ת,יישוב,183,84,99,7,176,94,182,8,3.15%
2018-05,חיפה,494,דאלית אל-כרמל,יישוב,394,153,241,17,377,191,370,8,4.23%
2018-05,חיפה,9300,זכרון יעקב,יישוב,202,82,120,86,116,12,199,2,1.75%
2018-05,חיפה,6500,חדרה,יישוב,1990,903,1087,279,1711,535,1881,50,3.62%
2018-05,חיפה,4000,חיפה,יישוב,4897,2362,2535,1077,3820,2048,4600,141,3.26%
2018-05,חיפה,1247,חריש,יישוב,131,45,86,36,95,14,128,2,3.00%
2018-05,חיפה,2100,טירת כרמל,יישוב,616,310,306,36,580,300,586,17,4.79%
2018-05,חיפה,654,כפר קרע,יישוב,347,146,201,20,327,184,342,9,3.65%
2018-05,חיפה,45,מ.א. אלונה,מועצה איזורית,15,5,10,7,8,0,15,0,1.41%
2018-05,חיפה,12,מ.א. זבולון,מועצה איזורית,184,86,98,27,157,97,176,0,2.97%
2018-05,חיפה,15,מ.א. חוף הכרמל,מועצה איזורית,309,142,167,118,191,46,303,0,2.05%
2018-05,חיפה,14,מ.א. מנשה,מועצה איזורית,227,103,124,74,153,44,226,0,2.63%
2018-05,חיפה,1327,מעלה עירון,יישוב,591,249,342,7,584,435,577,8,8.82%
2018-05,חיפה,2500,נשר,יישוב,334,165,169,65,269,111,315,6,2.49%
2018-05,חיפה,534,עספיא,יישוב,309,131,178,18,291,139,287,2,4.67%
2018-05,חיפה,637,ערערה,יישוב,486,215,271,14,472,282,472,15,5.23%
2018-05,חיפה,537,פוריידיס,יישוב,185,113,72,8,177,43,183,0,3.02%
2018-05,חיפה,7800,פרדס חנה-כרכור,יישוב,694,282,412,208,486,87,679,13,3.16%
2018-05,חיפה,6800,קריית אתא,יישוב,1209,554,655,121,1088,499,1170,25,3.79%
2018-05,חיפה,9500,קריית ביאליק,יישוב,831,363,468,111,720,287,804,31,3.76%
2018-05,חיפה,2300,קריית טבעון,יישוב,165,82,83,68,97,17,163,1,1.94%
2018-05,חיפה,9600,קריית ים,יישוב,1054,532,522,89,965,520,1015,27,4.80%
2018-05,חיפה,8200,קריית מוצקין,יישוב,783,346,437,150,633,261,761,19,3.27%
2018-05,חיפה,922,רכסים,יישוב,123,54,69,7,116,48,114,2,3.05%
2018-05,ירושלים,472,אבו גוש,יישוב,191,90,101,4,187,149,187,5,5.42%
2018-05,ירושלים,2610,בית שמש,יישוב,1065,500,565,75,990,294,1024,52,2.74%
2018-05,ירושלים,3000,ירושלים,יישוב,10330,4767,5563,1273,9057,5836,10049,155,3.14%
2018-05,ירושלים,26,מ.א. מטה יהודה,מועצה איזורית,470,235,235,137,333,74,464,2,1.79%
2018-05,ירושלים,1015,מבשרת ציון,יישוב,265,136,129,57,208,79,263,5,2.07%
2018-05,ירושלים,1137,קריית יערים,יישוב,44,20,24,8,36,8,44,0,2.47%
2018-05,תל אביב,2400,אור יהודה,יישוב,613,313,300,58,555,121,576,36,2.99%
2018-05,תל אביב,565,אזור,יישוב,157,74,83,30,127,14,152,7,2.27%
2018-05,תל אביב,6100,בני ברק,יישוב,1495,747,748,88,1407,506,1391,17,2.30%
2018-05,תל אביב,6200,בת ים,יישוב,2489,1232,1257,368,2121,755,2355,81,3.34%
2018-05,תל אביב,6300,גבעתיים,יישוב,708,311,397,355,353,64,704,6,2.21%
2018-05,תל אביב,6400,הרצלייה,יישוב,995,489,506,363,632,38,977,13,1.99%
2018-05,תל אביב,6600,חולון,יישוב,2784,1265,1519,466,2318,473,2710,44,2.69%
2018-05,תל אביב,267,כפר שמריהו,יישוב,5,1,4,3,2,0,5,0,0.60%
2018-05,תל אביב,2620,קריית אונו,יישוב,399,175,224,188,211,30,394,4,2.01%
2018-05,תל אביב,8600,רמת גן,יישוב,1937,872,1065,721,1216,249,1901,19,2.33%
2018-05,תל אביב,2650,רמת השרון,יישוב,364,168,196,189,175,13,361,2,1.57%
2018-05,תל אביב,5000,תל אביב -יפו,יישוב,6809,3363,3446,2834,3975,1223,6649,86,2.52%
2018-06,אזור יהודה והשומרון,3760,אורנית,יישוב,100,42,58,39,61,0,100,0,1.99%
2018-06,אזור יהודה והשומרון,3750,אלפי מנשה,יישוב,80,32,48,30,50,0,80,0,1.81%
2018-06,אזור יהודה והשומרון,3560,אלקנה,יישוב,26,17,9,12,14,1,26,0,1.42%
2018-06,אזור יהודה והשומרון,3650,אפרת,יישוב,69,37,32,28,41,2,69,0,1.40%
2018-06,אזור יהודה והשומרון,3570,אריאל,יישוב,225,97,128,59,166,12,223,9,2.04%
2018-06,אזור יהודה והשומרון,3574,בית אל,יישוב,41,19,22,10,31,10,40,0,1.60%
2018-06,אזור יהודה והשומרון,3652,בית אריה,יישוב,45,19,26,7,38,1,45,2,1.57%
2018-06,אזור יהודה והשומרון,3780,ביתר עילית,יישוב,391,174,217,17,374,127,384,8,2.48%
2018-06,אזור יהודה והשומרון,3730,גבעת זאב,יישוב,167,73,94,30,137,27,165,6,2.04%
2018-06,אזור יהודה והשומרון,3769,הר אדר,יישוב,34,17,17,16,18,4,34,0,1.55%
2018-06,אזור יהודה והשומרון,76,מ.א. גוש עציון,מועצה איזורית,154,76,78,66,88,12,152,0,1.50%
2018-06,אזור יהודה והשומרון,78,מ.א. הר חברון,מועצה איזורית,70,34,36,31,39,5,67,0,1.69%
2018-06,אזור יהודה והשומרון,74,מ.א. מגילות ים המלח,מועצה איזורית,20,5,15,5,15,1,20,0,2.16%
2018-06,אזור יהודה והשומרון,73,מ.א. מטה בנימין,מועצה איזורית,542,270,272,205,337,80,533,0,1.88%
2018-06,אזור יהודה והשומרון,75,מ.א. ערבות הירדן,מועצה איזורית,52,21,31,20,32,4,49,0,1.90%
2018-06,אזור יהודה והשומרון,72,מ.א. שומרון,מועצה איזורית,343,164,179,129,214,19,340,0,1.80%
2018-06,אזור יהודה והשומרון,3797,מודיעין עילית,יישוב,388,122,266,24,364,32,385,1,2.41%
2018-06,אזור יהודה והשומרון,3616,מעלה אדומים,יישוב,485,234,251,68,417,110,479,15,2.30%
2018-06,אזור יהודה והשומרון,3608,מעלה אפרים,יישוב,33,13,20,1,32,11,32,1,3.99%
2018-06,אזור יהודה והשומרון,3660,עמנואל,יישוב,35,17,18,3,32,18,35,0,2.60%
2018-06,אזור יהודה והשומרון,3557,קדומים,יישוב,26,15,11,12,14,0,26,2,1.31%
2018-06,אזור יהודה והשומרון,3611,קריית ארבע,יישוב,85,49,36,13,72,31,82,7,2.44%
2018-06,אזור יהודה והשומרון,3640,קרני שומרון,יישוב,71,32,39,23,48,3,67,1,1.65%
2018-06,הדרום,31,אופקים,יישוב,787,339,448,50,737,339,763,42,5.30%
2018-06,הדרום,2600,אילת,יישוב,836,421,415,43,793,199,787,47,2.29%
2018-06,הדרום,70,אשדוד,יישוב,4743,2077,2666,615,4128,1819,4545,119,4.06%
2018-06,הדרום,7100,אשקלון,יישוב,3289,1449,1840,375,2914,1248,3011,56,4.06%
2018-06,הדרום,9000,באר שבע,יישוב,5112,2395,2717,706,4406,2412,4810,109,4.49%
2018-06,הדרום,2200,דימונה,יישוב,1518,737,781,69,1449,926,1444,29,7.43%
2018-06,הדרום,1303,חורה,יישוב,439,181,258,1,438,378,418,0,8.81%
2018-06,הדרום,831,ירוחם,יישוב,365,199,166,9,356,188,337,23,6.60%
2018-06,הדרום,1059,כסיפה,יישוב,951,355,596,1,950,845,941,3,17.36%
2018-06,הדרום,1271,להבים,יישוב,43,25,18,23,20,0,43,1,1.22%
2018-06,הדרום,1060,לקיה,יישוב,541,230,311,5,536,460,517,2,10.68%
2018-06,הדרום,69,מ.א. אל קסום,מועצה איזורית,732,297,435,6,726,620,715,0,20.96%
2018-06,הדרום,38,מ.א. אשכול,מועצה איזורית,126,63,63,33,93,9,123,0,1.75%
2018-06,הדרום,33,מ.א. באר טוביה,מועצה איזורית,273,117,156,52,221,41,267,0,2.36%
2018-06,הדרום,41,מ.א. בני שמעון,מועצה איזורית,77,30,47,26,51,18,76,2,1.57%
2018-06,הדרום,54,מ.א. הערבה התיכונה,מועצה איזורית,30,16,14,11,19,1,29,0,1.52%
2018-06,הדרום,53,מ.א. חבל אילות,מועצה איזורית,23,7,16,6,17,0,21,4,0.85%
2018-06,הדרום,36,מ.א. חוף אשקלון,מועצה איזורית,206,98,108,38,168,34,198,0,2.28%
2018-06,הדרום,35,מ.א. יואב,מועצה איזורית,80,38,42,28,52,13,80,0,1.96%
2018-06,הדרום,50,מ.א. לכיש,מועצה איזורית,131,63,68,24,107,29,129,0,2.32%
2018-06,הדרום,42,מ.א. מרחבים,מועצה איזורית,156,74,82,21,135,29,153,0,2.43%
2018-06,הדרום,68,מ.א. נווה מדבר,מועצה איזורית,124,49,75,1,123,95,121,0,6.41%
2018-06,הדרום,48,מ.א. רמת נגב,מועצה איזורית,293,144,149,20,273,235,282,0,8.46%
2018-06,הדרום,39,מ.א. שדות נגב,מועצה איזורית,114,52,62,20,94,29,111,0,2.28%
2018-06,הדרום,37,מ.א. שער הנגב,מועצה איזורית,80,37,43,34,46,13,76,0,1.90%
2018-06,הדרום,34,מ.א. שפיר,מועצה איזורית,149,79,70,13,136,41,147,0,2.95%
2018-06,הדרום,51,מ.א. תמר,מועצה איזורית,9,5,4,4,5,3,9,0,1.38%
2018-06,הדרום,1268,מיתר,יישוב,57,29,28,28,29,5,55,2,1.12%
2018-06,הדרום,99,מצפה רמון,יישוב,206,84,122,12,194,140,194,15,7.03%
2018-06,הדרום,246,נתיבות,יישוב,921,424,497,67,854,339,868,55,5.27%
2018-06,הדרום,666,עומר,יישוב,44,24,20,20,24,3,44,0,1.04%
2018-06,הדרום,2560,ערד,יישוב,649,302,347,61,588,281,615,48,4.83%
2018-06,הדרום,1192,ערערה-בנגב,יישוב,953,419,534,5,948,849,932,5,18.25%
2018-06,הדרום,2630,קריית גת,יישוב,1648,706,942,123,1525,609,1577,52,5.36%
2018-06,הדרום,1034,קריית מלאכי,יישוב,756,338,418,25,731,309,725,37,5.84%
2018-06,הדרום,1161,רהט,יישוב,1949,759,1190,11,1938,1377,1932,27,8.66%
2018-06,הדרום,1286,שגב-שלום,יישוב,329,130,199,2,327,251,316,2,9.78%
2018-06,הדרום,1031,שדרות,יישוב,902,419,483,67,835,416,816,44,5.50%
2018-06,הדרום,1054,תל שבע,יישוב,669,302,367,5,664,570,612,4,10.73%
2018-06,המרכז,1066,"בני עי""ש",יישוב,109,52,57,15,94,31,105,2,2.63%
2018-06,המרכז,182,אבן יהודה,יישוב,131,57,74,57,74,13,131,1,1.88%
2018-06,המרכז,41,אליכין,יישוב,58,33,25,15,43,12,56,2,2.85%
2018-06,המרכז,1309,אלעד,יישוב,313,136,177,18,295,25,300,2,2.11%
2018-06,המרכז,2530,באר יעקב,יישוב,311,121,190,75,236,27,305,2,2.36%
2018-06,המרכז,466,בית דגן,יישוב,104,50,54,18,86,28,99,0,2.65%
2018-06,המרכז,681,גבעת שמואל,יישוב,240,125,115,93,147,25,235,1,1.88%
2018-06,המרכז,2550,גדרה,יישוב,276,120,156,60,216,54,267,12,2.06%
2018-06,המרכז,627,ג'לג'וליה,יישוב,63,27,36,3,60,32,58,2,1.36%
2018-06,המרכז,166,גן יבנה,יישוב,286,119,167,48,238,55,278,3,2.19%
2018-06,המרכז,229,גני תקווה,יישוב,187,80,107,69,118,21,187,0,1.94%
2018-06,המרכז,9700,הוד השרון,יישוב,651,264,387,321,330,17,645,10,1.97%
2018-06,המרכז,1290,זמר,יישוב,121,41,80,3,118,71,118,4,3.60%
2018-06,המרכז,2730,טייבה,יישוב,829,395,434,22,807,534,693,27,3.60%
2018-06,המרכז,2720,טירה,יישוב,125,69,56,20,105,22,122,9,0.98%
2018-06,המרכז,2660,יבנה,יישוב,661,309,352,135,526,138,650,28,2.58%
2018-06,המרכז,9400,יהוד,יישוב,344,153,191,90,254,36,338,8,2.07%
2018-06,המרכז,1224,כוכב יאיר,יישוב,83,29,54,59,24,0,83,0,1.49%
2018-06,המרכז,633,כפר ברא,יישוב,10,6,4,1,9,4,10,1,0.62%
2018-06,המרכז,168,כפר יונה,יישוב,278,131,147,58,220,41,277,4,2.36%
2018-06,המרכז,6900,כפר סבא,יישוב,1113,469,644,452,661,63,1102,26,2.08%
2018-06,המרכז,634,כפר קאסם,יישוב,163,77,86,4,159,83,160,3,1.55%
2018-06,המרכז,7000,לוד,יישוב,1499,721,778,137,1362,661,1463,36,3.97%
2018-06,המרכז,28,מ.א. ברנר,מועצה איזורית,69,28,41,37,32,2,68,6,1.67%
2018-06,המרכז,32,מ.א. גדרות,מועצה איזורית,35,17,18,12,23,4,35,0,1.42%
2018-06,המרכז,30,מ.א. גזר,מועצה איזורית,256,115,141,98,158,20,255,0,1.90%
2018-06,המרכז,27,מ.א. גן רווה,מועצה איזורית,44,26,18,22,22,0,44,0,1.47%
2018-06,המרכז,20,מ.א. דרום השרון,מועצה איזורית,324,139,185,152,172,9,322,0,1.99%
2018-06,המרכז,29,מ.א. חבל יבנה,מועצה איזורית,38,14,24,23,15,1,38,0,1.45%
2018-06,המרכז,25,מ.א. חבל מודיעין,מועצה איזורית,241,106,135,89,152,26,234,0,2.13%
2018-06,המרכז,19,מ.א. חוף השרון,מועצה איזורית,106,46,60,42,64,3,104,0,1.87%
2018-06,המרכז,18,מ.א. לב השרון,מועצה איזורית,258,119,139,81,177,26,253,0,2.28%
2018-06,המרכז,31,מ.א. נחל שורק,מועצה איזורית,40,14,26,10,30,6,37,42,0.87%
2018-06,המרכז,16,מ.א. עמק חפר,מועצה איזורית,340,136,204,142,198,9,337,0,1.71%
2018-06,המרכז,40,מ.א. שדות דן,מועצה איזורית,132,65,67,40,92,13,131,0,2.03%
2018-06,המרכז,1200,מודיעין-מכבים-רעות*,יישוב,799,342,457,409,390,29,792,11,1.72%
2018-06,המרכז,28,מזכרת בתיה,יישוב,161,75,86,61,100,18,161,6,1.98%
2018-06,המרכז,7200,נס ציונה,יישוב,580,271,309,171,409,115,572,7,2.31%
2018-06,המרכז,7400,נתניה,יישוב,3720,1768,1952,532,3188,933,3626,79,3.34%
2018-06,המרכז,587,סביון*,יישוב,19,5,14,7,12,1,18,0,0.86%
2018-06,המרכז,171,פרדסייה,יישוב,84,40,44,26,58,2,83,0,2.20%
2018-06,המרכז,7900,פתח תקווה,יישוב,3471,1615,1856,735,2736,684,3384,33,2.62%
2018-06,המרכז,195,קדימה-צורן,יישוב,248,108,140,96,152,21,246,6,2.10%
2018-06,המרכז,638,קלנסווה,יישוב,295,140,155,5,290,188,254,10,2.63%
2018-06,המרכז,469,קריית עקרון,יישוב,219,112,107,21,198,88,207,5,3.40%
2018-06,המרכז,2640,ראש העין,יישוב,749,328,421,160,589,88,740,9,2.39%
2018-06,המרכז,8300,ראשון לציון,יישוב,3739,1695,2044,820,2919,732,3692,37,2.63%
2018-06,המרכז,8400,רחובות,יישוב,2072,938,1134,545,1527,534,2015,53,2.84%
2018-06,המרכז,8500,רמלה,יישוב,1376,691,685,94,1282,434,1319,49,3.40%
2018-06,המרכז,8700,רעננה,יישוב,666,300,366,336,330,25,661,11,1.75%
2018-06,המרכז,1304,שוהם,יישוב,163,74,89,90,73,6,162,0,1.34%
2018-06,המרכז,154,תל מונד,יישוב,114,58,56,37,77,17,114,1,1.66%
2018-06,הצפון,473,אבו סנאן,יישוב,499,219,280,6,493,346,488,3,7.74%
2018-06,הצפון,478,אכסאל,יישוב,385,180,205,11,374,305,385,2,6.05%
2018-06,הצפון,529,אעבלין,יישוב,368,172,196,11,357,258,363,4,5.86%
2018-06,הצפון,482,בועיינה-נוג'ידאת,יישוב,193,97,96,6,187,145,190,4,4.43%
2018-06,הצפון,4001,בוקעאתא,יישוב,296,112,184,7,289,224,291,3,9.70%
2018-06,הצפון,998,ביר אל-מכסור,יישוב,248,118,130,4,244,169,245,2,5.90%
2018-06,הצפון,480,בית ג'ן,יישוב,349,92,257,14,335,228,339,1,5.66%
2018-06,הצפון,9200,בית שאן,יישוב,603,298,305,23,580,254,575,33,5.49%
2018-06,הצפון,944,בסמת טבעון,יישוב,146,68,78,2,144,91,133,2,3.69%
2018-06,הצפון,483,בענה,יישוב,289,132,157,6,283,231,277,4,7.16%
2018-06,הצפון,1292,ג'דיידה-מכר,יישוב,957,435,522,6,951,694,944,15,9.20%
2018-06,הצפון,485,ג'ולס,יישוב,143,37,106,0,143,81,142,3,4.37%
2018-06,הצפון,487,ג'ש (גוש חלב),יישוב,45,19,26,5,40,17,43,0,2.52%
2018-06,הצפון,489,דבורייה,יישוב,212,85,127,12,200,156,206,0,4.38%
2018-06,הצפון,490,דייר אל-אסד,יישוב,319,145,174,14,305,233,310,3,5.38%
2018-06,הצפון,492,דייר חנא,יישוב,459,208,251,10,449,321,457,7,8.67%
2018-06,הצפון,975,זרזיר,יישוב,167,63,104,6,161,98,164,6,4.60%
2018-06,הצפון,496,חורפיש,יישוב,110,53,57,11,99,45,102,3,3.33%
2018-06,הצפון,2034,חצור הגלילית,יישוב,193,80,113,13,180,84,180,4,3.71%
2018-06,הצפון,6700,טבריה,יישוב,1200,573,627,81,1119,513,1071,58,4.82%
2018-06,הצפון,962,טובא-זנגרייה,יישוב,289,113,176,3,286,151,283,3,8.30%
2018-06,הצפון,498,טורעאן,יישוב,273,122,151,8,265,206,267,8,4.25%
2018-06,הצפון,8900,טמרה,יישוב,1093,531,562,19,1074,851,1078,4,6.96%
2018-06,הצפון,1295,יאנוח-ג'ת,יישוב,109,31,78,2,107,62,104,4,3.26%
2018-06,הצפון,46,יבנאל,יישוב,69,45,24,10,59,33,59,1,3.75%
2018-06,הצפון,29,יסוד המעלה,יישוב,17,6,11,5,12,3,16,0,1.82%
2018-06,הצפון,499,יפיע,יישוב,429,199,230,24,405,312,428,1,4.97%
2018-06,הצפון,240,יקנעם עילית,יישוב,400,184,216,106,294,76,389,25,3.02%
2018-06,הצפון,502,ירכא,יישוב,326,130,196,2,324,220,323,3,4.62%
2018-06,הצפון,504,כאבול,יישוב,358,193,165,9,349,279,347,5,6.45%
2018-06,הצפון,505,כאוכב אבו אל-היג'א,יישוב,168,66,102,5,163,138,167,1,8.86%
2018-06,הצפון,1296,כסרא-סמיע,יישוב,153,47,106,1,152,93,141,8,3.65%
2018-06,הצפון,978,כעביה-טבאש-חג'אג'רה,יישוב,116,35,81,2,114,82,114,1,4.47%
2018-06,הצפון,1263,כפר ורדים,יישוב,56,21,35,29,27,5,55,1,1.77%
2018-06,הצפון,507,כפר יאסיף,יישוב,327,144,183,5,322,221,317,1,5.87%
2018-06,הצפון,508,כפר כמא,יישוב,25,12,13,4,21,11,24,0,1.40%
2018-06,הצפון,509,כפר כנא,יישוב,622,319,303,24,598,470,606,6,6.28%
2018-06,הצפון,510,כפר מנדא,יישוב,554,303,251,10,544,391,552,6,6.89%
2018-06,הצפון,47,כפר תבור,יישוב,42,20,22,18,24,4,39,1,1.65%
2018-06,הצפון,1139,כרמיאל,יישוב,1290,533,757,266,1024,588,1185,34,4.58%
2018-06,הצפון,65,מ.א. אל-בטוף,מועצה איזורית,201,96,105,11,190,143,190,1,5.84%
2018-06,הצפון,66,מ.א. בוסתן אל-מרג,מועצה איזורית,29,7,22,0,29,24,29,0,0.83%
2018-06,הצפון,71,מ.א. גולן,מועצה איזורית,195,88,107,67,128,15,191,0,2.17%
2018-06,הצפון,8,מ.א. הגלבוע,מועצה איזורית,518,223,295,53,465,262,510,0,3.61%
2018-06,הצפון,1,מ.א. הגליל העליון,מועצה איזורית,176,74,102,66,110,13,176,0,1.97%
2018-06,הצפון,3,מ.א. הגליל התחתון,מועצה איזורית,97,43,54,27,70,6,91,0,1.51%
2018-06,הצפון,55,מ.א. מבואות החרמון,מועצה איזורית,91,34,57,15,76,19,89,0,2.22%
2018-06,הצפון,13,מ.א. מגידו,מועצה איזורית,85,33,52,33,52,8,84,0,1.49%
2018-06,הצפון,4,מ.א. מטה אשר,מועצה איזורית,407,173,234,86,321,138,399,0,2.81%
2018-06,הצפון,52,מ.א. מעלה יוסף,מועצה איזורית,172,69,103,28,144,33,169,0,2.95%
2018-06,הצפון,2,מ.א. מרום הגליל,מועצה איזורית,253,109,144,26,227,91,244,0,3.42%
2018-06,הצפון,56,מ.א. משגב,מועצה איזורית,480,188,292,106,374,239,470,0,3.32%
2018-06,הצפון,6,מ.א. עמק הירדן,מועצה איזורית,129,58,71,37,92,20,119,0,1.75%
2018-06,הצפון,7,מ.א. עמק המעיינות,מועצה איזורית,159,71,88,37,122,29,154,0,2.35%
2018-06,הצפון,9,מ.א. עמק יזרעאל,מועצה איזורית,327,143,184,144,183,29,325,0,1.66%
2018-06,הצפון,481,מגאר,יישוב,924,379,545,16,908,670,901,10,8.53%
2018-06,הצפון,516,מג'ד אל-כרום,יישוב,411,202,209,11,400,269,404,6,5.49%
2018-06,הצפון,65,מגדל,יישוב,32,16,16,5,27,11,27,1,2.72%
2018-06,הצפון,874,מגדל העמק,יישוב,769,365,404,77,692,226,725,49,5.28%
2018-06,הצפון,4201,מג'דל שמס,יישוב,346,121,225,9,337,243,328,3,6.25%
2018-06,הצפון,517,מזרעה,יישוב,112,51,61,1,111,77,108,2,5.08%
2018-06,הצפון,43,מטולה,יישוב,21,14,7,5,16,5,20,0,1.99%
2018-06,הצפון,4203,מסעדה,יישוב,172,69,103,5,167,120,164,2,9.03%
2018-06,הצפון,518,מעיליא,יישוב,49,25,24,4,45,18,48,2,2.80%
2018-06,הצפון,1063,מעלות-תרשיחא,יישוב,635,315,320,75,560,299,600,28,4.94%
2018-06,הצפון,520,משהד,יישוב,144,65,79,1,143,107,138,0,3.87%
2018-06,הצפון,9100,נהרייה,יישוב,1537,744,793,178,1359,728,1452,49,4.60%
2018-06,הצפון,522,נחף,יישוב,328,138,190,9,319,240,323,8,5.78%
2018-06,הצפון,7300,נצרת,יישוב,2299,1062,1237,101,2198,1638,2281,18,6.21%
2018-06,הצפון,1061,נצרת עילית,יישוב,1186,591,595,113,1073,470,1069,96,4.57%
2018-06,הצפון,525,סאג'ור,יישוב,105,39,66,3,102,60,102,1,4.69%
2018-06,הצפון,7500,סח'נין,יישוב,1445,659,786,24,1421,1138,1427,15,9.28%
2018-06,הצפון,4501,ע'ג'ר,יישוב,66,25,41,0,66,38,65,1,5.48%
2018-06,הצפון,530,עיילבון,יישוב,126,55,71,6,120,72,122,1,4.23%
2018-06,הצפון,511,עילוט,יישוב,228,92,136,4,224,181,228,0,7.13%
2018-06,הצפון,532,עין מאהל,יישוב,288,161,127,5,283,217,278,1,4.78%
2018-06,הצפון,4502,עין קנייא,יישוב,98,42,56,2,96,75,97,0,8.80%
2018-06,הצפון,7600,עכו,יישוב,2395,1074,1321,135,2260,1631,2298,29,8.50%
2018-06,הצפון,7700,עפולה,יישוב,1342,565,777,147,1195,427,1280,70,4.67%
2018-06,הצפון,531,עראבה,יישוב,1016,430,586,23,993,843,1008,3,9.01%
2018-06,הצפון,535,פסוטה,יישוב,86,39,47,11,75,40,79,1,4.39%
2018-06,הצפון,536,פקיעין (בוקייעה),יישוב,96,54,42,5,91,58,94,4,3.15%
2018-06,הצפון,8000,צפת,יישוב,843,450,393,81,762,507,799,18,5.77%
2018-06,הצפון,4100,קצרין,יישוב,150,72,78,31,119,59,143,5,3.59%
2018-06,הצפון,2800,קריית שמונה,יישוב,606,303,303,59,547,222,581,22,4.49%
2018-06,הצפון,543,ראמה,יישוב,214,94,120,12,202,148,208,2,5.08%
2018-06,הצפון,26,ראש פינה,יישוב,39,12,27,5,34,16,38,1,2.31%
2018-06,הצפון,542,ריינה,יישוב,400,204,196,12,388,280,391,7,5.29%
2018-06,הצפון,122,רמת ישי,יישוב,81,28,53,29,52,15,80,0,1.94%
2018-06,הצפון,913,שבלי - אום אל-גנם,יישוב,146,55,91,5,141,86,143,4,5.05%
2018-06,הצפון,812,שלומי,יישוב,190,79,111,17,173,85,181,8,4.96%
2018-06,הצפון,538,שעב,יישוב,346,155,191,4,342,279,345,3,10.30%
2018-06,הצפון,8800,שפרעם,יישוב,1131,509,622,36,1095,807,1104,18,5.67%
2018-06,חיפה,1326,"בסמ""ה",יישוב,279,132,147,3,276,213,273,1,6.14%
2018-06,חיפה,2710,אום אל-פחם,יישוב,2210,953,1257,23,2187,1770,2158,27,9.33%
2018-06,חיפה,1020,אור עקיבא,יישוב,415,182,233,47,368,91,398,13,3.79%
2018-06,חיפה,6000,באקה אל-גרביה,יישוב,514,251,263,16,498,288,502,18,3.85%
2018-06,חיפה,9800,בנימינה-גבעת עדה*,יישוב,134,62,72,64,70,15,133,0,1.78%
2018-06,חיפה,541,ג'סר א-זרקא,יישוב,214,102,112,1,213,67,209,6,3.26%
2018-06,חיפה,628,ג'ת,יישוב,164,79,85,5,159,87,164,2,2.85%
2018-06,חיפה,494,דאלית אל-כרמל,יישוב,380,141,239,15,365,190,358,7,4.09%
2018-06,חיפה,9300,זכרון יעקב,יישוב,203,90,113,78,125,17,199,3,1.75%
2018-06,חיפה,6500,חדרה,יישוב,1886,838,1048,267,1619,512,1786,41,3.45%
2018-06,חיפה,4000,חיפה,יישוב,4806,2347,2459,1060,3746,2029,4506,134,3.20%
2018-06,חיפה,1247,חריש,יישוב,126,49,77,29,97,18,122,1,2.86%
2018-06,חיפה,2100,טירת כרמל,יישוב,612,312,300,45,567,302,578,17,4.73%
2018-06,חיפה,654,כפר קרע,יישוב,345,146,199,19,326,180,338,6,3.61%
2018-06,חיפה,45,מ.א. אלונה,מועצה איזורית,16,7,9,6,10,0,16,0,1.50%
2018-06,חיפה,12,מ.א. זבולון,מועצה איזורית,186,88,98,25,161,102,175,0,2.95%
2018-06,חיפה,15,מ.א. חוף הכרמל,מועצה איזורית,300,137,163,121,179,43,297,0,2.00%
2018-06,חיפה,14,מ.א. מנשה,מועצה איזורית,220,97,123,78,142,41,217,0,2.52%
2018-06,חיפה,1327,מעלה עירון,יישוב,573,248,325,7,566,426,560,4,8.58%
2018-06,חיפה,2500,נשר,יישוב,345,165,180,73,272,109,324,12,2.56%
2018-06,חיפה,534,עספיא,יישוב,316,129,187,18,298,141,294,6,4.78%
2018-06,חיפה,637,ערערה,יישוב,465,213,252,18,447,268,454,16,5.04%
2018-06,חיפה,537,פוריידיס,יישוב,170,98,72,9,161,38,168,8,2.78%
2018-06,חיפה,7800,פרדס חנה-כרכור,יישוב,678,280,398,204,474,63,666,17,3.10%
2018-06,חיפה,6800,קריית אתא,יישוב,1183,551,632,124,1059,492,1138,26,3.69%
2018-06,חיפה,9500,קריית ביאליק,יישוב,820,367,453,119,701,276,804,29,3.76%
2018-06,חיפה,2300,קריית טבעון,יישוב,173,80,93,68,105,18,171,0,2.04%
2018-06,חיפה,9600,קריית ים,יישוב,1070,539,531,87,983,509,1022,37,4.83%
2018-06,חיפה,8200,קריית מוצקין,יישוב,777,329,448,146,631,232,753,19,3.24%
2018-06,חיפה,922,רכסים,יישוב,135,58,77,9,126,50,125,0,3.34%
2018-06,ירושלים,472,אבו גוש,יישוב,191,87,104,6,185,149,187,1,5.42%
2018-06,ירושלים,2610,בית שמש,יישוב,1064,487,577,79,985,301,1015,39,2.72%
2018-06,ירושלים,3000,ירושלים,יישוב,10202,4699,5503,1312,8890,5726,9915,138,3.10%
2018-06,ירושלים,26,מ.א. מטה יהודה,מועצה איזורית,472,232,240,135,337,79,465,1,1.80%
2018-06,ירושלים,1015,מבשרת ציון,יישוב,275,146,129,63,212,72,272,4,2.13%
2018-06,ירושלים,1137,קריית יערים,יישוב,43,17,26,11,32,8,43,0,2.41%
2018-06,תל אביב,2400,אור יהודה,יישוב,591,299,292,65,526,113,566,19,2.94%
2018-06,תל אביב,565,אזור,יישוב,155,75,80,34,121,20,151,3,2.26%
2018-06,תל אביב,6100,בני ברק,יישוב,1495,737,758,88,1407,503,1390,19,2.30%
2018-06,תל אביב,6200,בת ים,יישוב,2368,1170,1198,335,2033,702,2248,89,3.19%
2018-06,תל אביב,6300,גבעתיים,יישוב,695,308,387,341,354,65,689,4,2.17%
2018-06,תל אביב,6400,הרצלייה,יישוב,987,472,515,382,605,36,973,20,1.98%
2018-06,תל אביב,6600,חולון,יישוב,2731,1241,1490,453,2278,458,2646,58,2.63%
2018-06,תל אביב,267,כפר שמריהו,יישוב,7,1,6,4,3,0,7,0,0.84%
2018-06,תל אביב,2620,קריית אונו,יישוב,371,171,200,170,201,36,361,4,1.85%
2018-06,תל אביב,8600,רמת גן,יישוב,1878,842,1036,711,1167,239,1847,21,2.26%
2018-06,תל אביב,2650,רמת השרון,יישוב,368,167,201,186,182,10,365,2,1.59%
2018-06,תל אביב,5000,תל אביב -יפו,יישוב,6753,3393,3360,2900,3853,1169,6615,68,2.51%
2018-07,אזור יהודה והשומרון,3760,אורנית,יישוב,97,41,56,37,60,0,97,0,1.93%
2018-07,אזור יהודה והשומרון,3750,אלפי מנשה,יישוב,89,36,53,30,59,1,89,2,2.01%
2018-07,אזור יהודה והשומרון,3560,אלקנה,יישוב,35,20,15,19,16,1,35,0,1.90%
2018-07,אזור יהודה והשומרון,3650,אפרת,יישוב,74,37,37,34,40,2,73,0,1.48%
2018-07,אזור יהודה והשומרון,3570,אריאל,יישוב,257,106,151,75,182,13,254,13,2.32%
2018-07,אזור יהודה והשומרון,3574,בית אל,יישוב,43,17,26,11,32,8,43,0,1.72%
2018-07,אזור יהודה והשומרון,3652,בית אריה,יישוב,47,18,29,9,38,1,47,0,1.64%
2018-07,אזור יהודה והשומרון,3780,ביתר עילית,יישוב,857,235,622,24,833,157,844,6,5.30%
2018-07,אזור יהודה והשומרון,3730,גבעת זאב,יישוב,198,89,109,40,158,28,196,0,2.41%
2018-07,אזור יהודה והשומרון,3769,הר אדר,יישוב,31,19,12,14,17,4,30,0,1.37%
2018-07,אזור יהודה והשומרון,76,מ.א. גוש עציון,מועצה איזורית,173,82,91,71,102,14,171,0,1.69%
2018-07,אזור יהודה והשומרון,78,מ.א. הר חברון,מועצה איזורית,78,37,41,34,44,4,76,0,1.92%
2018-07,אזור יהודה והשומרון,74,מ.א. מגילות ים המלח,מועצה איזורית,26,8,18,8,18,0,26,0,2.80%
2018-07,אזור יהודה והשומרון,73,מ.א. מטה בנימין,מועצה איזורית,631,293,338,236,395,93,624,0,2.20%
2018-07,אזור יהודה והשומרון,75,מ.א. ערבות הירדן,מועצה איזורית,55,22,33,22,33,5,53,0,2.06%
2018-07,אזור יהודה והשומרון,72,מ.א. שומרון,מועצה איזורית,388,172,216,153,235,16,387,0,2.04%
2018-07,אזור יהודה והשומרון,3797,מודיעין עילית,יישוב,858,146,712,34,824,24,854,7,5.19%
2018-07,אזור יהודה והשומרון,3616,מעלה אדומים,יישוב,558,233,325,79,479,112,554,9,2.65%
2018-07,אזור יהודה והשומרון,3608,מעלה אפרים,יישוב,35,15,20,1,34,11,35,0,4.34%
2018-07,אזור יהודה והשומרון,3660,עמנואל,יישוב,78,27,51,7,71,17,78,1,5.61%
2018-07,אזור יהודה והשומרון,3557,קדומים,יישוב,26,14,12,13,13,1,25,0,1.26%
2018-07,אזור יהודה והשומרון,3611,קריית ארבע,יישוב,98,53,45,18,80,32,93,3,2.76%
2018-07,אזור יהודה והשומרון,3640,קרני שומרון,יישוב,75,32,43,23,52,1,73,2,1.80%
2018-07,הדרום,31,אופקים,יישוב,1060,352,708,57,1003,357,1025,39,6.99%
2018-07,הדרום,2600,אילת,יישוב,931,468,463,53,878,219,877,48,2.55%
2018-07,הדרום,70,אשדוד,יישוב,5393,2110,3283,685,4708,1814,5187,91,4.61%
2018-07,הדרום,7100,אשקלון,יישוב,3556,1512,2044,403,3153,1283,3270,59,4.40%
2018-07,הדרום,9000,באר שבע,יישוב,5494,2499,2995,782,4712,2420,5196,93,4.83%
2018-07,הדרום,2200,דימונה,יישוב,1676,757,919,81,1595,934,1591,44,8.12%
2018-07,הדרום,1303,חורה,יישוב,473,198,275,1,472,397,445,1,9.32%
2018-07,הדרום,831,ירוחם,יישוב,414,212,202,10,404,196,383,21,7.43%
2018-07,הדרום,1059,כסיפה,יישוב,968,369,599,1,967,843,958,7,17.62%
2018-07,הדרום,1271,להבים,יישוב,58,34,24,30,28,0,58,0,1.64%
2018-07,הדרום,1060,לקיה,יישוב,629,259,370,7,622,502,588,3,11.97%
2018-07,הדרום,69,מ.א. אל קסום,מועצה איזורית,776,310,466,6,770,635,756,0,22.16%
2018-07,הדרום,38,מ.א. אשכול,מועצה איזורית,142,66,76,32,110,11,141,0,2.01%
2018-07,הדרום,33,מ.א. באר טוביה,מועצה איזורית,283,119,164,57,226,38,282,0,2.49%
2018-07,הדרום,41,מ.א. בני שמעון,מועצה איזורית,96,36,60,35,61,17,96,0,1.98%
2018-07,הדרום,54,מ.א. הערבה התיכונה,מועצה איזורית,32,15,17,14,18,0,32,0,1.68%
2018-07,הדרום,53,מ.א. חבל אילות,מועצה איזורית,27,6,21,8,19,0,25,4,1.01%
2018-07,הדרום,36,מ.א. חוף אשקלון,מועצה איזורית,226,109,117,45,181,37,216,0,2.48%
2018-07,הדרום,35,מ.א. יואב,מועצה איזורית,101,44,57,31,70,12,99,0,2.42%
2018-07,הדרום,50,מ.א. לכיש,מועצה איזורית,162,70,92,25,137,33,157,0,2.82%
2018-07,הדרום,42,מ.א. מרחבים,מועצה איזורית,207,68,139,37,170,28,205,0,3.26%
2018-07,הדרום,68,מ.א. נווה מדבר,מועצה איזורית,130,47,83,1,129,100,128,0,6.78%
2018-07,הדרום,48,מ.א. רמת נגב,מועצה איזורית,289,142,147,15,274,229,281,1,8.43%
2018-07,הדרום,39,מ.א. שדות נגב,מועצה איזורית,136,65,71,23,113,31,132,0,2.71%
2018-07,הדרום,37,מ.א. שער הנגב,מועצה איזורית,92,45,47,35,57,13,90,0,2.25%
2018-07,הדרום,34,מ.א. שפיר,מועצה איזורית,163,77,86,17,146,38,160,0,3.21%
2018-07,הדרום,51,מ.א. תמר,מועצה איזורית,10,5,5,5,5,3,10,0,1.54%
2018-07,הדרום,1268,מיתר,יישוב,57,27,30,26,31,2,56,0,1.14%
2018-07,הדרום,99,מצפה רמון,יישוב,235,91,144,16,219,143,225,16,8.06%
2018-07,הדרום,246,נתיבות,יישוב,1227,454,773,72,1155,345,1184,61,7.06%
2018-07,הדרום,666,עומר,יישוב,57,25,32,19,38,3,57,2,1.35%
2018-07,הדרום,2560,ערד,יישוב,690,302,388,73,617,275,657,37,5.15%
2018-07,הדרום,1192,ערערה-בנגב,יישוב,1009,447,562,8,1001,895,981,7,19.02%
2018-07,הדרום,2630,קריית גת,יישוב,1753,724,1029,125,1628,604,1676,39,5.68%
2018-07,הדרום,1034,קריית מלאכי,יישוב,818,347,471,24,794,324,769,42,6.17%
2018-07,הדרום,1161,רהט,יישוב,2183,867,1316,11,2172,1433,2150,51,9.54%
2018-07,הדרום,1286,שגב-שלום,יישוב,353,135,218,3,350,243,347,3,10.63%
2018-07,הדרום,1031,שדרות,יישוב,995,463,532,77,918,408,909,41,6.09%
2018-07,הדרום,1054,תל שבע,יישוב,722,311,411,6,716,583,665,6,11.55%
2018-07,המרכז,1066,"בני עי""ש",יישוב,134,62,72,20,114,33,131,5,3.26%
2018-07,המרכז,182,אבן יהודה,יישוב,145,65,80,56,89,14,143,1,2.05%
2018-07,המרכז,41,אליכין,יישוב,64,34,30,15,49,15,61,0,3.10%
2018-07,המרכז,1309,אלעד,יישוב,662,177,485,22,640,25,650,5,4.47%
2018-07,המרכז,2530,באר יעקב,יישוב,357,136,221,84,273,28,351,5,2.71%
2018-07,המרכז,466,בית דגן,יישוב,117,53,64,20,97,28,114,0,3.04%
2018-07,המרכז,681,גבעת שמואל,יישוב,258,132,126,99,159,28,254,1,2.03%
2018-07,המרכז,2550,גדרה,יישוב,294,123,171,66,228,53,289,8,2.23%
2018-07,המרכז,627,ג'לג'וליה,יישוב,65,33,32,4,61,28,64,1,1.49%
2018-07,המרכז,166,גן יבנה,יישוב,317,126,191,63,254,54,309,5,2.43%
2018-07,המרכז,229,גני תקווה,יישוב,200,82,118,69,131,23,197,0,2.04%
2018-07,המרכז,9700,הוד השרון,יישוב,740,282,458,342,398,18,734,11,2.24%
2018-07,המרכז,1290,זמר,יישוב,108,36,72,2,106,70,105,2,3.22%
2018-07,המרכז,2730,טייבה,יישוב,916,411,505,25,891,547,776,29,4.01%
2018-07,המרכז,2720,טירה,יישוב,158,85,73,18,140,22,150,6,1.20%
2018-07,המרכז,2660,יבנה,יישוב,749,341,408,164,585,137,738,22,2.92%
2018-07,המרכז,9400,יהוד,יישוב,389,164,225,101,288,40,384,3,2.35%
2018-07,המרכז,1224,כוכב יאיר,יישוב,83,31,52,56,27,0,83,1,1.49%
2018-07,המרכז,633,כפר ברא,יישוב,17,10,7,3,14,7,15,0,0.93%
2018-07,המרכז,168,כפר יונה,יישוב,305,135,170,64,241,42,302,5,2.57%
2018-07,המרכז,6900,כפר סבא,יישוב,1223,520,703,499,724,52,1216,19,2.29%
2018-07,המרכז,634,כפר קאסם,יישוב,200,92,108,7,193,91,193,5,1.87%
2018-07,המרכז,7000,לוד,יישוב,1629,752,877,147,1482,674,1584,41,4.28%
2018-07,המרכז,28,מ.א. ברנר,מועצה איזורית,75,30,45,36,39,4,74,5,1.82%
2018-07,המרכז,32,מ.א. גדרות,מועצה איזורית,35,19,16,13,22,3,35,0,1.42%
2018-07,המרכז,30,מ.א. גזר,מועצה איזורית,291,132,159,113,178,24,290,0,2.16%
2018-07,המרכז,27,מ.א. גן רווה,מועצה איזורית,61,31,30,28,33,0,61,0,2.04%
2018-07,המרכז,20,מ.א. דרום השרון,מועצה איזורית,356,151,205,161,195,7,355,0,2.19%
2018-07,המרכז,29,מ.א. חבל יבנה,מועצה איזורית,44,18,26,22,22,1,44,0,1.68%
2018-07,המרכז,25,מ.א. חבל מודיעין,מועצה איזורית,260,114,146,93,167,23,254,0,2.31%
2018-07,המרכז,19,מ.א. חוף השרון,מועצה איזורית,113,45,68,47,66,4,112,0,2.01%
2018-07,המרכז,18,מ.א. לב השרון,מועצה איזורית,282,118,164,79,203,28,275,0,2.47%
2018-07,המרכז,31,מ.א. נחל שורק,מועצה איזורית,53,18,35,11,42,6,51,39,1.13%
2018-07,המרכז,16,מ.א. עמק חפר,מועצה איזורית,366,145,221,156,210,7,363,0,1.84%
2018-07,המרכז,40,מ.א. שדות דן,מועצה איזורית,150,65,85,41,109,14,149,0,2.31%
2018-07,המרכז,1200,מודיעין-מכבים-רעות*,יישוב,886,364,522,434,452,28,878,15,1.90%
2018-07,המרכז,28,מזכרת בתיה,יישוב,164,62,102,59,105,18,161,5,1.98%
2018-07,המרכז,7200,נס ציונה,יישוב,623,281,342,178,445,106,614,14,2.48%
2018-07,המרכז,7400,נתניה,יישוב,4071,1863,2208,574,3497,896,3990,81,3.67%
2018-07,המרכז,587,סביון*,יישוב,23,6,17,9,14,1,22,0,1.05%
2018-07,המרכז,171,פרדסייה,יישוב,92,41,51,25,67,2,91,0,2.41%
2018-07,המרכז,7900,פתח תקווה,יישוב,3813,1663,2150,820,2993,693,3727,45,2.88%
2018-07,המרכז,195,קדימה-צורן,יישוב,272,107,165,98,174,17,270,4,2.30%
2018-07,המרכז,638,קלנסווה,יישוב,317,140,177,10,307,193,273,9,2.82%
2018-07,המרכז,469,קריית עקרון,יישוב,235,112,123,21,214,79,229,7,3.75%
2018-07,המרכז,2640,ראש העין,יישוב,872,366,506,187,685,90,866,4,2.79%
2018-07,המרכז,8300,ראשון לציון,יישוב,3987,1743,2244,854,3133,744,3942,58,2.80%
2018-07,המרכז,8400,רחובות,יישוב,2426,1001,1425,587,1839,544,2358,55,3.30%
2018-07,המרכז,8500,רמלה,יישוב,1479,680,799,104,1375,437,1431,46,3.68%
2018-07,המרכז,8700,רעננה,יישוב,702,321,381,347,355,27,697,9,1.84%
2018-07,המרכז,1304,שוהם,יישוב,195,80,115,93,102,9,194,0,1.60%
2018-07,המרכז,154,תל מונד,יישוב,117,50,67,40,77,11,117,1,1.70%
2018-07,הצפון,473,אבו סנאן,יישוב,522,223,299,3,519,353,511,7,8.07%
2018-07,הצפון,478,אכסאל,יישוב,389,183,206,9,380,303,388,1,6.10%
2018-07,הצפון,529,אעבלין,יישוב,358,159,199,12,346,255,353,9,5.71%
2018-07,הצפון,482,בועיינה-נוג'ידאת,יישוב,200,94,106,12,188,145,198,2,4.61%
2018-07,הצפון,4001,בוקעאתא,יישוב,294,109,185,5,289,225,286,0,9.55%
2018-07,הצפון,998,ביר אל-מכסור,יישוב,258,120,138,4,254,170,255,2,6.12%
2018-07,הצפון,480,בית ג'ן,יישוב,351,86,265,15,336,224,340,1,5.68%
2018-07,הצפון,9200,בית שאן,יישוב,670,327,343,25,645,265,647,37,6.13%
2018-07,הצפון,944,בסמת טבעון,יישוב,142,64,78,3,139,85,132,1,3.67%
2018-07,הצפון,483,בענה,יישוב,306,129,177,12,294,237,293,8,7.54%
2018-07,הצפון,1292,ג'דיידה-מכר,יישוב,980,442,538,7,973,685,966,15,9.39%
2018-07,הצפון,485,ג'ולס,יישוב,147,38,109,0,147,81,145,1,4.45%
2018-07,הצפון,487,ג'ש (גוש חלב),יישוב,44,19,25,5,39,16,44,0,2.58%
2018-07,הצפון,489,דבורייה,יישוב,229,91,138,17,212,153,222,0,4.70%
2018-07,הצפון,490,דייר אל-אסד,יישוב,347,147,200,18,329,231,336,6,5.81%
2018-07,הצפון,492,דייר חנא,יישוב,473,208,265,14,459,318,471,5,8.91%
2018-07,הצפון,975,זרזיר,יישוב,193,73,120,7,186,97,191,4,5.31%
2018-07,הצפון,496,חורפיש,יישוב,127,56,71,13,114,52,117,2,3.80%
2018-07,הצפון,2034,חצור הגלילית,יישוב,221,89,132,15,206,89,210,1,4.30%
2018-07,הצפון,6700,טבריה,יישוב,1366,610,756,86,1280,525,1223,51,5.46%
2018-07,הצפון,962,טובא-זנגרייה,יישוב,287,110,177,5,282,151,280,8,8.22%
2018-07,הצפון,498,טורעאן,יישוב,287,129,158,13,274,208,280,4,4.45%
2018-07,הצפון,8900,טמרה,יישוב,1192,543,649,31,1161,854,1171,13,7.52%
2018-07,הצפון,1295,יאנוח-ג'ת,יישוב,113,36,77,5,108,61,103,1,3.23%
2018-07,הצפון,46,יבנאל,יישוב,83,46,37,10,73,36,73,0,4.60%
2018-07,הצפון,29,יסוד המעלה,יישוב,17,5,12,3,14,4,16,0,1.82%
2018-07,הצפון,499,יפיע,יישוב,415,189,226,24,391,299,414,2,4.81%
2018-07,הצפון,240,יקנעם עילית,יישוב,480,203,277,110,370,83,473,21,3.65%
2018-07,הצפון,502,ירכא,יישוב,334,143,191,1,333,224,330,4,4.71%
2018-07,הצפון,504,כאבול,יישוב,369,190,179,10,359,277,358,0,6.64%
2018-07,הצפון,505,כאוכב אבו אל-היג'א,יישוב,170,69,101,4,166,136,168,0,8.91%
2018-07,הצפון,1296,כסרא-סמיע,יישוב,159,53,106,1,158,88,148,5,3.82%
2018-07,הצפון,978,כעביה-טבאש-חג'אג'רה,יישוב,136,44,92,6,130,82,133,4,5.18%
2018-07,הצפון,1263,כפר ורדים,יישוב,65,23,42,29,36,4,62,2,1.99%
2018-07,הצפון,507,כפר יאסיף,יישוב,346,153,193,4,342,221,336,3,6.20%
2018-07,הצפון,508,כפר כמא,יישוב,34,19,15,6,28,11,33,0,1.92%
2018-07,הצפון,509,כפר כנא,יישוב,665,341,324,26,639,479,645,16,6.66%
2018-07,הצפון,510,כפר מנדא,יישוב,621,303,318,12,609,405,620,2,7.68%
2018-07,הצפון,47,כפר תבור,יישוב,45,19,26,19,26,4,44,0,1.86%
2018-07,הצפון,1139,כרמיאל,יישוב,1371,573,798,289,1082,604,1275,30,4.91%
2018-07,הצפון,65,מ.א. אל-בטוף,מועצה איזורית,216,95,121,12,204,145,206,0,6.33%
2018-07,הצפון,66,מ.א. בוסתן אל-מרג,מועצה איזורית,29,9,20,0,29,26,29,1,0.83%
2018-07,הצפון,71,מ.א. גולן,מועצה איזורית,219,103,116,83,136,14,217,0,2.47%
2018-07,הצפון,8,מ.א. הגלבוע,מועצה איזורית,548,230,318,60,488,247,538,0,3.81%
2018-07,הצפון,1,מ.א. הגליל העליון,מועצה איזורית,208,88,120,83,125,13,208,0,2.32%
2018-07,הצפון,3,מ.א. הגליל התחתון,מועצה איזורית,107,41,66,35,72,9,101,0,1.68%
2018-07,הצפון,55,מ.א. מבואות החרמון,מועצה איזורית,94,35,59,17,77,18,93,0,2.32%
2018-07,הצפון,13,מ.א. מגידו,מועצה איזורית,92,39,53,28,64,8,92,0,1.63%
2018-07,הצפון,4,מ.א. מטה אשר,מועצה איזורית,435,179,256,83,352,132,424,0,2.99%
2018-07,הצפון,52,מ.א. מעלה יוסף,מועצה איזורית,180,67,113,31,149,33,178,0,3.10%
2018-07,הצפון,2,מ.א. מרום הגליל,מועצה איזורית,257,112,145,29,228,93,249,0,3.49%
2018-07,הצפון,56,מ.א. משגב,מועצה איזורית,498,201,297,121,377,237,484,0,3.42%
2018-07,הצפון,6,מ.א. עמק הירדן,מועצה איזורית,135,58,77,35,100,20,125,0,1.84%
2018-07,הצפון,7,מ.א. עמק המעיינות,מועצה איזורית,188,82,106,45,143,35,183,0,2.79%
2018-07,הצפון,9,מ.א. עמק יזרעאל,מועצה איזורית,374,170,204,164,210,32,369,0,1.89%
2018-07,הצפון,481,מגאר,יישוב,902,363,539,19,883,643,883,7,8.37%
2018-07,הצפון,516,מג'ד אל-כרום,יישוב,450,205,245,16,434,272,438,4,5.92%
2018-07,הצפון,65,מגדל,יישוב,32,15,17,6,26,5,27,0,2.72%
2018-07,הצפון,874,מגדל העמק,יישוב,835,372,463,88,747,232,789,57,5.71%
2018-07,הצפון,4201,מג'דל שמס,יישוב,340,126,214,15,325,227,329,2,6.26%
2018-07,הצפון,517,מזרעה,יישוב,126,59,67,3,123,81,119,2,5.57%
2018-07,הצפון,43,מטולה,יישוב,23,12,11,5,18,6,21,0,2.09%
2018-07,הצפון,4203,מסעדה,יישוב,170,69,101,6,164,118,162,2,8.93%
2018-07,הצפון,518,מעיליא,יישוב,51,20,31,7,44,19,49,0,2.86%
2018-07,הצפון,1063,מעלות-תרשיחא,יישוב,702,330,372,81,621,307,665,34,5.45%
2018-07,הצפון,520,משהד,יישוב,152,70,82,3,149,108,145,5,4.06%
2018-07,הצפון,9100,נהרייה,יישוב,1618,774,844,191,1427,724,1531,55,4.84%
2018-07,הצפון,522,נחף,יישוב,335,146,189,11,324,243,330,8,5.89%
2018-07,הצפון,7300,נצרת,יישוב,2480,1118,1362,138,2342,1653,2458,13,6.66%
2018-07,הצפון,1061,נצרת עילית,יישוב,1263,603,659,112,1151,485,1153,74,4.91%
2018-07,הצפון,525,סאג'ור,יישוב,107,45,62,7,100,61,103,0,4.73%
2018-07,הצפון,7500,סח'נין,יישוב,1494,660,834,34,1460,1131,1481,20,9.60%
2018-07,הצפון,4501,ע'ג'ר,יישוב,70,29,41,1,69,36,67,1,5.64%
2018-07,הצפון,530,עיילבון,יישוב,135,63,72,6,129,74,131,1,4.53%
2018-07,הצפון,511,עילוט,יישוב,225,91,134,3,222,167,225,0,7.04%
2018-07,הצפון,532,עין מאהל,יישוב,326,168,158,6,320,230,316,0,5.40%
2018-07,הצפון,4502,עין קנייא,יישוב,96,43,53,2,94,73,94,1,8.55%
2018-07,הצפון,7600,עכו,יישוב,2693,1120,1573,151,2542,1663,2595,38,9.50%
2018-07,הצפון,7700,עפולה,יישוב,1464,588,876,163,1301,424,1402,55,5.10%
2018-07,הצפון,531,עראבה,יישוב,1014,446,568,25,989,828,1004,9,8.98%
2018-07,הצפון,535,פסוטה,יישוב,87,37,50,12,75,37,81,2,4.50%
2018-07,הצפון,536,פקיעין (בוקייעה),יישוב,103,62,41,5,98,60,100,4,3.34%
2018-07,הצפון,8000,צפת,יישוב,1010,504,506,99,911,526,957,20,6.83%
2018-07,הצפון,4100,קצרין,יישוב,172,77,95,37,135,57,167,4,4.17%
2018-07,הצפון,2800,קריית שמונה,יישוב,661,317,344,63,598,219,636,29,4.90%
2018-07,הצפון,543,ראמה,יישוב,230,94,136,17,213,145,221,1,5.38%
2018-07,הצפון,26,ראש פינה,יישוב,44,13,31,6,38,18,42,0,2.55%
2018-07,הצפון,542,ריינה,יישוב,422,204,218,15,407,281,411,8,5.54%
2018-07,הצפון,122,רמת ישי,יישוב,90,31,59,31,59,15,88,3,2.13%
2018-07,הצפון,913,שבלי - אום אל-גנם,יישוב,157,55,102,8,149,93,151,5,5.32%
2018-07,הצפון,812,שלומי,יישוב,201,87,114,17,184,82,194,1,5.30%
2018-07,הצפון,538,שעב,יישוב,325,142,183,5,320,263,324,3,9.73%
2018-07,הצפון,8800,שפרעם,יישוב,1186,513,673,43,1143,796,1169,14,5.99%
2018-07,חיפה,1326,"בסמ""ה",יישוב,290,135,155,4,286,214,287,3,6.43%
2018-07,חיפה,2710,אום אל-פחם,יישוב,2329,1001,1328,32,2297,1775,2279,46,9.80%
2018-07,חיפה,1020,אור עקיבא,יישוב,463,193,270,51,412,95,444,14,4.21%
2018-07,חיפה,6000,באקה אל-גרביה,יישוב,525,272,253,18,507,276,520,23,3.99%
2018-07,חיפה,9800,בנימינה-גבעת עדה*,יישוב,159,75,84,73,86,19,157,4,2.09%
2018-07,חיפה,541,ג'סר א-זרקא,יישוב,219,112,107,2,217,57,211,13,3.29%
2018-07,חיפה,628,ג'ת,יישוב,185,94,91,7,178,88,185,2,3.20%
2018-07,חיפה,494,דאלית אל-כרמל,יישוב,413,145,268,14,399,188,387,8,4.41%
2018-07,חיפה,9300,זכרון יעקב,יישוב,231,99,132,93,138,17,229,2,2.01%
2018-07,חיפה,6500,חדרה,יישוב,1986,859,1127,269,1717,521,1874,35,3.61%
2018-07,חיפה,4000,חיפה,יישוב,5084,2461,2623,1143,3941,1983,4799,136,3.40%
2018-07,חיפה,1247,חריש,יישוב,170,64,106,36,134,24,165,2,3.83%
2018-07,חיפה,2100,טירת כרמל,יישוב,610,308,302,47,563,296,584,12,4.77%
2018-07,חיפה,654,כפר קרע,יישוב,371,158,213,20,351,187,366,5,3.90%
2018-07,חיפה,45,מ.א. אלונה,מועצה איזורית,15,5,10,3,12,0,15,0,1.41%
2018-07,חיפה,12,מ.א. זבולון,מועצה איזורית,190,89,101,26,164,101,180,0,3.04%
2018-07,חיפה,15,מ.א. חוף הכרמל,מועצה איזורית,326,159,167,124,202,39,322,0,2.17%
2018-07,חיפה,14,מ.א. מנשה,מועצה איזורית,237,106,131,81,156,45,235,0,2.73%
2018-07,חיפה,1327,מעלה עירון,יישוב,610,249,361,12,598,437,596,8,9.08%
2018-07,חיפה,2500,נשר,יישוב,363,180,183,74,289,108,349,7,2.76%
2018-07,חיפה,534,עספיא,יישוב,319,129,190,18,301,142,299,4,4.86%
2018-07,חיפה,637,ערערה,יישוב,478,213,265,16,462,279,464,13,5.15%
2018-07,חיפה,537,פוריידיס,יישוב,196,105,91,12,184,39,194,9,3.20%
2018-07,חיפה,7800,פרדס חנה-כרכור,יישוב,708,296,412,214,494,57,695,14,3.23%
2018-07,חיפה,6800,קריית אתא,יישוב,1347,555,792,134,1213,503,1302,25,4.20%
2018-07,חיפה,9500,קריית ביאליק,יישוב,843,357,486,119,724,277,819,24,3.83%
2018-07,חיפה,2300,קריית טבעון,יישוב,179,86,93,79,100,21,176,2,2.09%
2018-07,חיפה,9600,קריית ים,יישוב,1111,587,524,105,1006,490,1070,34,5.05%
2018-07,חיפה,8200,קריית מוצקין,יישוב,830,352,478,158,672,239,816,28,3.50%
2018-07,חיפה,922,רכסים,יישוב,178,56,122,14,164,46,167,0,4.41%
2018-07,ירושלים,472,אבו גוש,יישוב,197,84,113,9,188,148,192,1,5.56%
2018-07,ירושלים,2610,בית שמש,יישוב,1605,533,1072,87,1518,307,1570,30,4.14%
2018-07,ירושלים,3000,ירושלים,יישוב,11931,4891,7040,1502,10429,5888,11633,116,3.62%
2018-07,ירושלים,26,מ.א. מטה יהודה,מועצה איזורית,567,249,318,155,412,87,556,0,2.15%
2018-07,ירושלים,1015,מבשרת ציון,יישוב,267,129,138,65,202,80,263,3,2.07%
2018-07,ירושלים,1137,קריית יערים,יישוב,68,25,43,18,50,6,68,0,3.76%
2018-07,תל אביב,2400,אור יהודה,יישוב,724,337,387,71,653,117,708,38,3.65%
2018-07,תל אביב,565,אזור,יישוב,175,81,94,37,138,16,173,5,2.58%
2018-07,תל אביב,6100,בני ברק,יישוב,2742,798,1944,101,2641,504,2645,20,4.29%
2018-07,תל אביב,6200,בת ים,יישוב,2521,1245,1276,366,2155,710,2395,83,3.40%
2018-07,תל אביב,6300,גבעתיים,יישוב,742,330,412,365,377,62,732,2,2.30%
2018-07,תל אביב,6400,הרצלייה,יישוב,1091,511,580,413,678,37,1078,14,2.19%
2018-07,תל אביב,6600,חולון,יישוב,2944,1306,1638,508,2436,471,2868,47,2.84%
2018-07,תל אביב,267,כפר שמריהו,יישוב,7,1,6,4,3,0,7,0,0.84%
2018-07,תל אביב,2620,קריית אונו,יישוב,393,168,225,182,211,24,389,2,1.99%
2018-07,תל אביב,8600,רמת גן,יישוב,2115,889,1226,783,1332,233,2079,23,2.54%
2018-07,תל אביב,2650,רמת השרון,יישוב,412,182,230,200,212,7,408,2,1.78%
2018-07,תל אביב,5000,תל אביב -יפו,יישוב,7152,3506,3646,3076,4076,1155,7022,81,2.66%
2018-08,אזור יהודה והשומרון,3760,אורנית,יישוב,100,40,60,41,59,0,100,0,1.99%
2018-08,אזור יהודה והשומרון,3750,אלפי מנשה,יישוב,97,39,58,30,67,2,97,0,2.18%
2018-08,אזור יהודה והשומרון,3560,אלקנה,יישוב,31,19,12,17,14,0,31,1,1.68%
2018-08,אזור יהודה והשומרון,3650,אפרת,יישוב,73,33,40,35,38,2,73,0,1.48%
2018-08,אזור יהודה והשומרון,3570,אריאל,יישוב,267,112,155,75,192,16,263,9,2.40%
2018-08,אזור יהודה והשומרון,3574,בית אל,יישוב,49,22,27,16,33,8,49,0,1.96%
2018-08,אזור יהודה והשומרון,3652,בית אריה,יישוב,49,19,30,9,40,0,48,1,1.67%
2018-08,אזור יהודה והשומרון,3780,ביתר עילית,יישוב,940,234,706,28,912,145,931,5,5.81%
2018-08,אזור יהודה והשומרון,3730,גבעת זאב,יישוב,209,85,124,46,163,29,203,3,2.50%
2018-08,אזור יהודה והשומרון,3769,הר אדר,יישוב,30,19,11,14,16,4,29,0,1.33%
2018-08,אזור יהודה והשומרון,76,מ.א. גוש עציון,מועצה איזורית,179,85,94,74,105,16,177,0,1.75%
2018-08,אזור יהודה והשומרון,78,מ.א. הר חברון,מועצה איזורית,75,29,46,34,41,3,74,0,1.87%
2018-08,אזור יהודה והשומרון,74,מ.א. מגילות ים המלח,מועצה איזורית,24,9,15,6,18,0,24,1,2.59%
2018-08,אזור יהודה והשומרון,73,מ.א. מטה בנימין,מועצה איזורית,630,283,347,218,412,92,622,0,2.19%
2018-08,אזור יהודה והשומרון,75,מ.א. ערבות הירדן,מועצה איזורית,52,26,26,16,36,5,50,0,1.94%
2018-08,אזור יהודה והשומרון,72,מ.א. שומרון,מועצה איזורית,376,155,221,149,227,15,374,0,1.97%
2018-08,אזור יהודה והשומרון,3797,מודיעין עילית,יישוב,981,171,810,44,937,32,976,2,5.89%
2018-08,אזור יהודה והשומרון,3616,מעלה אדומים,יישוב,546,224,322,81,465,106,542,10,2.59%
2018-08,אזור יהודה והשומרון,3608,מעלה אפרים,יישוב,32,13,19,1,31,12,32,0,3.99%
2018-08,אזור יהודה והשומרון,3660,עמנואל,יישוב,93,30,63,7,86,15,93,2,6.62%
2018-08,אזור יהודה והשומרון,3557,קדומים,יישוב,30,16,14,13,17,2,29,0,1.46%
2018-08,אזור יהודה והשומרון,3611,קריית ארבע,יישוב,104,51,53,17,87,33,99,3,2.93%
2018-08,אזור יהודה והשומרון,3640,קרני שומרון,יישוב,65,30,35,16,49,0,64,1,1.58%
2018-08,הדרום,31,אופקים,יישוב,1022,343,679,59,963,350,996,38,6.80%
2018-08,הדרום,2600,אילת,יישוב,935,454,481,50,885,200,887,48,2.57%
2018-08,הדרום,70,אשדוד,יישוב,5458,2065,3393,685,4773,1787,5249,79,4.66%
2018-08,הדרום,7100,אשקלון,יישוב,3575,1467,2108,409,3166,1296,3296,77,4.43%
2018-08,הדרום,9000,באר שבע,יישוב,5450,2465,2985,758,4692,2384,5163,94,4.80%
2018-08,הדרום,2200,דימונה,יישוב,1655,727,928,77,1578,914,1571,20,8.03%
2018-08,הדרום,1303,חורה,יישוב,476,201,275,4,472,393,452,4,9.45%
2018-08,הדרום,831,ירוחם,יישוב,447,218,229,10,437,198,421,21,8.11%
2018-08,הדרום,1059,כסיפה,יישוב,944,353,591,1,943,841,935,1,17.27%
2018-08,הדרום,1271,להבים,יישוב,65,38,27,36,29,0,65,0,1.83%
2018-08,הדרום,1060,לקיה,יישוב,616,251,365,7,609,483,585,3,11.92%
2018-08,הדרום,69,מ.א. אל קסום,מועצה איזורית,761,306,455,5,756,626,740,0,21.70%
2018-08,הדרום,38,מ.א. אשכול,מועצה איזורית,140,68,72,29,111,9,139,0,1.98%
2018-08,הדרום,33,מ.א. באר טוביה,מועצה איזורית,269,112,157,57,212,42,264,0,2.33%
2018-08,הדרום,41,מ.א. בני שמעון,מועצה איזורית,90,35,55,31,59,17,89,2,1.83%
2018-08,הדרום,54,מ.א. הערבה התיכונה,מועצה איזורית,30,14,16,13,17,1,29,0,1.52%
2018-08,הדרום,53,מ.א. חבל אילות,מועצה איזורית,24,7,17,6,18,0,23,0,0.93%
2018-08,הדרום,36,מ.א. חוף אשקלון,מועצה איזורית,222,98,124,54,168,39,212,0,2.44%
2018-08,הדרום,35,מ.א. יואב,מועצה איזורית,99,44,55,28,71,9,99,0,2.42%
2018-08,הדרום,50,מ.א. לכיש,מועצה איזורית,155,55,100,30,125,30,154,0,2.76%
2018-08,הדרום,42,מ.א. מרחבים,מועצה איזורית,200,67,133,34,166,29,198,0,3.15%
2018-08,הדרום,68,מ.א. נווה מדבר,מועצה איזורית,136,54,82,1,135,107,133,0,7.04%
2018-08,הדרום,48,מ.א. רמת נגב,מועצה איזורית,281,138,143,16,265,229,272,1,8.16%
2018-08,הדרום,39,מ.א. שדות נגב,מועצה איזורית,137,64,73,29,108,28,134,0,2.75%
2018-08,הדרום,37,מ.א. שער הנגב,מועצה איזורית,95,47,48,33,62,13,92,0,2.30%
2018-08,הדרום,34,מ.א. שפיר,מועצה איזורית,164,77,87,18,146,41,163,0,3.27%
2018-08,הדרום,51,מ.א. תמר,מועצה איזורית,12,6,6,8,4,3,12,0,1.84%
2018-08,הדרום,1268,מיתר,יישוב,67,26,41,29,38,2,66,0,1.34%
2018-08,הדרום,99,מצפה רמון,יישוב,237,84,153,17,220,146,227,11,8.13%
2018-08,הדרום,246,נתיבות,יישוב,1199,424,775,87,1112,348,1152,48,6.88%
2018-08,הדרום,666,עומר,יישוב,57,28,29,20,37,3,57,1,1.35%
2018-08,הדרום,2560,ערד,יישוב,642,257,385,72,570,268,614,38,4.83%
2018-08,הדרום,1192,ערערה-בנגב,יישוב,979,433,546,7,972,870,948,4,18.50%
2018-08,הדרום,2630,קריית גת,יישוב,1697,688,1009,135,1562,580,1626,51,5.52%
2018-08,הדרום,1034,קריית מלאכי,יישוב,797,326,471,26,771,309,759,44,6.10%
2018-08,הדרום,1161,רהט,יישוב,2050,845,1205,12,2038,1385,2024,58,9.03%
2018-08,הדרום,1286,שגב-שלום,יישוב,344,130,214,3,341,235,336,4,10.33%
2018-08,הדרום,1031,שדרות,יישוב,969,433,536,76,893,416,884,39,5.93%
2018-08,הדרום,1054,תל שבע,יישוב,728,325,403,6,722,583,682,12,11.81%
2018-08,המרכז,1066,"בני עי""ש",יישוב,147,65,82,21,126,32,143,6,3.55%
2018-08,המרכז,182,אבן יהודה,יישוב,146,68,78,54,92,17,144,2,2.06%
2018-08,המרכז,41,אליכין,יישוב,65,29,36,16,49,13,62,2,3.15%
2018-08,המרכז,1309,אלעד,יישוב,740,196,544,30,710,29,721,1,4.93%
2018-08,המרכז,2530,באר יעקב,יישוב,332,117,215,87,245,29,327,2,2.53%
2018-08,המרכז,466,בית דגן,יישוב,115,51,64,21,94,29,111,0,2.96%
2018-08,המרכז,681,גבעת שמואל,יישוב,272,132,140,100,172,29,268,1,2.14%
2018-08,המרכז,2550,גדרה,יישוב,318,132,186,72,246,47,311,5,2.40%
2018-08,המרכז,627,ג'לג'וליה,יישוב,62,27,35,4,58,29,57,1,1.33%
2018-08,המרכז,166,גן יבנה,יישוב,308,120,188,62,246,52,303,0,2.38%
2018-08,המרכז,229,גני תקווה,יישוב,210,84,126,71,139,22,210,0,2.17%
2018-08,המרכז,9700,הוד השרון,יישוב,758,278,480,349,409,14,750,7,2.29%
2018-08,המרכז,1290,זמר,יישוב,112,35,77,3,109,77,108,2,3.31%
2018-08,המרכז,2730,טייבה,יישוב,896,405,491,27,869,527,765,22,3.96%
2018-08,המרכז,2720,טירה,יישוב,173,74,99,18,155,21,170,10,1.36%
2018-08,המרכז,2660,יבנה,יישוב,774,340,434,165,609,132,755,16,2.99%
2018-08,המרכז,9400,יהוד,יישוב,407,164,243,97,310,39,401,9,2.45%
2018-08,המרכז,1224,כוכב יאיר,יישוב,87,33,54,57,30,0,87,1,1.56%
2018-08,המרכז,633,כפר ברא,יישוב,20,11,9,3,17,7,19,0,1.18%
2018-08,המרכז,168,כפר יונה,יישוב,327,131,196,63,264,43,326,6,2.77%
2018-08,המרכז,6900,כפר סבא,יישוב,1252,533,719,479,773,51,1239,22,2.33%
2018-08,המרכז,634,כפר קאסם,יישוב,181,78,103,7,174,80,178,3,1.73%
2018-08,המרכז,7000,לוד,יישוב,1595,713,882,147,1448,618,1562,34,4.23%
2018-08,המרכז,28,מ.א. ברנר,מועצה איזורית,79,37,42,37,42,5,79,0,1.93%
2018-08,המרכז,32,מ.א. גדרות,מועצה איזורית,35,16,19,16,19,2,35,0,1.42%
2018-08,המרכז,30,מ.א. גזר,מועצה איזורית,326,135,191,114,212,24,322,0,2.40%
2018-08,המרכז,27,מ.א. גן רווה,מועצה איזורית,65,32,33,31,34,0,65,2,2.17%
2018-08,המרכז,20,מ.א. דרום השרון,מועצה איזורית,354,144,210,153,201,9,350,0,2.16%
2018-08,המרכז,29,מ.א. חבל יבנה,מועצה איזורית,41,19,22,24,17,1,40,0,1.53%
2018-08,המרכז,25,מ.א. חבל מודיעין,מועצה איזורית,266,113,153,88,178,22,260,0,2.37%
2018-08,המרכז,19,מ.א. חוף השרון,מועצה איזורית,110,48,62,46,64,2,110,0,1.98%
2018-08,המרכז,18,מ.א. לב השרון,מועצה איזורית,280,119,161,72,208,25,274,1,2.46%
2018-08,המרכז,31,מ.א. נחל שורק,מועצה איזורית,63,23,40,14,49,10,61,38,1.36%
2018-08,המרכז,16,מ.א. עמק חפר,מועצה איזורית,363,142,221,141,222,10,361,0,1.83%
2018-08,המרכז,40,מ.א. שדות דן,מועצה איזורית,146,56,90,40,106,10,146,0,2.26%
2018-08,המרכז,1200,מודיעין-מכבים-רעות*,יישוב,920,351,569,415,505,34,912,16,1.97%
2018-08,המרכז,28,מזכרת בתיה,יישוב,185,66,119,56,129,20,184,0,2.25%
2018-08,המרכז,7200,נס ציונה,יישוב,621,261,360,167,454,106,610,7,2.46%
2018-08,המרכז,7400,נתניה,יישוב,4208,1773,2435,561,3647,885,4132,66,3.79%
2018-08,המרכז,587,סביון*,יישוב,25,9,16,12,13,1,25,0,1.20%
2018-08,המרכז,171,פרדסייה,יישוב,94,34,60,21,73,4,93,1,2.46%
2018-08,המרכז,7900,פתח תקווה,יישוב,3925,1634,2291,811,3114,681,3840,36,2.96%
2018-08,המרכז,195,קדימה-צורן,יישוב,276,114,162,91,185,15,275,1,2.34%
2018-08,המרכז,638,קלנסווה,יישוב,282,134,148,10,272,175,248,9,2.56%
2018-08,המרכז,469,קריית עקרון,יישוב,259,117,142,24,235,88,252,8,4.11%
2018-08,המרכז,2640,ראש העין,יישוב,979,380,598,179,800,102,970,5,3.11%
2018-08,המרכז,8300,ראשון לציון,יישוב,3895,1677,2218,822,3073,691,3860,58,2.75%
2018-08,המרכז,8400,רחובות,יישוב,2529,995,1534,596,1933,534,2465,40,3.45%
2018-08,המרכז,8500,רמלה,יישוב,1483,666,817,102,1381,417,1443,39,3.71%
2018-08,המרכז,8700,רעננה,יישוב,712,322,390,341,371,23,706,10,1.86%
2018-08,המרכז,1304,שוהם,יישוב,191,81,110,81,110,7,189,1,1.56%
2018-08,המרכז,154,תל מונד,יישוב,142,55,87,41,101,12,140,0,2.03%
2018-08,הצפון,473,אבו סנאן,יישוב,513,223,290,1,512,339,504,8,7.97%
2018-08,הצפון,478,אכסאל,יישוב,406,187,219,13,393,312,406,2,6.36%
2018-08,הצפון,529,אעבלין,יישוב,359,154,205,17,342,253,352,4,5.69%
2018-08,הצפון,482,בועיינה-נוג'ידאת,יישוב,197,90,107,13,184,144,195,2,4.54%
2018-08,הצפון,4001,בוקעאתא,יישוב,288,105,183,8,280,217,280,3,9.37%
2018-08,הצפון,998,ביר אל-מכסור,יישוב,239,109,130,4,235,159,239,3,5.76%
2018-08,הצפון,480,בית ג'ן,יישוב,346,85,261,12,334,217,337,2,5.63%
2018-08,הצפון,9200,בית שאן,יישוב,686,322,364,24,662,270,661,36,6.26%
2018-08,הצפון,944,בסמת טבעון,יישוב,135,62,73,4,131,82,127,4,3.53%
2018-08,הצפון,483,בענה,יישוב,301,129,172,13,288,231,292,1,7.52%
2018-08,הצפון,1292,ג'דיידה-מכר,יישוב,980,426,554,6,974,675,963,11,9.37%
2018-08,הצפון,485,ג'ולס,יישוב,145,40,105,0,145,79,145,2,4.45%
2018-08,הצפון,487,ג'ש (גוש חלב),יישוב,49,20,29,6,43,18,49,3,2.86%
2018-08,הצפון,489,דבורייה,יישוב,222,91,131,12,210,148,218,4,4.62%
2018-08,הצפון,490,דייר אל-אסד,יישוב,347,136,211,20,327,227,334,4,5.78%
2018-08,הצפון,492,דייר חנא,יישוב,457,204,253,16,441,301,456,4,8.65%
2018-08,הצפון,975,זרזיר,יישוב,197,70,127,8,189,91,196,10,5.44%
2018-08,הצפון,496,חורפיש,יישוב,110,52,58,12,98,49,102,4,3.33%
2018-08,הצפון,2034,חצור הגלילית,יישוב,236,96,140,23,213,81,222,6,4.54%
2018-08,הצפון,6700,טבריה,יישוב,1331,581,750,89,1242,519,1198,43,5.36%
2018-08,הצפון,962,טובא-זנגרייה,יישוב,267,100,167,3,264,149,261,13,7.70%
2018-08,הצפון,498,טורעאן,יישוב,309,123,186,12,297,213,297,4,4.71%
2018-08,הצפון,8900,טמרה,יישוב,1189,536,653,37,1152,836,1168,9,7.50%
2018-08,הצפון,1295,יאנוח-ג'ת,יישוב,117,45,72,5,112,59,106,5,3.32%
2018-08,הצפון,46,יבנאל,יישוב,85,46,39,9,76,32,76,1,4.78%
2018-08,הצפון,29,יסוד המעלה,יישוב,15,4,11,1,14,2,15,0,1.71%
2018-08,הצפון,499,יפיע,יישוב,434,194,240,29,405,296,431,1,5.00%
2018-08,הצפון,240,יקנעם עילית,יישוב,477,213,264,110,367,81,468,24,3.61%
2018-08,הצפון,502,ירכא,יישוב,326,140,186,1,325,216,324,6,4.63%
2018-08,הצפון,504,כאבול,יישוב,362,184,178,7,355,271,354,0,6.57%
2018-08,הצפון,505,כאוכב אבו אל-היג'א,יישוב,165,64,101,7,158,131,162,3,8.62%
2018-08,הצפון,1296,כסרא-סמיע,יישוב,156,53,103,1,155,85,148,1,3.82%
2018-08,הצפון,978,כעביה-טבאש-חג'אג'רה,יישוב,128,45,83,6,122,80,122,1,4.77%
2018-08,הצפון,1263,כפר ורדים,יישוב,69,25,44,30,39,6,67,2,2.15%
2018-08,הצפון,507,כפר יאסיף,יישוב,336,152,184,2,334,210,328,6,6.06%
2018-08,הצפון,508,כפר כמא,יישוב,36,19,17,8,28,8,36,2,2.09%
2018-08,הצפון,509,כפר כנא,יישוב,625,317,308,28,597,466,607,12,6.29%
2018-08,הצפון,510,כפר מנדא,יישוב,612,283,329,13,599,400,607,2,7.53%
2018-08,הצפון,47,כפר תבור,יישוב,48,18,30,19,29,4,47,0,1.98%
2018-08,הצפון,1139,כרמיאל,יישוב,1376,570,806,280,1096,600,1280,34,4.93%
2018-08,הצפון,65,מ.א. אל-בטוף,מועצה איזורית,200,91,109,11,189,136,194,2,5.96%
2018-08,הצפון,66,מ.א. בוסתן אל-מרג,מועצה איזורית,26,7,19,0,26,24,26,1,0.74%
2018-08,הצפון,71,מ.א. גולן,מועצה איזורית,232,110,122,88,144,12,230,0,2.62%
2018-08,הצפון,8,מ.א. הגלבוע,מועצה איזורית,553,225,328,58,495,231,547,0,3.87%
2018-08,הצפון,1,מ.א. הגליל העליון,מועצה איזורית,217,93,124,92,125,13,217,0,2.43%
2018-08,הצפון,3,מ.א. הגליל התחתון,מועצה איזורית,102,44,58,42,60,7,98,0,1.63%
2018-08,הצפון,55,מ.א. מבואות החרמון,מועצה איזורית,97,38,59,21,76,18,95,0,2.37%
2018-08,הצפון,13,מ.א. מגידו,מועצה איזורית,95,42,53,29,66,9,95,0,1.68%
2018-08,הצפון,4,מ.א. מטה אשר,מועצה איזורית,419,170,249,78,341,124,409,0,2.88%
2018-08,הצפון,52,מ.א. מעלה יוסף,מועצה איזורית,180,63,117,28,152,26,178,0,3.10%
2018-08,הצפון,2,מ.א. מרום הגליל,מועצה איזורית,249,118,131,27,222,86,243,0,3.40%
2018-08,הצפון,56,מ.א. משגב,מועצה איזורית,504,212,292,124,380,234,486,0,3.44%
2018-08,הצפון,6,מ.א. עמק הירדן,מועצה איזורית,141,65,76,32,109,20,131,0,1.93%
2018-08,הצפון,7,מ.א. עמק המעיינות,מועצה איזורית,188,77,111,45,143,34,183,0,2.79%
2018-08,הצפון,9,מ.א. עמק יזרעאל,מועצה איזורית,397,181,216,171,226,35,390,0,1.99%
2018-08,הצפון,481,מגאר,יישוב,849,354,495,18,831,629,830,13,7.91%
2018-08,הצפון,516,מג'ד אל-כרום,יישוב,485,201,284,20,465,282,473,7,6.37%
2018-08,הצפון,65,מגדל,יישוב,37,17,20,6,31,5,32,2,3.21%
2018-08,הצפון,874,מגדל העמק,יישוב,807,356,451,90,717,220,767,51,5.56%
2018-08,הצפון,4201,מג'דל שמס,יישוב,323,117,206,10,313,222,312,6,5.96%
2018-08,הצפון,517,מזרעה,יישוב,130,66,64,3,127,84,121,2,5.66%
2018-08,הצפון,43,מטולה,יישוב,25,12,13,7,18,6,23,0,2.28%
2018-08,הצפון,4203,מסעדה,יישוב,169,68,101,4,165,118,162,0,8.93%
2018-08,הצפון,518,מעיליא,יישוב,50,21,29,3,47,18,48,2,2.80%
2018-08,הצפון,1063,מעלות-תרשיחא,יישוב,704,317,387,79,625,303,664,35,5.44%
2018-08,הצפון,520,משהד,יישוב,140,61,79,2,138,98,136,2,3.82%
2018-08,הצפון,9100,נהרייה,יישוב,1574,740,834,182,1392,685,1492,51,4.72%
2018-08,הצפון,522,נחף,יישוב,315,138,177,10,305,235,310,6,5.56%
2018-08,הצפון,7300,נצרת,יישוב,2430,1082,1348,133,2297,1608,2410,11,6.53%
2018-08,הצפון,1061,נצרת עילית,יישוב,1236,554,682,122,1114,471,1117,87,4.76%
2018-08,הצפון,525,סאג'ור,יישוב,96,41,55,4,92,56,93,1,4.29%
2018-08,הצפון,7500,סח'נין,יישוב,1459,638,821,50,1409,1097,1442,11,9.37%
2018-08,הצפון,4501,ע'ג'ר,יישוב,69,32,37,3,66,38,66,1,5.56%
2018-08,הצפון,530,עיילבון,יישוב,126,63,63,6,120,71,123,1,4.26%
2018-08,הצפון,511,עילוט,יישוב,230,91,139,4,226,163,229,0,7.15%
2018-08,הצפון,532,עין מאהל,יישוב,307,160,147,9,298,223,297,2,5.09%
2018-08,הצפון,4502,עין קנייא,יישוב,88,39,49,0,88,70,85,2,7.80%
2018-08,הצפון,7600,עכו,יישוב,2685,1090,1595,163,2522,1626,2583,33,9.46%
2018-08,הצפון,7700,עפולה,יישוב,1523,598,925,171,1352,447,1456,55,5.28%
2018-08,הצפון,531,עראבה,יישוב,970,435,535,31,939,792,962,9,8.64%
2018-08,הצפון,535,פסוטה,יישוב,84,40,44,10,74,39,82,2,4.55%
2018-08,הצפון,536,פקיעין (בוקייעה),יישוב,101,58,43,3,98,62,97,2,3.25%
2018-08,הצפון,8000,צפת,יישוב,1021,486,535,97,924,498,983,23,7.00%
2018-08,הצפון,4100,קצרין,יישוב,181,77,104,34,147,57,177,4,4.41%
2018-08,הצפון,2800,קריית שמונה,יישוב,639,288,351,60,579,209,614,21,4.73%
2018-08,הצפון,543,ראמה,יישוב,220,90,130,16,204,140,211,2,5.15%
2018-08,הצפון,26,ראש פינה,יישוב,43,11,32,6,37,17,41,0,2.49%
2018-08,הצפון,542,ריינה,יישוב,423,207,216,15,408,269,414,5,5.58%
2018-08,הצפון,122,רמת ישי,יישוב,99,30,69,40,59,14,97,0,2.34%
2018-08,הצפון,913,שבלי - אום אל-גנם,יישוב,148,58,90,8,140,91,142,2,5.02%
2018-08,הצפון,812,שלומי,יישוב,193,76,117,17,176,76,189,6,5.17%
2018-08,הצפון,538,שעב,יישוב,311,137,174,6,305,254,308,0,9.30%
2018-08,הצפון,8800,שפרעם,יישוב,1152,497,655,51,1101,771,1134,19,5.82%
2018-08,חיפה,1326,"בסמ""ה",יישוב,294,139,155,7,287,208,292,1,6.54%
2018-08,חיפה,2710,אום אל-פחם,יישוב,2275,981,1294,38,2237,1729,2228,31,9.60%
2018-08,חיפה,1020,אור עקיבא,יישוב,453,201,252,54,399,94,441,9,4.18%
2018-08,חיפה,6000,באקה אל-גרביה,יישוב,516,267,249,18,498,275,509,14,3.90%
2018-08,חיפה,9800,בנימינה-גבעת עדה*,יישוב,156,70,86,66,90,17,154,0,2.05%
2018-08,חיפה,541,ג'סר א-זרקא,יישוב,196,99,97,2,194,57,192,16,3.00%
2018-08,חיפה,628,ג'ת,יישוב,165,81,84,6,159,84,163,1,2.83%
2018-08,חיפה,494,דאלית אל-כרמל,יישוב,391,142,249,12,379,186,370,6,4.23%
2018-08,חיפה,9300,זכרון יעקב,יישוב,242,100,142,90,152,15,240,6,2.10%
2018-08,חיפה,6500,חדרה,יישוב,1993,842,1151,272,1721,496,1890,52,3.64%
2018-08,חיפה,4000,חיפה,יישוב,5153,2400,2753,1158,3995,1937,4854,145,3.43%
2018-08,חיפה,1247,חריש,יישוב,193,66,127,41,152,25,188,0,4.34%
2018-08,חיפה,2100,טירת כרמל,יישוב,615,289,326,41,574,300,586,17,4.79%
2018-08,חיפה,654,כפר קרע,יישוב,356,153,203,17,339,187,352,8,3.75%
2018-08,חיפה,45,מ.א. אלונה,מועצה איזורית,18,8,10,4,14,0,18,0,1.69%
2018-08,חיפה,12,מ.א. זבולון,מועצה איזורית,186,87,99,26,160,94,179,0,3.02%
2018-08,חיפה,15,מ.א. חוף הכרמל,מועצה איזורית,332,160,172,132,200,42,326,0,2.20%
2018-08,חיפה,14,מ.א. מנשה,מועצה איזורית,219,99,120,79,140,47,214,0,2.49%
2018-08,חיפה,1327,מעלה עירון,יישוב,586,235,351,11,575,417,576,1,8.80%
2018-08,חיפה,2500,נשר,יישוב,378,178,200,85,293,108,360,7,2.84%
2018-08,חיפה,534,עספיא,יישוב,313,132,181,18,295,144,293,1,4.77%
2018-08,חיפה,637,ערערה,יישוב,466,210,256,20,446,274,454,9,5.04%
2018-08,חיפה,537,פוריידיס,יישוב,174,92,82,12,162,38,174,6,2.88%
2018-08,חיפה,7800,פרדס חנה-כרכור,יישוב,672,271,401,205,467,60,662,18,3.08%
2018-08,חיפה,6800,קריית אתא,יישוב,1404,535,869,129,1275,495,1361,25,4.38%
2018-08,חיפה,9500,קריית ביאליק,יישוב,837,343,494,128,709,274,817,28,3.82%
2018-08,חיפה,2300,קריית טבעון,יישוב,185,89,96,71,114,21,179,1,2.13%
2018-08,חיפה,9600,קריית ים,יישוב,1096,559,537,110,986,487,1058,35,4.99%
2018-08,חיפה,8200,קריית מוצקין,יישוב,815,341,474,165,650,231,794,16,3.41%
2018-08,חיפה,922,רכסים,יישוב,196,52,144,11,185,46,185,1,4.86%
2018-08,ירושלים,472,אבו גוש,יישוב,199,84,115,9,190,137,195,3,5.64%
2018-08,ירושלים,2610,בית שמש,יישוב,1640,523,1117,91,1549,300,1599,28,4.22%
2018-08,ירושלים,3000,ירושלים,יישוב,12391,4963,7428,1526,10865,5832,12133,112,3.77%
2018-08,ירושלים,26,מ.א. מטה יהודה,מועצה איזורית,583,257,326,141,442,91,575,0,2.22%
2018-08,ירושלים,1015,מבשרת ציון,יישוב,274,131,143,67,207,76,271,3,2.13%
2018-08,ירושלים,1137,קריית יערים,יישוב,62,21,41,17,45,7,62,0,3.44%
2018-08,תל אביב,2400,אור יהודה,יישוב,770,327,443,67,703,110,750,28,3.86%
2018-08,תל אביב,565,אזור,יישוב,169,78,91,31,138,17,165,1,2.46%
2018-08,תל אביב,6100,בני ברק,יישוב,3045,800,2245,104,2941,506,2946,5,4.76%
2018-08,תל אביב,6200,בת ים,יישוב,2475,1192,1283,370,2105,671,2361,61,3.35%
2018-08,תל אביב,6300,גבעתיים,יישוב,719,323,396,349,370,60,710,2,2.23%
2018-08,תל אביב,6400,הרצלייה,יישוב,1143,490,653,419,724,32,1134,9,2.30%
2018-08,תל אביב,6600,חולון,יישוב,2961,1283,1678,487,2474,484,2874,39,2.85%
2018-08,תל אביב,267,כפר שמריהו,יישוב,11,3,8,5,6,0,11,0,1.32%
2018-08,תל אביב,2620,קריית אונו,יישוב,402,171,231,180,222,26,399,7,2.04%
2018-08,תל אביב,8600,רמת גן,יישוב,2041,848,1193,761,1280,218,2008,14,2.45%
2018-08,תל אביב,2650,רמת השרון,יישוב,448,178,270,193,255,9,445,2,1.93%
2018-08,תל אביב,5000,תל אביב -יפו,יישוב,6713,3272,3441,2913,3800,1045,6597,43,2.51%
2018-09,אזור יהודה והשומרון,3760,אורנית,יישוב,94,40,54,44,50,0,94,0,1.87%
2018-09,אזור יהודה והשומרון,3750,אלפי מנשה,יישוב,98,39,59,29,69,1,98,1,2.21%
2018-09,אזור יהודה והשומרון,3560,אלקנה,יישוב,29,15,14,17,12,0,29,0,1.58%
2018-09,אזור יהודה והשומרון,3650,אפרת,יישוב,66,30,36,33,33,2,66,0,1.34%
2018-09,אזור יהודה והשומרון,3570,אריאל,יישוב,237,100,137,66,171,18,235,4,2.15%
2018-09,אזור יהודה והשומרון,3574,בית אל,יישוב,42,17,25,14,28,9,42,0,1.68%
2018-09,אזור יהודה והשומרון,3652,בית אריה,יישוב,44,20,24,9,35,0,44,2,1.54%
2018-09,אזור יהודה והשומרון,3780,ביתר עילית,יישוב,518,204,314,20,498,134,511,1,3.27%
2018-09,אזור יהודה והשומרון,3730,גבעת זאב,יישוב,168,75,93,42,126,27,163,2,2.01%
2018-09,אזור יהודה והשומרון,3769,הר אדר,יישוב,30,19,11,13,17,4,30,0,1.37%
2018-09,אזור יהודה והשומרון,76,מ.א. גוש עציון,מועצה איזורית,171,80,91,72,99,18,169,0,1.67%
2018-09,אזור יהודה והשומרון,78,מ.א. הר חברון,מועצה איזורית,67,32,35,32,35,3,66,0,1.66%
2018-09,אזור יהודה והשומרון,74,מ.א. מגילות ים המלח,מועצה איזורית,22,7,15,5,17,0,22,0,2.37%
2018-09,אזור יהודה והשומרון,73,מ.א. מטה בנימין,מועצה איזורית,528,246,282,203,325,85,522,0,1.84%
2018-09,אזור יהודה והשומרון,75,מ.א. ערבות הירדן,מועצה איזורית,52,29,23,14,38,5,50,0,1.94%
2018-09,אזור יהודה והשומרון,72,מ.א. שומרון,מועצה איזורית,372,159,213,159,213,15,369,0,1.95%
2018-09,אזור יהודה והשומרון,3797,מודיעין עילית,יישוב,535,159,376,33,502,22,535,1,3.32%
2018-09,אזור יהודה והשומרון,3616,מעלה אדומים,יישוב,438,193,245,81,357,87,435,4,2.09%
2018-09,אזור יהודה והשומרון,3608,מעלה אפרים,יישוב,29,11,18,2,27,10,29,0,3.63%
2018-09,אזור יהודה והשומרון,3660,עמנואל,יישוב,56,22,34,5,51,15,56,1,4.09%
2018-09,אזור יהודה והשומרון,3557,קדומים,יישוב,20,12,8,12,8,0,19,0,0.96%
2018-09,אזור יהודה והשומרון,3611,קריית ארבע,יישוב,77,33,44,14,63,27,74,3,2.21%
2018-09,אזור יהודה והשומרון,3640,קרני שומרון,יישוב,68,32,36,24,44,0,66,0,1.63%
2018-09,הדרום,31,אופקים,יישוב,796,290,506,54,742,324,772,18,5.35%
2018-09,הדרום,2600,אילת,יישוב,852,412,440,41,811,195,812,17,2.36%
2018-09,הדרום,70,אשדוד,יישוב,4563,1903,2660,616,3947,1700,4380,28,3.92%
2018-09,הדרום,7100,אשקלון,יישוב,3159,1313,1846,360,2799,1202,2926,25,3.95%
2018-09,הדרום,9000,באר שבע,יישוב,4842,2214,2628,714,4128,2251,4588,54,4.29%
2018-09,הדרום,2200,דימונה,יישוב,1397,633,764,70,1327,845,1330,13,6.88%
2018-09,הדרום,1303,חורה,יישוב,427,191,236,7,420,360,413,3,8.71%
2018-09,הדרום,831,ירוחם,יישוב,370,174,196,13,357,193,349,8,6.82%
2018-09,הדרום,1059,כסיפה,יישוב,909,333,576,2,907,819,902,0,16.76%
2018-09,הדרום,1271,להבים,יישוב,71,43,28,40,31,1,71,0,2.00%
2018-09,הדרום,1060,לקיה,יישוב,508,225,283,6,502,420,487,1,10.12%
2018-09,הדרום,69,מ.א. אל קסום,מועצה איזורית,709,286,423,4,705,602,687,0,20.14%
2018-09,הדרום,38,מ.א. אשכול,מועצה איזורית,134,65,69,32,102,8,133,0,1.90%
2018-09,הדרום,33,מ.א. באר טוביה,מועצה איזורית,232,101,131,49,183,39,229,0,2.02%
2018-09,הדרום,41,מ.א. בני שמעון,מועצה איזורית,90,34,56,32,58,16,90,1,1.86%
2018-09,הדרום,54,מ.א. הערבה התיכונה,מועצה איזורית,28,14,14,11,17,0,28,0,1.47%
2018-09,הדרום,53,מ.א. חבל אילות,מועצה איזורית,23,8,15,6,17,0,22,0,0.89%
2018-09,הדרום,36,מ.א. חוף אשקלון,מועצה איזורית,199,93,106,43,156,37,192,0,2.21%
2018-09,הדרום,35,מ.א. יואב,מועצה איזורית,92,36,56,24,68,12,92,0,2.25%
2018-09,הדרום,50,מ.א. לכיש,מועצה איזורית,161,54,107,35,126,27,160,0,2.87%
2018-09,הדרום,42,מ.א. מרחבים,מועצה איזורית,170,66,104,33,137,23,167,0,2.65%
2018-09,הדרום,68,מ.א. נווה מדבר,מועצה איזורית,129,48,81,1,128,105,126,0,6.67%
2018-09,הדרום,48,מ.א. רמת נגב,מועצה איזורית,277,136,141,16,261,225,267,1,8.02%
2018-09,הדרום,39,מ.א. שדות נגב,מועצה איזורית,115,52,63,26,89,23,112,0,2.30%
2018-09,הדרום,37,מ.א. שער הנגב,מועצה איזורית,90,45,45,42,48,11,87,0,2.18%
2018-09,הדרום,34,מ.א. שפיר,מועצה איזורית,157,75,82,19,138,38,155,0,3.11%
2018-09,הדרום,51,מ.א. תמר,מועצה איזורית,10,4,6,5,5,3,10,0,1.54%
2018-09,הדרום,1268,מיתר,יישוב,66,20,46,33,33,1,64,0,1.30%
2018-09,הדרום,99,מצפה רמון,יישוב,225,83,142,19,206,146,215,8,7.73%
2018-09,הדרום,246,נתיבות,יישוב,898,347,551,67,831,327,860,25,5.23%
2018-09,הדרום,666,עומר,יישוב,49,24,25,23,26,3,49,1,1.16%
2018-09,הדרום,2560,ערד,יישוב,544,241,303,66,478,246,520,16,4.12%
2018-09,הדרום,1192,ערערה-בנגב,יישוב,923,393,530,6,917,822,897,0,17.68%
2018-09,הדרום,2630,קריית גת,יישוב,1445,593,852,124,1321,537,1384,13,4.74%
2018-09,הדרום,1034,קריית מלאכי,יישוב,672,271,401,31,641,296,639,15,5.18%
2018-09,הדרום,1161,רהט,יישוב,1835,737,1098,8,1827,1350,1813,17,8.17%
2018-09,הדרום,1286,שגב-שלום,יישוב,315,119,196,3,312,224,305,2,9.47%
2018-09,הדרום,1031,שדרות,יישוב,837,363,474,65,772,413,760,15,5.14%
2018-09,הדרום,1054,תל שבע,יישוב,622,272,350,3,619,529,586,7,10.32%
2018-09,המרכז,1066,"בני עי""ש",יישוב,125,59,66,17,108,31,121,0,3.02%
2018-09,המרכז,182,אבן יהודה,יישוב,143,61,82,55,88,16,140,1,2.01%
2018-09,המרכז,41,אליכין,יישוב,54,21,33,13,41,12,51,1,2.60%
2018-09,המרכז,1309,אלעד,יישוב,404,149,255,23,381,25,391,5,2.74%
2018-09,המרכז,2530,באר יעקב,יישוב,296,108,188,84,212,25,289,1,2.24%
2018-09,המרכז,466,בית דגן,יישוב,98,44,54,19,79,25,95,0,2.54%
2018-09,המרכז,681,גבעת שמואל,יישוב,249,123,126,100,149,23,246,1,1.97%
2018-09,המרכז,2550,גדרה,יישוב,274,109,165,69,205,46,268,1,2.07%
2018-09,המרכז,627,ג'לג'וליה,יישוב,55,25,30,3,52,23,51,0,1.19%
2018-09,המרכז,166,גן יבנה,יישוב,290,110,180,61,229,52,280,1,2.21%
2018-09,המרכז,229,גני תקווה,יישוב,176,74,102,67,109,17,175,1,1.82%
2018-09,המרכז,9700,הוד השרון,יישוב,634,242,392,328,306,15,628,5,1.92%
2018-09,המרכז,1290,זמר,יישוב,90,28,62,3,87,62,88,0,2.71%
2018-09,המרכז,2730,טייבה,יישוב,880,404,476,30,850,512,756,14,3.91%
2018-09,המרכז,2720,טירה,יישוב,128,66,62,18,110,20,125,4,1.00%
2018-09,המרכז,2660,יבנה,יישוב,693,293,400,161,532,128,686,9,2.72%
2018-09,המרכז,9400,יהוד,יישוב,343,139,204,89,254,33,340,3,2.09%
2018-09,המרכז,1224,כוכב יאיר,יישוב,92,37,55,67,25,0,92,1,1.65%
2018-09,המרכז,633,כפר ברא,יישוב,13,9,4,1,12,4,13,0,0.81%
2018-09,המרכז,168,כפר יונה,יישוב,283,123,160,58,225,35,282,3,2.41%
2018-09,המרכז,6900,כפר סבא,יישוב,1084,462,622,452,632,45,1078,16,2.04%
2018-09,המרכז,634,כפר קאסם,יישוב,146,67,79,10,136,70,143,0,1.39%
2018-09,המרכז,7000,לוד,יישוב,1434,660,774,133,1301,578,1408,16,3.83%
2018-09,המרכז,28,מ.א. ברנר,מועצה איזורית,67,33,34,32,35,6,67,1,1.65%
2018-09,המרכז,32,מ.א. גדרות,מועצה איזורית,31,14,17,14,17,3,31,0,1.26%
2018-09,המרכז,30,מ.א. גזר,מועצה איזורית,272,123,149,106,166,24,269,0,2.00%
2018-09,המרכז,27,מ.א. גן רווה,מועצה איזורית,56,27,29,31,25,0,56,0,1.87%
2018-09,המרכז,20,מ.א. דרום השרון,מועצה איזורית,327,130,197,153,174,8,324,0,2.00%
2018-09,המרכז,29,מ.א. חבל יבנה,מועצה איזורית,32,15,17,19,13,1,32,1,1.22%
2018-09,המרכז,25,מ.א. חבל מודיעין,מועצה איזורית,204,94,110,72,132,21,201,0,1.83%
2018-09,המרכז,19,מ.א. חוף השרון,מועצה איזורית,94,46,48,42,52,2,94,0,1.69%
2018-09,המרכז,18,מ.א. לב השרון,מועצה איזורית,234,113,121,73,161,17,231,0,2.08%
2018-09,המרכז,31,מ.א. נחל שורק,מועצה איזורית,58,22,36,13,45,8,57,18,1.34%
2018-09,המרכז,16,מ.א. עמק חפר,מועצה איזורית,330,133,197,138,192,15,329,0,1.67%
2018-09,המרכז,40,מ.א. שדות דן,מועצה איזורית,130,53,77,43,87,8,130,0,2.02%
2018-09,המרכז,1200,מודיעין-מכבים-רעות*,יישוב,761,313,448,383,378,26,754,4,1.64%
2018-09,המרכז,28,מזכרת בתיה,יישוב,149,64,85,48,101,21,147,1,1.81%
2018-09,המרכז,7200,נס ציונה,יישוב,536,233,303,160,376,92,530,3,2.14%
2018-09,המרכז,7400,נתניה,יישוב,3506,1576,1930,538,2968,809,3438,31,3.17%
2018-09,המרכז,587,סביון*,יישוב,19,8,11,10,9,0,19,0,0.91%
2018-09,המרכז,171,פרדסייה,יישוב,76,27,49,20,56,5,76,0,2.02%
2018-09,המרכז,7900,פתח תקווה,יישוב,3315,1464,1851,735,2580,603,3252,25,2.52%
2018-09,המרכז,195,קדימה-צורן,יישוב,245,101,144,84,161,16,244,0,2.08%
2018-09,המרכז,638,קלנסווה,יישוב,278,132,146,9,269,175,241,7,2.49%
2018-09,המרכז,469,קריית עקרון,יישוב,202,93,109,26,176,70,197,1,3.24%
2018-09,המרכז,2640,ראש העין,יישוב,810,355,455,177,633,101,802,3,2.59%
2018-09,המרכז,8300,ראשון לציון,יישוב,3365,1422,1943,756,2609,620,3347,18,2.39%
2018-09,המרכז,8400,רחובות,יישוב,1995,865,1130,542,1453,474,1944,19,2.74%
2018-09,המרכז,8500,רמלה,יישוב,1217,568,649,95,1122,359,1178,27,3.05%
2018-09,המרכז,8700,רעננה,יישוב,654,301,353,335,319,24,650,6,1.72%
2018-09,המרכז,1304,שוהם,יישוב,172,76,96,77,95,6,171,1,1.41%
2018-09,המרכז,154,תל מונד,יישוב,121,49,72,43,78,9,120,0,1.74%
2018-09,הצפון,473,אבו סנאן,יישוב,475,206,269,2,473,321,467,2,7.43%
2018-09,הצפון,478,אכסאל,יישוב,375,180,195,15,360,300,374,1,5.89%
2018-09,הצפון,529,אעבלין,יישוב,334,140,194,17,317,248,329,2,5.34%
2018-09,הצפון,482,בועיינה-נוג'ידאת,יישוב,195,90,105,12,183,143,195,1,4.54%
2018-09,הצפון,4001,בוקעאתא,יישוב,278,112,166,9,269,206,270,2,9.07%
2018-09,הצפון,998,ביר אל-מכסור,יישוב,239,109,130,4,235,158,239,2,5.76%
2018-09,הצפון,480,בית ג'ן,יישוב,322,84,238,12,310,212,313,0,5.25%
2018-09,הצפון,9200,בית שאן,יישוב,616,273,343,28,588,267,597,16,5.69%
2018-09,הצפון,944,בסמת טבעון,יישוב,122,57,65,3,119,74,114,1,3.18%
2018-09,הצפון,483,בענה,יישוב,282,130,152,11,271,225,273,0,7.06%
2018-09,הצפון,1292,ג'דיידה-מכר,יישוב,922,399,523,4,918,650,902,4,8.82%
2018-09,הצפון,485,ג'ולס,יישוב,135,33,102,0,135,76,134,1,4.13%
2018-09,הצפון,487,ג'ש (גוש חלב),יישוב,45,17,28,5,40,17,44,0,2.58%
2018-09,הצפון,489,דבורייה,יישוב,208,82,126,10,198,151,204,2,4.34%
2018-09,הצפון,490,דייר אל-אסד,יישוב,307,135,172,19,288,214,296,2,5.15%
2018-09,הצפון,492,דייר חנא,יישוב,429,196,233,16,413,293,427,1,8.15%
2018-09,הצפון,975,זרזיר,יישוב,170,57,113,8,162,87,170,3,4.76%
2018-09,הצפון,496,חורפיש,יישוב,97,44,53,10,87,46,90,2,2.95%
2018-09,הצפון,2034,חצור הגלילית,יישוב,233,93,140,25,208,92,221,3,4.52%
2018-09,הצפון,6700,טבריה,יישוב,1183,532,651,87,1096,507,1050,20,4.73%
2018-09,הצפון,962,טובא-זנגרייה,יישוב,235,96,139,2,233,147,227,8,6.77%
2018-09,הצפון,498,טורעאן,יישוב,267,114,153,13,254,209,258,4,4.11%
2018-09,הצפון,8900,טמרה,יישוב,1113,523,590,42,1071,799,1093,5,7.05%
2018-09,הצפון,1295,יאנוח-ג'ת,יישוב,104,40,64,7,97,51,98,1,3.08%
2018-09,הצפון,46,יבנאל,יישוב,77,41,36,6,71,28,68,2,4.30%
2018-09,הצפון,29,יסוד המעלה,יישוב,18,6,12,4,14,3,18,1,2.05%
2018-09,הצפון,499,יפיע,יישוב,423,188,235,26,397,289,420,1,4.88%
2018-09,הצפון,240,יקנעם עילית,יישוב,392,176,216,95,297,72,385,11,2.99%
2018-09,הצפון,502,ירכא,יישוב,319,133,186,1,318,207,317,0,4.54%
2018-09,הצפון,504,כאבול,יישוב,332,172,160,8,324,256,324,1,6.04%
2018-09,הצפון,505,כאוכב אבו אל-היג'א,יישוב,158,61,97,6,152,128,155,1,8.28%
2018-09,הצפון,1296,כסרא-סמיע,יישוב,146,50,96,1,145,79,142,0,3.67%
2018-09,הצפון,978,כעביה-טבאש-חג'אג'רה,יישוב,122,45,77,10,112,77,121,0,4.73%
2018-09,הצפון,1263,כפר ורדים,יישוב,54,18,36,25,29,7,53,0,1.71%
2018-09,הצפון,507,כפר יאסיף,יישוב,315,140,175,2,313,195,308,3,5.71%
2018-09,הצפון,508,כפר כמא,יישוב,35,15,20,7,28,9,35,0,2.03%
2018-09,הצפון,509,כפר כנא,יישוב,607,311,296,34,573,454,587,3,6.09%
2018-09,הצפון,510,כפר מנדא,יישוב,527,263,264,14,513,388,525,2,6.58%
2018-09,הצפון,47,כפר תבור,יישוב,48,16,32,18,30,3,47,0,1.98%
2018-09,הצפון,1139,כרמיאל,יישוב,1271,513,758,292,979,563,1184,10,4.57%
2018-09,הצפון,65,מ.א. אל-בטוף,מועצה איזורית,183,85,98,11,172,131,177,0,5.44%
2018-09,הצפון,66,מ.א. בוסתן אל-מרג,מועצה איזורית,23,3,20,0,23,21,23,0,0.65%
2018-09,הצפון,71,מ.א. גולן,מועצה איזורית,218,105,113,81,137,12,217,0,2.47%
2018-09,הצפון,8,מ.א. הגלבוע,מועצה איזורית,510,202,308,62,448,223,507,0,3.59%
2018-09,הצפון,1,מ.א. הגליל העליון,מועצה איזורית,206,84,122,87,119,12,206,0,2.30%
2018-09,הצפון,3,מ.א. הגליל התחתון,מועצה איזורית,103,44,59,42,61,9,99,0,1.64%
2018-09,הצפון,55,מ.א. מבואות החרמון,מועצה איזורית,95,38,57,21,74,18,94,0,2.34%
2018-09,הצפון,13,מ.א. מגידו,מועצה איזורית,89,36,53,33,56,9,89,0,1.58%
2018-09,הצפון,4,מ.א. מטה אשר,מועצה איזורית,371,148,223,74,297,120,361,0,2.54%
2018-09,הצפון,52,מ.א. מעלה יוסף,מועצה איזורית,163,55,108,24,139,32,161,0,2.81%
2018-09,הצפון,2,מ.א. מרום הגליל,מועצה איזורית,227,109,118,24,203,80,221,0,3.10%
2018-09,הצפון,56,מ.א. משגב,מועצה איזורית,501,205,296,133,368,223,481,0,3.40%
2018-09,הצפון,6,מ.א. עמק הירדן,מועצה איזורית,139,62,77,35,104,20,128,0,1.88%
2018-09,הצפון,7,מ.א. עמק המעיינות,מועצה איזורית,178,66,112,48,130,30,175,0,2.67%
2018-09,הצפון,9,מ.א. עמק יזרעאל,מועצה איזורית,368,143,225,163,205,31,362,0,1.85%
2018-09,הצפון,481,מגאר,יישוב,781,339,442,18,763,594,761,0,7.30%
2018-09,הצפון,516,מג'ד אל-כרום,יישוב,428,190,238,17,411,262,418,4,5.67%
2018-09,הצפון,65,מגדל,יישוב,32,14,18,7,25,7,30,0,3.02%
2018-09,הצפון,874,מגדל העמק,יישוב,664,278,386,81,583,206,636,25,4.66%
2018-09,הצפון,4201,מג'דל שמס,יישוב,332,121,211,10,322,220,317,3,6.05%
2018-09,הצפון,517,מזרעה,יישוב,121,58,63,5,116,80,114,0,5.35%
2018-09,הצפון,43,מטולה,יישוב,19,9,10,6,13,7,17,0,1.70%
2018-09,הצפון,4203,מסעדה,יישוב,152,58,94,5,147,111,146,1,8.12%
2018-09,הצפון,518,מעיליא,יישוב,45,21,24,1,44,21,43,0,2.51%
2018-09,הצפון,1063,מעלות-תרשיחא,יישוב,601,266,335,75,526,270,573,13,4.73%
2018-09,הצפון,520,משהד,יישוב,148,65,83,4,144,105,144,1,4.03%
2018-09,הצפון,9100,נהרייה,יישוב,1442,647,795,179,1263,680,1369,26,4.35%
2018-09,הצפון,522,נחף,יישוב,312,138,174,11,301,232,305,3,5.47%
2018-09,הצפון,7300,נצרת,יישוב,2223,1023,1200,122,2101,1556,2205,9,6.01%
2018-09,הצפון,1061,נצרת עילית,יישוב,1072,463,609,119,953,437,968,39,4.15%
2018-09,הצפון,525,סאג'ור,יישוב,95,40,55,4,91,56,93,1,4.29%
2018-09,הצפון,7500,סח'נין,יישוב,1376,605,771,47,1329,1051,1364,4,8.91%
2018-09,הצפון,4501,ע'ג'ר,יישוב,64,26,38,3,61,36,62,1,5.24%
2018-09,הצפון,530,עיילבון,יישוב,119,61,58,6,113,67,117,0,4.06%
2018-09,הצפון,511,עילוט,יישוב,200,84,116,3,197,152,200,0,6.31%
2018-09,הצפון,532,עין מאהל,יישוב,304,158,146,9,295,226,295,2,5.06%
2018-09,הצפון,4502,עין קנייא,יישוב,88,39,49,2,86,69,85,0,7.80%
2018-09,הצפון,7600,עכו,יישוב,2265,997,1268,138,2127,1539,2170,17,8.07%
2018-09,הצפון,7700,עפולה,יישוב,1303,497,806,181,1122,420,1260,21,4.60%
2018-09,הצפון,531,עראבה,יישוב,934,428,506,33,901,757,928,4,8.36%
2018-09,הצפון,535,פסוטה,יישוב,71,31,40,10,61,38,67,0,3.75%
2018-09,הצפון,536,פקיעין (בוקייעה),יישוב,97,53,44,3,94,61,95,1,3.18%
2018-09,הצפון,8000,צפת,יישוב,867,424,443,92,775,469,832,12,5.99%
2018-09,הצפון,4100,קצרין,יישוב,149,64,85,30,119,49,145,6,3.64%
2018-09,הצפון,2800,קריית שמונה,יישוב,555,246,309,61,494,191,536,8,4.16%
2018-09,הצפון,543,ראמה,יישוב,200,86,114,14,186,129,192,1,4.70%
2018-09,הצפון,26,ראש פינה,יישוב,38,11,27,7,31,19,36,0,2.20%
2018-09,הצפון,542,ריינה,יישוב,389,200,189,16,373,255,381,0,5.16%
2018-09,הצפון,122,רמת ישי,יישוב,87,30,57,35,52,13,86,0,2.08%
2018-09,הצפון,913,שבלי - אום אל-גנם,יישוב,129,47,82,6,123,80,126,1,4.48%
2018-09,הצפון,812,שלומי,יישוב,160,67,93,13,147,72,151,2,4.17%
2018-09,הצפון,538,שעב,יישוב,301,134,167,4,297,246,299,0,9.05%
2018-09,הצפון,8800,שפרעם,יישוב,1089,493,596,57,1032,738,1070,7,5.51%
2018-09,חיפה,1326,"בסמ""ה",יישוב,287,141,146,8,279,203,283,0,6.35%
2018-09,חיפה,2710,אום אל-פחם,יישוב,2138,940,1198,36,2102,1633,2102,21,9.11%
2018-09,חיפה,1020,אור עקיבא,יישוב,410,172,238,57,353,88,396,1,3.77%
2018-09,חיפה,6000,באקה אל-גרביה,יישוב,490,256,234,21,469,254,482,8,3.70%
2018-09,חיפה,9800,בנימינה-גבעת עדה*,יישוב,153,65,88,67,86,16,152,1,2.03%
2018-09,חיפה,541,ג'סר א-זרקא,יישוב,165,90,75,1,164,46,161,6,2.53%
2018-09,חיפה,628,ג'ת,יישוב,158,80,78,8,150,73,157,5,2.73%
2018-09,חיפה,494,דאלית אל-כרמל,יישוב,366,125,241,16,350,186,345,3,3.95%
2018-09,חיפה,9300,זכרון יעקב,יישוב,209,90,119,89,120,11,209,0,1.84%
2018-09,חיפה,6500,חדרה,יישוב,1788,756,1032,259,1529,457,1705,28,3.29%
2018-09,חיפה,4000,חיפה,יישוב,4563,2174,2389,1091,3472,1788,4318,60,3.07%
2018-09,חיפה,1247,חריש,יישוב,179,63,116,46,133,23,173,5,4.01%
2018-09,חיפה,2100,טירת כרמל,יישוב,561,268,293,42,519,278,534,10,4.38%
2018-09,חיפה,654,כפר קרע,יישוב,357,162,195,20,337,188,352,7,3.75%
2018-09,חיפה,45,מ.א. אלונה,מועצה איזורית,16,5,11,6,10,0,16,0,1.50%
2018-09,חיפה,12,מ.א. זבולון,מועצה איזורית,175,84,91,28,147,91,165,0,2.78%
2018-09,חיפה,15,מ.א. חוף הכרמל,מועצה איזורית,313,147,166,130,183,40,309,0,2.09%
2018-09,חיפה,14,מ.א. מנשה,מועצה איזורית,211,97,114,78,133,46,207,0,2.41%
2018-09,חיפה,1327,מעלה עירון,יישוב,538,220,318,8,530,397,531,1,8.17%
2018-09,חיפה,2500,נשר,יישוב,321,164,157,77,244,90,309,4,2.45%
2018-09,חיפה,534,עספיא,יישוב,284,121,163,23,261,136,268,1,4.38%
2018-09,חיפה,637,ערערה,יישוב,451,195,256,20,431,263,436,4,4.85%
2018-09,חיפה,537,פוריידיס,יישוב,155,84,71,7,148,32,155,3,2.57%
2018-09,חיפה,7800,פרדס חנה-כרכור,יישוב,593,241,352,194,399,62,581,16,2.72%
2018-09,חיפה,6800,קריית אתא,יישוב,1132,499,633,129,1003,448,1096,13,3.56%
2018-09,חיפה,9500,קריית ביאליק,יישוב,757,322,435,131,626,261,741,13,3.48%
2018-09,חיפה,2300,קריית טבעון,יישוב,184,86,98,74,110,19,180,1,2.14%
2018-09,חיפה,9600,קריית ים,יישוב,1008,506,502,109,899,464,973,9,4.61%
2018-09,חיפה,8200,קריית מוצקין,יישוב,755,315,440,163,592,223,743,4,3.20%
2018-09,חיפה,922,רכסים,יישוב,130,47,83,9,121,45,117,1,3.13%
2018-09,ירושלים,472,אבו גוש,יישוב,191,85,106,8,183,137,189,2,5.47%
2018-09,ירושלים,2610,בית שמש,יישוב,1215,442,773,92,1123,267,1187,12,3.16%
2018-09,ירושלים,3000,ירושלים,יישוב,10181,4495,5686,1387,8794,5551,9959,72,3.12%
2018-09,ירושלים,26,מ.א. מטה יהודה,מועצה איזורית,514,244,270,136,378,80,507,0,1.96%
2018-09,ירושלים,1015,מבשרת ציון,יישוב,244,125,119,66,178,69,241,2,1.90%
2018-09,ירושלים,1137,קריית יערים,יישוב,43,17,26,14,29,6,43,0,2.41%
2018-09,תל אביב,2400,אור יהודה,יישוב,547,268,279,52,495,100,531,9,2.77%
2018-09,תל אביב,565,אזור,יישוב,143,71,72,26,117,16,141,0,2.11%
2018-09,תל אביב,6100,בני ברק,יישוב,1695,687,1008,95,1600,459,1599,4,2.64%
2018-09,תל אביב,6200,בת ים,יישוב,2190,1047,1143,330,1860,614,2097,16,2.99%
2018-09,תל אביב,6300,גבעתיים,יישוב,673,299,374,336,337,66,666,2,2.10%
2018-09,תל אביב,6400,הרצלייה,יישוב,992,447,545,423,569,27,978,1,1.99%
2018-09,תל אביב,6600,חולון,יישוב,2611,1167,1444,471,2140,428,2554,16,2.54%
2018-09,תל אביב,267,כפר שמריהו,יישוב,9,2,7,3,6,0,9,0,1.08%
2018-09,תל אביב,2620,קריית אונו,יישוב,347,161,186,163,184,22,344,0,1.76%
2018-09,תל אביב,8600,רמת גן,יישוב,1832,813,1019,731,1101,201,1806,7,2.21%
2018-09,תל אביב,2650,רמת השרון,יישוב,375,155,220,178,197,9,372,3,1.62%
2018-09,תל אביב,5000,תל אביב -יפו,יישוב,6482,3146,3336,2922,3560,1007,6380,34,2.43%
2018-10,אזור יהודה והשומרון,3760,אורנית,יישוב,99,40,59,45,54,2,99,0,1.97%
2018-10,אזור יהודה והשומרון,3750,אלפי מנשה,יישוב,105,45,60,32,73,0,105,2,2.36%
2018-10,אזור יהודה והשומרון,3560,אלקנה,יישוב,41,17,24,23,18,0,41,1,2.21%
2018-10,אזור יהודה והשומרון,3650,אפרת,יישוב,83,45,38,42,41,2,83,0,1.68%
2018-10,אזור יהודה והשומרון,3570,אריאל,יישוב,279,120,159,84,195,17,278,10,2.53%
2018-10,אזור יהודה והשומרון,3574,בית אל,יישוב,50,25,25,14,36,9,50,0,2.00%
2018-10,אזור יהודה והשומרון,3652,בית אריה,יישוב,51,21,30,5,46,0,51,1,1.78%
2018-10,אזור יהודה והשומרון,3780,ביתר עילית,יישוב,532,229,303,22,510,135,522,4,3.34%
2018-10,אזור יהודה והשומרון,3730,גבעת זאב,יישוב,174,82,92,46,128,28,173,1,2.14%
2018-10,אזור יהודה והשומרון,3769,הר אדר,יישוב,37,23,14,16,21,4,36,0,1.64%
2018-10,אזור יהודה והשומרון,76,מ.א. גוש עציון,מועצה איזורית,208,95,113,78,130,15,207,0,2.04%
2018-10,אזור יהודה והשומרון,78,מ.א. הר חברון,מועצה איזורית,73,37,36,34,39,4,71,0,1.79%
2018-10,אזור יהודה והשומרון,74,מ.א. מגילות ים המלח,מועצה איזורית,23,10,13,5,18,0,23,0,2.48%
2018-10,אזור יהודה והשומרון,73,מ.א. מטה בנימין,מועצה איזורית,574,261,313,218,356,93,562,0,1.98%
2018-10,אזור יהודה והשומרון,75,מ.א. ערבות הירדן,מועצה איזורית,62,32,30,16,46,4,60,0,2.33%
2018-10,אזור יהודה והשומרון,72,מ.א. שומרון,מועצה איזורית,442,193,249,182,260,19,438,0,2.31%
2018-10,אזור יהודה והשומרון,3797,מודיעין עילית,יישוב,501,171,330,33,468,30,499,4,3.10%
2018-10,אזור יהודה והשומרון,3616,מעלה אדומים,יישוב,540,251,289,86,454,96,536,17,2.57%
2018-10,אזור יהודה והשומרון,3608,מעלה אפרים,יישוב,31,12,19,1,30,10,31,1,3.87%
2018-10,אזור יהודה והשומרון,3660,עמנואל,יישוב,51,22,29,6,45,15,51,0,3.74%
2018-10,אזור יהודה והשומרון,3557,קדומים,יישוב,27,14,13,14,13,0,27,0,1.36%
2018-10,אזור יהודה והשומרון,3611,קריית ארבע,יישוב,85,44,41,15,70,28,83,7,2.47%
2018-10,אזור יהודה והשומרון,3640,קרני שומרון,יישוב,82,42,40,27,55,1,80,1,1.97%
2018-10,הדרום,31,אופקים,יישוב,890,367,523,56,834,349,860,44,5.93%
2018-10,הדרום,2600,אילת,יישוב,973,487,486,49,924,228,926,47,2.68%
2018-10,הדרום,70,אשדוד,יישוב,5076,2158,2918,653,4423,1839,4850,94,4.32%
2018-10,הדרום,7100,אשקלון,יישוב,3494,1497,1997,389,3105,1312,3219,61,4.33%
2018-10,הדרום,9000,באר שבע,יישוב,5380,2502,2878,807,4573,2425,5069,89,4.72%
2018-10,הדרום,2200,דימונה,יישוב,1574,737,837,79,1495,921,1470,24,7.55%
2018-10,הדרום,1303,חורה,יישוב,493,223,270,9,484,400,467,0,9.74%
2018-10,הדרום,831,ירוחם,יישוב,401,203,198,14,387,195,377,28,7.32%
2018-10,הדרום,1059,כסיפה,יישוב,995,382,613,3,992,876,983,11,18.00%
2018-10,הדרום,1271,להבים,יישוב,70,40,30,43,27,1,70,0,1.97%
2018-10,הדרום,1060,לקיה,יישוב,575,251,324,5,570,476,543,9,11.16%
2018-10,הדרום,69,מ.א. אל קסום,מועצה איזורית,792,323,469,9,783,666,752,0,22.04%
2018-10,הדרום,38,מ.א. אשכול,מועצה איזורית,153,67,86,39,114,9,151,0,2.15%
2018-10,הדרום,33,מ.א. באר טוביה,מועצה איזורית,274,123,151,50,224,46,271,0,2.39%
2018-10,הדרום,41,מ.א. בני שמעון,מועצה איזורית,97,40,57,34,63,19,97,0,2.00%
2018-10,הדרום,54,מ.א. הערבה התיכונה,מועצה איזורית,32,17,15,14,18,0,32,0,1.68%
2018-10,הדרום,53,מ.א. חבל אילות,מועצה איזורית,33,12,21,6,27,1,31,1,1.25%
2018-10,הדרום,36,מ.א. חוף אשקלון,מועצה איזורית,232,102,130,43,189,39,222,0,2.55%
2018-10,הדרום,35,מ.א. יואב,מועצה איזורית,97,37,60,32,65,11,97,0,2.37%
2018-10,הדרום,50,מ.א. לכיש,מועצה איזורית,179,69,110,34,145,31,176,0,3.16%
2018-10,הדרום,42,מ.א. מרחבים,מועצה איזורית,191,77,114,35,156,27,186,0,2.95%
2018-10,הדרום,68,מ.א. נווה מדבר,מועצה איזורית,131,52,79,0,131,103,127,0,6.72%
2018-10,הדרום,48,מ.א. רמת נגב,מועצה איזורית,291,146,145,19,272,222,282,2,8.46%
2018-10,הדרום,39,מ.א. שדות נגב,מועצה איזורית,144,63,81,34,110,27,137,1,2.81%
2018-10,הדרום,37,מ.א. שער הנגב,מועצה איזורית,102,52,50,52,50,13,98,0,2.45%
2018-10,הדרום,34,מ.א. שפיר,מועצה איזורית,164,78,86,17,147,37,162,0,3.25%
2018-10,הדרום,51,מ.א. תמר,מועצה איזורית,13,6,7,4,9,3,13,0,2.00%
2018-10,הדרום,1268,מיתר,יישוב,68,23,45,35,33,4,65,0,1.32%
2018-10,הדרום,99,מצפה רמון,יישוב,242,97,145,21,221,150,229,16,8.20%
2018-10,הדרום,246,נתיבות,יישוב,1038,412,626,70,968,343,978,52,5.90%
2018-10,הדרום,666,עומר,יישוב,59,28,31,25,34,3,59,1,1.40%
2018-10,הדרום,2560,ערד,יישוב,609,277,332,69,540,262,581,18,4.58%
2018-10,הדרום,1192,ערערה-בנגב,יישוב,1000,428,572,7,993,877,974,10,18.91%
2018-10,הדרום,2630,קריית גת,יישוב,1649,677,972,135,1514,593,1563,49,5.32%
2018-10,הדרום,1034,קריית מלאכי,יישוב,858,362,496,31,827,323,817,33,6.53%
2018-10,הדרום,1161,רהט,יישוב,2057,858,1199,8,2049,1444,2024,39,9.03%
2018-10,הדרום,1286,שגב-שלום,יישוב,318,143,175,3,315,242,310,3,9.61%
2018-10,הדרום,1031,שדרות,יישוב,920,429,491,65,855,442,830,40,5.59%
2018-10,הדרום,1054,תל שבע,יישוב,701,324,377,4,697,582,646,9,11.26%
2018-10,המרכז,1066,"בני עי""ש",יישוב,132,63,69,19,113,36,124,5,3.09%
2018-10,המרכז,182,אבן יהודה,יישוב,161,66,95,58,103,17,158,2,2.26%
2018-10,המרכז,41,אליכין,יישוב,60,28,32,14,46,12,57,0,2.90%
2018-10,המרכז,1309,אלעד,יישוב,391,161,230,23,368,29,376,3,2.63%
2018-10,המרכז,2530,באר יעקב,יישוב,351,137,214,98,253,33,343,8,2.65%
2018-10,המרכז,466,בית דגן,יישוב,102,52,50,19,83,21,100,0,2.67%
2018-10,המרכז,681,גבעת שמואל,יישוב,271,133,138,113,158,26,267,0,2.13%
2018-10,המרכז,2550,גדרה,יישוב,320,134,186,69,251,51,311,7,2.40%
2018-10,המרכז,627,ג'לג'וליה,יישוב,69,30,39,3,66,27,63,0,1.47%
2018-10,המרכז,166,גן יבנה,יישוב,330,120,210,68,262,50,322,5,2.53%
2018-10,המרכז,229,גני תקווה,יישוב,196,80,116,77,119,21,195,2,2.02%
2018-10,המרכז,9700,הוד השרון,יישוב,712,285,427,345,367,17,699,13,2.14%
2018-10,המרכז,1290,זמר,יישוב,95,30,65,5,90,60,92,5,2.83%
2018-10,המרכז,2730,טייבה,יישוב,907,446,461,31,876,529,771,33,3.99%
2018-10,המרכז,2720,טירה,יישוב,151,81,70,20,131,24,145,11,1.16%
2018-10,המרכז,2660,יבנה,יישוב,738,357,381,154,584,142,721,28,2.86%
2018-10,המרכז,9400,יהוד,יישוב,397,171,226,99,298,38,386,9,2.36%
2018-10,המרכז,1224,כוכב יאיר,יישוב,100,39,61,65,35,0,100,0,1.79%
2018-10,המרכז,633,כפר ברא,יישוב,13,7,6,1,12,6,10,0,0.62%
2018-10,המרכז,168,כפר יונה,יישוב,318,140,178,69,249,40,316,1,2.69%
2018-10,המרכז,6900,כפר סבא,יישוב,1308,569,739,540,768,57,1291,27,2.43%
2018-10,המרכז,634,כפר קאסם,יישוב,173,78,95,9,164,78,170,2,1.65%
2018-10,המרכז,7000,לוד,יישוב,1612,761,851,146,1466,619,1579,42,4.27%
2018-10,המרכז,28,מ.א. ברנר,מועצה איזורית,74,38,36,35,39,5,74,6,1.81%
2018-10,המרכז,32,מ.א. גדרות,מועצה איזורית,36,15,21,18,18,3,36,0,1.46%
2018-10,המרכז,30,מ.א. גזר,מועצה איזורית,287,131,156,117,170,22,284,0,2.12%
2018-10,המרכז,27,מ.א. גן רווה,מועצה איזורית,54,25,29,32,22,0,54,0,1.80%
2018-10,המרכז,20,מ.א. דרום השרון,מועצה איזורית,348,151,197,156,192,12,343,0,2.12%
2018-10,המרכז,29,מ.א. חבל יבנה,מועצה איזורית,38,20,18,21,17,1,37,0,1.41%
2018-10,המרכז,25,מ.א. חבל מודיעין,מועצה איזורית,235,105,130,75,160,20,230,0,2.09%
2018-10,המרכז,19,מ.א. חוף השרון,מועצה איזורית,114,49,65,57,57,2,114,0,2.05%
2018-10,המרכז,18,מ.א. לב השרון,מועצה איזורית,262,126,136,75,187,18,259,0,2.33%
2018-10,המרכז,31,מ.א. נחל שורק,מועצה איזורית,65,27,38,18,47,7,64,44,1.47%
2018-10,המרכז,16,מ.א. עמק חפר,מועצה איזורית,383,162,221,156,227,16,382,0,1.94%
2018-10,המרכז,40,מ.א. שדות דן,מועצה איזורית,146,66,80,47,99,8,146,0,2.26%
2018-10,המרכז,1200,מודיעין-מכבים-רעות*,יישוב,877,381,496,412,465,37,867,18,1.88%
2018-10,המרכז,28,מזכרת בתיה,יישוב,170,69,101,52,118,20,168,6,2.06%
2018-10,המרכז,7200,נס ציונה,יישוב,598,269,329,176,422,102,584,9,2.36%
2018-10,המרכז,7400,נתניה,יישוב,3960,1838,2122,576,3384,935,3874,86,3.56%
2018-10,המרכז,587,סביון*,יישוב,20,7,13,10,10,0,20,0,0.96%
2018-10,המרכז,171,פרדסייה,יישוב,79,30,49,24,55,3,79,1,2.10%
2018-10,המרכז,7900,פתח תקווה,יישוב,3762,1711,2051,824,2938,652,3675,52,2.84%
2018-10,המרכז,195,קדימה-צורן,יישוב,283,115,168,97,186,20,281,1,2.39%
2018-10,המרכז,638,קלנסווה,יישוב,286,135,151,8,278,172,246,9,2.54%
2018-10,המרכז,469,קריית עקרון,יישוב,224,103,121,25,199,82,212,5,3.48%
2018-10,המרכז,2640,ראש העין,יישוב,952,438,514,194,758,106,941,15,3.02%
2018-10,המרכז,8300,ראשון לציון,יישוב,3859,1653,2206,865,2994,704,3817,50,2.72%
2018-10,המרכז,8400,רחובות,יישוב,2234,1012,1222,582,1652,531,2159,51,3.03%
2018-10,המרכז,8500,רמלה,יישוב,1420,690,730,104,1316,421,1368,43,3.52%
2018-10,המרכז,8700,רעננה,יישוב,759,347,412,376,383,24,754,6,1.99%
2018-10,המרכז,1304,שוהם,יישוב,176,75,101,94,82,7,175,1,1.45%
2018-10,המרכז,154,תל מונד,יישוב,136,57,79,50,86,10,136,0,1.97%
2018-10,הצפון,473,אבו סנאן,יישוב,490,213,277,4,486,333,482,5,7.65%
2018-10,הצפון,478,אכסאל,יישוב,396,188,208,17,379,319,395,0,6.20%
2018-10,הצפון,529,אעבלין,יישוב,343,148,195,17,326,248,335,4,5.43%
2018-10,הצפון,482,בועיינה-נוג'ידאת,יישוב,194,95,99,8,186,141,191,3,4.46%
2018-10,הצפון,4001,בוקעאתא,יישוב,298,121,177,5,293,208,291,1,9.70%
2018-10,הצפון,998,ביר אל-מכסור,יישוב,257,115,142,7,250,169,255,3,6.12%
2018-10,הצפון,480,בית ג'ן,יישוב,343,87,256,13,330,221,329,0,5.50%
2018-10,הצפון,9200,בית שאן,יישוב,703,312,391,35,668,273,679,34,6.42%
2018-10,הצפון,944,בסמת טבעון,יישוב,139,68,71,3,136,85,125,6,3.48%
2018-10,הצפון,483,בענה,יישוב,279,126,153,11,268,230,270,2,6.99%
2018-10,הצפון,1292,ג'דיידה-מכר,יישוב,976,437,539,7,969,688,958,10,9.32%
2018-10,הצפון,485,ג'ולס,יישוב,147,42,105,1,146,70,146,2,4.48%
2018-10,הצפון,487,ג'ש (גוש חלב),יישוב,49,21,28,4,45,19,47,0,2.75%
2018-10,הצפון,489,דבורייה,יישוב,222,97,125,11,211,154,216,3,4.58%
2018-10,הצפון,490,דייר אל-אסד,יישוב,302,141,161,21,281,211,293,1,5.10%
2018-10,הצפון,492,דייר חנא,יישוב,436,196,240,14,422,296,434,2,8.27%
2018-10,הצפון,975,זרזיר,יישוב,187,74,113,9,178,90,184,3,5.13%
2018-10,הצפון,496,חורפיש,יישוב,103,41,62,11,92,49,96,7,3.14%
2018-10,הצפון,2034,חצור הגלילית,יישוב,265,106,159,24,241,97,251,6,5.10%
2018-10,הצפון,6700,טבריה,יישוב,1372,641,731,100,1272,541,1222,62,5.46%
2018-10,הצפון,962,טובא-זנגרייה,יישוב,248,112,136,4,244,160,241,7,7.15%
2018-10,הצפון,498,טורעאן,יישוב,279,122,157,15,264,213,268,4,4.27%
2018-10,הצפון,8900,טמרה,יישוב,1148,547,601,42,1106,816,1124,13,7.24%
2018-10,הצפון,1295,יאנוח-ג'ת,יישוב,118,44,74,5,113,57,112,1,3.50%
2018-10,הצפון,46,יבנאל,יישוב,96,52,44,11,85,33,89,0,5.55%
2018-10,הצפון,29,יסוד המעלה,יישוב,23,8,15,5,18,7,22,0,2.49%
2018-10,הצפון,499,יפיע,יישוב,430,197,233,22,408,293,426,4,4.95%
2018-10,הצפון,240,יקנעם עילית,יישוב,489,226,263,106,383,83,484,28,3.73%
2018-10,הצפון,502,ירכא,יישוב,348,155,193,0,348,222,343,7,4.89%
2018-10,הצפון,504,כאבול,יישוב,356,187,169,10,346,266,346,4,6.43%
2018-10,הצפון,505,כאוכב אבו אל-היג'א,יישוב,166,69,97,9,157,133,164,1,8.72%
2018-10,הצפון,1296,כסרא-סמיע,יישוב,161,52,109,3,158,82,155,5,4.00%
2018-10,הצפון,978,כעביה-טבאש-חג'אג'רה,יישוב,139,55,84,10,129,84,137,3,5.32%
2018-10,הצפון,1263,כפר ורדים,יישוב,70,24,46,29,41,8,67,2,2.15%
2018-10,הצפון,507,כפר יאסיף,יישוב,352,160,192,4,348,210,345,7,6.35%
2018-10,הצפון,508,כפר כמא,יישוב,42,16,26,6,36,11,41,0,2.37%
2018-10,הצפון,509,כפר כנא,יישוב,645,329,316,36,609,468,618,13,6.40%
2018-10,הצפון,510,כפר מנדא,יישוב,557,276,281,19,538,417,549,1,6.86%
2018-10,הצפון,47,כפר תבור,יישוב,39,12,27,13,26,3,38,1,1.61%
2018-10,הצפון,1139,כרמיאל,יישוב,1406,577,829,315,1091,612,1295,38,4.98%
2018-10,הצפון,65,מ.א. אל-בטוף,מועצה איזורית,178,84,94,11,167,133,171,0,5.25%
2018-10,הצפון,66,מ.א. בוסתן אל-מרג,מועצה איזורית,24,4,20,1,23,20,24,1,0.68%
2018-10,הצפון,71,מ.א. גולן,מועצה איזורית,233,109,124,82,151,16,231,0,2.63%
2018-10,הצפון,8,מ.א. הגלבוע,מועצה איזורית,536,227,309,68,468,235,529,0,3.75%
2018-10,הצפון,1,מ.א. הגליל העליון,מועצה איזורית,234,92,142,100,134,12,233,0,2.60%
2018-10,הצפון,3,מ.א. הגליל התחתון,מועצה איזורית,103,44,59,46,57,9,99,0,1.64%
2018-10,הצפון,55,מ.א. מבואות החרמון,מועצה איזורית,102,42,60,26,76,18,101,0,2.52%
2018-10,הצפון,13,מ.א. מגידו,מועצה איזורית,113,50,63,39,74,11,113,0,2.00%
2018-10,הצפון,4,מ.א. מטה אשר,מועצה איזורית,417,169,248,85,332,126,402,0,2.83%
2018-10,הצפון,52,מ.א. מעלה יוסף,מועצה איזורית,186,67,119,28,158,37,183,0,3.19%
2018-10,הצפון,2,מ.א. מרום הגליל,מועצה איזורית,247,126,121,26,221,93,238,0,3.33%
2018-10,הצפון,56,מ.א. משגב,מועצה איזורית,551,227,324,150,401,245,526,0,3.72%
2018-10,הצפון,6,מ.א. עמק הירדן,מועצה איזורית,167,76,91,42,125,22,156,0,2.30%
2018-10,הצפון,7,מ.א. עמק המעיינות,מועצה איזורית,207,82,125,51,156,32,203,0,3.10%
2018-10,הצפון,9,מ.א. עמק יזרעאל,מועצה איזורית,439,170,269,204,235,33,433,0,2.21%
2018-10,הצפון,481,מגאר,יישוב,866,367,499,24,842,607,845,5,8.04%
2018-10,הצפון,516,מג'ד אל-כרום,יישוב,436,193,243,22,414,272,424,1,5.75%
2018-10,הצפון,65,מגדל,יישוב,34,17,17,3,31,8,32,0,3.21%
2018-10,הצפון,874,מגדל העמק,יישוב,814,357,457,92,722,219,767,62,5.56%
2018-10,הצפון,4201,מג'דל שמס,יישוב,345,132,213,11,334,212,331,2,6.30%
2018-10,הצפון,517,מזרעה,יישוב,125,55,70,4,121,80,118,1,5.53%
2018-10,הצפון,43,מטולה,יישוב,22,10,12,4,18,8,20,2,1.99%
2018-10,הצפון,4203,מסעדה,יישוב,153,56,97,7,146,111,147,3,8.17%
2018-10,הצפון,518,מעיליא,יישוב,54,25,29,6,48,24,51,0,2.97%
2018-10,הצפון,1063,מעלות-תרשיחא,יישוב,668,291,377,80,588,283,629,36,5.17%
2018-10,הצפון,520,משהד,יישוב,140,66,74,3,137,111,135,3,3.79%
2018-10,הצפון,9100,נהרייה,יישוב,1638,761,877,186,1452,727,1541,61,4.87%
2018-10,הצפון,522,נחף,יישוב,318,144,174,12,306,235,310,1,5.56%
2018-10,הצפון,7300,נצרת,יישוב,2299,1067,1232,135,2164,1603,2283,19,6.21%
2018-10,הצפון,1061,נצרת עילית,יישוב,1291,559,732,128,1163,474,1158,93,4.93%
2018-10,הצפון,525,סאג'ור,יישוב,103,40,63,6,97,65,100,1,4.60%
2018-10,הצפון,7500,סח'נין,יישוב,1427,629,798,53,1374,1081,1411,12,9.18%
2018-10,הצפון,4501,ע'ג'ר,יישוב,69,26,43,4,65,36,68,0,5.72%
2018-10,הצפון,530,עיילבון,יישוב,134,66,68,3,131,72,131,1,4.53%
2018-10,הצפון,511,עילוט,יישוב,211,88,123,0,211,162,211,1,6.63%
2018-10,הצפון,532,עין מאהל,יישוב,303,162,141,11,292,215,295,5,5.06%
2018-10,הצפון,4502,עין קנייא,יישוב,101,49,52,2,99,66,99,0,8.97%
2018-10,הצפון,7600,עכו,יישוב,2472,1083,1389,143,2329,1665,2348,36,8.67%
2018-10,הצפון,7700,עפולה,יישוב,1552,664,888,211,1341,468,1462,68,5.30%
2018-10,הצפון,531,עראבה,יישוב,997,463,534,41,956,786,985,11,8.83%
2018-10,הצפון,535,פסוטה,יישוב,79,34,45,12,67,39,76,3,4.23%
2018-10,הצפון,536,פקיעין (בוקייעה),יישוב,104,57,47,5,99,65,101,1,3.37%
2018-10,הצפון,8000,צפת,יישוב,983,480,503,96,887,542,934,20,6.67%
2018-10,הצפון,4100,קצרין,יישוב,187,80,107,35,152,59,177,5,4.41%
2018-10,הצפון,2800,קריית שמונה,יישוב,601,270,331,63,538,198,581,27,4.49%
2018-10,הצפון,543,ראמה,יישוב,202,89,113,15,187,132,194,0,4.75%
2018-10,הצפון,26,ראש פינה,יישוב,45,15,30,8,37,19,42,0,2.55%
2018-10,הצפון,542,ריינה,יישוב,398,202,196,18,380,270,386,8,5.22%
2018-10,הצפון,122,רמת ישי,יישוב,104,35,69,38,66,16,100,2,2.41%
2018-10,הצפון,913,שבלי - אום אל-גנם,יישוב,138,55,83,6,132,85,136,2,4.82%
2018-10,הצפון,812,שלומי,יישוב,174,71,103,14,160,78,168,4,4.62%
2018-10,הצפון,538,שעב,יישוב,328,151,177,6,322,262,324,2,9.73%
2018-10,הצפון,8800,שפרעם,יישוב,1134,522,612,65,1069,744,1113,11,5.72%
2018-10,חיפה,1326,"בסמ""ה",יישוב,314,161,153,8,306,207,311,4,6.93%
2018-10,חיפה,2710,אום אל-פחם,יישוב,2226,1002,1224,36,2190,1691,2180,30,9.41%
2018-10,חיפה,1020,אור עקיבא,יישוב,450,189,261,57,393,88,430,9,4.08%
2018-10,חיפה,6000,באקה אל-גרביה,יישוב,534,276,258,26,508,256,526,17,4.03%
2018-10,חיפה,9800,בנימינה-גבעת עדה*,יישוב,178,81,97,77,101,23,177,2,2.35%
2018-10,חיפה,541,ג'סר א-זרקא,יישוב,169,95,74,1,168,50,162,7,2.55%
2018-10,חיפה,628,ג'ת,יישוב,172,90,82,8,164,75,171,4,2.96%
2018-10,חיפה,494,דאלית אל-כרמל,יישוב,378,143,235,16,362,183,355,7,4.06%
2018-10,חיפה,9300,זכרון יעקב,יישוב,233,101,132,105,128,11,231,1,2.03%
2018-10,חיפה,6500,חדרה,יישוב,2017,883,1134,280,1737,525,1899,26,3.66%
2018-10,חיפה,4000,חיפה,יישוב,5203,2463,2740,1256,3947,2040,4886,146,3.46%
2018-10,חיפה,1247,חריש,יישוב,200,73,127,51,149,19,196,3,4.52%
2018-10,חיפה,2100,טירת כרמל,יישוב,619,298,321,46,573,293,590,16,4.82%
2018-10,חיפה,654,כפר קרע,יישוב,353,153,200,22,331,193,346,5,3.69%
2018-10,חיפה,45,מ.א. אלונה,מועצה איזורית,14,5,9,6,8,0,14,0,1.31%
2018-10,חיפה,12,מ.א. זבולון,מועצה איזורית,183,89,94,28,155,94,172,0,2.90%
2018-10,חיפה,15,מ.א. חוף הכרמל,מועצה איזורית,353,158,195,142,211,40,348,0,2.35%
2018-10,חיפה,14,מ.א. מנשה,מועצה איזורית,243,108,135,83,160,51,239,0,2.78%
2018-10,חיפה,1327,מעלה עירון,יישוב,549,233,316,10,539,410,541,10,8.31%
2018-10,חיפה,2500,נשר,יישוב,395,199,196,88,307,112,378,5,2.98%
2018-10,חיפה,534,עספיא,יישוב,310,126,184,24,286,142,290,6,4.72%
2018-10,חיפה,637,ערערה,יישוב,470,219,251,16,454,272,458,16,5.08%
2018-10,חיפה,537,פוריידיס,יישוב,172,102,70,6,166,32,172,11,2.84%
2018-10,חיפה,7800,פרדס חנה-כרכור,יישוב,657,292,365,194,463,68,633,14,2.95%
2018-10,חיפה,6800,קריית אתא,יישוב,1259,562,697,143,1116,491,1215,34,3.93%
2018-10,חיפה,9500,קריית ביאליק,יישוב,829,349,480,139,690,280,810,24,3.79%
2018-10,חיפה,2300,קריית טבעון,יישוב,185,84,101,82,103,22,179,2,2.13%
2018-10,חיפה,9600,קריית ים,יישוב,1113,557,556,129,984,507,1064,39,5.02%
2018-10,חיפה,8200,קריית מוצקין,יישוב,862,359,503,176,686,232,851,17,3.65%
2018-10,חיפה,922,רכסים,יישוב,125,53,72,12,113,48,113,1,3.03%
2018-10,ירושלים,472,אבו גוש,יישוב,201,85,116,11,190,136,198,2,5.72%
2018-10,ירושלים,2610,בית שמש,יישוב,1267,502,765,97,1170,296,1219,20,3.25%
2018-10,ירושלים,3000,ירושלים,יישוב,10954,4896,6058,1511,9443,5784,10657,133,3.33%
2018-10,ירושלים,26,מ.א. מטה יהודה,מועצה איזורית,586,275,311,160,426,94,574,0,2.22%
2018-10,ירושלים,1015,מבשרת ציון,יישוב,292,148,144,76,216,80,286,6,2.24%
2018-10,ירושלים,1137,קריית יערים,יישוב,44,19,25,14,30,8,43,1,2.41%
2018-10,תל אביב,2400,אור יהודה,יישוב,660,334,326,63,597,116,636,39,3.30%
2018-10,תל אביב,565,אזור,יישוב,163,84,79,27,136,18,161,2,2.41%
2018-10,תל אביב,6100,בני ברק,יישוב,1722,773,949,100,1622,491,1622,14,2.68%
2018-10,תל אביב,6200,בת ים,יישוב,2588,1242,1346,380,2208,705,2462,97,3.49%
2018-10,תל אביב,6300,גבעתיים,יישוב,759,329,430,391,368,76,751,4,2.36%
2018-10,תל אביב,6400,הרצלייה,יישוב,1144,516,628,459,685,36,1127,10,2.29%
2018-10,תל אביב,6600,חולון,יישוב,2955,1330,1625,521,2434,467,2869,51,2.84%
2018-10,תל אביב,267,כפר שמריהו,יישוב,9,3,6,2,7,0,9,0,1.08%
2018-10,תל אביב,2620,קריית אונו,יישוב,382,170,212,178,204,27,378,4,1.93%
2018-10,תל אביב,8600,רמת גן,יישוב,2043,925,1118,803,1240,239,2011,21,2.46%
2018-10,תל אביב,2650,רמת השרון,יישוב,445,185,260,202,243,9,440,1,1.91%
2018-10,תל אביב,5000,תל אביב -יפו,יישוב,7386,3631,3755,3290,4096,1136,7248,91,2.75%
2018-11,אזור יהודה והשומרון,3760,אורנית,יישוב,113,45,68,44,69,2,112,1,2.22%
2018-11,אזור יהודה והשומרון,3750,אלפי מנשה,יישוב,95,43,52,25,70,1,95,1,2.14%
2018-11,אזור יהודה והשומרון,3560,אלקנה,יישוב,39,15,24,21,18,0,39,0,2.11%
2018-11,אזור יהודה והשומרון,3650,אפרת,יישוב,73,37,36,38,35,3,72,1,1.46%
2018-11,אזור יהודה והשומרון,3570,אריאל,יישוב,254,115,139,71,183,13,251,9,2.29%
2018-11,אזור יהודה והשומרון,3574,בית אל,יישוב,44,24,20,12,32,8,44,1,1.76%
2018-11,אזור יהודה והשומרון,3652,בית אריה,יישוב,55,28,27,6,49,0,55,1,1.91%
2018-11,אזור יהודה והשומרון,3780,ביתר עילית,יישוב,497,235,262,16,481,137,489,4,3.14%
2018-11,אזור יהודה והשומרון,3730,גבעת זאב,יישוב,176,89,87,44,132,32,174,2,2.15%
2018-11,אזור יהודה והשומרון,3769,הר אדר,יישוב,36,23,13,18,18,5,35,0,1.60%
2018-11,אזור יהודה והשומרון,76,מ.א. גוש עציון,מועצה איזורית,197,95,102,78,119,19,195,0,1.92%
2018-11,אזור יהודה והשומרון,78,מ.א. הר חברון,מועצה איזורית,65,27,38,28,37,4,64,0,1.61%
2018-11,אזור יהודה והשומרון,74,מ.א. מגילות ים המלח,מועצה איזורית,22,11,11,6,16,0,22,0,2.37%
2018-11,אזור יהודה והשומרון,73,מ.א. מטה בנימין,מועצה איזורית,561,264,297,190,371,89,552,0,1.95%
2018-11,אזור יהודה והשומרון,75,מ.א. ערבות הירדן,מועצה איזורית,57,32,25,16,41,6,56,0,2.18%
2018-11,אזור יהודה והשומרון,72,מ.א. שומרון,מועצה איזורית,423,194,229,165,258,17,420,0,2.22%
2018-11,אזור יהודה והשומרון,3797,מודיעין עילית,יישוב,430,168,262,34,396,30,426,2,2.66%
2018-11,אזור יהודה והשומרון,3616,מעלה אדומים,יישוב,510,233,277,80,430,88,504,20,2.42%
2018-11,אזור יהודה והשומרון,3608,מעלה אפרים,יישוב,32,13,19,1,31,9,32,0,3.99%
2018-11,אזור יהודה והשומרון,3660,עמנואל,יישוב,52,26,26,2,50,17,51,0,3.74%
2018-11,אזור יהודה והשומרון,3557,קדומים,יישוב,29,16,13,19,10,0,29,0,1.46%
2018-11,אזור יהודה והשומרון,3611,קריית ארבע,יישוב,73,36,37,16,57,27,71,5,2.12%
2018-11,אזור יהודה והשומרון,3640,קרני שומרון,יישוב,83,43,40,31,52,2,83,4,2.04%
2018-11,הדרום,31,אופקים,יישוב,810,340,470,48,762,346,776,37,5.38%
2018-11,הדרום,2600,אילת,יישוב,948,482,466,50,898,208,898,39,2.61%
2018-11,הדרום,70,אשדוד,יישוב,4905,2146,2759,618,4287,1818,4694,89,4.19%
2018-11,הדרום,7100,אשקלון,יישוב,3340,1472,1868,365,2975,1293,3058,71,4.13%
2018-11,הדרום,9000,באר שבע,יישוב,5062,2353,2709,776,4286,2358,4770,98,4.45%
2018-11,הדרום,2200,דימונה,יישוב,1497,710,787,69,1428,906,1407,31,7.25%
2018-11,הדרום,1303,חורה,יישוב,481,219,262,9,472,388,455,2,9.51%
2018-11,הדרום,831,ירוחם,יישוב,372,181,191,18,354,201,344,16,6.73%
2018-11,הדרום,1059,כסיפה,יישוב,975,378,597,4,971,873,966,1,17.74%
2018-11,הדרום,1271,להבים,יישוב,62,38,24,40,22,1,62,0,1.75%
2018-11,הדרום,1060,לקיה,יישוב,552,248,304,4,548,464,530,3,10.92%
2018-11,הדרום,69,מ.א. אל קסום,מועצה איזורית,800,318,482,10,790,671,756,0,22.16%
2018-11,הדרום,38,מ.א. אשכול,מועצה איזורית,126,52,74,32,94,9,124,0,1.77%
2018-11,הדרום,33,מ.א. באר טוביה,מועצה איזורית,260,124,136,42,218,42,259,0,2.29%
2018-11,הדרום,41,מ.א. בני שמעון,מועצה איזורית,83,41,42,31,52,15,82,1,1.69%
2018-11,הדרום,54,מ.א. הערבה התיכונה,מועצה איזורית,25,14,11,10,15,0,25,0,1.31%
2018-11,הדרום,53,מ.א. חבל אילות,מועצה איזורית,26,8,18,5,21,1,25,0,1.01%
2018-11,הדרום,36,מ.א. חוף אשקלון,מועצה איזורית,227,102,125,35,192,42,217,0,2.50%
2018-11,הדרום,35,מ.א. יואב,מועצה איזורית,87,28,59,31,56,12,87,0,2.13%
2018-11,הדרום,50,מ.א. לכיש,מועצה איזורית,167,69,98,29,138,31,164,0,2.94%
2018-11,הדרום,42,מ.א. מרחבים,מועצה איזורית,173,71,102,28,145,30,170,0,2.70%
2018-11,הדרום,68,מ.א. נווה מדבר,מועצה איזורית,132,51,81,2,130,99,128,0,6.78%
2018-11,הדרום,48,מ.א. רמת נגב,מועצה איזורית,275,138,137,17,258,210,268,1,8.04%
2018-11,הדרום,39,מ.א. שדות נגב,מועצה איזורית,121,57,64,24,97,26,114,0,2.34%
2018-11,הדרום,37,מ.א. שער הנגב,מועצה איזורית,120,61,59,45,75,36,111,0,2.78%
2018-11,הדרום,34,מ.א. שפיר,מועצה איזורית,148,70,78,16,132,39,146,0,2.93%
2018-11,הדרום,51,מ.א. תמר,מועצה איזורית,11,4,7,3,8,3,11,0,1.69%
2018-11,הדרום,1268,מיתר,יישוב,69,23,46,37,32,5,67,0,1.36%
2018-11,הדרום,99,מצפה רמון,יישוב,221,95,126,16,205,136,209,14,7.53%
2018-11,הדרום,246,נתיבות,יישוב,868,385,483,53,815,343,821,46,5.00%
2018-11,הדרום,666,עומר,יישוב,58,27,31,25,33,5,56,2,1.33%
2018-11,הדרום,2560,ערד,יישוב,600,292,308,67,533,261,574,33,4.53%
2018-11,הדרום,1192,ערערה-בנגב,יישוב,964,422,542,15,949,847,935,15,18.29%
2018-11,הדרום,2630,קריית גת,יישוב,1560,680,880,122,1438,576,1486,56,5.07%
2018-11,הדרום,1034,קריית מלאכי,יישוב,784,363,421,27,757,317,748,46,6.02%
2018-11,הדרום,1161,רהט,יישוב,1992,822,1170,9,1983,1417,1964,44,8.79%
2018-11,הדרום,1286,שגב-שלום,יישוב,311,128,183,3,308,233,300,6,9.33%
2018-11,הדרום,1031,שדרות,יישוב,905,431,474,61,844,430,826,28,5.57%
2018-11,הדרום,1054,תל שבע,יישוב,684,317,367,3,681,566,640,4,11.17%
2018-11,המרכז,1066,"בני עי""ש",יישוב,138,65,73,20,118,35,129,7,3.21%
2018-11,המרכז,182,אבן יהודה,יישוב,156,66,90,58,98,14,155,0,2.22%
2018-11,המרכז,41,אליכין,יישוב,64,29,35,16,48,13,61,1,3.10%
2018-11,המרכז,1309,אלעד,יישוב,342,148,194,27,315,23,329,6,2.31%
2018-11,המרכז,2530,באר יעקב,יישוב,315,121,194,88,227,29,312,3,2.41%
2018-11,המרכז,466,בית דגן,יישוב,96,54,42,15,81,21,95,3,2.54%
2018-11,המרכז,681,גבעת שמואל,יישוב,246,115,131,98,148,27,243,1,1.94%
2018-11,המרכז,2550,גדרה,יישוב,292,120,172,61,231,46,285,5,2.20%
2018-11,המרכז,627,ג'לג'וליה,יישוב,71,34,37,4,67,27,70,2,1.63%
2018-11,המרכז,166,גן יבנה,יישוב,307,128,179,51,256,51,297,4,2.34%
2018-11,המרכז,229,גני תקווה,יישוב,178,74,104,66,112,17,178,0,1.85%
2018-11,המרכז,9700,הוד השרון,יישוב,632,269,363,304,328,12,624,9,1.91%
2018-11,המרכז,1290,זמר,יישוב,97,35,62,4,93,61,94,2,2.89%
2018-11,המרכז,2730,טייבה,יישוב,889,437,452,26,863,540,745,26,3.86%
2018-11,המרכז,2720,טירה,יישוב,126,78,48,16,110,19,120,11,0.96%
2018-11,המרכז,2660,יבנה,יישוב,693,337,356,138,555,130,683,32,2.71%
2018-11,המרכז,9400,יהוד,יישוב,384,185,199,94,290,34,379,16,2.32%
2018-11,המרכז,1224,כוכב יאיר,יישוב,98,38,60,61,37,1,98,0,1.76%
2018-11,המרכז,633,כפר ברא,יישוב,17,9,8,2,15,4,17,0,1.05%
2018-11,המרכז,168,כפר יונה,יישוב,292,122,170,57,235,34,289,10,2.46%
2018-11,המרכז,6900,כפר סבא,יישוב,1201,528,673,480,721,55,1186,30,2.24%
2018-11,המרכז,634,כפר קאסם,יישוב,179,84,95,8,171,78,175,6,1.70%
2018-11,המרכז,7000,לוד,יישוב,1574,765,809,140,1434,620,1530,40,4.14%
2018-11,המרכז,28,מ.א. ברנר,מועצה איזורית,68,34,34,36,32,3,68,3,1.68%
2018-11,המרכז,32,מ.א. גדרות,מועצה איזורית,47,19,28,23,24,4,45,0,1.82%
2018-11,המרכז,30,מ.א. גזר,מועצה איזורית,266,123,143,103,163,20,265,0,1.97%
2018-11,המרכז,27,מ.א. גן רווה,מועצה איזורית,57,25,32,32,25,1,57,0,1.90%
2018-11,המרכז,20,מ.א. דרום השרון,מועצה איזורית,310,144,166,137,173,10,307,0,1.90%
2018-11,המרכז,29,מ.א. חבל יבנה,מועצה איזורית,33,15,18,17,16,1,33,0,1.26%
2018-11,המרכז,25,מ.א. חבל מודיעין,מועצה איזורית,221,101,120,74,147,18,217,0,1.97%
2018-11,המרכז,19,מ.א. חוף השרון,מועצה איזורית,105,44,61,52,53,2,105,0,1.89%
2018-11,המרכז,18,מ.א. לב השרון,מועצה איזורית,264,122,142,77,187,18,260,0,2.34%
2018-11,המרכז,31,מ.א. נחל שורק,מועצה איזורית,64,30,34,19,45,7,62,37,1.45%
2018-11,המרכז,16,מ.א. עמק חפר,מועצה איזורית,381,171,210,151,230,15,379,0,1.93%
2018-11,המרכז,40,מ.א. שדות דן,מועצה איזורית,123,62,61,36,87,9,123,0,1.91%
2018-11,המרכז,1200,מודיעין-מכבים-רעות*,יישוב,816,352,464,378,438,28,801,11,1.74%
2018-11,המרכז,28,מזכרת בתיה,יישוב,151,61,90,48,103,18,146,3,1.80%
2018-11,המרכז,7200,נס ציונה,יישוב,559,256,303,151,408,106,548,8,2.22%
2018-11,המרכז,7400,נתניה,יישוב,3792,1830,1962,548,3244,935,3718,74,3.42%
2018-11,המרכז,587,סביון*,יישוב,15,5,10,9,6,0,15,0,0.72%
2018-11,המרכז,171,פרדסייה,יישוב,83,33,50,27,56,3,83,0,2.20%
2018-11,המרכז,7900,פתח תקווה,יישוב,3490,1610,1880,759,2731,621,3403,56,2.64%
2018-11,המרכז,195,קדימה-צורן,יישוב,270,106,164,92,178,17,269,2,2.29%
2018-11,המרכז,638,קלנסווה,יישוב,276,138,138,7,269,169,241,12,2.49%
2018-11,המרכז,469,קריית עקרון,יישוב,209,104,105,21,188,77,203,4,3.34%
2018-11,המרכז,2640,ראש העין,יישוב,863,415,448,180,683,86,854,17,2.75%
2018-11,המרכז,8300,ראשון לציון,יישוב,3617,1569,2048,804,2813,651,3576,51,2.55%
2018-11,המרכז,8400,רחובות,יישוב,2093,944,1149,523,1570,523,2012,53,2.83%
2018-11,המרכז,8500,רמלה,יישוב,1318,645,673,94,1224,401,1279,56,3.30%
2018-11,המרכז,8700,רעננה,יישוב,721,347,374,347,374,21,717,12,1.89%
2018-11,המרכז,1304,שוהם,יישוב,173,74,99,86,87,6,171,0,1.41%
2018-11,המרכז,154,תל מונד,יישוב,126,56,70,43,83,10,126,1,1.83%
2018-11,הצפון,473,אבו סנאן,יישוב,499,224,275,5,494,326,490,3,7.77%
2018-11,הצפון,478,אכסאל,יישוב,385,182,203,18,367,308,383,2,6.02%
2018-11,הצפון,529,אעבלין,יישוב,350,154,196,17,333,247,341,2,5.52%
2018-11,הצפון,482,בועיינה-נוג'ידאת,יישוב,206,106,100,8,198,139,202,3,4.70%
2018-11,הצפון,4001,בוקעאתא,יישוב,284,110,174,4,280,194,278,1,9.31%
2018-11,הצפון,998,ביר אל-מכסור,יישוב,257,116,141,7,250,171,253,3,6.08%
2018-11,הצפון,480,בית ג'ן,יישוב,332,89,243,9,323,205,321,2,5.38%
2018-11,הצפון,9200,בית שאן,יישוב,657,307,350,25,632,266,636,35,6.03%
2018-11,הצפון,944,בסמת טבעון,יישוב,142,76,66,2,140,84,133,0,3.69%
2018-11,הצפון,483,בענה,יישוב,280,121,159,10,270,227,270,2,6.99%
2018-11,הצפון,1292,ג'דיידה-מכר,יישוב,935,418,517,7,928,657,921,17,8.99%
2018-11,הצפון,485,ג'ולס,יישוב,143,40,103,1,142,65,142,0,4.37%
2018-11,הצפון,487,ג'ש (גוש חלב),יישוב,43,21,22,2,41,18,43,3,2.52%
2018-11,הצפון,489,דבורייה,יישוב,210,92,118,11,199,146,205,3,4.36%
2018-11,הצפון,490,דייר אל-אסד,יישוב,305,145,160,18,287,210,294,2,5.12%
2018-11,הצפון,492,דייר חנא,יישוב,436,193,243,13,423,301,433,2,8.25%
2018-11,הצפון,975,זרזיר,יישוב,172,72,100,5,167,88,172,9,4.81%
2018-11,הצפון,496,חורפיש,יישוב,92,42,50,10,82,45,85,1,2.79%
2018-11,הצפון,2034,חצור הגלילית,יישוב,226,89,137,19,207,91,213,2,4.36%
2018-11,הצפון,6700,טבריה,יישוב,1328,637,691,86,1242,543,1183,56,5.29%
2018-11,הצפון,962,טובא-זנגרייה,יישוב,238,113,125,4,234,147,233,2,6.93%
2018-11,הצפון,498,טורעאן,יישוב,286,129,157,20,266,208,279,5,4.43%
2018-11,הצפון,8900,טמרה,יישוב,1119,536,583,38,1081,806,1101,11,7.10%
2018-11,הצפון,1295,יאנוח-ג'ת,יישוב,126,48,78,5,121,56,119,3,3.71%
2018-11,הצפון,46,יבנאל,יישוב,100,53,47,8,92,41,92,0,5.72%
2018-11,הצפון,29,יסוד המעלה,יישוב,19,6,13,6,13,5,19,0,2.16%
2018-11,הצפון,499,יפיע,יישוב,446,206,240,18,428,297,444,4,5.14%
2018-11,הצפון,240,יקנעם עילית,יישוב,448,204,244,91,357,83,438,20,3.39%
2018-11,הצפון,502,ירכא,יישוב,356,160,196,0,356,222,351,5,5.00%
2018-11,הצפון,504,כאבול,יישוב,354,181,173,12,342,270,342,3,6.36%
2018-11,הצפון,505,כאוכב אבו אל-היג'א,יישוב,165,68,97,7,158,134,163,2,8.67%
2018-11,הצפון,1296,כסרא-סמיע,יישוב,180,65,115,4,176,86,172,5,4.42%
2018-11,הצפון,978,כעביה-טבאש-חג'אג'רה,יישוב,129,53,76,10,119,83,127,0,4.96%
2018-11,הצפון,1263,כפר ורדים,יישוב,64,27,37,24,40,4,63,2,2.02%
2018-11,הצפון,507,כפר יאסיף,יישוב,346,154,192,4,342,212,339,4,6.25%
2018-11,הצפון,508,כפר כמא,יישוב,37,14,23,5,32,11,33,0,1.92%
2018-11,הצפון,509,כפר כנא,יישוב,623,320,303,35,588,467,597,14,6.19%
2018-11,הצפון,510,כפר מנדא,יישוב,530,260,270,15,515,411,525,1,6.58%
2018-11,הצפון,47,כפר תבור,יישוב,35,11,24,12,23,3,33,0,1.40%
2018-11,הצפון,1139,כרמיאל,יישוב,1335,567,768,288,1047,602,1242,38,4.79%
2018-11,הצפון,65,מ.א. אל-בטוף,מועצה איזורית,184,93,91,14,170,129,175,1,5.37%
2018-11,הצפון,66,מ.א. בוסתן אל-מרג,מועצה איזורית,27,8,19,1,26,19,27,0,0.77%
2018-11,הצפון,71,מ.א. גולן,מועצה איזורית,226,95,131,69,157,15,225,0,2.56%
2018-11,הצפון,8,מ.א. הגלבוע,מועצה איזורית,507,220,287,65,442,231,500,0,3.54%
2018-11,הצפון,1,מ.א. הגליל העליון,מועצה איזורית,204,87,117,81,123,8,202,0,2.26%
2018-11,הצפון,3,מ.א. הגליל התחתון,מועצה איזורית,104,47,57,39,65,10,101,0,1.68%
2018-11,הצפון,55,מ.א. מבואות החרמון,מועצה איזורית,98,46,52,27,71,17,97,0,2.42%
2018-11,הצפון,13,מ.א. מגידו,מועצה איזורית,106,41,65,37,69,11,105,0,1.86%
2018-11,הצפון,4,מ.א. מטה אשר,מועצה איזורית,402,178,224,73,329,127,389,0,2.74%
2018-11,הצפון,52,מ.א. מעלה יוסף,מועצה איזורית,174,69,105,26,148,31,171,1,2.98%
2018-11,הצפון,2,מ.א. מרום הגליל,מועצה איזורית,249,125,124,30,219,93,243,0,3.40%
2018-11,הצפון,56,מ.א. משגב,מועצה איזורית,533,224,309,143,390,242,513,0,3.63%
2018-11,הצפון,6,מ.א. עמק הירדן,מועצה איזורית,172,88,84,45,127,22,161,0,2.37%
2018-11,הצפון,7,מ.א. עמק המעיינות,מועצה איזורית,198,77,121,48,150,29,195,0,2.98%
2018-11,הצפון,9,מ.א. עמק יזרעאל,מועצה איזורית,396,155,241,186,210,34,391,0,2.00%
2018-11,הצפון,481,מגאר,יישוב,840,361,479,13,827,597,823,8,7.85%
2018-11,הצפון,516,מג'ד אל-כרום,יישוב,420,185,235,18,402,266,411,0,5.58%
2018-11,הצפון,65,מגדל,יישוב,36,15,21,5,31,9,31,1,3.12%
2018-11,הצפון,874,מגדל העמק,יישוב,735,333,402,80,655,221,696,55,5.07%
2018-11,הצפון,4201,מג'דל שמס,יישוב,337,129,208,11,326,210,324,6,6.17%
2018-11,הצפון,517,מזרעה,יישוב,137,60,77,6,131,86,132,0,6.15%
2018-11,הצפון,43,מטולה,יישוב,18,11,7,2,16,8,15,0,1.50%
2018-11,הצפון,4203,מסעדה,יישוב,157,57,100,7,150,108,150,2,8.32%
2018-11,הצפון,518,מעיליא,יישוב,54,27,27,7,47,21,53,0,3.08%
2018-11,הצפון,1063,מעלות-תרשיחא,יישוב,668,287,381,92,576,271,629,36,5.17%
2018-11,הצפון,520,משהד,יישוב,139,66,73,4,135,107,136,2,3.82%
2018-11,הצפון,9100,נהרייה,יישוב,1617,765,852,176,1441,736,1514,58,4.78%
2018-11,הצפון,522,נחף,יישוב,326,143,183,10,316,234,317,0,5.67%
2018-11,הצפון,7300,נצרת,יישוב,2274,1048,1226,111,2163,1607,2261,13,6.16%
2018-11,הצפון,1061,נצרת עילית,יישוב,1251,568,683,115,1136,484,1125,89,4.79%
2018-11,הצפון,525,סאג'ור,יישוב,108,43,65,5,103,65,103,3,4.73%
2018-11,הצפון,7500,סח'נין,יישוב,1404,609,795,58,1346,1073,1389,12,9.05%
2018-11,הצפון,4501,ע'ג'ר,יישוב,70,28,42,4,66,34,69,0,5.80%
2018-11,הצפון,530,עיילבון,יישוב,138,68,70,7,131,68,135,1,4.66%
2018-11,הצפון,511,עילוט,יישוב,213,86,127,1,212,165,213,1,6.69%
2018-11,הצפון,532,עין מאהל,יישוב,298,157,141,11,287,218,290,0,4.98%
2018-11,הצפון,4502,עין קנייא,יישוב,97,48,49,1,96,64,95,3,8.64%
2018-11,הצפון,7600,עכו,יישוב,2447,1090,1357,148,2299,1661,2336,38,8.63%
2018-11,הצפון,7700,עפולה,יישוב,1419,596,823,184,1235,455,1345,56,4.90%
2018-11,הצפון,531,עראבה,יישוב,995,466,529,42,953,785,985,7,8.83%
2018-11,הצפון,535,פסוטה,יישוב,76,33,43,11,65,38,71,1,3.96%
2018-11,הצפון,536,פקיעין (בוקייעה),יישוב,114,60,54,10,104,58,113,3,3.76%
2018-11,הצפון,8000,צפת,יישוב,1006,496,510,108,898,555,953,20,6.80%
2018-11,הצפון,4100,קצרין,יישוב,174,77,97,29,145,56,167,4,4.17%
2018-11,הצפון,2800,קריית שמונה,יישוב,592,270,322,54,538,189,570,25,4.41%
2018-11,הצפון,543,ראמה,יישוב,216,89,127,15,201,144,207,2,5.05%
2018-11,הצפון,26,ראש פינה,יישוב,50,18,32,11,39,17,48,0,2.91%
2018-11,הצפון,542,ריינה,יישוב,400,207,193,21,379,269,388,9,5.25%
2018-11,הצפון,122,רמת ישי,יישוב,102,36,66,39,63,15,100,4,2.41%
2018-11,הצפון,913,שבלי - אום אל-גנם,יישוב,146,63,83,6,140,85,143,4,5.05%
2018-11,הצפון,812,שלומי,יישוב,165,70,95,14,151,74,160,6,4.41%
2018-11,הצפון,538,שעב,יישוב,325,148,177,5,320,251,321,2,9.65%
2018-11,הצפון,8800,שפרעם,יישוב,1124,523,601,50,1074,752,1101,19,5.66%
2018-11,חיפה,1326,"בסמ""ה",יישוב,302,151,151,8,294,196,300,3,6.70%
2018-11,חיפה,2710,אום אל-פחם,יישוב,2224,1021,1203,34,2190,1691,2176,39,9.40%
2018-11,חיפה,1020,אור עקיבא,יישוב,467,192,275,61,406,93,456,15,4.32%
2018-11,חיפה,6000,באקה אל-גרביה,יישוב,498,254,244,23,475,256,489,15,3.76%
2018-11,חיפה,9800,בנימינה-גבעת עדה*,יישוב,157,67,90,68,89,21,157,1,2.09%
2018-11,חיפה,541,ג'סר א-זרקא,יישוב,175,106,69,2,173,47,168,7,2.64%
2018-11,חיפה,628,ג'ת,יישוב,178,98,80,9,169,83,176,6,3.05%
2018-11,חיפה,494,דאלית אל-כרמל,יישוב,377,145,232,18,359,184,355,8,4.06%
2018-11,חיפה,9300,זכרון יעקב,יישוב,233,90,143,109,124,10,233,0,2.04%
2018-11,חיפה,6500,חדרה,יישוב,1947,856,1091,266,1681,506,1829,45,3.53%
2018-11,חיפה,4000,חיפה,יישוב,5025,2453,2572,1233,3792,1970,4726,148,3.35%
2018-11,חיפה,1247,חריש,יישוב,212,75,137,68,144,25,204,1,4.69%
2018-11,חיפה,2100,טירת כרמל,יישוב,621,299,322,43,578,296,594,21,4.85%
2018-11,חיפה,654,כפר קרע,יישוב,333,155,178,22,311,185,325,6,3.48%
2018-11,חיפה,45,מ.א. אלונה,מועצה איזורית,13,4,9,6,7,0,13,0,1.22%
2018-11,חיפה,12,מ.א. זבולון,מועצה איזורית,176,88,88,25,151,86,169,0,2.85%
2018-11,חיפה,15,מ.א. חוף הכרמל,מועצה איזורית,334,147,187,131,203,44,331,0,2.23%
2018-11,חיפה,14,מ.א. מנשה,מועצה איזורית,236,103,133,81,155,50,233,0,2.71%
2018-11,חיפה,1327,מעלה עירון,יישוב,525,241,284,14,511,392,516,8,7.96%
2018-11,חיפה,2500,נשר,יישוב,370,194,176,87,283,99,359,10,2.83%
2018-11,חיפה,534,עספיא,יישוב,304,127,177,22,282,139,283,6,4.61%
2018-11,חיפה,637,ערערה,יישוב,452,210,242,16,436,264,440,9,4.89%
2018-11,חיפה,537,פוריידיס,יישוב,193,106,87,8,185,39,193,4,3.18%
2018-11,חיפה,7800,פרדס חנה-כרכור,יישוב,609,284,325,192,417,64,600,18,2.80%
2018-11,חיפה,6800,קריית אתא,יישוב,1216,569,647,131,1085,464,1177,22,3.81%
2018-11,חיפה,9500,קריית ביאליק,יישוב,790,353,437,123,667,291,764,33,3.58%
2018-11,חיפה,2300,קריית טבעון,יישוב,178,80,98,74,104,25,173,2,2.06%
2018-11,חיפה,9600,קריית ים,יישוב,1048,518,530,119,929,478,997,28,4.72%
2018-11,חיפה,8200,קריית מוצקין,יישוב,813,359,454,161,652,237,795,23,3.41%
2018-11,חיפה,922,רכסים,יישוב,119,51,68,14,105,39,112,2,3.00%
2018-11,ירושלים,472,אבו גוש,יישוב,201,93,108,10,191,135,199,5,5.75%
2018-11,ירושלים,2610,בית שמש,יישוב,1082,489,593,88,994,290,1034,39,2.77%
2018-11,ירושלים,3000,ירושלים,יישוב,10608,4830,5778,1395,9213,5783,10303,159,3.22%
2018-11,ירושלים,26,מ.א. מטה יהודה,מועצה איזורית,541,268,273,143,398,85,537,0,2.08%
2018-11,ירושלים,1015,מבשרת ציון,יישוב,270,134,136,67,203,78,264,5,2.07%
2018-11,ירושלים,1137,קריית יערים,יישוב,45,20,25,12,33,8,45,0,2.52%
2018-11,תל אביב,2400,אור יהודה,יישוב,641,335,306,61,580,115,611,39,3.17%
2018-11,תל אביב,565,אזור,יישוב,173,82,91,31,142,19,170,1,2.54%
2018-11,תל אביב,6100,בני ברק,יישוב,1584,776,808,94,1490,499,1478,16,2.44%
2018-11,תל אביב,6200,בת ים,יישוב,2467,1181,1286,363,2104,690,2345,87,3.33%
2018-11,תל אביב,6300,גבעתיים,יישוב,729,311,418,363,366,76,719,7,2.26%
2018-11,תל אביב,6400,הרצלייה,יישוב,1060,474,586,400,660,32,1044,10,2.12%
2018-11,תל אביב,6600,חולון,יישוב,2858,1296,1562,484,2374,472,2782,47,2.76%
2018-11,תל אביב,267,כפר שמריהו,יישוב,8,3,5,3,5,0,8,0,0.96%
2018-11,תל אביב,2620,קריית אונו,יישוב,376,173,203,177,199,30,372,4,1.90%
2018-11,תל אביב,8600,רמת גן,יישוב,1946,892,1054,755,1191,237,1908,25,2.33%
2018-11,תל אביב,2650,רמת השרון,יישוב,425,177,248,191,234,8,420,5,1.83%
2018-11,תל אביב,5000,תל אביב -יפו,יישוב,6959,3444,3515,3008,3951,1132,6816,112,2.59%
2018-12,אזור יהודה והשומרון,3760,אורנית,יישוב,113,42,71,47,66,1,113,0,2.24%
2018-12,אזור יהודה והשומרון,3750,אלפי מנשה,יישוב,81,32,49,26,55,2,81,0,1.83%
2018-12,אזור יהודה והשומרון,3560,אלקנה,יישוב,47,20,27,25,22,0,47,0,2.53%
2018-12,אזור יהודה והשומרון,3650,אפרת,יישוב,79,34,45,43,36,5,79,0,1.60%
2018-12,אזור יהודה והשומרון,3570,אריאל,יישוב,243,105,138,67,176,13,240,9,2.19%
2018-12,אזור יהודה והשומרון,3574,בית אל,יישוב,38,20,18,9,29,9,37,1,1.49%
2018-12,אזור יהודה והשומרון,3652,בית אריה,יישוב,46,24,22,7,39,1,46,0,1.61%
2018-12,אזור יהודה והשומרון,3780,ביתר עילית,יישוב,472,234,238,16,456,129,462,2,2.97%
2018-12,אזור יהודה והשומרון,3730,גבעת זאב,יישוב,186,94,92,49,137,36,185,1,2.28%
2018-12,אזור יהודה והשומרון,3769,הר אדר,יישוב,34,21,13,18,16,5,33,0,1.51%
2018-12,אזור יהודה והשומרון,76,מ.א. גוש עציון,מועצה איזורית,175,88,87,81,94,17,171,0,1.69%
2018-12,אזור יהודה והשומרון,78,מ.א. הר חברון,מועצה איזורית,61,30,31,27,34,2,61,1,1.54%
2018-12,אזור יהודה והשומרון,74,מ.א. מגילות ים המלח,מועצה איזורית,28,14,14,10,18,0,28,0,3.02%
2018-12,אזור יהודה והשומרון,73,מ.א. מטה בנימין,מועצה איזורית,561,277,284,192,369,85,555,0,1.96%
2018-12,אזור יהודה והשומרון,75,מ.א. ערבות הירדן,מועצה איזורית,56,31,25,10,46,6,55,0,2.14%
2018-12,אזור יהודה והשומרון,72,מ.א. שומרון,מועצה איזורית,408,195,213,162,246,16,404,0,2.13%
2018-12,אזור יהודה והשומרון,3797,מודיעין עילית,יישוב,445,184,261,38,407,34,440,2,2.74%
2018-12,אזור יהודה והשומרון,3616,מעלה אדומים,יישוב,503,237,266,85,418,93,499,12,2.39%
2018-12,אזור יהודה והשומרון,3608,מעלה אפרים,יישוב,33,12,21,2,31,8,33,0,4.10%
2018-12,אזור יהודה והשומרון,3660,עמנואל,יישוב,49,23,26,3,46,12,49,2,3.60%
2018-12,אזור יהודה והשומרון,3557,קדומים,יישוב,35,22,13,21,14,1,34,1,1.70%
2018-12,אזור יהודה והשומרון,3611,קריית ארבע,יישוב,78,36,42,17,61,27,75,3,2.24%
2018-12,אזור יהודה והשומרון,3640,קרני שומרון,יישוב,81,39,42,33,48,3,78,2,1.92%
2018-12,הדרום,31,אופקים,יישוב,811,343,468,52,759,345,778,28,5.39%
2018-12,הדרום,2600,אילת,יישוב,976,516,460,55,921,209,933,49,2.70%
2018-12,הדרום,70,אשדוד,יישוב,4835,2119,2716,599,4236,1795,4632,98,4.14%
2018-12,הדרום,7100,אשקלון,יישוב,3194,1468,1726,344,2850,1261,2922,59,3.95%
2018-12,הדרום,9000,באר שבע,יישוב,5032,2353,2679,780,4252,2390,4729,86,4.42%
2018-12,הדרום,2200,דימונה,יישוב,1499,698,801,68,1431,892,1414,30,7.28%
2018-12,הדרום,1303,חורה,יישוב,489,217,272,6,483,398,457,4,9.55%
2018-12,הדרום,831,ירוחם,יישוב,372,181,191,25,347,194,350,21,6.83%
2018-12,הדרום,1059,כסיפה,יישוב,994,392,602,3,991,884,982,10,17.98%
2018-12,הדרום,1271,להבים,יישוב,64,33,31,42,22,2,64,1,1.80%
2018-12,הדרום,1060,לקיה,יישוב,565,265,300,1,564,469,537,2,11.05%
2018-12,הדרום,69,מ.א. אל קסום,מועצה איזורית,800,325,475,9,791,664,765,0,22.43%
2018-12,הדרום,38,מ.א. אשכול,מועצה איזורית,127,54,73,36,91,8,127,0,1.81%
2018-12,הדרום,33,מ.א. באר טוביה,מועצה איזורית,272,128,144,55,217,41,271,0,2.39%
2018-12,הדרום,41,מ.א. בני שמעון,מועצה איזורית,77,34,43,29,48,12,77,2,1.59%
2018-12,הדרום,54,מ.א. הערבה התיכונה,מועצה איזורית,22,12,10,7,15,0,22,0,1.15%
2018-12,הדרום,53,מ.א. חבל אילות,מועצה איזורית,28,10,18,5,23,0,27,0,1.09%
2018-12,הדרום,36,מ.א. חוף אשקלון,מועצה איזורית,224,109,115,39,185,41,215,0,2.47%
2018-12,הדרום,35,מ.א. יואב,מועצה איזורית,99,38,61,34,65,14,97,0,2.37%
2018-12,הדרום,50,מ.א. לכיש,מועצה איזורית,159,76,83,24,135,32,158,0,2.84%
2018-12,הדרום,42,מ.א. מרחבים,מועצה איזורית,166,72,94,31,135,25,164,0,2.61%
2018-12,הדרום,68,מ.א. נווה מדבר,מועצה איזורית,136,58,78,3,133,97,133,0,7.04%
2018-12,הדרום,48,מ.א. רמת נגב,מועצה איזורית,264,130,134,19,245,207,257,0,7.70%
2018-12,הדרום,39,מ.א. שדות נגב,מועצה איזורית,132,64,68,32,100,28,126,0,2.59%
2018-12,הדרום,37,מ.א. שער הנגב,מועצה איזורית,103,46,57,38,65,34,96,0,2.40%
2018-12,הדרום,34,מ.א. שפיר,מועצה איזורית,157,68,89,21,136,39,157,0,3.15%
2018-12,הדרום,51,מ.א. תמר,מועצה איזורית,9,2,7,3,6,2,9,0,1.38%
2018-12,הדרום,1268,מיתר,יישוב,68,24,44,38,30,5,66,2,1.34%
2018-12,הדרום,99,מצפה רמון,יישוב,209,91,118,18,191,127,201,10,7.27%
2018-12,הדרום,246,נתיבות,יישוב,864,386,478,54,810,352,819,40,4.99%
2018-12,הדרום,666,עומר,יישוב,51,24,27,23,28,5,50,0,1.19%
2018-12,הדרום,2560,ערד,יישוב,598,288,310,64,534,260,569,27,4.49%
2018-12,הדרום,1192,ערערה-בנגב,יישוב,960,421,539,16,944,867,931,1,18.23%
2018-12,הדרום,2630,קריית גת,יישוב,1558,699,859,128,1430,582,1487,61,5.07%
2018-12,הדרום,1034,קריית מלאכי,יישוב,793,359,434,33,760,309,755,32,6.07%
2018-12,הדרום,1161,רהט,יישוב,2010,855,1155,9,2001,1389,1980,29,8.86%
2018-12,הדרום,1286,שגב-שלום,יישוב,323,140,183,4,319,242,310,6,9.61%
2018-12,הדרום,1031,שדרות,יישוב,903,440,463,65,838,425,825,28,5.56%
2018-12,הדרום,1054,תל שבע,יישוב,668,317,351,7,661,546,624,8,10.92%
2018-12,המרכז,1066,"בני עי""ש",יישוב,137,66,71,18,119,30,130,3,3.24%
2018-12,המרכז,182,אבן יהודה,יישוב,159,71,88,70,89,12,159,1,2.27%
2018-12,המרכז,41,אליכין,יישוב,65,31,34,16,49,11,61,2,3.10%
2018-12,המרכז,1309,אלעד,יישוב,336,154,182,28,308,24,327,5,2.30%
2018-12,המרכז,2530,באר יעקב,יישוב,317,128,189,87,230,28,314,5,2.43%
2018-12,המרכז,466,בית דגן,יישוב,92,50,42,15,77,20,91,0,2.44%
2018-12,המרכז,681,גבעת שמואל,יישוב,247,115,132,95,152,30,244,2,1.95%
2018-12,המרכז,2550,גדרה,יישוב,290,133,157,59,231,49,283,10,2.18%
2018-12,המרכז,627,ג'לג'וליה,יישוב,78,39,39,6,72,33,74,1,1.72%
2018-12,המרכז,166,גן יבנה,יישוב,308,127,181,61,247,51,300,2,2.36%
2018-12,המרכז,229,גני תקווה,יישוב,186,80,106,73,113,23,185,2,1.92%
2018-12,המרכז,9700,הוד השרון,יישוב,622,254,368,280,342,12,613,9,1.88%
2018-12,המרכז,1290,זמר,יישוב,98,37,61,6,92,60,95,4,2.92%
2018-12,המרכז,2730,טייבה,יישוב,882,444,438,29,853,530,755,29,3.91%
2018-12,המרכז,2720,טירה,יישוב,162,98,64,15,147,21,157,13,1.25%
2018-12,המרכז,2660,יבנה,יישוב,695,340,355,151,544,132,687,29,2.72%
2018-12,המרכז,9400,יהוד,יישוב,389,187,202,100,289,33,384,8,2.35%
2018-12,המרכז,1224,כוכב יאיר,יישוב,109,41,68,67,42,1,108,3,1.93%
2018-12,המרכז,633,כפר ברא,יישוב,14,8,6,0,14,3,14,1,0.87%
2018-12,המרכז,168,כפר יונה,יישוב,288,129,159,57,231,32,286,4,2.44%
2018-12,המרכז,6900,כפר סבא,יישוב,1145,529,616,459,686,53,1127,16,2.13%
2018-12,המרכז,634,כפר קאסם,יישוב,166,81,85,8,158,66,160,5,1.55%
2018-12,המרכז,7000,לוד,יישוב,1501,734,767,134,1367,603,1471,37,3.99%
2018-12,המרכז,28,מ.א. ברנר,מועצה איזורית,75,40,35,36,39,5,73,5,1.80%
2018-12,המרכז,32,מ.א. גדרות,מועצה איזורית,48,21,27,24,24,3,47,0,1.91%
2018-12,המרכז,30,מ.א. גזר,מועצה איזורית,246,116,130,92,154,21,243,0,1.81%
2018-12,המרכז,27,מ.א. גן רווה,מועצה איזורית,59,28,31,35,24,1,58,1,1.94%
2018-12,המרכז,20,מ.א. דרום השרון,מועצה איזורית,318,147,171,144,174,8,316,0,1.95%
2018-12,המרכז,29,מ.א. חבל יבנה,מועצה איזורית,37,17,20,13,24,1,37,0,1.41%
2018-12,המרכז,25,מ.א. חבל מודיעין,מועצה איזורית,225,110,115,73,152,23,220,0,2.00%
2018-12,המרכז,19,מ.א. חוף השרון,מועצה איזורית,110,42,68,59,51,2,110,0,1.98%
2018-12,המרכז,18,מ.א. לב השרון,מועצה איזורית,272,131,141,78,194,17,270,0,2.43%
2018-12,המרכז,31,מ.א. נחל שורק,מועצה איזורית,67,35,32,19,48,5,66,28,1.55%
2018-12,המרכז,16,מ.א. עמק חפר,מועצה איזורית,382,177,205,152,230,18,381,0,1.94%
2018-12,המרכז,40,מ.א. שדות דן,מועצה איזורית,131,66,65,41,90,7,131,0,2.03%
2018-12,המרכז,1200,מודיעין-מכבים-רעות*,יישוב,795,348,447,355,440,28,784,13,1.70%
2018-12,המרכז,28,מזכרת בתיה,יישוב,143,61,82,50,93,16,142,5,1.75%
2018-12,המרכז,7200,נס ציונה,יישוב,553,248,305,151,402,102,539,7,2.18%
2018-12,המרכז,7400,נתניה,יישוב,3793,1864,1929,502,3291,918,3715,85,3.42%
2018-12,המרכז,587,סביון*,יישוב,17,8,9,9,8,0,17,0,0.82%
2018-12,המרכז,171,פרדסייה,יישוב,85,35,50,29,56,3,85,0,2.25%
2018-12,המרכז,7900,פתח תקווה,יישוב,3430,1587,1843,754,2676,608,3356,51,2.60%
2018-12,המרכז,195,קדימה-צורן,יישוב,270,104,166,91,179,17,269,5,2.29%
2018-12,המרכז,638,קלנסווה,יישוב,296,154,142,8,288,172,260,11,2.69%
2018-12,המרכז,469,קריית עקרון,יישוב,233,129,104,16,217,82,217,10,3.56%
2018-12,המרכז,2640,ראש העין,יישוב,833,390,443,172,661,81,817,13,2.64%
2018-12,המרכז,8300,ראשון לציון,יישוב,3633,1606,2027,789,2844,664,3588,49,2.56%
2018-12,המרכז,8400,רחובות,יישוב,2012,931,1081,497,1515,495,1951,50,2.75%
2018-12,המרכז,8500,רמלה,יישוב,1360,674,686,97,1263,420,1313,48,3.38%
2018-12,המרכז,8700,רעננה,יישוב,743,351,392,352,391,31,736,12,1.94%
2018-12,המרכז,1304,שוהם,יישוב,171,78,93,78,93,4,168,1,1.39%
2018-12,המרכז,154,תל מונד,יישוב,122,57,65,41,81,11,121,0,1.76%
2018-12,הצפון,473,אבו סנאן,יישוב,478,212,266,6,472,324,470,6,7.47%
2018-12,הצפון,478,אכסאל,יישוב,393,189,204,22,371,317,389,1,6.11%
2018-12,הצפון,529,אעבלין,יישוב,351,152,199,18,333,246,341,6,5.52%
2018-12,הצפון,482,בועיינה-נוג'ידאת,יישוב,216,113,103,9,207,143,211,3,4.90%
2018-12,הצפון,4001,בוקעאתא,יישוב,289,121,168,5,284,196,281,3,9.40%
2018-12,הצפון,998,ביר אל-מכסור,יישוב,253,120,133,5,248,164,250,1,6.01%
2018-12,הצפון,480,בית ג'ן,יישוב,341,98,243,12,329,201,330,1,5.52%
2018-12,הצפון,9200,בית שאן,יישוב,659,310,349,32,627,265,632,39,6.00%
2018-12,הצפון,944,בסמת טבעון,יישוב,149,80,69,2,147,83,138,0,3.83%
2018-12,הצפון,483,בענה,יישוב,301,140,161,13,288,231,290,0,7.47%
2018-12,הצפון,1292,ג'דיידה-מכר,יישוב,932,421,511,8,924,659,910,11,8.90%
2018-12,הצפון,485,ג'ולס,יישוב,156,47,109,2,154,69,155,3,4.75%
2018-12,הצפון,487,ג'ש (גוש חלב),יישוב,41,21,20,3,38,18,40,0,2.35%
2018-12,הצפון,489,דבורייה,יישוב,215,105,110,8,207,149,212,3,4.50%
2018-12,הצפון,490,דייר אל-אסד,יישוב,307,142,165,17,290,211,297,0,5.17%
2018-12,הצפון,492,דייר חנא,יישוב,457,208,249,13,444,313,456,2,8.65%
2018-12,הצפון,975,זרזיר,יישוב,167,75,92,4,163,88,162,7,4.54%
2018-12,הצפון,496,חורפיש,יישוב,93,41,52,9,84,47,85,3,2.79%
2018-12,הצפון,2034,חצור הגלילית,יישוב,218,90,128,19,199,84,209,6,4.28%
2018-12,הצפון,6700,טבריה,יישוב,1288,639,649,82,1206,530,1169,51,5.23%
2018-12,הצפון,962,טובא-זנגרייה,יישוב,255,117,138,7,248,154,247,7,7.32%
2018-12,הצפון,498,טורעאן,יישוב,297,134,163,22,275,207,292,6,4.63%
2018-12,הצפון,8900,טמרה,יישוב,1105,531,574,32,1073,801,1082,16,6.99%
2018-12,הצפון,1295,יאנוח-ג'ת,יישוב,123,47,76,6,117,56,118,5,3.68%
2018-12,הצפון,46,יבנאל,יישוב,86,50,36,5,81,37,78,0,4.90%
2018-12,הצפון,29,יסוד המעלה,יישוב,19,9,10,6,13,3,19,0,2.16%
2018-12,הצפון,499,יפיע,יישוב,447,206,241,20,427,294,443,2,5.13%
2018-12,הצפון,240,יקנעם עילית,יישוב,440,199,241,96,344,80,431,25,3.34%
2018-12,הצפון,502,ירכא,יישוב,359,163,196,1,358,208,355,3,5.05%
2018-12,הצפון,504,כאבול,יישוב,355,177,178,7,348,267,338,4,6.29%
2018-12,הצפון,505,כאוכב אבו אל-היג'א,יישוב,152,60,92,5,147,125,151,3,8.08%
2018-12,הצפון,1296,כסרא-סמיע,יישוב,188,69,119,9,179,81,177,9,4.54%
2018-12,הצפון,978,כעביה-טבאש-חג'אג'רה,יישוב,150,66,84,10,140,88,149,3,5.76%
2018-12,הצפון,1263,כפר ורדים,יישוב,54,24,30,23,31,2,53,0,1.71%
2018-12,הצפון,507,כפר יאסיף,יישוב,346,149,197,5,341,210,338,5,6.23%
2018-12,הצפון,508,כפר כמא,יישוב,43,16,27,5,38,12,38,1,2.20%
2018-12,הצפון,509,כפר כנא,יישוב,631,329,302,38,593,470,608,8,6.30%
2018-12,הצפון,510,כפר מנדא,יישוב,559,277,282,15,544,419,551,3,6.88%
2018-12,הצפון,47,כפר תבור,יישוב,38,11,27,10,28,2,37,1,1.57%
2018-12,הצפון,1139,כרמיאל,יישוב,1339,590,749,280,1059,601,1240,40,4.78%
2018-12,הצפון,65,מ.א. אל-בטוף,מועצה איזורית,188,92,96,12,176,129,180,0,5.53%
2018-12,הצפון,66,מ.א. בוסתן אל-מרג,מועצה איזורית,28,10,18,1,27,20,28,0,0.80%
2018-12,הצפון,71,מ.א. גולן,מועצה איזורית,234,100,134,67,167,15,233,0,2.65%
2018-12,הצפון,8,מ.א. הגלבוע,מועצה איזורית,515,226,289,70,445,230,506,0,3.58%
2018-12,הצפון,1,מ.א. הגליל העליון,מועצה איזורית,215,91,124,89,126,12,210,0,2.35%
2018-12,הצפון,3,מ.א. הגליל התחתון,מועצה איזורית,111,50,61,45,66,12,109,0,1.81%
2018-12,הצפון,55,מ.א. מבואות החרמון,מועצה איזורית,104,54,50,26,78,18,103,0,2.57%
2018-12,הצפון,13,מ.א. מגידו,מועצה איזורית,102,43,59,33,69,8,101,0,1.79%
2018-12,הצפון,4,מ.א. מטה אשר,מועצה איזורית,389,165,224,70,319,122,380,0,2.68%
2018-12,הצפון,52,מ.א. מעלה יוסף,מועצה איזורית,181,76,105,24,157,34,175,0,3.05%
2018-12,הצפון,2,מ.א. מרום הגליל,מועצה איזורית,241,122,119,31,210,88,235,0,3.29%
2018-12,הצפון,56,מ.א. משגב,מועצה איזורית,531,232,299,143,388,233,513,0,3.63%
2018-12,הצפון,6,מ.א. עמק הירדן,מועצה איזורית,178,91,87,50,128,18,167,0,2.46%
2018-12,הצפון,7,מ.א. עמק המעיינות,מועצה איזורית,199,88,111,49,150,31,197,0,3.01%
2018-12,הצפון,9,מ.א. עמק יזרעאל,מועצה איזורית,405,165,240,194,211,32,399,0,2.04%
2018-12,הצפון,481,מגאר,יישוב,845,369,476,18,827,599,829,10,7.90%
2018-12,הצפון,516,מג'ד אל-כרום,יישוב,434,187,247,15,419,273,426,1,5.77%
2018-12,הצפון,65,מגדל,יישוב,35,17,18,6,29,8,32,0,3.21%
2018-12,הצפון,874,מגדל העמק,יישוב,731,355,376,71,660,208,686,58,5.01%
2018-12,הצפון,4201,מג'דל שמס,יישוב,338,135,203,8,330,205,321,3,6.12%
2018-12,הצפון,517,מזרעה,יישוב,136,58,78,5,131,85,130,3,6.06%
2018-12,הצפון,43,מטולה,יישוב,21,11,10,7,14,7,20,0,1.99%
2018-12,הצפון,4203,מסעדה,יישוב,159,56,103,7,152,105,154,3,8.53%
2018-12,הצפון,518,מעיליא,יישוב,51,26,25,9,42,19,49,0,2.86%
2018-12,הצפון,1063,מעלות-תרשיחא,יישוב,668,308,360,97,571,265,634,31,5.21%
2018-12,הצפון,520,משהד,יישוב,139,64,75,4,135,105,136,5,3.82%
2018-12,הצפון,9100,נהרייה,יישוב,1614,778,836,168,1446,729,1521,54,4.81%
2018-12,הצפון,522,נחף,יישוב,355,158,197,12,343,246,347,1,6.18%
2018-12,הצפון,7300,נצרת,יישוב,2237,1033,1204,109,2128,1582,2224,17,6.06%
2018-12,הצפון,1061,נצרת עילית,יישוב,1222,568,654,120,1102,480,1113,75,4.75%
2018-12,הצפון,525,סאג'ור,יישוב,113,45,68,6,107,65,109,1,4.99%
2018-12,הצפון,7500,סח'נין,יישוב,1416,635,781,51,1365,1067,1399,11,9.11%
2018-12,הצפון,4501,ע'ג'ר,יישוב,79,34,45,5,74,37,78,0,6.51%
2018-12,הצפון,530,עיילבון,יישוב,140,68,72,7,133,71,138,0,4.76%
2018-12,הצפון,511,עילוט,יישוב,210,86,124,1,209,161,210,0,6.60%
2018-12,הצפון,532,עין מאהל,יישוב,314,167,147,11,303,222,305,1,5.22%
2018-12,הצפון,4502,עין קנייא,יישוב,103,50,53,1,102,67,101,0,9.13%
2018-12,הצפון,7600,עכו,יישוב,2412,1098,1314,153,2259,1640,2298,30,8.50%
2018-12,הצפון,7700,עפולה,יישוב,1436,620,816,188,1248,447,1355,54,4.93%
2018-12,הצפון,531,עראבה,יישוב,994,467,527,36,958,780,983,9,8.81%
2018-12,הצפון,535,פסוטה,יישוב,74,32,42,15,59,36,70,1,3.91%
2018-12,הצפון,536,פקיעין (בוקייעה),יישוב,107,56,51,9,98,59,106,2,3.54%
2018-12,הצפון,8000,צפת,יישוב,980,493,487,106,874,520,937,19,6.69%
2018-12,הצפון,4100,קצרין,יישוב,178,81,97,33,145,59,172,2,4.29%
2018-12,הצפון,2800,קריית שמונה,יישוב,590,271,319,63,527,186,567,34,4.39%
2018-12,הצפון,543,ראמה,יישוב,213,94,119,19,194,137,203,2,4.96%
2018-12,הצפון,26,ראש פינה,יישוב,49,19,30,12,37,19,47,0,2.85%
2018-12,הצפון,542,ריינה,יישוב,402,215,187,19,383,266,392,5,5.30%
2018-12,הצפון,122,רמת ישי,יישוב,102,42,60,39,63,13,101,2,2.44%
2018-12,הצפון,913,שבלי - אום אל-גנם,יישוב,150,71,79,7,143,83,146,3,5.16%
2018-12,הצפון,812,שלומי,יישוב,166,73,93,14,152,75,161,5,4.44%
2018-12,הצפון,538,שעב,יישוב,342,157,185,5,337,256,338,3,10.11%
2018-12,הצפון,8800,שפרעם,יישוב,1129,519,610,49,1080,739,1098,17,5.64%
2018-12,חיפה,1326,"בסמ""ה",יישוב,309,159,150,7,302,196,304,8,6.79%
2018-12,חיפה,2710,אום אל-פחם,יישוב,2251,1045,1206,35,2216,1697,2197,33,9.48%
2018-12,חיפה,1020,אור עקיבא,יישוב,463,205,258,61,402,99,450,17,4.26%
2018-12,חיפה,6000,באקה אל-גרביה,יישוב,502,262,240,20,482,256,494,20,3.79%
2018-12,חיפה,9800,בנימינה-גבעת עדה*,יישוב,170,73,97,78,92,17,168,3,2.23%
2018-12,חיפה,541,ג'סר א-זרקא,יישוב,173,104,69,2,171,43,168,6,2.64%
2018-12,חיפה,628,ג'ת,יישוב,178,102,76,14,164,81,177,6,3.06%
2018-12,חיפה,494,דאלית אל-כרמל,יישוב,397,157,240,19,378,193,373,5,4.26%
2018-12,חיפה,9300,זכרון יעקב,יישוב,226,95,131,106,120,15,225,2,1.98%
2018-12,חיפה,6500,חדרה,יישוב,1867,849,1018,248,1619,508,1770,35,3.42%
2018-12,חיפה,4000,חיפה,יישוב,4921,2421,2500,1215,3706,1956,4626,154,3.28%
2018-12,חיפה,1247,חריש,יישוב,203,72,131,64,139,25,198,4,4.56%
2018-12,חיפה,2100,טירת כרמל,יישוב,628,318,310,43,585,298,604,17,4.93%
2018-12,חיפה,654,כפר קרע,יישוב,337,160,177,25,312,176,330,7,3.53%
2018-12,חיפה,45,מ.א. אלונה,מועצה איזורית,17,7,10,7,10,0,17,0,1.59%
2018-12,חיפה,12,מ.א. זבולון,מועצה איזורית,184,93,91,34,150,91,175,0,2.95%
2018-12,חיפה,15,מ.א. חוף הכרמל,מועצה איזורית,348,160,188,134,214,46,343,0,2.32%
2018-12,חיפה,14,מ.א. מנשה,מועצה איזורית,253,112,141,80,173,48,251,0,2.92%
2018-12,חיפה,1327,מעלה עירון,יישוב,521,243,278,12,509,389,512,10,7.90%
2018-12,חיפה,2500,נשר,יישוב,361,182,179,86,275,98,342,4,2.70%
2018-12,חיפה,534,עספיא,יישוב,319,136,183,25,294,135,298,6,4.84%
2018-12,חיפה,637,ערערה,יישוב,464,221,243,21,443,261,451,9,5.01%
2018-12,חיפה,537,פוריידיס,יישוב,202,114,88,9,193,40,197,4,3.24%
2018-12,חיפה,7800,פרדס חנה-כרכור,יישוב,598,268,330,190,408,58,586,14,2.74%
2018-12,חיפה,6800,קריית אתא,יישוב,1236,595,641,129,1107,470,1200,39,3.88%
2018-12,חיפה,9500,קריית ביאליק,יישוב,773,333,440,123,650,285,754,27,3.54%
2018-12,חיפה,2300,קריית טבעון,יישוב,184,85,99,77,107,19,184,2,2.19%
2018-12,חיפה,9600,קריית ים,יישוב,1029,501,528,104,925,478,980,29,4.64%
2018-12,חיפה,8200,קריית מוצקין,יישוב,819,364,455,166,653,231,795,19,3.41%
2018-12,חיפה,922,רכסים,יישוב,116,53,63,16,100,38,109,1,2.92%
2018-12,ירושלים,472,אבו גוש,יישוב,203,96,107,10,193,145,200,2,5.77%
2018-12,ירושלים,2610,בית שמש,יישוב,1083,489,594,83,1000,283,1043,40,2.79%
2018-12,ירושלים,3000,ירושלים,יישוב,10599,4865,5734,1419,9180,5818,10319,131,3.23%
2018-12,ירושלים,26,מ.א. מטה יהודה,מועצה איזורית,553,265,288,145,408,81,549,0,2.12%
2018-12,ירושלים,1015,מבשרת ציון,יישוב,291,150,141,71,220,74,286,4,2.24%
2018-12,ירושלים,1137,קריית יערים,יישוב,39,16,23,10,29,7,38,0,2.14%
2018-12,תל אביב,2400,אור יהודה,יישוב,647,321,326,68,579,120,607,34,3.15%
2018-12,תל אביב,565,אזור,יישוב,171,80,91,30,141,14,168,3,2.51%
2018-12,תל אביב,6100,בני ברק,יישוב,1538,757,781,99,1439,482,1437,22,2.38%
2018-12,תל אביב,6200,בת ים,יישוב,2455,1193,1262,356,2099,695,2333,76,3.31%
2018-12,תל אביב,6300,גבעתיים,יישוב,709,312,397,353,356,81,695,4,2.19%
2018-12,תל אביב,6400,הרצלייה,יישוב,1049,478,571,417,632,27,1040,12,2.11%
2018-12,תל אביב,6600,חולון,יישוב,2812,1262,1550,478,2334,474,2740,46,2.72%
2018-12,תל אביב,267,כפר שמריהו,יישוב,9,3,6,4,5,0,9,0,1.08%
2018-12,תל אביב,2620,קריית אונו,יישוב,373,174,199,173,200,28,368,6,1.88%
2018-12,תל אביב,8600,רמת גן,יישוב,1885,866,1019,760,1125,226,1849,38,2.26%
2018-12,תל אביב,2650,רמת השרון,יישוב,425,174,251,187,238,7,419,1,1.82%
2018-12,תל אביב,5000,תל אביב -יפו,יישוב,6992,3483,3509,3122,3870,1096,6849,100,2.60%
2019-01,אזור יהודה והשומרון,3760,אורנית,יישוב,112,44,68,45,67,2,111,0,2.20%
2019-01,אזור יהודה והשומרון,3750,אלפי מנשה,יישוב,79,30,49,22,57,2,79,0,1.79%
2019-01,אזור יהודה והשומרון,3560,אלקנה,יישוב,36,13,23,20,16,0,36,0,1.95%
2019-01,אזור יהודה והשומרון,3650,אפרת,יישוב,69,31,38,41,28,2,69,4,1.40%
2019-01,אזור יהודה והשומרון,3570,אריאל,יישוב,235,96,139,65,170,13,233,7,2.13%
2019-01,אזור יהודה והשומרון,3574,בית אל,יישוב,30,15,15,8,22,9,30,1,1.21%
2019-01,אזור יהודה והשומרון,3652,בית אריה,יישוב,46,24,22,5,41,1,46,2,1.61%
2019-01,אזור יהודה והשומרון,3780,ביתר עילית,יישוב,423,202,221,12,411,116,417,1,2.69%
2019-01,אזור יהודה והשומרון,3730,גבעת זאב,יישוב,160,77,83,45,115,29,159,2,1.97%
2019-01,אזור יהודה והשומרון,3769,הר אדר,יישוב,34,21,13,17,17,5,33,0,1.51%
2019-01,אזור יהודה והשומרון,76,מ.א. גוש עציון,מועצה איזורית,163,86,77,81,82,14,158,0,1.56%
2019-01,אזור יהודה והשומרון,78,מ.א. הר חברון,מועצה איזורית,58,29,29,25,33,3,58,0,1.46%
2019-01,אזור יהודה והשומרון,74,מ.א. מגילות ים המלח,מועצה איזורית,29,13,16,8,21,0,29,0,3.15%
2019-01,אזור יהודה והשומרון,73,מ.א. מטה בנימין,מועצה איזורית,528,250,278,183,345,81,522,0,1.84%
2019-01,אזור יהודה והשומרון,75,מ.א. ערבות הירדן,מועצה איזורית,57,31,26,8,49,6,56,0,2.18%
2019-01,אזור יהודה והשומרון,72,מ.א. שומרון,מועצה איזורית,389,190,199,148,241,12,385,0,2.03%
2019-01,אזור יהודה והשומרון,3797,מודיעין עילית,יישוב,394,161,233,37,357,27,393,3,2.46%
2019-01,אזור יהודה והשומרון,3616,מעלה אדומים,יישוב,482,235,247,88,394,86,476,20,2.29%
2019-01,אזור יהודה והשומרון,3608,מעלה אפרים,יישוב,35,12,23,1,34,8,35,0,4.34%
2019-01,אזור יהודה והשומרון,3660,עמנואל,יישוב,34,16,18,1,33,10,34,1,2.53%
2019-01,אזור יהודה והשומרון,3557,קדומים,יישוב,33,21,12,19,14,1,33,0,1.65%
2019-01,אזור יהודה והשומרון,3611,קריית ארבע,יישוב,64,32,32,13,51,19,61,3,1.83%
2019-01,אזור יהודה והשומרון,3640,קרני שומרון,יישוב,65,28,37,28,37,2,64,2,1.58%
2019-01,הדרום,31,אופקים,יישוב,685,285,400,49,636,293,663,41,4.63%
2019-01,הדרום,2600,אילת,יישוב,949,486,463,57,892,209,908,29,2.63%
2019-01,הדרום,70,אשדוד,יישוב,4478,1961,2517,587,3891,1678,4281,114,3.83%
2019-01,הדרום,7100,אשקלון,יישוב,2882,1351,1531,313,2569,1122,2654,62,3.60%
2019-01,הדרום,9000,באר שבע,יישוב,4641,2196,2445,709,3932,2201,4385,99,4.11%
2019-01,הדרום,2200,דימונה,יישוב,1373,645,728,69,1304,841,1302,23,6.75%
2019-01,הדרום,1303,חורה,יישוב,449,202,247,4,445,375,429,4,9.02%
2019-01,הדרום,831,ירוחם,יישוב,382,191,191,25,357,191,363,27,7.07%
2019-01,הדרום,1059,כסיפה,יישוב,956,371,585,2,954,856,946,4,17.44%
2019-01,הדרום,1271,להבים,יישוב,54,30,24,32,22,2,54,1,1.53%
2019-01,הדרום,1060,לקיה,יישוב,527,244,283,0,527,451,493,3,10.24%
2019-01,הדרום,69,מ.א. אל קסום,מועצה איזורית,741,302,439,8,733,623,723,1,21.19%
2019-01,הדרום,38,מ.א. אשכול,מועצה איזורית,115,51,64,34,81,5,115,0,1.64%
2019-01,הדרום,33,מ.א. באר טוביה,מועצה איזורית,252,124,128,49,203,37,250,0,2.21%
2019-01,הדרום,41,מ.א. בני שמעון,מועצה איזורית,64,29,35,25,39,13,64,1,1.32%
2019-01,הדרום,54,מ.א. הערבה התיכונה,מועצה איזורית,18,12,6,4,14,0,18,0,0.94%
2019-01,הדרום,53,מ.א. חבל אילות,מועצה איזורית,25,11,14,5,20,1,24,0,0.97%
2019-01,הדרום,36,מ.א. חוף אשקלון,מועצה איזורית,215,105,110,41,174,36,207,0,2.38%
2019-01,הדרום,35,מ.א. יואב,מועצה איזורית,100,40,60,33,67,14,99,0,2.42%
2019-01,הדרום,50,מ.א. לכיש,מועצה איזורית,158,80,78,27,131,35,155,0,2.78%
2019-01,הדרום,42,מ.א. מרחבים,מועצה איזורית,148,64,84,23,125,25,146,0,2.32%
2019-01,הדרום,68,מ.א. נווה מדבר,מועצה איזורית,124,47,77,3,121,89,122,0,6.46%
2019-01,הדרום,48,מ.א. רמת נגב,מועצה איזורית,257,123,134,19,238,202,252,1,7.54%
2019-01,הדרום,39,מ.א. שדות נגב,מועצה איזורית,110,55,55,23,87,27,106,0,2.18%
2019-01,הדרום,37,מ.א. שער הנגב,מועצה איזורית,107,56,51,32,75,53,100,0,2.50%
2019-01,הדרום,34,מ.א. שפיר,מועצה איזורית,143,59,84,21,122,34,142,0,2.85%
2019-01,הדרום,51,מ.א. תמר,מועצה איזורית,10,3,7,0,10,2,10,0,1.54%
2019-01,הדרום,1268,מיתר,יישוב,63,21,42,35,28,5,63,0,1.28%
2019-01,הדרום,99,מצפה רמון,יישוב,202,85,117,17,185,123,194,13,7.03%
2019-01,הדרום,246,נתיבות,יישוב,814,371,443,54,760,332,771,40,4.71%
2019-01,הדרום,666,עומר,יישוב,51,23,28,22,29,4,51,1,1.21%
2019-01,הדרום,2560,ערד,יישוב,564,274,290,66,498,246,529,26,4.19%
2019-01,הדרום,1192,ערערה-בנגב,יישוב,901,383,518,14,887,819,882,56,17.44%
2019-01,הדרום,2630,קריית גת,יישוב,1446,631,815,108,1338,541,1388,46,4.75%
2019-01,הדרום,1034,קריית מלאכי,יישוב,665,293,372,24,641,279,634,21,5.15%
2019-01,הדרום,1161,רהט,יישוב,1852,765,1087,7,1845,1331,1819,39,8.19%
2019-01,הדרום,1286,שגב-שלום,יישוב,290,126,164,4,286,225,280,7,8.76%
2019-01,הדרום,1031,שדרות,יישוב,867,415,452,54,813,418,784,32,5.30%
2019-01,הדרום,1054,תל שבע,יישוב,635,295,340,5,630,522,598,10,10.51%
2019-01,המרכז,1066,"בני עי""ש",יישוב,134,64,70,19,115,27,129,3,3.21%
2019-01,המרכז,182,אבן יהודה,יישוב,164,75,89,74,90,12,164,0,2.34%
2019-01,המרכז,41,אליכין,יישוב,56,28,28,13,43,11,52,1,2.65%
2019-01,המרכז,1309,אלעד,יישוב,336,158,178,29,307,22,328,1,2.31%
2019-01,המרכז,2530,באר יעקב,יישוב,306,120,186,87,219,26,303,5,2.35%
2019-01,המרכז,466,בית דגן,יישוב,77,45,32,14,63,15,76,3,2.04%
2019-01,המרכז,681,גבעת שמואל,יישוב,229,113,116,82,147,26,227,0,1.82%
2019-01,המרכז,2550,גדרה,יישוב,260,117,143,52,208,50,252,5,1.95%
2019-01,המרכז,627,ג'לג'וליה,יישוב,66,32,34,8,58,28,64,2,1.49%
2019-01,המרכז,166,גן יבנה,יישוב,292,119,173,61,231,42,286,5,2.25%
2019-01,המרכז,229,גני תקווה,יישוב,171,75,96,63,108,18,170,0,1.77%
2019-01,המרכז,9700,הוד השרון,יישוב,554,227,327,255,299,10,549,7,1.69%
2019-01,המרכז,1290,זמר,יישוב,88,36,52,5,83,56,86,5,2.65%
2019-01,המרכז,2730,טייבה,יישוב,824,419,405,25,799,507,707,19,3.67%
2019-01,המרכז,2720,טירה,יישוב,127,72,55,12,115,15,125,8,1.00%
2019-01,המרכז,2660,יבנה,יישוב,566,279,287,130,436,99,557,25,2.22%
2019-01,המרכז,9400,יהוד,יישוב,338,159,179,103,235,25,333,5,2.04%
2019-01,המרכז,1224,כוכב יאיר,יישוב,91,34,57,58,33,0,91,0,1.63%
2019-01,המרכז,633,כפר ברא,יישוב,13,10,3,1,12,3,12,2,0.75%
2019-01,המרכז,168,כפר יונה,יישוב,274,121,153,59,215,29,271,2,2.31%
2019-01,המרכז,6900,כפר סבא,יישוב,1043,478,565,420,623,45,1031,23,1.95%
2019-01,המרכז,634,כפר קאסם,יישוב,162,81,81,6,156,65,158,8,1.53%
2019-01,המרכז,7000,לוד,יישוב,1497,726,771,128,1369,637,1463,23,3.97%
2019-01,המרכז,28,מ.א. ברנר,מועצה איזורית,69,37,32,33,36,4,67,5,1.66%
2019-01,המרכז,32,מ.א. גדרות,מועצה איזורית,50,23,27,27,23,3,50,0,2.03%
2019-01,המרכז,30,מ.א. גזר,מועצה איזורית,228,111,117,87,141,20,228,0,1.70%
2019-01,המרכז,27,מ.א. גן רווה,מועצה איזורית,58,25,33,33,25,1,58,0,1.94%
2019-01,המרכז,20,מ.א. דרום השרון,מועצה איזורית,301,138,163,141,160,8,299,0,1.85%
2019-01,המרכז,29,מ.א. חבל יבנה,מועצה איזורית,30,18,12,10,20,1,30,0,1.14%
2019-01,המרכז,25,מ.א. חבל מודיעין,מועצה איזורית,225,115,110,70,155,23,221,0,2.01%
2019-01,המרכז,19,מ.א. חוף השרון,מועצה איזורית,112,43,69,59,53,3,112,0,2.01%
2019-01,המרכז,18,מ.א. לב השרון,מועצה איזורית,235,110,125,65,170,15,234,0,2.11%
2019-01,המרכז,31,מ.א. נחל שורק,מועצה איזורית,59,32,27,17,42,5,58,41,1.40%
2019-01,המרכז,16,מ.א. עמק חפר,מועצה איזורית,356,173,183,134,222,12,355,0,1.80%
2019-01,המרכז,40,מ.א. שדות דן,מועצה איזורית,127,73,54,35,92,7,127,0,1.97%
2019-01,המרכז,1200,מודיעין-מכבים-רעות*,יישוב,734,311,423,325,409,26,729,20,1.58%
2019-01,המרכז,28,מזכרת בתיה,יישוב,125,52,73,43,82,13,123,5,1.52%
2019-01,המרכז,7200,נס ציונה,יישוב,504,211,293,133,371,85,492,8,1.99%
2019-01,המרכז,7400,נתניה,יישוב,3420,1677,1743,452,2968,772,3358,72,3.10%
2019-01,המרכז,587,סביון*,יישוב,14,7,7,8,6,0,14,0,0.67%
2019-01,המרכז,171,פרדסייה,יישוב,71,30,41,24,47,1,71,0,1.89%
2019-01,המרכז,7900,פתח תקווה,יישוב,3171,1465,1706,676,2495,565,3098,47,2.40%
2019-01,המרכז,195,קדימה-צורן,יישוב,270,101,169,96,174,17,267,0,2.27%
2019-01,המרכז,638,קלנסווה,יישוב,284,146,138,11,273,163,250,8,2.58%
2019-01,המרכז,469,קריית עקרון,יישוב,184,103,81,13,171,67,176,5,2.91%
2019-01,המרכז,2640,ראש העין,יישוב,745,357,388,163,582,79,737,11,2.38%
2019-01,המרכז,8300,ראשון לציון,יישוב,3339,1483,1856,729,2610,573,3312,31,2.37%
2019-01,המרכז,8400,רחובות,יישוב,1819,834,985,449,1370,450,1750,30,2.47%
2019-01,המרכז,8500,רמלה,יישוב,1228,581,647,85,1143,380,1189,57,3.07%
2019-01,המרכז,8700,רעננה,יישוב,679,319,360,312,367,23,671,6,1.77%
2019-01,המרכז,1304,שוהם,יישוב,159,68,91,78,81,4,159,1,1.32%
2019-01,המרכז,154,תל מונד,יישוב,116,54,62,38,78,9,116,1,1.68%
2019-01,הצפון,473,אבו סנאן,יישוב,472,214,258,9,463,313,467,1,7.43%
2019-01,הצפון,478,אכסאל,יישוב,382,189,193,15,367,301,382,5,6.01%
2019-01,הצפון,529,אעבלין,יישוב,350,155,195,18,332,240,345,2,5.58%
2019-01,הצפון,482,בועיינה-נוג'ידאת,יישוב,221,116,105,13,208,143,215,3,4.99%
2019-01,הצפון,4001,בוקעאתא,יישוב,276,110,166,4,272,194,272,2,9.13%
2019-01,הצפון,998,ביר אל-מכסור,יישוב,237,110,127,4,233,157,234,3,5.65%
2019-01,הצפון,480,בית ג'ן,יישוב,328,96,232,11,317,195,318,2,5.33%
2019-01,הצפון,9200,בית שאן,יישוב,579,268,311,29,550,249,562,29,5.37%
2019-01,הצפון,944,בסמת טבעון,יישוב,149,82,67,3,146,81,139,2,3.85%
2019-01,הצפון,483,בענה,יישוב,293,135,158,14,279,230,282,5,7.28%
2019-01,הצפון,1292,ג'דיידה-מכר,יישוב,883,408,475,6,877,620,861,4,8.46%
2019-01,הצפון,485,ג'ולס,יישוב,161,45,116,2,159,65,160,1,4.89%
2019-01,הצפון,487,ג'ש (גוש חלב),יישוב,41,21,20,4,37,16,41,0,2.40%
2019-01,הצפון,489,דבורייה,יישוב,196,92,104,7,189,142,194,3,4.13%
2019-01,הצפון,490,דייר אל-אסד,יישוב,302,142,160,15,287,211,293,2,5.10%
2019-01,הצפון,492,דייר חנא,יישוב,435,210,225,10,425,286,434,12,8.27%
2019-01,הצפון,975,זרזיר,יישוב,152,77,75,5,147,74,149,3,4.19%
2019-01,הצפון,496,חורפיש,יישוב,82,40,42,8,74,42,76,3,2.50%
2019-01,הצפון,2034,חצור הגלילית,יישוב,199,79,120,19,180,83,187,1,3.85%
2019-01,הצפון,6700,טבריה,יישוב,1185,582,603,77,1108,490,1071,41,4.82%
2019-01,הצפון,962,טובא-זנגרייה,יישוב,248,108,140,5,243,137,243,1,7.21%
2019-01,הצפון,498,טורעאן,יישוב,299,140,159,19,280,207,295,6,4.68%
2019-01,הצפון,8900,טמרה,יישוב,1063,511,552,25,1038,783,1046,13,6.77%
2019-01,הצפון,1295,יאנוח-ג'ת,יישוב,114,45,69,6,108,51,109,2,3.41%
2019-01,הצפון,46,יבנאל,יישוב,80,42,38,6,74,37,73,3,4.60%
2019-01,הצפון,29,יסוד המעלה,יישוב,18,8,10,7,11,2,18,0,2.05%
2019-01,הצפון,499,יפיע,יישוב,448,204,244,22,426,287,444,4,5.14%
2019-01,הצפון,240,יקנעם עילית,יישוב,385,162,223,91,294,77,376,24,2.92%
2019-01,הצפון,502,ירכא,יישוב,321,144,177,2,319,194,316,3,4.52%
2019-01,הצפון,504,כאבול,יישוב,342,178,164,6,336,268,327,4,6.10%
2019-01,הצפון,505,כאוכב אבו אל-היג'א,יישוב,144,59,85,5,139,116,144,1,7.74%
2019-01,הצפון,1296,כסרא-סמיע,יישוב,175,57,118,9,166,82,166,2,4.27%
2019-01,הצפון,978,כעביה-טבאש-חג'אג'רה,יישוב,138,57,81,8,130,79,136,3,5.29%
2019-01,הצפון,1263,כפר ורדים,יישוב,53,26,27,19,34,3,52,1,1.67%
2019-01,הצפון,507,כפר יאסיף,יישוב,321,147,174,5,316,192,315,1,5.83%
2019-01,הצפון,508,כפר כמא,יישוב,43,16,27,4,39,9,39,1,2.26%
2019-01,הצפון,509,כפר כנא,יישוב,624,330,294,36,588,473,601,8,6.23%
2019-01,הצפון,510,כפר מנדא,יישוב,535,273,262,15,520,383,531,1,6.65%
2019-01,הצפון,47,כפר תבור,יישוב,39,14,25,10,29,2,37,0,1.57%
2019-01,הצפון,1139,כרמיאל,יישוב,1238,558,680,255,983,559,1150,56,4.45%
2019-01,הצפון,65,מ.א. אל-בטוף,מועצה איזורית,193,95,98,10,183,123,184,4,5.64%
2019-01,הצפון,66,מ.א. בוסתן אל-מרג,מועצה איזורית,22,6,16,1,21,18,22,0,0.63%
2019-01,הצפון,71,מ.א. גולן,מועצה איזורית,216,91,125,60,156,15,216,0,2.46%
2019-01,הצפון,8,מ.א. הגלבוע,מועצה איזורית,479,213,266,67,412,217,473,0,3.35%
2019-01,הצפון,1,מ.א. הגליל העליון,מועצה איזורית,211,92,119,85,126,7,208,0,2.32%
2019-01,הצפון,3,מ.א. הגליל התחתון,מועצה איזורית,106,44,62,39,67,9,105,0,1.74%
2019-01,הצפון,55,מ.א. מבואות החרמון,מועצה איזורית,97,47,50,24,73,18,97,0,2.42%
2019-01,הצפון,13,מ.א. מגידו,מועצה איזורית,96,40,56,34,62,8,95,0,1.68%
2019-01,הצפון,4,מ.א. מטה אשר,מועצה איזורית,356,151,205,64,292,112,347,0,2.44%
2019-01,הצפון,52,מ.א. מעלה יוסף,מועצה איזורית,165,70,95,25,140,33,158,0,2.76%
2019-01,הצפון,2,מ.א. מרום הגליל,מועצה איזורית,225,108,117,31,194,85,222,0,3.11%
2019-01,הצפון,56,מ.א. משגב,מועצה איזורית,480,209,271,125,355,208,465,0,3.29%
2019-01,הצפון,6,מ.א. עמק הירדן,מועצה איזורית,167,90,77,48,119,17,157,0,2.31%
2019-01,הצפון,7,מ.א. עמק המעיינות,מועצה איזורית,192,82,110,44,148,31,189,1,2.88%
2019-01,הצפון,9,מ.א. עמק יזרעאל,מועצה איזורית,357,136,221,180,177,35,351,0,1.79%
2019-01,הצפון,481,מגאר,יישוב,818,363,455,17,801,583,805,5,7.69%
2019-01,הצפון,516,מג'ד אל-כרום,יישוב,427,182,245,11,416,267,418,7,5.67%
2019-01,הצפון,65,מגדל,יישוב,40,19,21,6,34,7,35,4,3.50%
2019-01,הצפון,874,מגדל העמק,יישוב,614,297,317,58,556,177,569,45,4.19%
2019-01,הצפון,4201,מג'דל שמס,יישוב,311,122,189,6,305,203,300,7,5.74%
2019-01,הצפון,517,מזרעה,יישוב,121,56,65,2,119,78,117,1,5.49%
2019-01,הצפון,43,מטולה,יישוב,20,12,8,4,16,5,18,1,1.80%
2019-01,הצפון,4203,מסעדה,יישוב,145,53,92,8,137,101,138,2,7.71%
2019-01,הצפון,518,מעיליא,יישוב,44,22,22,7,37,17,42,1,2.46%
2019-01,הצפון,1063,מעלות-תרשיחא,יישוב,620,288,332,85,535,253,596,37,4.91%
2019-01,הצפון,520,משהד,יישוב,136,63,73,6,130,104,133,1,3.74%
2019-01,הצפון,9100,נהרייה,יישוב,1429,714,715,163,1266,694,1354,56,4.30%
2019-01,הצפון,522,נחף,יישוב,340,153,187,9,331,239,334,8,5.96%
2019-01,הצפון,7300,נצרת,יישוב,2211,1049,1162,99,2112,1522,2196,21,5.99%
2019-01,הצפון,1061,נצרת עילית,יישוב,1141,538,603,110,1031,437,1040,64,4.45%
2019-01,הצפון,525,סאג'ור,יישוב,109,46,63,4,105,62,107,2,4.91%
2019-01,הצפון,7500,סח'נין,יישוב,1384,627,757,51,1333,1017,1367,20,8.92%
2019-01,הצפון,4501,ע'ג'ר,יישוב,70,28,42,4,66,36,69,0,5.80%
2019-01,הצפון,530,עיילבון,יישוב,131,68,63,6,125,68,129,1,4.46%
2019-01,הצפון,511,עילוט,יישוב,219,94,125,1,218,162,218,3,6.83%
2019-01,הצפון,532,עין מאהל,יישוב,315,168,147,12,303,215,306,0,5.24%
2019-01,הצפון,4502,עין קנייא,יישוב,101,48,53,2,99,69,99,2,8.97%
2019-01,הצפון,7600,עכו,יישוב,2256,1025,1231,135,2121,1547,2153,24,8.01%
2019-01,הצפון,7700,עפולה,יישוב,1307,566,741,173,1134,415,1249,54,4.57%
2019-01,הצפון,531,עראבה,יישוב,974,459,515,32,942,753,965,12,8.66%
2019-01,הצפון,535,פסוטה,יישוב,65,30,35,12,53,31,62,1,3.48%
2019-01,הצפון,536,פקיעין (בוקייעה),יישוב,95,47,48,6,89,54,94,0,3.15%
2019-01,הצפון,8000,צפת,יישוב,885,437,448,95,790,512,843,29,6.06%
2019-01,הצפון,4100,קצרין,יישוב,166,77,89,27,139,53,164,5,4.10%
2019-01,הצפון,2800,קריית שמונה,יישוב,532,250,282,57,475,168,512,20,3.98%
2019-01,הצפון,543,ראמה,יישוב,200,90,110,15,185,133,191,1,4.68%
2019-01,הצפון,26,ראש פינה,יישוב,42,14,28,10,32,17,41,0,2.49%
2019-01,הצפון,542,ריינה,יישוב,391,212,179,13,378,261,377,3,5.11%
2019-01,הצפון,122,רמת ישי,יישוב,98,39,59,40,58,16,97,1,2.34%
2019-01,הצפון,913,שבלי - אום אל-גנם,יישוב,151,72,79,4,147,82,147,3,5.19%
2019-01,הצפון,812,שלומי,יישוב,151,68,83,10,141,68,147,4,4.07%
2019-01,הצפון,538,שעב,יישוב,316,147,169,5,311,238,314,4,9.46%
2019-01,הצפון,8800,שפרעם,יישוב,1102,525,577,47,1055,737,1074,14,5.53%
2019-01,חיפה,1326,"בסמ""ה",יישוב,287,144,143,5,282,190,283,6,6.35%
2019-01,חיפה,2710,אום אל-פחם,יישוב,2094,992,1102,30,2064,1558,2052,36,8.91%
2019-01,חיפה,1020,אור עקיבא,יישוב,431,185,246,62,369,84,424,8,4.03%
2019-01,חיפה,6000,באקה אל-גרביה,יישוב,478,260,218,19,459,239,470,16,3.62%
2019-01,חיפה,9800,בנימינה-גבעת עדה*,יישוב,158,65,93,78,80,15,157,0,2.09%
2019-01,חיפה,541,ג'סר א-זרקא,יישוב,155,91,64,2,153,38,151,7,2.38%
2019-01,חיפה,628,ג'ת,יישוב,172,97,75,15,157,73,171,4,2.96%
2019-01,חיפה,494,דאלית אל-כרמל,יישוב,379,149,230,16,363,179,358,3,4.09%
2019-01,חיפה,9300,זכרון יעקב,יישוב,218,86,132,99,119,14,217,2,1.91%
2019-01,חיפה,6500,חדרה,יישוב,1710,797,913,231,1479,449,1627,28,3.15%
2019-01,חיפה,4000,חיפה,יישוב,4532,2220,2312,1097,3435,1787,4287,81,3.05%
2019-01,חיפה,1247,חריש,יישוב,201,76,125,56,145,20,198,1,4.56%
2019-01,חיפה,2100,טירת כרמל,יישוב,598,306,292,42,556,284,576,16,4.71%
2019-01,חיפה,654,כפר קרע,יישוב,310,147,163,23,287,164,303,6,3.25%
2019-01,חיפה,45,מ.א. אלונה,מועצה איזורית,15,6,9,4,11,0,15,0,1.41%
2019-01,חיפה,12,מ.א. זבולון,מועצה איזורית,175,93,82,29,146,82,168,0,2.83%
2019-01,חיפה,15,מ.א. חוף הכרמל,מועצה איזורית,321,157,164,129,192,42,317,0,2.14%
2019-01,חיפה,14,מ.א. מנשה,מועצה איזורית,232,103,129,71,161,46,230,0,2.67%
2019-01,חיפה,1327,מעלה עירון,יישוב,500,244,256,11,489,369,492,7,7.62%
2019-01,חיפה,2500,נשר,יישוב,332,166,166,82,250,89,320,8,2.53%
2019-01,חיפה,534,עספיא,יישוב,283,122,161,20,263,121,262,1,4.28%
2019-01,חיפה,637,ערערה,יישוב,439,209,230,21,418,259,427,7,4.76%
2019-01,חיפה,537,פוריידיס,יישוב,187,109,78,7,180,29,187,3,3.08%
2019-01,חיפה,7800,פרדס חנה-כרכור,יישוב,547,242,305,186,361,49,540,10,2.53%
2019-01,חיפה,6800,קריית אתא,יישוב,1156,578,578,117,1039,448,1113,23,3.61%
2019-01,חיפה,9500,קריית ביאליק,יישוב,697,308,389,113,584,241,679,13,3.20%
2019-01,חיפה,2300,קריית טבעון,יישוב,170,80,90,73,97,19,170,0,2.02%
2019-01,חיפה,9600,קריית ים,יישוב,960,463,497,100,860,447,916,23,4.35%
2019-01,חיפה,8200,קריית מוצקין,יישוב,739,329,410,148,591,215,721,10,3.11%
2019-01,חיפה,922,רכסים,יישוב,103,47,56,12,91,36,95,0,2.56%
2019-01,ירושלים,472,אבו גוש,יישוב,191,85,106,11,180,139,189,3,5.47%
2019-01,ירושלים,2610,בית שמש,יישוב,940,432,508,79,861,235,911,38,2.45%
2019-01,ירושלים,3000,ירושלים,יישוב,9817,4520,5297,1289,8528,5477,9567,125,3.00%
2019-01,ירושלים,26,מ.א. מטה יהודה,מועצה איזורית,503,245,258,118,385,75,496,0,1.92%
2019-01,ירושלים,1015,מבשרת ציון,יישוב,266,137,129,70,196,79,262,2,2.06%
2019-01,ירושלים,1137,קריית יערים,יישוב,37,16,21,8,29,7,36,0,2.03%
2019-01,תל אביב,2400,אור יהודה,יישוב,559,282,277,59,500,93,538,23,2.80%
2019-01,תל אביב,565,אזור,יישוב,156,73,83,31,125,14,153,1,2.29%
2019-01,תל אביב,6100,בני ברק,יישוב,1411,681,730,97,1314,433,1326,16,2.20%
2019-01,תל אביב,6200,בת ים,יישוב,2314,1140,1174,346,1968,622,2209,51,3.14%
2019-01,תל אביב,6300,גבעתיים,יישוב,663,302,361,318,345,68,651,6,2.05%
2019-01,תל אביב,6400,הרצלייה,יישוב,941,424,517,375,566,24,931,6,1.90%
2019-01,תל אביב,6600,חולון,יישוב,2651,1216,1435,441,2210,424,2595,46,2.58%
2019-01,תל אביב,267,כפר שמריהו,יישוב,8,3,5,4,4,0,8,0,0.96%
2019-01,תל אביב,2620,קריית אונו,יישוב,339,151,188,152,187,27,336,4,1.72%
2019-01,תל אביב,8600,רמת גן,יישוב,1740,812,928,717,1023,197,1712,33,2.10%
2019-01,תל אביב,2650,רמת השרון,יישוב,389,154,235,170,219,8,386,3,1.68%
2019-01,תל אביב,5000,תל אביב -יפו,יישוב,6189,3077,3112,2800,3389,904,6092,94,2.32%
2019-02,אזור יהודה והשומרון,3760,אורנית,יישוב,126,50,76,57,69,2,126,0,2.50%
2019-02,אזור יהודה והשומרון,3750,אלפי מנשה,יישוב,86,36,50,21,65,2,86,2,1.94%
2019-02,אזור יהודה והשומרון,3560,אלקנה,יישוב,38,14,24,22,16,0,38,0,2.06%
2019-02,אזור יהודה והשומרון,3650,אפרת,יישוב,91,45,46,56,35,3,91,0,1.84%
2019-02,אזור יהודה והשומרון,3570,אריאל,יישוב,257,110,147,74,183,14,254,2,2.32%
2019-02,אזור יהודה והשומרון,3574,בית אל,יישוב,29,15,14,6,23,9,29,0,1.17%
2019-02,אזור יהודה והשומרון,3652,בית אריה,יישוב,54,24,30,12,42,3,54,1,1.88%
2019-02,אזור יהודה והשומרון,3780,ביתר עילית,יישוב,459,221,238,19,440,128,450,2,2.89%
2019-02,אזור יהודה והשומרון,3730,גבעת זאב,יישוב,186,91,95,50,136,34,184,2,2.27%
2019-02,אזור יהודה והשומרון,3769,הר אדר,יישוב,45,24,21,19,26,5,44,0,2.00%
2019-02,אזור יהודה והשומרון,76,מ.א. גוש עציון,מועצה איזורית,202,102,100,97,105,18,196,0,1.93%
2019-02,אזור יהודה והשומרון,78,מ.א. הר חברון,מועצה איזורית,66,34,32,27,39,3,66,0,1.66%
2019-02,אזור יהודה והשומרון,74,מ.א. מגילות ים המלח,מועצה איזורית,26,12,14,8,18,0,26,0,2.82%
2019-02,אזור יהודה והשומרון,73,מ.א. מטה בנימין,מועצה איזורית,636,297,339,213,423,90,631,0,2.22%
2019-02,אזור יהודה והשומרון,75,מ.א. ערבות הירדן,מועצה איזורית,68,35,33,13,55,8,66,0,2.57%
2019-02,אזור יהודה והשומרון,72,מ.א. שומרון,מועצה איזורית,435,207,228,185,250,13,434,0,2.29%
2019-02,אזור יהודה והשומרון,3797,מודיעין עילית,יישוב,430,173,257,34,396,28,429,0,2.68%
2019-02,אזור יהודה והשומרון,3616,מעלה אדומים,יישוב,512,253,259,93,419,97,509,5,2.44%
2019-02,אזור יהודה והשומרון,3608,מעלה אפרים,יישוב,39,14,25,2,37,8,38,0,4.70%
2019-02,אזור יהודה והשומרון,3660,עמנואל,יישוב,39,18,21,1,38,12,38,0,2.81%
2019-02,אזור יהודה והשומרון,3557,קדומים,יישוב,32,19,13,15,17,2,32,1,1.60%
2019-02,אזור יהודה והשומרון,3611,קריית ארבע,יישוב,84,39,45,21,63,24,82,0,2.44%
2019-02,אזור יהודה והשומרון,3640,קרני שומרון,יישוב,76,33,43,32,44,2,75,2,1.85%
2019-02,הדרום,31,אופקים,יישוב,748,307,441,46,702,333,725,28,5.04%
2019-02,הדרום,2600,אילת,יישוב,1078,533,545,63,1015,235,1040,13,3.00%
2019-02,הדרום,70,אשדוד,יישוב,4927,2149,2778,663,4264,1831,4725,39,4.21%
2019-02,הדרום,7100,אשקלון,יישוב,3215,1497,1718,382,2833,1251,2978,20,4.02%
2019-02,הדרום,9000,באר שבע,יישוב,4947,2355,2592,774,4173,2375,4682,40,4.38%
2019-02,הדרום,2200,דימונה,יישוב,1507,721,786,75,1432,917,1434,18,7.38%
2019-02,הדרום,1303,חורה,יישוב,463,209,254,5,458,392,437,1,9.17%
2019-02,הדרום,831,ירוחם,יישוב,377,183,194,26,351,194,357,17,6.96%
2019-02,הדרום,1059,כסיפה,יישוב,979,389,590,4,975,880,968,6,17.77%
2019-02,הדרום,1271,להבים,יישוב,59,27,32,34,25,2,59,0,1.67%
2019-02,הדרום,1060,לקיה,יישוב,562,261,301,2,560,474,526,2,10.85%
2019-02,הדרום,69,מ.א. אל קסום,מועצה איזורית,787,327,460,8,779,663,762,0,22.33%
2019-02,הדרום,38,מ.א. אשכול,מועצה איזורית,133,55,78,40,93,7,133,0,1.90%
2019-02,הדרום,33,מ.א. באר טוביה,מועצה איזורית,267,129,138,58,209,42,266,0,2.35%
2019-02,הדרום,41,מ.א. בני שמעון,מועצה איזורית,78,31,47,30,48,11,77,0,1.59%
2019-02,הדרום,54,מ.א. הערבה התיכונה,מועצה איזורית,21,12,9,6,15,0,21,0,1.10%
2019-02,הדרום,53,מ.א. חבל אילות,מועצה איזורית,28,10,18,7,21,1,28,3,1.13%
2019-02,הדרום,36,מ.א. חוף אשקלון,מועצה איזורית,224,117,107,43,181,34,217,0,2.50%
2019-02,הדרום,35,מ.א. יואב,מועצה איזורית,109,47,62,41,68,14,108,0,2.64%
2019-02,הדרום,50,מ.א. לכיש,מועצה איזורית,174,86,88,30,144,37,173,0,3.11%
2019-02,הדרום,42,מ.א. מרחבים,מועצה איזורית,167,73,94,32,135,30,166,0,2.64%
2019-02,הדרום,68,מ.א. נווה מדבר,מועצה איזורית,135,54,81,5,130,92,132,0,6.99%
2019-02,הדרום,48,מ.א. רמת נגב,מועצה איזורית,254,125,129,21,233,193,246,0,7.37%
2019-02,הדרום,39,מ.א. שדות נגב,מועצה איזורית,108,55,53,25,83,28,105,0,2.16%
2019-02,הדרום,37,מ.א. שער הנגב,מועצה איזורית,115,59,56,42,73,52,110,0,2.75%
2019-02,הדרום,34,מ.א. שפיר,מועצה איזורית,164,66,98,25,139,37,164,0,3.29%
2019-02,הדרום,51,מ.א. תמר,מועצה איזורית,17,6,11,4,13,2,17,0,2.61%
2019-02,הדרום,1268,מיתר,יישוב,67,23,44,35,32,5,67,0,1.36%
2019-02,הדרום,99,מצפה רמון,יישוב,199,86,113,17,182,129,191,4,6.93%
2019-02,הדרום,246,נתיבות,יישוב,828,363,465,65,763,347,784,39,4.79%
2019-02,הדרום,666,עומר,יישוב,52,23,29,25,27,4,52,0,1.23%
2019-02,הדרום,2560,ערד,יישוב,614,291,323,74,540,270,582,31,4.59%
2019-02,הדרום,1192,ערערה-בנגב,יישוב,969,419,550,21,948,855,946,3,18.47%
2019-02,הדרום,2630,קריית גת,יישוב,1578,692,886,125,1453,596,1525,21,5.20%
2019-02,הדרום,1034,קריית מלאכי,יישוב,701,311,390,25,676,307,673,3,5.44%
2019-02,הדרום,1161,רהט,יישוב,1828,767,1061,10,1818,1370,1795,32,8.10%
2019-02,הדרום,1286,שגב-שלום,יישוב,301,121,180,3,298,230,291,2,9.07%
2019-02,הדרום,1031,שדרות,יישוב,880,416,464,58,822,437,803,10,5.42%
2019-02,הדרום,1054,תל שבע,יישוב,650,303,347,8,642,552,609,0,10.68%
2019-02,המרכז,1066,"בני עי""ש",יישוב,154,75,79,20,134,29,148,0,3.67%
2019-02,המרכז,182,אבן יהודה,יישוב,177,79,98,74,103,12,177,0,2.52%
2019-02,המרכז,41,אליכין,יישוב,62,30,32,17,45,11,59,0,3.00%
2019-02,המרכז,1309,אלעד,יישוב,373,181,192,36,337,22,365,1,2.56%
2019-02,המרכז,2530,באר יעקב,יישוב,346,130,216,102,244,26,344,1,2.65%
2019-02,המרכז,466,בית דגן,יישוב,88,50,38,21,67,19,85,0,2.28%
2019-02,המרכז,681,גבעת שמואל,יישוב,276,130,146,115,161,29,271,0,2.16%
2019-02,המרכז,2550,גדרה,יישוב,301,141,160,67,234,55,297,2,2.29%
2019-02,המרכז,627,ג'לג'וליה,יישוב,67,35,32,5,62,28,65,2,1.52%
2019-02,המרכז,166,גן יבנה,יישוב,338,148,190,67,271,46,334,1,2.62%
2019-02,המרכז,229,גני תקווה,יישוב,198,90,108,78,120,22,198,0,2.05%
2019-02,המרכז,9700,הוד השרון,יישוב,657,262,395,313,344,14,655,4,2.00%
2019-02,המרכז,1290,זמר,יישוב,106,46,60,6,100,62,104,1,3.19%
2019-02,המרכז,2730,טייבה,יישוב,833,425,408,25,808,514,716,21,3.71%
2019-02,המרכז,2720,טירה,יישוב,138,79,59,17,121,19,134,0,1.07%
2019-02,המרכז,2660,יבנה,יישוב,618,279,339,140,478,122,611,5,2.43%
2019-02,המרכז,9400,יהוד,יישוב,377,174,203,125,252,28,373,4,2.28%
2019-02,המרכז,1224,כוכב יאיר,יישוב,107,45,62,65,42,0,107,0,1.92%
2019-02,המרכז,633,כפר ברא,יישוב,15,11,4,2,13,2,15,0,0.93%
2019-02,המרכז,168,כפר יונה,יישוב,308,140,168,65,243,41,305,2,2.60%
2019-02,המרכז,6900,כפר סבא,יישוב,1171,539,632,478,693,49,1162,7,2.19%
2019-02,המרכז,634,כפר קאסם,יישוב,186,94,92,11,175,71,177,0,1.72%
2019-02,המרכז,7000,לוד,יישוב,1566,771,795,154,1412,635,1541,4,4.17%
2019-02,המרכז,28,מ.א. ברנר,מועצה איזורית,79,44,35,38,41,5,77,0,1.90%
2019-02,המרכז,32,מ.א. גדרות,מועצה איזורית,50,22,28,27,23,4,49,0,1.99%
2019-02,המרכז,30,מ.א. גזר,מועצה איזורית,258,124,134,92,166,20,258,0,1.92%
2019-02,המרכז,27,מ.א. גן רווה,מועצה איזורית,61,26,35,36,25,3,60,0,2.00%
2019-02,המרכז,20,מ.א. דרום השרון,מועצה איזורית,366,162,204,161,205,10,364,0,2.25%
2019-02,המרכז,29,מ.א. חבל יבנה,מועצה איזורית,43,26,17,14,29,1,43,0,1.64%
2019-02,המרכז,25,מ.א. חבל מודיעין,מועצה איזורית,238,119,119,79,159,18,236,0,2.15%
2019-02,המרכז,19,מ.א. חוף השרון,מועצה איזורית,120,44,76,66,54,4,119,0,2.14%
2019-02,המרכז,18,מ.א. לב השרון,מועצה איזורית,276,132,144,84,192,17,275,0,2.47%
2019-02,המרכז,31,מ.א. נחל שורק,מועצה איזורית,65,32,33,21,44,6,64,28,1.52%
2019-02,המרכז,16,מ.א. עמק חפר,מועצה איזורית,409,188,221,155,254,15,407,0,2.07%
2019-02,המרכז,40,מ.א. שדות דן,מועצה איזורית,144,83,61,42,102,10,144,0,2.23%
2019-02,המרכז,1200,מודיעין-מכבים-רעות*,יישוב,849,360,489,393,456,33,844,4,1.83%
2019-02,המרכז,28,מזכרת בתיה,יישוב,148,63,85,49,99,14,146,0,1.80%
2019-02,המרכז,7200,נס ציונה,יישוב,575,258,317,160,415,100,565,1,2.28%
2019-02,המרכז,7400,נתניה,יישוב,3743,1861,1882,560,3183,860,3685,9,3.39%
2019-02,המרכז,587,סביון*,יישוב,20,8,12,10,10,0,20,0,0.96%
2019-02,המרכז,171,פרדסייה,יישוב,72,30,42,24,48,1,72,0,1.92%
2019-02,המרכז,7900,פתח תקווה,יישוב,3581,1648,1933,789,2792,640,3506,27,2.71%
2019-02,המרכז,195,קדימה-צורן,יישוב,302,117,185,114,188,15,300,0,2.55%
2019-02,המרכז,638,קלנסווה,יישוב,286,153,133,16,270,161,253,6,2.61%
2019-02,המרכז,469,קריית עקרון,יישוב,213,120,93,18,195,74,208,2,3.42%
2019-02,המרכז,2640,ראש העין,יישוב,827,388,439,195,632,88,822,5,2.65%
2019-02,המרכז,8300,ראשון לציון,יישוב,3839,1690,2149,906,2933,646,3812,10,2.71%
2019-02,המרכז,8400,רחובות,יישוב,2033,916,1117,519,1514,512,1967,6,2.77%
2019-02,המרכז,8500,רמלה,יישוב,1324,650,674,92,1232,422,1287,13,3.32%
2019-02,המרכז,8700,רעננה,יישוב,767,340,427,379,388,31,761,4,2.01%
2019-02,המרכז,1304,שוהם,יישוב,193,77,116,92,101,5,193,3,1.59%
2019-02,המרכז,154,תל מונד,יישוב,132,58,74,50,82,11,132,0,1.91%
2019-02,הצפון,473,אבו סנאן,יישוב,499,230,269,13,486,324,493,0,7.81%
2019-02,הצפון,478,אכסאל,יישוב,406,199,207,18,388,314,406,0,6.36%
2019-02,הצפון,529,אעבלין,יישוב,377,167,210,24,353,262,371,0,5.98%
2019-02,הצפון,482,בועיינה-נוג'ידאת,יישוב,230,119,111,15,215,151,225,1,5.21%
2019-02,הצפון,4001,בוקעאתא,יישוב,296,127,169,7,289,198,291,0,9.70%
2019-02,הצפון,998,ביר אל-מכסור,יישוב,251,114,137,5,246,165,249,0,5.99%
2019-02,הצפון,480,בית ג'ן,יישוב,367,109,258,17,350,209,355,1,5.91%
2019-02,הצפון,9200,בית שאן,יישוב,596,277,319,31,565,269,578,7,5.51%
2019-02,הצפון,944,בסמת טבעון,יישוב,160,82,78,6,154,85,145,0,4.01%
2019-02,הצפון,483,בענה,יישוב,318,148,170,22,296,239,305,0,7.83%
2019-02,הצפון,1292,ג'דיידה-מכר,יישוב,962,450,512,10,952,672,939,1,9.15%
2019-02,הצפון,485,ג'ולס,יישוב,188,57,131,2,186,75,186,1,5.64%
2019-02,הצפון,487,ג'ש (גוש חלב),יישוב,48,27,21,5,43,19,48,0,2.80%
2019-02,הצפון,489,דבורייה,יישוב,214,101,113,9,205,147,212,0,4.50%
2019-02,הצפון,490,דייר אל-אסד,יישוב,323,148,175,24,299,220,314,0,5.45%
2019-02,הצפון,492,דייר חנא,יישוב,469,225,244,15,454,297,469,3,8.88%
2019-02,הצפון,975,זרזיר,יישוב,169,87,82,5,164,83,166,1,4.65%
2019-02,הצפון,496,חורפיש,יישוב,93,44,49,12,81,43,87,0,2.86%
2019-02,הצפון,2034,חצור הגלילית,יישוב,225,85,140,21,204,92,215,2,4.40%
2019-02,הצפון,6700,טבריה,יישוב,1287,647,640,94,1193,561,1174,20,5.25%
2019-02,הצפון,962,טובא-זנגרייה,יישוב,263,111,152,6,257,148,256,1,7.57%
2019-02,הצפון,498,טורעאן,יישוב,316,149,167,24,292,216,311,0,4.92%
2019-02,הצפון,8900,טמרה,יישוב,1119,547,572,28,1091,819,1089,0,7.03%
2019-02,הצפון,1295,יאנוח-ג'ת,יישוב,122,46,76,8,114,54,117,1,3.65%
2019-02,הצפון,46,יבנאל,יישוב,88,43,45,6,82,41,77,0,4.84%
2019-02,הצפון,29,יסוד המעלה,יישוב,19,8,11,8,11,2,19,0,2.16%
2019-02,הצפון,499,יפיע,יישוב,477,221,256,28,449,294,474,2,5.47%
2019-02,הצפון,240,יקנעם עילית,יישוב,463,201,262,108,355,81,455,17,3.51%
2019-02,הצפון,502,ירכא,יישוב,354,157,197,1,353,204,350,0,4.99%
2019-02,הצפון,504,כאבול,יישוב,367,189,178,10,357,283,351,0,6.51%
2019-02,הצפון,505,כאוכב אבו אל-היג'א,יישוב,158,68,90,6,152,125,158,1,8.43%
2019-02,הצפון,1296,כסרא-סמיע,יישוב,165,57,108,6,159,81,156,3,4.02%
2019-02,הצפון,978,כעביה-טבאש-חג'אג'רה,יישוב,130,51,79,9,121,81,129,1,5.03%
2019-02,הצפון,1263,כפר ורדים,יישוב,57,28,29,25,32,4,54,2,1.74%
2019-02,הצפון,507,כפר יאסיף,יישוב,349,155,194,9,340,196,343,0,6.32%
2019-02,הצפון,508,כפר כמא,יישוב,49,23,26,4,45,10,46,0,2.65%
2019-02,הצפון,509,כפר כנא,יישוב,667,344,323,38,629,505,632,0,6.53%
2019-02,הצפון,510,כפר מנדא,יישוב,584,306,278,15,569,418,581,0,7.23%
2019-02,הצפון,47,כפר תבור,יישוב,45,16,29,12,33,3,42,1,1.77%
2019-02,הצפון,1139,כרמיאל,יישוב,1354,596,758,294,1060,606,1270,22,4.89%
2019-02,הצפון,65,מ.א. אל-בטוף,מועצה איזורית,215,111,104,14,201,137,203,2,6.21%
2019-02,הצפון,66,מ.א. בוסתן אל-מרג,מועצה איזורית,22,6,16,2,20,17,22,1,0.63%
2019-02,הצפון,71,מ.א. גולן,מועצה איזורית,239,105,134,74,165,17,237,0,2.70%
2019-02,הצפון,8,מ.א. הגלבוע,מועצה איזורית,513,221,292,72,441,238,505,0,3.58%
2019-02,הצפון,1,מ.א. הגליל העליון,מועצה איזורית,233,100,133,104,129,9,230,0,2.57%
2019-02,הצפון,3,מ.א. הגליל התחתון,מועצה איזורית,117,46,71,45,72,10,113,0,1.88%
2019-02,הצפון,55,מ.א. מבואות החרמון,מועצה איזורית,107,53,54,26,81,19,107,0,2.66%
2019-02,הצפון,13,מ.א. מגידו,מועצה איזורית,99,37,62,40,59,8,99,0,1.75%
2019-02,הצפון,4,מ.א. מטה אשר,מועצה איזורית,414,193,221,84,330,121,407,0,2.87%
2019-02,הצפון,52,מ.א. מעלה יוסף,מועצה איזורית,186,79,107,29,157,35,182,0,3.17%
2019-02,הצפון,2,מ.א. מרום הגליל,מועצה איזורית,261,112,149,37,224,91,259,0,3.63%
2019-02,הצפון,56,מ.א. משגב,מועצה איזורית,555,236,319,160,395,233,541,0,3.83%
2019-02,הצפון,6,מ.א. עמק הירדן,מועצה איזורית,183,92,91,58,125,17,172,0,2.53%
2019-02,הצפון,7,מ.א. עמק המעיינות,מועצה איזורית,223,101,122,62,161,32,220,0,3.36%
2019-02,הצפון,9,מ.א. עמק יזרעאל,מועצה איזורית,404,155,249,209,195,38,400,0,2.04%
2019-02,הצפון,481,מגאר,יישוב,863,377,486,19,844,604,850,6,8.08%
2019-02,הצפון,516,מג'ד אל-כרום,יישוב,460,205,255,11,449,278,449,0,6.06%
2019-02,הצפון,65,מגדל,יישוב,45,22,23,7,38,7,43,2,4.27%
2019-02,הצפון,874,מגדל העמק,יישוב,641,299,342,64,577,206,606,27,4.45%
2019-02,הצפון,4201,מג'דל שמס,יישוב,331,127,204,13,318,211,321,1,6.12%
2019-02,הצפון,517,מזרעה,יישוב,133,61,72,2,131,86,129,0,6.01%
2019-02,הצפון,43,מטולה,יישוב,25,14,11,3,22,5,23,1,2.28%
2019-02,הצפון,4203,מסעדה,יישוב,147,57,90,8,139,103,141,0,7.86%
2019-02,הצפון,518,מעיליא,יישוב,50,24,26,7,43,19,49,2,2.86%
2019-02,הצפון,1063,מעלות-תרשיחא,יישוב,630,291,339,86,544,277,601,21,4.95%
2019-02,הצפון,520,משהד,יישוב,148,70,78,5,143,110,141,0,3.95%
2019-02,הצפון,9100,נהרייה,יישוב,1545,759,786,186,1359,754,1461,5,4.62%
2019-02,הצפון,522,נחף,יישוב,362,172,190,10,352,249,356,0,6.33%
2019-02,הצפון,7300,נצרת,יישוב,2343,1123,1220,128,2215,1566,2324,15,6.32%
2019-02,הצפון,1061,נצרת עילית,יישוב,1221,570,651,128,1093,495,1118,16,4.77%
2019-02,הצפון,525,סאג'ור,יישוב,118,47,71,5,113,66,115,1,5.25%
2019-02,הצפון,7500,סח'נין,יישוב,1443,675,768,57,1386,1056,1423,6,9.25%
2019-02,הצפון,4501,ע'ג'ר,יישוב,79,31,48,6,73,39,78,0,6.51%
2019-02,הצפון,530,עיילבון,יישוב,137,70,67,10,127,70,135,1,4.66%
2019-02,הצפון,511,עילוט,יישוב,234,106,128,4,230,163,234,0,7.30%
2019-02,הצפון,532,עין מאהל,יישוב,327,178,149,13,314,221,321,0,5.48%
2019-02,הצפון,4502,עין קנייא,יישוב,97,45,52,2,95,68,95,1,8.64%
2019-02,הצפון,7600,עכו,יישוב,2379,1074,1305,153,2226,1622,2279,1,8.44%
2019-02,הצפון,7700,עפולה,יישוב,1399,589,810,206,1193,466,1361,5,4.95%
2019-02,הצפון,531,עראבה,יישוב,1006,471,535,32,974,772,996,5,8.92%
2019-02,הצפון,535,פסוטה,יישוב,70,33,37,10,60,33,67,2,3.75%
2019-02,הצפון,536,פקיעין (בוקייעה),יישוב,105,56,49,7,98,57,104,1,3.47%
2019-02,הצפון,8000,צפת,יישוב,950,474,476,106,844,538,910,11,6.51%
2019-02,הצפון,4100,קצרין,יישוב,182,84,98,26,156,57,180,1,4.48%
2019-02,הצפון,2800,קריית שמונה,יישוב,555,260,295,68,487,182,539,5,4.18%
2019-02,הצפון,543,ראמה,יישוב,223,100,123,19,204,148,213,0,5.19%
2019-02,הצפון,26,ראש פינה,יישוב,45,15,30,9,36,21,44,0,2.67%
2019-02,הצפון,542,ריינה,יישוב,418,224,194,17,401,276,402,0,5.43%
2019-02,הצפון,122,רמת ישי,יישוב,98,35,63,43,55,16,97,1,2.34%
2019-02,הצפון,913,שבלי - אום אל-גנם,יישוב,167,71,96,5,162,80,163,0,5.72%
2019-02,הצפון,812,שלומי,יישוב,166,71,95,13,153,73,163,0,4.49%
2019-02,הצפון,538,שעב,יישוב,326,149,177,6,320,246,324,1,9.73%
2019-02,הצפון,8800,שפרעם,יישוב,1226,590,636,63,1163,811,1181,0,6.05%
2019-02,חיפה,1326,"בסמ""ה",יישוב,290,144,146,8,282,196,285,3,6.39%
2019-02,חיפה,2710,אום אל-פחם,יישוב,2162,1010,1152,29,2133,1618,2107,40,9.13%
2019-02,חיפה,1020,אור עקיבא,יישוב,480,206,274,69,411,97,474,3,4.48%
2019-02,חיפה,6000,באקה אל-גרביה,יישוב,506,261,245,21,485,264,495,11,3.80%
2019-02,חיפה,9800,בנימינה-גבעת עדה*,יישוב,184,73,111,95,89,15,183,0,2.43%
2019-02,חיפה,541,ג'סר א-זרקא,יישוב,167,99,68,3,164,37,164,0,2.58%
2019-02,חיפה,628,ג'ת,יישוב,192,112,80,14,178,85,191,11,3.30%
2019-02,חיפה,494,דאלית אל-כרמל,יישוב,409,164,245,16,393,192,385,0,4.39%
2019-02,חיפה,9300,זכרון יעקב,יישוב,248,96,152,123,125,15,246,0,2.16%
2019-02,חיפה,6500,חדרה,יישוב,1964,939,1025,290,1674,526,1871,4,3.60%
2019-02,חיפה,4000,חיפה,יישוב,5225,2528,2697,1325,3900,1968,4959,13,3.51%
2019-02,חיפה,1247,חריש,יישוב,231,85,146,58,173,23,227,2,5.19%
2019-02,חיפה,2100,טירת כרמל,יישוב,647,340,307,47,600,285,628,16,5.11%
2019-02,חיפה,654,כפר קרע,יישוב,331,159,172,31,300,171,322,4,3.44%
2019-02,חיפה,45,מ.א. אלונה,מועצה איזורית,19,8,11,5,14,0,19,0,1.78%
2019-02,חיפה,12,מ.א. זבולון,מועצה איזורית,216,116,100,38,178,97,206,0,3.47%
2019-02,חיפה,15,מ.א. חוף הכרמל,מועצה איזורית,353,167,186,132,221,50,347,0,2.34%
2019-02,חיפה,14,מ.א. מנשה,מועצה איזורית,265,116,149,79,186,49,263,0,3.06%
2019-02,חיפה,1327,מעלה עירון,יישוב,537,259,278,14,523,391,528,4,8.13%
2019-02,חיפה,2500,נשר,יישוב,372,181,191,96,276,98,361,1,2.85%
2019-02,חיפה,534,עספיא,יישוב,304,133,171,23,281,131,285,0,4.64%
2019-02,חיפה,637,ערערה,יישוב,453,216,237,24,429,262,441,7,4.91%
2019-02,חיפה,537,פוריידיס,יישוב,188,109,79,7,181,30,188,0,3.10%
2019-02,חיפה,7800,פרדס חנה-כרכור,יישוב,614,282,332,209,405,63,606,2,2.83%
2019-02,חיפה,6800,קריית אתא,יישוב,1281,638,643,144,1137,470,1246,2,4.03%
2019-02,חיפה,9500,קריית ביאליק,יישוב,772,336,436,120,652,259,756,3,3.55%
2019-02,חיפה,2300,קריית טבעון,יישוב,198,93,105,88,110,21,198,0,2.35%
2019-02,חיפה,9600,קריית ים,יישוב,1076,534,542,119,957,482,1030,2,4.87%
2019-02,חיפה,8200,קריית מוצקין,יישוב,852,387,465,172,680,226,835,2,3.58%
2019-02,חיפה,922,רכסים,יישוב,105,47,58,10,95,37,101,0,2.71%
2019-02,ירושלים,472,אבו גוש,יישוב,209,103,106,11,198,150,207,0,5.96%
2019-02,ירושלים,2610,בית שמש,יישוב,1038,498,540,98,940,278,1008,35,2.70%
2019-02,ירושלים,3000,ירושלים,יישוב,10562,4902,5660,1484,9078,5703,10332,49,3.23%
2019-02,ירושלים,26,מ.א. מטה יהודה,מועצה איזורית,574,282,292,144,430,87,568,0,2.20%
2019-02,ירושלים,1015,מבשרת ציון,יישוב,307,155,152,80,227,83,303,0,2.37%
2019-02,ירושלים,1137,קריית יערים,יישוב,44,20,24,10,34,11,44,0,2.47%
2019-02,תל אביב,2400,אור יהודה,יישוב,625,310,315,69,556,107,601,7,3.12%
2019-02,תל אביב,565,אזור,יישוב,191,91,100,38,153,14,188,0,2.80%
2019-02,תל אביב,6100,בני ברק,יישוב,1532,724,808,113,1419,457,1439,1,2.38%
2019-02,תל אביב,6200,בת ים,יישוב,2547,1229,1318,372,2175,670,2457,21,3.48%
2019-02,תל אביב,6300,גבעתיים,יישוב,761,332,429,393,368,78,752,2,2.36%
2019-02,תל אביב,6400,הרצלייה,יישוב,1031,451,580,418,613,30,1026,1,2.09%
2019-02,תל אביב,6600,חולון,יישוב,2995,1346,1649,536,2459,460,2940,33,2.91%
2019-02,תל אביב,267,כפר שמריהו,יישוב,12,6,6,6,6,0,12,0,1.43%
2019-02,תל אביב,2620,קריית אונו,יישוב,417,187,230,210,207,33,415,1,2.12%
2019-02,תל אביב,8600,רמת גן,יישוב,2072,942,1130,878,1194,231,2045,9,2.50%
2019-02,תל אביב,2650,רמת השרון,יישוב,434,171,263,204,230,7,431,2,1.87%
2019-02,תל אביב,5000,תל אביב -יפו,יישוב,7118,3513,3605,3302,3816,1019,7023,26,2.66%
2019-03,אזור יהודה והשומרון,3760,אורנית,יישוב,114,48,66,49,65,3,114,0,2.26%
2019-03,אזור יהודה והשומרון,3750,אלפי מנשה,יישוב,91,40,51,23,68,2,91,1,2.05%
2019-03,אזור יהודה והשומרון,3560,אלקנה,יישוב,36,17,19,21,15,1,36,0,1.95%
2019-03,אזור יהודה והשומרון,3650,אפרת,יישוב,87,41,46,51,36,5,87,1,1.76%
2019-03,אזור יהודה והשומרון,3570,אריאל,יישוב,276,118,158,73,203,15,271,10,2.47%
2019-03,אזור יהודה והשומרון,3574,בית אל,יישוב,34,20,14,10,24,10,33,0,1.33%
2019-03,אזור יהודה והשומרון,3652,בית אריה,יישוב,55,25,30,15,40,2,55,0,1.91%
2019-03,אזור יהודה והשומרון,3780,ביתר עילית,יישוב,487,225,262,21,466,142,473,2,3.04%
2019-03,אזור יהודה והשומרון,3730,גבעת זאב,יישוב,195,97,98,44,151,37,192,1,2.36%
2019-03,אזור יהודה והשומרון,3769,הר אדר,יישוב,46,23,23,18,28,5,46,1,2.09%
2019-03,אזור יהודה והשומרון,76,מ.א. גוש עציון,מועצה איזורית,201,101,100,96,105,19,197,0,1.94%
2019-03,אזור יהודה והשומרון,78,מ.א. הר חברון,מועצה איזורית,72,33,39,32,40,3,71,0,1.79%
2019-03,אזור יהודה והשומרון,74,מ.א. מגילות ים המלח,מועצה איזורית,23,10,13,8,15,0,23,0,2.50%
2019-03,אזור יהודה והשומרון,73,מ.א. מטה בנימין,מועצה איזורית,637,304,333,220,417,82,631,0,2.22%
2019-03,אזור יהודה והשומרון,75,מ.א. ערבות הירדן,מועצה איזורית,66,34,32,12,54,8,64,0,2.49%
2019-03,אזור יהודה והשומרון,72,מ.א. שומרון,מועצה איזורית,429,201,228,187,242,12,428,0,2.26%
2019-03,אזור יהודה והשומרון,3797,מודיעין עילית,יישוב,419,159,260,34,385,27,415,1,2.59%
2019-03,אזור יהודה והשומרון,3616,מעלה אדומים,יישוב,572,265,307,95,477,97,567,14,2.71%
2019-03,אזור יהודה והשומרון,3608,מעלה אפרים,יישוב,30,11,19,1,29,8,29,0,3.63%
2019-03,אזור יהודה והשומרון,3660,עמנואל,יישוב,43,19,24,1,42,12,42,0,3.10%
2019-03,אזור יהודה והשומרון,3557,קדומים,יישוב,35,20,15,19,16,3,34,2,1.70%
2019-03,אזור יהודה והשומרון,3611,קריית ארבע,יישוב,94,46,48,20,74,33,89,5,2.64%
2019-03,אזור יהודה והשומרון,3640,קרני שומרון,יישוב,79,37,42,32,47,4,78,1,1.92%
2019-03,הדרום,31,אופקים,יישוב,826,344,482,52,774,338,790,23,5.47%
2019-03,הדרום,2600,אילת,יישוב,1033,520,513,64,969,205,996,49,2.88%
2019-03,הדרום,70,אשדוד,יישוב,4966,2191,2775,645,4321,1858,4718,84,4.21%
2019-03,הדרום,7100,אשקלון,יישוב,3326,1523,1803,370,2956,1302,3023,55,4.08%
2019-03,הדרום,9000,באר שבע,יישוב,5192,2468,2724,776,4416,2447,4856,102,4.53%
2019-03,הדרום,2200,דימונה,יישוב,1492,701,791,75,1417,916,1409,26,7.26%
2019-03,הדרום,1303,חורה,יישוב,500,230,270,2,498,414,468,2,9.76%
2019-03,הדרום,831,ירוחם,יישוב,378,189,189,22,356,194,354,23,6.91%
2019-03,הדרום,1059,כסיפה,יישוב,1023,416,607,6,1017,896,1012,2,18.43%
2019-03,הדרום,1271,להבים,יישוב,52,25,27,31,21,2,52,0,1.47%
2019-03,הדרום,1060,לקיה,יישוב,618,300,318,4,614,503,564,0,11.54%
2019-03,הדרום,69,מ.א. אל קסום,מועצה איזורית,866,370,496,12,854,717,816,0,23.92%
2019-03,הדרום,38,מ.א. אשכול,מועצה איזורית,121,50,71,32,89,6,121,0,1.73%
2019-03,הדרום,33,מ.א. באר טוביה,מועצה איזורית,266,129,137,57,209,42,260,0,2.30%
2019-03,הדרום,41,מ.א. בני שמעון,מועצה איזורית,83,31,52,33,50,11,81,0,1.67%
2019-03,הדרום,54,מ.א. הערבה התיכונה,מועצה איזורית,26,14,12,6,20,1,25,0,1.31%
2019-03,הדרום,53,מ.א. חבל אילות,מועצה איזורית,27,11,16,3,24,0,27,0,1.09%
2019-03,הדרום,36,מ.א. חוף אשקלון,מועצה איזורית,227,116,111,41,186,33,220,0,2.53%
2019-03,הדרום,35,מ.א. יואב,מועצה איזורית,97,38,59,38,59,10,95,0,2.32%
2019-03,הדרום,50,מ.א. לכיש,מועצה איזורית,176,90,86,29,147,41,173,0,3.11%
2019-03,הדרום,42,מ.א. מרחבים,מועצה איזורית,147,65,82,29,118,25,145,0,2.30%
2019-03,הדרום,68,מ.א. נווה מדבר,מועצה איזורית,141,58,83,5,136,99,137,0,7.25%
2019-03,הדרום,48,מ.א. רמת נגב,מועצה איזורית,285,150,135,20,265,220,277,0,8.31%
2019-03,הדרום,39,מ.א. שדות נגב,מועצה איזורית,112,53,59,19,93,28,109,0,2.24%
2019-03,הדרום,37,מ.א. שער הנגב,מועצה איזורית,84,37,47,30,54,31,80,0,2.00%
2019-03,הדרום,34,מ.א. שפיר,מועצה איזורית,164,68,96,30,134,37,164,0,3.29%
2019-03,הדרום,51,מ.א. תמר,מועצה איזורית,16,6,10,4,12,2,16,0,2.46%
2019-03,הדרום,1268,מיתר,יישוב,68,25,43,33,35,8,68,1,1.38%
2019-03,הדרום,99,מצפה רמון,יישוב,203,82,121,14,189,132,194,11,7.03%
2019-03,הדרום,246,נתיבות,יישוב,839,370,469,67,772,335,791,28,4.83%
2019-03,הדרום,666,עומר,יישוב,54,25,29,30,24,6,54,0,1.28%
2019-03,הדרום,2560,ערד,יישוב,651,326,325,71,580,251,612,32,4.81%
2019-03,הדרום,1192,ערערה-בנגב,יישוב,996,430,566,23,973,898,963,7,18.74%
2019-03,הדרום,2630,קריית גת,יישוב,1615,713,902,135,1480,596,1549,27,5.27%
2019-03,הדרום,1034,קריית מלאכי,יישוב,803,381,422,30,773,329,756,28,6.08%
2019-03,הדרום,1161,רהט,יישוב,2059,897,1162,14,2045,1397,2017,33,9.01%
2019-03,הדרום,1286,שגב-שלום,יישוב,336,145,191,4,332,252,316,5,9.78%
2019-03,הדרום,1031,שדרות,יישוב,910,441,469,63,847,430,825,24,5.56%
2019-03,הדרום,1054,תל שבע,יישוב,755,360,395,10,745,628,675,7,11.71%
2019-03,המרכז,1066,"בני עי""ש",יישוב,143,71,72,18,125,27,135,2,3.36%
2019-03,המרכז,182,אבן יהודה,יישוב,169,77,92,70,99,13,169,1,2.41%
2019-03,המרכז,41,אליכין,יישוב,54,27,27,13,41,10,51,0,2.60%
2019-03,המרכז,1309,אלעד,יישוב,364,180,184,36,328,27,350,3,2.46%
2019-03,המרכז,2530,באר יעקב,יישוב,362,136,226,105,257,29,358,1,2.76%
2019-03,המרכז,466,בית דגן,יישוב,89,49,40,20,69,18,89,1,2.39%
2019-03,המרכז,681,גבעת שמואל,יישוב,273,121,152,114,159,29,268,0,2.14%
2019-03,המרכז,2550,גדרה,יישוב,304,141,163,64,240,47,298,11,2.30%
2019-03,המרכז,627,ג'לג'וליה,יישוב,84,43,41,4,80,41,75,2,1.75%
2019-03,המרכז,166,גן יבנה,יישוב,332,149,183,69,263,42,327,3,2.57%
2019-03,המרכז,229,גני תקווה,יישוב,194,87,107,75,119,22,192,0,1.99%
2019-03,המרכז,9700,הוד השרון,יישוב,654,265,389,307,347,16,645,5,1.97%
2019-03,המרכז,1290,זמר,יישוב,115,54,61,8,107,57,114,1,3.48%
2019-03,המרכז,2730,טייבה,יישוב,848,445,403,26,822,504,723,26,3.75%
2019-03,המרכז,2720,טירה,יישוב,154,98,56,19,135,21,147,8,1.18%
2019-03,המרכז,2660,יבנה,יישוב,667,321,346,128,539,120,658,28,2.61%
2019-03,המרכז,9400,יהוד,יישוב,388,192,196,123,265,31,384,10,2.35%
2019-03,המרכז,1224,כוכב יאיר,יישוב,93,35,58,54,39,1,93,0,1.67%
2019-03,המרכז,633,כפר ברא,יישוב,14,9,5,2,12,2,12,0,0.75%
2019-03,המרכז,168,כפר יונה,יישוב,314,143,171,57,257,37,309,0,2.63%
2019-03,המרכז,6900,כפר סבא,יישוב,1135,509,626,476,659,52,1123,19,2.12%
2019-03,המרכז,634,כפר קאסם,יישוב,198,105,93,12,186,71,189,1,1.83%
2019-03,המרכז,7000,לוד,יישוב,1621,795,826,139,1482,663,1578,32,4.27%
2019-03,המרכז,28,מ.א. ברנר,מועצה איזורית,77,41,36,36,41,2,76,2,1.87%
2019-03,המרכז,32,מ.א. גדרות,מועצה איזורית,37,18,19,23,14,3,36,1,1.46%
2019-03,המרכז,30,מ.א. גזר,מועצה איזורית,264,122,142,91,173,20,262,0,1.95%
2019-03,המרכז,27,מ.א. גן רווה,מועצה איזורית,52,18,34,30,22,2,51,0,1.70%
2019-03,המרכז,20,מ.א. דרום השרון,מועצה איזורית,344,150,194,145,199,9,342,0,2.11%
2019-03,המרכז,29,מ.א. חבל יבנה,מועצה איזורית,45,24,21,17,28,0,43,0,1.64%
2019-03,המרכז,25,מ.א. חבל מודיעין,מועצה איזורית,237,110,127,61,176,16,235,0,2.14%
2019-03,המרכז,19,מ.א. חוף השרון,מועצה איזורית,120,43,77,71,49,5,119,0,2.14%
2019-03,המרכז,18,מ.א. לב השרון,מועצה איזורית,256,117,139,85,171,15,254,0,2.28%
2019-03,המרכז,31,מ.א. נחל שורק,מועצה איזורית,64,29,35,21,43,6,63,23,1.47%
2019-03,המרכז,16,מ.א. עמק חפר,מועצה איזורית,406,197,209,162,244,13,405,0,2.06%
2019-03,המרכז,40,מ.א. שדות דן,מועצה איזורית,136,70,66,38,98,7,136,0,2.11%
2019-03,המרכז,1200,מודיעין-מכבים-רעות*,יישוב,849,356,493,391,458,27,836,11,1.81%
2019-03,המרכז,28,מזכרת בתיה,יישוב,153,66,87,50,103,15,149,2,1.83%
2019-03,המרכז,7200,נס ציונה,יישוב,562,261,301,160,402,108,546,7,2.21%
2019-03,המרכז,7400,נתניה,יישוב,3840,1918,1922,564,3276,940,3751,84,3.45%
2019-03,המרכז,587,סביון*,יישוב,20,12,8,9,11,0,20,0,0.96%
2019-03,המרכז,171,פרדסייה,יישוב,75,35,40,25,50,2,75,1,1.99%
2019-03,המרכז,7900,פתח תקווה,יישוב,3547,1654,1893,812,2735,640,3439,42,2.66%
2019-03,המרכז,195,קדימה-צורן,יישוב,289,118,171,109,180,15,287,1,2.44%
2019-03,המרכז,638,קלנסווה,יישוב,303,165,138,16,287,156,263,10,2.72%
2019-03,המרכז,469,קריית עקרון,יישוב,228,125,103,24,204,73,217,6,3.56%
2019-03,המרכז,2640,ראש העין,יישוב,848,393,455,171,677,91,841,5,2.71%
2019-03,המרכז,8300,ראשון לציון,יישוב,3868,1747,2121,909,2959,633,3821,39,2.72%
2019-03,המרכז,8400,רחובות,יישוב,2052,926,1126,490,1562,508,1965,40,2.77%
2019-03,המרכז,8500,רמלה,יישוב,1411,704,707,110,1301,422,1350,42,3.48%
2019-03,המרכז,8700,רעננה,יישוב,740,335,405,365,375,35,734,10,1.94%
2019-03,המרכז,1304,שוהם,יישוב,195,86,109,92,103,4,193,3,1.59%
2019-03,המרכז,154,תל מונד,יישוב,125,57,68,51,74,9,125,0,1.81%
2019-03,הצפון,473,אבו סנאן,יישוב,511,230,281,9,502,328,503,6,7.96%
2019-03,הצפון,478,אכסאל,יישוב,414,192,222,16,398,308,411,1,6.44%
2019-03,הצפון,529,אעבלין,יישוב,366,162,204,23,343,250,359,5,5.80%
2019-03,הצפון,482,בועיינה-נוג'ידאת,יישוב,257,126,131,18,239,156,249,1,5.73%
2019-03,הצפון,4001,בוקעאתא,יישוב,289,123,166,7,282,195,283,3,9.46%
2019-03,הצפון,998,ביר אל-מכסור,יישוב,266,125,141,4,262,167,263,2,6.30%
2019-03,הצפון,480,בית ג'ן,יישוב,368,109,259,21,347,207,350,2,5.83%
2019-03,הצפון,9200,בית שאן,יישוב,632,311,321,33,599,273,603,25,5.74%
2019-03,הצפון,944,בסמת טבעון,יישוב,150,73,77,6,144,78,135,0,3.75%
2019-03,הצפון,483,בענה,יישוב,341,154,187,25,316,246,319,9,8.16%
2019-03,הצפון,1292,ג'דיידה-מכר,יישוב,974,454,520,11,963,666,947,5,9.22%
2019-03,הצפון,485,ג'ולס,יישוב,178,61,117,1,177,74,176,1,5.35%
2019-03,הצפון,487,ג'ש (גוש חלב),יישוב,56,30,26,5,51,20,55,3,3.20%
2019-03,הצפון,489,דבורייה,יישוב,226,111,115,9,217,153,222,1,4.70%
2019-03,הצפון,490,דייר אל-אסד,יישוב,333,150,183,26,307,225,321,7,5.56%
2019-03,הצפון,492,דייר חנא,יישוב,471,219,252,16,455,302,467,4,8.84%
2019-03,הצפון,975,זרזיר,יישוב,185,96,89,6,179,85,181,8,5.05%
2019-03,הצפון,496,חורפיש,יישוב,101,48,53,13,88,45,94,1,3.08%
2019-03,הצפון,2034,חצור הגלילית,יישוב,235,102,133,22,213,100,218,3,4.46%
2019-03,הצפון,6700,טבריה,יישוב,1365,703,662,87,1278,558,1237,48,5.52%
2019-03,הצפון,962,טובא-זנגרייה,יישוב,272,126,146,7,265,153,264,3,7.78%
2019-03,הצפון,498,טורעאן,יישוב,339,153,186,27,312,224,326,7,5.14%
2019-03,הצפון,8900,טמרה,יישוב,1144,556,588,29,1115,816,1096,9,7.07%
2019-03,הצפון,1295,יאנוח-ג'ת,יישוב,128,44,84,9,119,53,122,1,3.80%
2019-03,הצפון,46,יבנאל,יישוב,86,39,47,7,79,42,76,0,4.78%
2019-03,הצפון,29,יסוד המעלה,יישוב,17,7,10,7,10,2,17,0,1.93%
2019-03,הצפון,499,יפיע,יישוב,469,217,252,21,448,308,464,3,5.36%
2019-03,הצפון,240,יקנעם עילית,יישוב,498,220,278,108,390,97,484,22,3.73%
2019-03,הצפון,502,ירכא,יישוב,365,153,212,1,364,213,361,3,5.13%
2019-03,הצפון,504,כאבול,יישוב,372,189,183,8,364,288,355,0,6.58%
2019-03,הצפון,505,כאוכב אבו אל-היג'א,יישוב,170,71,99,6,164,131,169,1,8.96%
2019-03,הצפון,1296,כסרא-סמיע,יישוב,188,71,117,5,183,78,178,2,4.56%
2019-03,הצפון,978,כעביה-טבאש-חג'אג'רה,יישוב,146,62,84,6,140,82,141,4,5.47%
2019-03,הצפון,1263,כפר ורדים,יישוב,56,26,30,24,32,3,53,2,1.71%
2019-03,הצפון,507,כפר יאסיף,יישוב,356,145,211,7,349,207,346,6,6.37%
2019-03,הצפון,508,כפר כמא,יישוב,46,20,26,3,43,12,44,1,2.54%
2019-03,הצפון,509,כפר כנא,יישוב,708,353,355,43,665,508,675,9,6.94%
2019-03,הצפון,510,כפר מנדא,יישוב,596,319,277,14,582,420,591,3,7.34%
2019-03,הצפון,47,כפר תבור,יישוב,42,15,27,12,30,2,39,0,1.65%
2019-03,הצפון,1139,כרמיאל,יישוב,1358,598,760,288,1070,609,1260,46,4.85%
2019-03,הצפון,65,מ.א. אל-בטוף,מועצה איזורית,227,117,110,16,211,134,215,1,6.57%
2019-03,הצפון,66,מ.א. בוסתן אל-מרג,מועצה איזורית,27,9,18,2,25,18,27,0,0.77%
2019-03,הצפון,71,מ.א. גולן,מועצה איזורית,208,98,110,63,145,17,205,0,2.33%
2019-03,הצפון,8,מ.א. הגלבוע,מועצה איזורית,508,220,288,73,435,221,498,0,3.53%
2019-03,הצפון,1,מ.א. הגליל העליון,מועצה איזורית,221,100,121,103,118,11,219,0,2.45%
2019-03,הצפון,3,מ.א. הגליל התחתון,מועצה איזורית,127,49,78,48,79,11,120,0,1.99%
2019-03,הצפון,55,מ.א. מבואות החרמון,מועצה איזורית,114,55,59,28,86,20,112,0,2.79%
2019-03,הצפון,13,מ.א. מגידו,מועצה איזורית,106,42,64,43,63,13,106,0,1.88%
2019-03,הצפון,4,מ.א. מטה אשר,מועצה איזורית,429,195,234,90,339,118,418,0,2.94%
2019-03,הצפון,52,מ.א. מעלה יוסף,מועצה איזורית,178,76,102,30,148,40,172,0,3.00%
2019-03,הצפון,2,מ.א. מרום הגליל,מועצה איזורית,269,119,150,39,230,96,262,0,3.67%
2019-03,הצפון,56,מ.א. משגב,מועצה איזורית,548,232,316,151,397,233,533,0,3.77%
2019-03,הצפון,6,מ.א. עמק הירדן,מועצה איזורית,197,93,104,58,139,16,188,0,2.77%
2019-03,הצפון,7,מ.א. עמק המעיינות,מועצה איזורית,202,91,111,60,142,30,198,0,3.02%
2019-03,הצפון,9,מ.א. עמק יזרעאל,מועצה איזורית,424,156,268,222,202,33,419,0,2.14%
2019-03,הצפון,481,מגאר,יישוב,938,401,537,20,918,624,923,9,8.72%
2019-03,הצפון,516,מג'ד אל-כרום,יישוב,465,210,255,9,456,287,450,4,6.08%
2019-03,הצפון,65,מגדל,יישוב,50,23,27,6,44,9,48,1,4.74%
2019-03,הצפון,874,מגדל העמק,יישוב,741,336,405,72,669,216,690,55,5.03%
2019-03,הצפון,4201,מג'דל שמס,יישוב,339,129,210,15,324,216,324,2,6.17%
2019-03,הצפון,517,מזרעה,יישוב,141,68,73,3,138,87,136,0,6.32%
2019-03,הצפון,43,מטולה,יישוב,27,17,10,6,21,6,26,0,2.57%
2019-03,הצפון,4203,מסעדה,יישוב,153,57,96,8,145,107,146,0,8.12%
2019-03,הצפון,518,מעיליא,יישוב,57,29,28,5,52,22,54,3,3.14%
2019-03,הצפון,1063,מעלות-תרשיחא,יישוב,686,320,366,87,599,290,650,32,5.33%
2019-03,הצפון,520,משהד,יישוב,164,76,88,6,158,108,156,4,4.35%
2019-03,הצפון,9100,נהרייה,יישוב,1653,820,833,199,1454,747,1554,61,4.90%
2019-03,הצפון,522,נחף,יישוב,388,188,200,17,371,261,376,6,6.66%
2019-03,הצפון,7300,נצרת,יישוב,2398,1122,1276,130,2268,1610,2366,17,6.42%
2019-03,הצפון,1061,נצרת עילית,יישוב,1335,640,695,138,1197,496,1200,86,5.10%
2019-03,הצפון,525,סאג'ור,יישוב,121,49,72,7,114,68,117,1,5.34%
2019-03,הצפון,7500,סח'נין,יישוב,1451,671,780,59,1392,1075,1427,14,9.28%
2019-03,הצפון,4501,ע'ג'ר,יישוב,89,41,48,3,86,38,88,0,7.28%
2019-03,הצפון,530,עיילבון,יישוב,152,74,78,10,142,79,149,0,5.12%
2019-03,הצפון,511,עילוט,יישוב,247,114,133,9,238,171,245,1,7.62%
2019-03,הצפון,532,עין מאהל,יישוב,340,189,151,12,328,222,333,3,5.67%
2019-03,הצפון,4502,עין קנייא,יישוב,98,44,54,2,96,68,95,2,8.64%
2019-03,הצפון,7600,עכו,יישוב,2442,1116,1326,150,2292,1646,2327,23,8.60%
2019-03,הצפון,7700,עפולה,יישוב,1498,687,811,208,1290,460,1434,46,5.21%
2019-03,הצפון,531,עראבה,יישוב,1013,467,546,32,981,787,997,12,8.92%
2019-03,הצפון,535,פסוטה,יישוב,81,38,43,14,67,34,78,0,4.34%
2019-03,הצפון,536,פקיעין (בוקייעה),יישוב,109,60,49,6,103,57,109,3,3.63%
2019-03,הצפון,8000,צפת,יישוב,961,486,475,101,860,525,913,14,6.53%
2019-03,הצפון,4100,קצרין,יישוב,173,80,93,23,150,65,168,2,4.19%
2019-03,הצפון,2800,קריית שמונה,יישוב,592,294,298,70,522,190,564,16,4.37%
2019-03,הצפון,543,ראמה,יישוב,228,103,125,22,206,135,218,2,5.31%
2019-03,הצפון,26,ראש פינה,יישוב,42,14,28,7,35,20,41,0,2.49%
2019-03,הצפון,542,ריינה,יישוב,437,216,221,18,419,280,420,9,5.66%
2019-03,הצפון,122,רמת ישי,יישוב,90,29,61,34,56,13,89,3,2.15%
2019-03,הצפון,913,שבלי - אום אל-גנם,יישוב,200,87,113,9,191,85,194,2,6.74%
2019-03,הצפון,812,שלומי,יישוב,186,79,107,13,173,74,180,2,4.94%
2019-03,הצפון,538,שעב,יישוב,325,153,172,6,319,243,323,2,9.71%
2019-03,הצפון,8800,שפרעם,יישוב,1187,558,629,64,1123,772,1145,11,5.87%
2019-03,חיפה,1326,"בסמ""ה",יישוב,307,149,158,10,297,197,301,4,6.72%
2019-03,חיפה,2710,אום אל-פחם,יישוב,2229,1054,1175,35,2194,1622,2175,39,9.39%
2019-03,חיפה,1020,אור עקיבא,יישוב,517,228,289,64,453,109,502,11,4.73%
2019-03,חיפה,6000,באקה אל-גרביה,יישוב,528,276,252,16,512,256,514,13,3.94%
2019-03,חיפה,9800,בנימינה-גבעת עדה*,יישוב,174,67,107,89,85,14,173,5,2.30%
2019-03,חיפה,541,ג'סר א-זרקא,יישוב,195,127,68,4,191,41,193,5,3.02%
2019-03,חיפה,628,ג'ת,יישוב,189,102,87,17,172,82,185,4,3.20%
2019-03,חיפה,494,דאלית אל-כרמל,יישוב,430,189,241,19,411,189,401,7,4.56%
2019-03,חיפה,9300,זכרון יעקב,יישוב,241,94,147,120,121,14,234,3,2.05%
2019-03,חיפה,6500,חדרה,יישוב,2034,983,1051,262,1772,556,1926,35,3.71%
2019-03,חיפה,4000,חיפה,יישוב,5346,2620,2726,1308,4038,2066,4996,81,3.53%
2019-03,חיפה,1247,חריש,יישוב,236,92,144,56,180,30,229,2,5.24%
2019-03,חיפה,2100,טירת כרמל,יישוב,676,359,317,48,628,291,650,19,5.28%
2019-03,חיפה,654,כפר קרע,יישוב,345,162,183,28,317,165,335,10,3.58%
2019-03,חיפה,45,מ.א. אלונה,מועצה איזורית,19,7,12,8,11,0,18,0,1.69%
2019-03,חיפה,12,מ.א. זבולון,מועצה איזורית,233,124,109,36,197,103,218,0,3.68%
2019-03,חיפה,15,מ.א. חוף הכרמל,מועצה איזורית,332,154,178,135,197,46,326,0,2.20%
2019-03,חיפה,14,מ.א. מנשה,מועצה איזורית,262,121,141,79,183,48,259,0,3.01%
2019-03,חיפה,1327,מעלה עירון,יישוב,545,254,291,13,532,388,536,5,8.24%
2019-03,חיפה,2500,נשר,יישוב,387,189,198,90,297,114,369,2,2.91%
2019-03,חיפה,534,עספיא,יישוב,318,139,179,26,292,135,294,5,4.78%
2019-03,חיפה,637,ערערה,יישוב,467,213,254,23,444,265,449,11,4.99%
2019-03,חיפה,537,פוריידיס,יישוב,188,117,71,6,182,26,186,3,3.07%
2019-03,חיפה,7800,פרדס חנה-כרכור,יישוב,677,320,357,202,475,69,661,16,3.08%
2019-03,חיפה,6800,קריית אתא,יישוב,1312,632,680,154,1158,482,1267,38,4.09%
2019-03,חיפה,9500,קריית ביאליק,יישוב,778,337,441,116,662,279,753,22,3.53%
2019-03,חיפה,2300,קריית טבעון,יישוב,176,74,102,77,99,24,173,0,2.06%
2019-03,חיפה,9600,קריית ים,יישוב,1111,558,553,109,1002,490,1054,25,4.98%
2019-03,חיפה,8200,קריית מוצקין,יישוב,846,377,469,155,691,238,809,12,3.47%
2019-03,חיפה,922,רכסים,יישוב,111,51,60,9,102,45,104,0,2.79%
2019-03,ירושלים,472,אבו גוש,יישוב,219,111,108,11,208,150,215,2,6.18%
2019-03,ירושלים,2610,בית שמש,יישוב,1133,518,615,103,1030,289,1085,28,2.90%
2019-03,ירושלים,3000,ירושלים,יישוב,10792,5036,5756,1501,9291,5805,10480,109,3.27%
2019-03,ירושלים,26,מ.א. מטה יהודה,מועצה איזורית,557,275,282,152,405,88,550,0,2.13%
2019-03,ירושלים,1015,מבשרת ציון,יישוב,293,140,153,84,209,77,286,5,2.24%
2019-03,ירושלים,1137,קריית יערים,יישוב,42,18,24,12,30,9,42,0,2.36%
2019-03,תל אביב,2400,אור יהודה,יישוב,649,331,318,71,578,128,618,36,3.20%
2019-03,תל אביב,565,אזור,יישוב,195,89,106,41,154,14,192,1,2.86%
2019-03,תל אביב,6100,בני ברק,יישוב,1532,729,803,128,1404,452,1441,10,2.38%
2019-03,תל אביב,6200,בת ים,יישוב,2542,1204,1338,365,2177,663,2411,70,3.42%
2019-03,תל אביב,6300,גבעתיים,יישוב,776,352,424,396,380,80,766,3,2.40%
2019-03,תל אביב,6400,הרצלייה,יישוב,1056,483,573,417,639,41,1042,15,2.12%
2019-03,תל אביב,6600,חולון,יישוב,3016,1366,1650,522,2494,459,2925,34,2.90%
2019-03,תל אביב,267,כפר שמריהו,יישוב,14,7,7,6,8,0,14,0,1.67%
2019-03,תל אביב,2620,קריית אונו,יישוב,404,174,230,211,193,35,396,6,2.02%
2019-03,תל אביב,8600,רמת גן,יישוב,2106,949,1157,893,1213,256,2064,29,2.52%
2019-03,תל אביב,2650,רמת השרון,יישוב,437,177,260,204,233,15,429,3,1.87%
2019-03,תל אביב,5000,תל אביב -יפו,יישוב,7335,3633,3702,3374,3961,1117,7176,87,2.72%
2019-04,אזור יהודה והשומרון,3760,אורנית,יישוב,111,46,65,53,58,3,111,0,2.20%
2019-04,אזור יהודה והשומרון,3750,אלפי מנשה,יישוב,92,35,57,27,65,2,92,0,2.07%
2019-04,אזור יהודה והשומרון,3560,אלקנה,יישוב,36,19,17,24,12,1,36,0,1.95%
2019-04,אזור יהודה והשומרון,3650,אפרת,יישוב,74,33,41,49,25,3,73,0,1.48%
2019-04,אזור יהודה והשומרון,3570,אריאל,יישוב,272,123,149,70,202,14,267,11,2.43%
2019-04,אזור יהודה והשומרון,3574,בית אל,יישוב,40,25,15,11,29,11,39,2,1.57%
2019-04,אזור יהודה והשומרון,3652,בית אריה,יישוב,53,24,29,14,39,1,53,2,1.85%
2019-04,אזור יהודה והשומרון,3780,ביתר עילית,יישוב,442,202,240,21,421,130,431,3,2.78%
2019-04,אזור יהודה והשומרון,3730,גבעת זאב,יישוב,192,96,96,36,156,35,190,6,2.34%
2019-04,אזור יהודה והשומרון,3769,הר אדר,יישוב,46,20,26,19,27,4,46,0,2.09%
2019-04,אזור יהודה והשומרון,76,מ.א. גוש עציון,מועצה איזורית,164,80,84,81,83,17,161,0,1.59%
2019-04,אזור יהודה והשומרון,78,מ.א. הר חברון,מועצה איזורית,61,29,32,29,32,2,61,0,1.54%
2019-04,אזור יהודה והשומרון,74,מ.א. מגילות ים המלח,מועצה איזורית,23,10,13,8,15,0,23,0,2.49%
2019-04,אזור יהודה והשומרון,73,מ.א. מטה בנימין,מועצה איזורית,589,281,308,208,381,86,580,0,2.04%
2019-04,אזור יהודה והשומרון,75,מ.א. ערבות הירדן,מועצה איזורית,60,33,27,13,47,7,58,0,2.25%
2019-04,אזור יהודה והשומרון,72,מ.א. שומרון,מועצה איזורית,409,201,208,171,238,13,409,0,2.16%
2019-04,אזור יהודה והשומרון,3797,מודיעין עילית,יישוב,390,139,251,34,356,28,388,1,2.43%
2019-04,אזור יהודה והשומרון,3616,מעלה אדומים,יישוב,542,252,290,95,447,95,536,21,2.57%
2019-04,אזור יהודה והשומרון,3608,מעלה אפרים,יישוב,30,12,18,2,28,11,29,0,3.63%
2019-04,אזור יהודה והשומרון,3660,עמנואל,יישוב,35,17,18,2,33,12,34,1,2.53%
2019-04,אזור יהודה והשומרון,3557,קדומים,יישוב,28,15,13,16,12,2,28,1,1.41%
2019-04,אזור יהודה והשומרון,3611,קריית ארבע,יישוב,82,41,41,20,62,33,77,2,2.30%
2019-04,אזור יהודה והשומרון,3640,קרני שומרון,יישוב,80,39,41,31,49,3,78,3,1.92%
2019-04,הדרום,31,אופקים,יישוב,749,319,430,45,704,315,721,25,5.02%
2019-04,הדרום,2600,אילת,יישוב,884,445,439,58,826,210,857,25,2.49%
2019-04,הדרום,70,אשדוד,יישוב,4575,2047,2528,596,3979,1736,4363,67,3.90%
2019-04,הדרום,7100,אשקלון,יישוב,3169,1428,1741,367,2802,1245,2906,54,3.93%
2019-04,הדרום,9000,באר שבע,יישוב,4850,2326,2524,740,4110,2344,4549,61,4.26%
2019-04,הדרום,2200,דימונה,יישוב,1445,682,763,80,1365,895,1367,20,7.06%
2019-04,הדרום,1303,חורה,יישוב,482,223,259,2,480,402,456,1,9.53%
2019-04,הדרום,831,ירוחם,יישוב,335,165,170,19,316,178,312,9,6.14%
2019-04,הדרום,1059,כסיפה,יישוב,1004,410,594,6,998,890,990,1,18.10%
2019-04,הדרום,1271,להבים,יישוב,47,18,29,25,22,2,47,1,1.33%
2019-04,הדרום,1060,לקיה,יישוב,572,267,305,3,569,473,530,3,10.92%
2019-04,הדרום,69,מ.א. אל קסום,מועצה איזורית,836,348,488,12,824,699,796,0,23.34%
2019-04,הדרום,38,מ.א. אשכול,מועצה איזורית,106,49,57,26,80,6,105,0,1.50%
2019-04,הדרום,33,מ.א. באר טוביה,מועצה איזורית,265,119,146,58,207,41,261,1,2.30%
2019-04,הדרום,41,מ.א. בני שמעון,מועצה איזורית,81,29,52,30,51,13,78,0,1.61%
2019-04,הדרום,54,מ.א. הערבה התיכונה,מועצה איזורית,27,11,16,6,21,0,27,0,1.42%
2019-04,הדרום,53,מ.א. חבל אילות,מועצה איזורית,20,8,12,2,18,0,20,1,0.81%
2019-04,הדרום,36,מ.א. חוף אשקלון,מועצה איזורית,226,113,113,46,180,34,219,0,2.52%
2019-04,הדרום,35,מ.א. יואב,מועצה איזורית,86,35,51,40,46,11,85,0,2.08%
2019-04,הדרום,50,מ.א. לכיש,מועצה איזורית,184,89,95,30,154,44,182,0,3.27%
2019-04,הדרום,42,מ.א. מרחבים,מועצה איזורית,134,55,79,24,110,21,133,0,2.11%
2019-04,הדרום,68,מ.א. נווה מדבר,מועצה איזורית,133,52,81,4,129,102,131,0,6.93%
2019-04,הדרום,48,מ.א. רמת נגב,מועצה איזורית,296,149,147,15,281,241,288,1,8.65%
2019-04,הדרום,39,מ.א. שדות נגב,מועצה איזורית,101,47,54,18,83,25,98,0,2.02%
2019-04,הדרום,37,מ.א. שער הנגב,מועצה איזורית,91,39,52,37,54,29,87,1,2.18%
2019-04,הדרום,34,מ.א. שפיר,מועצה איזורית,149,65,84,18,131,35,148,0,2.97%
2019-04,הדרום,51,מ.א. תמר,מועצה איזורית,15,5,10,4,11,2,15,0,2.30%
2019-04,הדרום,1268,מיתר,יישוב,63,24,39,35,28,7,63,2,1.28%
2019-04,הדרום,99,מצפה רמון,יישוב,204,81,123,10,194,133,196,11,7.10%
2019-04,הדרום,246,נתיבות,יישוב,785,343,442,63,722,335,734,30,4.50%
2019-04,הדרום,666,עומר,יישוב,50,21,29,31,19,5,50,0,1.19%
2019-04,הדרום,2560,ערד,יישוב,603,298,305,64,539,248,573,25,4.52%
2019-04,הדרום,1192,ערערה-בנגב,יישוב,958,404,554,19,939,864,932,4,18.25%
2019-04,הדרום,2630,קריית גת,יישוב,1529,667,862,117,1412,583,1466,34,5.01%
2019-04,הדרום,1034,קריית מלאכי,יישוב,728,342,386,31,697,314,693,18,5.60%
2019-04,הדרום,1161,רהט,יישוב,1886,818,1068,15,1871,1338,1859,41,8.36%
2019-04,הדרום,1286,שגב-שלום,יישוב,304,135,169,4,300,233,291,0,9.07%
2019-04,הדרום,1031,שדרות,יישוב,846,398,448,63,783,424,764,16,5.17%
2019-04,הדרום,1054,תל שבע,יישוב,703,325,378,7,696,596,641,6,11.18%
2019-04,המרכז,1066,"בני עי""ש",יישוב,131,67,64,20,111,28,125,5,3.12%
2019-04,המרכז,182,אבן יהודה,יישוב,158,73,85,63,95,15,157,0,2.24%
2019-04,המרכז,41,אליכין,יישוב,56,31,25,12,44,11,52,0,2.65%
2019-04,המרכז,1309,אלעד,יישוב,333,164,169,33,300,20,322,1,2.26%
2019-04,המרכז,2530,באר יעקב,יישוב,347,139,208,100,247,32,341,5,2.63%
2019-04,המרכז,466,בית דגן,יישוב,93,52,41,18,75,21,92,0,2.46%
2019-04,המרכז,681,גבעת שמואל,יישוב,238,109,129,96,142,28,233,0,1.87%
2019-04,המרכז,2550,גדרה,יישוב,275,127,148,67,208,45,268,6,2.07%
2019-04,המרכז,627,ג'לג'וליה,יישוב,67,37,30,7,60,29,63,3,1.47%
2019-04,המרכז,166,גן יבנה,יישוב,309,138,171,63,246,43,304,2,2.39%
2019-04,המרכז,229,גני תקווה,יישוב,196,82,114,71,125,21,196,1,2.03%
2019-04,המרכז,9700,הוד השרון,יישוב,604,248,356,277,327,14,600,2,1.84%
2019-04,המרכז,1290,זמר,יישוב,115,56,59,9,106,56,114,4,3.48%
2019-04,המרכז,2730,טייבה,יישוב,778,395,383,25,753,465,652,27,3.39%
2019-04,המרכז,2720,טירה,יישוב,136,83,53,20,116,14,133,7,1.06%
2019-04,המרכז,2660,יבנה,יישוב,594,276,318,119,475,111,586,12,2.33%
2019-04,המרכז,9400,יהוד,יישוב,366,177,189,117,249,29,363,8,2.22%
2019-04,המרכז,1224,כוכב יאיר,יישוב,78,26,52,44,34,2,77,0,1.39%
2019-04,המרכז,633,כפר ברא,יישוב,15,11,4,2,13,2,15,0,0.93%
2019-04,המרכז,168,כפר יונה,יישוב,304,142,162,52,252,35,300,4,2.56%
2019-04,המרכז,6900,כפר סבא,יישוב,1012,454,558,422,590,40,1003,16,1.90%
2019-04,המרכז,634,כפר קאסם,יישוב,180,92,88,8,172,67,173,2,1.68%
2019-04,המרכז,7000,לוד,יישוב,1461,720,741,135,1326,617,1428,26,3.88%
2019-04,המרכז,28,מ.א. ברנר,מועצה איזורית,65,34,31,26,39,3,63,2,1.55%
2019-04,המרכז,32,מ.א. גדרות,מועצה איזורית,32,17,15,18,14,1,32,0,1.30%
2019-04,המרכז,30,מ.א. גזר,מועצה איזורית,257,112,145,89,168,21,256,0,1.91%
2019-04,המרכז,27,מ.א. גן רווה,מועצה איזורית,47,18,29,26,21,3,46,0,1.54%
2019-04,המרכז,20,מ.א. דרום השרון,מועצה איזורית,331,139,192,143,188,11,329,0,2.03%
2019-04,המרכז,29,מ.א. חבל יבנה,מועצה איזורית,39,24,15,14,25,0,38,1,1.45%
2019-04,המרכז,25,מ.א. חבל מודיעין,מועצה איזורית,226,102,124,58,168,17,221,0,2.01%
2019-04,המרכז,19,מ.א. חוף השרון,מועצה איזורית,100,37,63,56,44,3,99,0,1.78%
2019-04,המרכז,18,מ.א. לב השרון,מועצה איזורית,246,103,143,86,160,20,243,0,2.19%
2019-04,המרכז,31,מ.א. נחל שורק,מועצה איזורית,56,26,30,17,39,7,55,25,1.31%
2019-04,המרכז,16,מ.א. עמק חפר,מועצה איזורית,372,185,187,148,224,10,370,0,1.88%
2019-04,המרכז,40,מ.א. שדות דן,מועצה איזורית,123,66,57,33,90,7,123,0,1.91%
2019-04,המרכז,1200,מודיעין-מכבים-רעות*,יישוב,799,332,467,368,431,22,790,5,1.71%
2019-04,המרכז,28,מזכרת בתיה,יישוב,152,62,90,48,104,17,147,2,1.81%
2019-04,המרכז,7200,נס ציונה,יישוב,523,230,293,158,365,92,517,9,2.09%
2019-04,המרכז,7400,נתניה,יישוב,3471,1717,1754,505,2966,850,3402,48,3.14%
2019-04,המרכז,587,סביון*,יישוב,17,10,7,8,9,0,17,0,0.82%
2019-04,המרכז,171,פרדסייה,יישוב,72,35,37,22,50,3,71,0,1.89%
2019-04,המרכז,7900,פתח תקווה,יישוב,3337,1573,1764,766,2571,613,3252,52,2.52%
2019-04,המרכז,195,קדימה-צורן,יישוב,262,106,156,101,161,14,258,1,2.20%
2019-04,המרכז,638,קלנסווה,יישוב,283,153,130,16,267,142,246,6,2.54%
2019-04,המרכז,469,קריית עקרון,יישוב,216,114,102,22,194,76,208,3,3.42%
2019-04,המרכז,2640,ראש העין,יישוב,807,376,431,172,635,85,802,3,2.59%
2019-04,המרכז,8300,ראשון לציון,יישוב,3609,1634,1975,851,2758,587,3565,59,2.54%
2019-04,המרכז,8400,רחובות,יישוב,1876,862,1014,453,1423,465,1812,34,2.56%
2019-04,המרכז,8500,רמלה,יישוב,1252,603,649,95,1157,394,1218,35,3.15%
2019-04,המרכז,8700,רעננה,יישוב,698,291,407,333,365,32,690,9,1.82%
2019-04,המרכז,1304,שוהם,יישוב,174,71,103,88,86,4,174,1,1.44%
2019-04,המרכז,154,תל מונד,יישוב,128,63,65,51,77,9,127,0,1.84%
2019-04,הצפון,473,אבו סנאן,יישוב,513,235,278,8,505,328,503,10,7.96%
2019-04,הצפון,478,אכסאל,יישוב,397,194,203,17,380,306,396,6,6.22%
2019-04,הצפון,529,אעבלין,יישוב,327,148,179,16,311,221,323,3,5.25%
2019-04,הצפון,482,בועיינה-נוג'ידאת,יישוב,246,123,123,17,229,144,240,2,5.54%
2019-04,הצפון,4001,בוקעאתא,יישוב,273,116,157,7,266,190,267,3,8.97%
2019-04,הצפון,998,ביר אל-מכסור,יישוב,253,124,129,3,250,149,251,2,6.03%
2019-04,הצפון,480,בית ג'ן,יישוב,353,107,246,20,333,206,341,1,5.69%
2019-04,הצפון,9200,בית שאן,יישוב,570,283,287,29,541,258,547,31,5.23%
2019-04,הצפון,944,בסמת טבעון,יישוב,136,64,72,5,131,72,127,2,3.53%
2019-04,הצפון,483,בענה,יישוב,315,141,174,16,299,228,301,1,7.73%
2019-04,הצפון,1292,ג'דיידה-מכר,יישוב,912,417,495,8,904,657,891,9,8.73%
2019-04,הצפון,485,ג'ולס,יישוב,175,62,113,3,172,69,174,2,5.30%
2019-04,הצפון,487,ג'ש (גוש חלב),יישוב,46,26,20,6,40,19,45,1,2.63%
2019-04,הצפון,489,דבורייה,יישוב,213,105,108,11,202,148,209,2,4.44%
2019-04,הצפון,490,דייר אל-אסד,יישוב,317,144,173,19,298,221,304,2,5.29%
2019-04,הצפון,492,דייר חנא,יישוב,456,218,238,17,439,292,455,5,8.64%
2019-04,הצפון,975,זרזיר,יישוב,182,93,89,3,179,88,174,3,4.86%
2019-04,הצפון,496,חורפיש,יישוב,86,35,51,7,79,42,78,1,2.57%
2019-04,הצפון,2034,חצור הגלילית,יישוב,223,105,118,18,205,102,212,8,4.34%
2019-04,הצפון,6700,טבריה,יישוב,1242,626,616,76,1166,515,1130,46,5.07%
2019-04,הצפון,962,טובא-זנגרייה,יישוב,266,119,147,6,260,148,259,6,7.65%
2019-04,הצפון,498,טורעאן,יישוב,311,146,165,25,286,205,306,6,4.84%
2019-04,הצפון,8900,טמרה,יישוב,1073,536,537,23,1050,769,1044,7,6.76%
2019-04,הצפון,1295,יאנוח-ג'ת,יישוב,124,43,81,6,118,51,116,0,3.62%
2019-04,הצפון,46,יבנאל,יישוב,80,40,40,6,74,35,70,0,4.42%
2019-04,הצפון,29,יסוד המעלה,יישוב,15,7,8,7,8,1,15,1,1.71%
2019-04,הצפון,499,יפיע,יישוב,441,209,232,15,426,289,439,3,5.09%
2019-04,הצפון,240,יקנעם עילית,יישוב,434,201,233,91,343,88,418,19,3.24%
2019-04,הצפון,502,ירכא,יישוב,349,143,206,0,349,206,345,3,4.92%
2019-04,הצפון,504,כאבול,יישוב,346,174,172,10,336,262,335,3,6.24%
2019-04,הצפון,505,כאוכב אבו אל-היג'א,יישוב,169,71,98,5,164,125,168,2,8.91%
2019-04,הצפון,1296,כסרא-סמיע,יישוב,170,64,106,3,167,74,163,2,4.19%
2019-04,הצפון,978,כעביה-טבאש-חג'אג'רה,יישוב,122,52,70,4,118,77,120,0,4.69%
2019-04,הצפון,1263,כפר ורדים,יישוב,52,22,30,22,30,4,50,0,1.61%
2019-04,הצפון,507,כפר יאסיף,יישוב,335,141,194,5,330,199,328,4,6.06%
2019-04,הצפון,508,כפר כמא,יישוב,44,20,24,2,42,10,43,2,2.48%
2019-04,הצפון,509,כפר כנא,יישוב,676,336,340,39,637,483,655,12,6.75%
2019-04,הצפון,510,כפר מנדא,יישוב,572,309,263,13,559,398,568,2,7.08%
2019-04,הצפון,47,כפר תבור,יישוב,37,12,25,12,25,1,35,0,1.48%
2019-04,הצפון,1139,כרמיאל,יישוב,1259,541,718,275,984,577,1170,33,4.52%
2019-04,הצפון,65,מ.א. אל-בטוף,מועצה איזורית,205,105,100,13,192,127,197,2,6.02%
2019-04,הצפון,66,מ.א. בוסתן אל-מרג,מועצה איזורית,25,7,18,2,23,18,25,0,0.71%
2019-04,הצפון,71,מ.א. גולן,מועצה איזורית,205,98,107,59,146,16,202,0,2.30%
2019-04,הצפון,8,מ.א. הגלבוע,מועצה איזורית,474,202,272,64,410,228,465,0,3.29%
2019-04,הצפון,1,מ.א. הגליל העליון,מועצה איזורית,197,85,112,95,102,11,196,0,2.19%
2019-04,הצפון,3,מ.א. הגליל התחתון,מועצה איזורית,117,51,66,45,72,8,113,0,1.88%
2019-04,הצפון,55,מ.א. מבואות החרמון,מועצה איזורית,101,47,54,25,76,19,100,0,2.49%
2019-04,הצפון,13,מ.א. מגידו,מועצה איזורית,91,40,51,38,53,12,90,0,1.59%
2019-04,הצפון,4,מ.א. מטה אשר,מועצה איזורית,386,170,216,78,308,118,376,0,2.65%
2019-04,הצפון,52,מ.א. מעלה יוסף,מועצה איזורית,173,75,98,26,147,41,169,0,2.95%
2019-04,הצפון,2,מ.א. מרום הגליל,מועצה איזורית,254,117,137,36,218,92,250,0,3.50%
2019-04,הצפון,56,מ.א. משגב,מועצה איזורית,509,221,288,133,376,223,499,0,3.53%
2019-04,הצפון,6,מ.א. עמק הירדן,מועצה איזורית,185,86,99,48,137,15,178,0,2.62%
2019-04,הצפון,7,מ.א. עמק המעיינות,מועצה איזורית,174,80,94,54,120,30,170,0,2.59%
2019-04,הצפון,9,מ.א. עמק יזרעאל,מועצה איזורית,395,153,242,214,181,35,392,0,2.00%
2019-04,הצפון,481,מגאר,יישוב,928,379,549,23,905,615,914,9,8.64%
2019-04,הצפון,516,מג'ד אל-כרום,יישוב,424,193,231,10,414,270,414,0,5.62%
2019-04,הצפון,65,מגדל,יישוב,53,26,27,6,47,8,50,2,4.93%
2019-04,הצפון,874,מגדל העמק,יישוב,710,333,377,70,640,216,671,55,4.90%
2019-04,הצפון,4201,מג'דל שמס,יישוב,326,120,206,14,312,209,317,3,6.05%
2019-04,הצפון,517,מזרעה,יישוב,140,67,73,3,137,85,136,3,6.32%
2019-04,הצפון,43,מטולה,יישוב,24,15,9,6,18,5,23,1,2.28%
2019-04,הצפון,4203,מסעדה,יישוב,141,51,90,8,133,105,136,1,7.61%
2019-04,הצפון,518,מעיליא,יישוב,45,25,20,6,39,18,43,0,2.51%
2019-04,הצפון,1063,מעלות-תרשיחא,יישוב,625,292,333,89,536,269,597,23,4.92%
2019-04,הצפון,520,משהד,יישוב,156,70,86,5,151,106,152,3,4.25%
2019-04,הצפון,9100,נהרייה,יישוב,1521,749,772,185,1336,719,1443,45,4.57%
2019-04,הצפון,522,נחף,יישוב,382,185,197,15,367,255,372,1,6.59%
2019-04,הצפון,7300,נצרת,יישוב,2273,1082,1191,118,2155,1543,2251,16,6.13%
2019-04,הצפון,1061,נצרת עילית,יישוב,1208,578,630,125,1083,473,1102,70,4.70%
2019-04,הצפון,525,סאג'ור,יישוב,120,45,75,5,115,62,118,3,5.38%
2019-04,הצפון,7500,סח'נין,יישוב,1423,658,765,56,1367,1043,1402,18,9.13%
2019-04,הצפון,4501,ע'ג'ר,יישוב,83,36,47,2,81,35,81,1,6.74%
2019-04,הצפון,530,עיילבון,יישוב,138,63,75,9,129,75,136,2,4.69%
2019-04,הצפון,511,עילוט,יישוב,240,112,128,7,233,169,240,3,7.47%
2019-04,הצפון,532,עין מאהל,יישוב,322,175,147,11,311,215,315,1,5.38%
2019-04,הצפון,4502,עין קנייא,יישוב,89,38,51,2,87,65,88,0,8.05%
2019-04,הצפון,7600,עכו,יישוב,2320,1060,1260,130,2190,1565,2219,18,8.24%
2019-04,הצפון,7700,עפולה,יישוב,1365,623,742,190,1175,435,1318,52,4.81%
2019-04,הצפון,531,עראבה,יישוב,984,442,542,29,955,765,974,10,8.74%
2019-04,הצפון,535,פסוטה,יישוב,82,37,45,8,74,32,79,0,4.39%
2019-04,הצפון,536,פקיעין (בוקייעה),יישוב,98,56,42,3,95,55,98,0,3.28%
2019-04,הצפון,8000,צפת,יישוב,879,454,425,90,789,477,844,24,6.07%
2019-04,הצפון,4100,קצרין,יישוב,168,75,93,25,143,60,165,1,4.12%
2019-04,הצפון,2800,קריית שמונה,יישוב,563,278,285,73,490,188,539,23,4.18%
2019-04,הצפון,543,ראמה,יישוב,221,103,118,20,201,135,212,3,5.17%
2019-04,הצפון,26,ראש פינה,יישוב,42,18,24,6,36,22,40,2,2.43%
2019-04,הצפון,542,ריינה,יישוב,389,193,196,16,373,245,377,11,5.11%
2019-04,הצפון,122,רמת ישי,יישוב,86,28,58,35,51,9,84,2,2.04%
2019-04,הצפון,913,שבלי - אום אל-גנם,יישוב,177,72,105,8,169,83,175,2,6.12%
2019-04,הצפון,812,שלומי,יישוב,182,80,102,15,167,71,178,3,4.88%
2019-04,הצפון,538,שעב,יישוב,318,146,172,6,312,238,317,0,9.54%
2019-04,הצפון,8800,שפרעם,יישוב,1148,548,600,61,1087,728,1121,14,5.76%
2019-04,חיפה,1326,"בסמ""ה",יישוב,288,140,148,8,280,192,285,2,6.39%
2019-04,חיפה,2710,אום אל-פחם,יישוב,2203,1035,1168,37,2166,1597,2133,34,9.23%
2019-04,חיפה,1020,אור עקיבא,יישוב,468,207,261,54,414,100,455,5,4.31%
2019-04,חיפה,6000,באקה אל-גרביה,יישוב,481,242,239,12,469,249,473,14,3.64%
2019-04,חיפה,9800,בנימינה-גבעת עדה*,יישוב,152,55,97,77,75,16,152,2,2.03%
2019-04,חיפה,541,ג'סר א-זרקא,יישוב,199,136,63,3,196,40,196,7,3.06%
2019-04,חיפה,628,ג'ת,יישוב,180,100,80,16,164,80,178,1,3.08%
2019-04,חיפה,494,דאלית אל-כרמל,יישוב,414,180,234,21,393,179,395,10,4.50%
2019-04,חיפה,9300,זכרון יעקב,יישוב,220,85,135,105,115,16,218,1,1.91%
2019-04,חיפה,6500,חדרה,יישוב,1893,888,1005,228,1665,501,1795,32,3.46%
2019-04,חיפה,4000,חיפה,יישוב,4981,2451,2530,1215,3766,1961,4682,80,3.32%
2019-04,חיפה,1247,חריש,יישוב,237,84,153,52,185,32,229,1,5.24%
2019-04,חיפה,2100,טירת כרמל,יישוב,638,343,295,48,590,279,609,12,4.97%
2019-04,חיפה,654,כפר קרע,יישוב,328,151,177,21,307,155,322,1,3.44%
2019-04,חיפה,45,מ.א. אלונה,מועצה איזורית,21,7,14,10,11,0,21,0,1.97%
2019-04,חיפה,12,מ.א. זבולון,מועצה איזורית,218,122,96,31,187,96,208,0,3.51%
2019-04,חיפה,15,מ.א. חוף הכרמל,מועצה איזורית,307,149,158,128,179,41,300,0,2.03%
2019-04,חיפה,14,מ.א. מנשה,מועצה איזורית,239,112,127,70,169,47,238,0,2.77%
2019-04,חיפה,1327,מעלה עירון,יישוב,546,254,292,14,532,373,537,6,8.26%
2019-04,חיפה,2500,נשר,יישוב,360,180,180,83,277,97,344,7,2.72%
2019-04,חיפה,534,עספיא,יישוב,304,136,168,30,274,129,283,6,4.61%
2019-04,חיפה,637,ערערה,יישוב,441,201,240,20,421,254,429,10,4.78%
2019-04,חיפה,537,פוריידיס,יישוב,183,116,67,4,179,29,181,4,2.99%
2019-04,חיפה,7800,פרדס חנה-כרכור,יישוב,601,268,333,180,421,59,590,6,2.76%
2019-04,חיפה,6800,קריית אתא,יישוב,1204,576,628,130,1074,459,1161,15,3.76%
2019-04,חיפה,9500,קריית ביאליק,יישוב,713,316,397,94,619,266,690,7,3.25%
2019-04,חיפה,2300,קריית טבעון,יישוב,153,55,98,67,86,24,151,2,1.80%
2019-04,חיפה,9600,קריית ים,יישוב,1022,507,515,93,929,455,974,31,4.62%
2019-04,חיפה,8200,קריית מוצקין,יישוב,779,359,420,139,640,221,757,7,3.26%
2019-04,חיפה,922,רכסים,יישוב,98,45,53,8,90,37,96,1,2.58%
2019-04,ירושלים,472,אבו גוש,יישוב,213,112,101,11,202,145,211,1,6.07%
2019-04,ירושלים,2610,בית שמש,יישוב,1040,491,549,100,940,251,1008,27,2.70%
2019-04,ירושלים,3000,ירושלים,יישוב,10224,4818,5406,1376,8848,5636,9933,137,3.11%
2019-04,ירושלים,26,מ.א. מטה יהודה,מועצה איזורית,541,269,272,143,398,79,534,2,2.06%
2019-04,ירושלים,1015,מבשרת ציון,יישוב,256,124,132,78,178,69,253,8,1.99%
2019-04,ירושלים,1137,קריית יערים,יישוב,38,15,23,13,25,9,38,0,2.14%
2019-04,תל אביב,2400,אור יהודה,יישוב,578,306,272,61,517,111,566,26,2.94%
2019-04,תל אביב,565,אזור,יישוב,192,86,106,36,156,15,191,3,2.84%
2019-04,תל אביב,6100,בני ברק,יישוב,1369,659,710,109,1260,420,1280,16,2.12%
2019-04,תל אביב,6200,בת ים,יישוב,2288,1120,1168,333,1955,598,2174,62,3.09%
2019-04,תל אביב,6300,גבעתיים,יישוב,709,324,385,375,334,64,702,11,2.21%
2019-04,תל אביב,6400,הרצלייה,יישוב,1006,447,559,414,592,35,994,5,2.02%
2019-04,תל אביב,6600,חולון,יישוב,2789,1238,1551,486,2303,438,2719,33,2.70%
2019-04,תל אביב,267,כפר שמריהו,יישוב,14,7,7,7,7,0,14,0,1.67%
2019-04,תל אביב,2620,קריית אונו,יישוב,403,176,227,214,189,30,400,3,2.04%
2019-04,תל אביב,8600,רמת גן,יישוב,1925,879,1046,801,1124,236,1902,20,2.33%
2019-04,תל אביב,2650,רמת השרון,יישוב,392,155,237,188,204,8,389,2,1.69%
2019-04,תל אביב,5000,תל אביב -יפו,יישוב,6694,3316,3378,3048,3646,1018,6579,75,2.50%
2019-05,אזור יהודה והשומרון,3760,אורנית,יישוב,114,47,67,53,61,3,114,1,2.26%
2019-05,אזור יהודה והשומרון,3750,אלפי מנשה,יישוב,97,38,59,28,69,2,97,2,2.18%
2019-05,אזור יהודה והשומרון,3560,אלקנה,יישוב,36,20,16,23,13,1,36,0,1.95%
2019-05,אזור יהודה והשומרון,3650,אפרת,יישוב,69,30,39,42,27,3,69,1,1.40%
2019-05,אזור יהודה והשומרון,3570,אריאל,יישוב,269,121,148,70,199,12,266,12,2.42%
2019-05,אזור יהודה והשומרון,3574,בית אל,יישוב,37,25,12,11,26,11,36,1,1.45%
2019-05,אזור יהודה והשומרון,3652,בית אריה,יישוב,62,31,31,17,45,1,62,1,2.15%
2019-05,אזור יהודה והשומרון,3780,ביתר עילית,יישוב,510,243,267,24,486,148,496,2,3.18%
2019-05,אזור יהודה והשומרון,3730,גבעת זאב,יישוב,200,98,102,35,165,34,199,5,2.45%
2019-05,אזור יהודה והשומרון,3769,הר אדר,יישוב,42,17,25,16,26,3,42,1,1.91%
2019-05,אזור יהודה והשומרון,76,מ.א. גוש עציון,מועצה איזורית,175,87,88,78,97,18,171,0,1.69%
2019-05,אזור יהודה והשומרון,78,מ.א. הר חברון,מועצה איזורית,67,35,32,32,35,2,67,0,1.69%
2019-05,אזור יהודה והשומרון,74,מ.א. מגילות ים המלח,מועצה איזורית,23,7,16,10,13,0,23,0,2.50%
2019-05,אזור יהודה והשומרון,73,מ.א. מטה בנימין,מועצה איזורית,625,298,327,213,412,89,614,0,2.16%
2019-05,אזור יהודה והשומרון,75,מ.א. ערבות הירדן,מועצה איזורית,60,30,30,13,47,7,57,0,2.22%
2019-05,אזור יהודה והשומרון,72,מ.א. שומרון,מועצה איזורית,444,219,225,175,269,15,443,0,2.34%
2019-05,אזור יהודה והשומרון,3797,מודיעין עילית,יישוב,451,158,293,34,417,31,445,7,2.77%
2019-05,אזור יהודה והשומרון,3616,מעלה אדומים,יישוב,551,253,298,98,453,92,545,24,2.61%
2019-05,אזור יהודה והשומרון,3608,מעלה אפרים,יישוב,34,14,20,1,33,11,34,0,4.22%
2019-05,אזור יהודה והשומרון,3660,עמנואל,יישוב,42,22,20,3,39,13,40,1,2.96%
2019-05,אזור יהודה והשומרון,3557,קדומים,יישוב,35,24,11,19,16,1,34,1,1.70%
2019-05,אזור יהודה והשומרון,3611,קריית ארבע,יישוב,88,43,45,19,69,32,85,3,2.53%
2019-05,אזור יהודה והשומרון,3640,קרני שומרון,יישוב,91,42,49,33,58,3,90,1,2.21%
2019-05,הדרום,31,אופקים,יישוב,817,354,463,44,773,321,787,35,5.45%
2019-05,הדרום,2600,אילת,יישוב,931,468,463,51,880,232,898,44,2.61%
2019-05,הדרום,70,אשדוד,יישוב,4731,2115,2616,616,4115,1729,4519,112,4.04%
2019-05,הדרום,7100,אשקלון,יישוב,3338,1470,1868,378,2960,1226,3055,73,4.12%
2019-05,הדרום,9000,באר שבע,יישוב,5117,2528,2589,756,4361,2357,4820,105,4.50%
2019-05,הדרום,2200,דימונה,יישוב,1483,725,758,74,1409,900,1398,38,7.21%
2019-05,הדרום,1303,חורה,יישוב,493,230,263,2,491,416,462,3,9.64%
2019-05,הדרום,831,ירוחם,יישוב,365,180,185,16,349,199,338,30,6.62%
2019-05,הדרום,1059,כסיפה,יישוב,1002,409,593,4,998,894,990,3,18.10%
2019-05,הדרום,1271,להבים,יישוב,47,17,30,25,22,3,47,1,1.33%
2019-05,הדרום,1060,לקיה,יישוב,574,263,311,3,571,471,530,1,10.92%
2019-05,הדרום,69,מ.א. אל קסום,מועצה איזורית,839,337,502,10,829,712,804,0,23.57%
2019-05,הדרום,38,מ.א. אשכול,מועצה איזורית,115,56,59,32,83,6,115,0,1.64%
2019-05,הדרום,33,מ.א. באר טוביה,מועצה איזורית,276,124,152,63,213,42,270,0,2.38%
2019-05,הדרום,41,מ.א. בני שמעון,מועצה איזורית,84,35,49,33,51,12,83,2,1.71%
2019-05,הדרום,54,מ.א. הערבה התיכונה,מועצה איזורית,36,15,21,11,25,0,36,0,1.89%
2019-05,הדרום,53,מ.א. חבל אילות,מועצה איזורית,20,10,10,2,18,1,20,2,0.81%
2019-05,הדרום,36,מ.א. חוף אשקלון,מועצה איזורית,238,114,124,47,191,36,229,0,2.63%
2019-05,הדרום,35,מ.א. יואב,מועצה איזורית,86,33,53,37,49,12,84,0,2.05%
2019-05,הדרום,50,מ.א. לכיש,מועצה איזורית,193,94,99,30,163,42,191,0,3.43%
2019-05,הדרום,42,מ.א. מרחבים,מועצה איזורית,152,65,87,27,125,20,151,0,2.40%
2019-05,הדרום,68,מ.א. נווה מדבר,מועצה איזורית,136,57,79,2,134,102,131,0,6.93%
2019-05,הדרום,48,מ.א. רמת נגב,מועצה איזורית,292,148,144,16,276,238,288,1,8.65%
2019-05,הדרום,39,מ.א. שדות נגב,מועצה איזורית,111,48,63,19,92,23,106,0,2.18%
2019-05,הדרום,37,מ.א. שער הנגב,מועצה איזורית,94,40,54,40,54,26,90,0,2.25%
2019-05,הדרום,34,מ.א. שפיר,מועצה איזורית,159,75,84,19,140,32,159,0,3.19%
2019-05,הדרום,51,מ.א. תמר,מועצה איזורית,15,6,9,4,11,2,15,0,2.30%
2019-05,הדרום,1268,מיתר,יישוב,60,26,34,37,23,7,60,1,1.22%
2019-05,הדרום,99,מצפה רמון,יישוב,213,90,123,9,204,143,206,17,7.43%
2019-05,הדרום,246,נתיבות,יישוב,890,405,485,68,822,340,836,41,5.09%
2019-05,הדרום,666,עומר,יישוב,49,21,28,29,20,5,49,1,1.16%
2019-05,הדרום,2560,ערד,יישוב,625,318,307,75,550,243,596,30,4.69%
2019-05,הדרום,1192,ערערה-בנגב,יישוב,977,417,560,21,956,880,950,37,18.53%
2019-05,הדרום,2630,קריית גת,יישוב,1624,708,916,124,1500,577,1559,57,5.31%
2019-05,הדרום,1034,קריית מלאכי,יישוב,769,366,403,26,743,325,720,30,5.80%
2019-05,הדרום,1161,רהט,יישוב,1930,836,1094,17,1913,1355,1904,49,8.54%
2019-05,הדרום,1286,שגב-שלום,יישוב,318,133,185,4,314,238,307,2,9.53%
2019-05,הדרום,1031,שדרות,יישוב,906,424,482,64,842,427,823,30,5.55%
2019-05,הדרום,1054,תל שבע,יישוב,701,316,385,8,693,597,650,6,11.32%
2019-05,המרכז,1066,"בני עי""ש",יישוב,140,73,67,23,117,31,130,6,3.24%
2019-05,המרכז,182,אבן יהודה,יישוב,160,73,87,66,94,13,160,1,2.29%
2019-05,המרכז,41,אליכין,יישוב,60,32,28,9,51,11,56,2,2.85%
2019-05,המרכז,1309,אלעד,יישוב,344,171,173,32,312,23,334,5,2.35%
2019-05,המרכז,2530,באר יעקב,יישוב,362,148,214,105,257,31,358,3,2.76%
2019-05,המרכז,466,בית דגן,יישוב,102,55,47,23,79,23,100,3,2.67%
2019-05,המרכז,681,גבעת שמואל,יישוב,250,117,133,107,143,25,245,1,1.96%
2019-05,המרכז,2550,גדרה,יישוב,300,142,158,73,227,51,290,11,2.24%
2019-05,המרכז,627,ג'לג'וליה,יישוב,68,40,28,2,66,32,63,1,1.47%
2019-05,המרכז,166,גן יבנה,יישוב,318,136,182,62,256,46,314,3,2.47%
2019-05,המרכז,229,גני תקווה,יישוב,201,85,116,70,131,20,200,1,2.07%
2019-05,המרכז,9700,הוד השרון,יישוב,655,276,379,293,362,19,642,14,1.97%
2019-05,המרכז,1290,זמר,יישוב,121,55,66,11,110,59,119,2,3.63%
2019-05,המרכז,2730,טייבה,יישוב,779,387,392,24,755,466,653,23,3.40%
2019-05,המרכז,2720,טירה,יישוב,142,87,55,18,124,22,140,8,1.12%
2019-05,המרכז,2660,יבנה,יישוב,647,307,340,137,510,116,633,23,2.52%
2019-05,המרכז,9400,יהוד,יישוב,388,194,194,119,269,23,380,4,2.33%
2019-05,המרכז,1224,כוכב יאיר,יישוב,83,29,54,47,36,2,83,2,1.49%
2019-05,המרכז,633,כפר ברא,יישוב,16,11,5,2,14,3,16,1,0.99%
2019-05,המרכז,168,כפר יונה,יישוב,317,145,172,60,257,33,313,6,2.66%
2019-05,המרכז,6900,כפר סבא,יישוב,1068,490,578,412,656,38,1061,23,2.01%
2019-05,המרכז,634,כפר קאסם,יישוב,173,93,80,11,162,62,168,4,1.63%
2019-05,המרכז,7000,לוד,יישוב,1477,712,765,128,1349,596,1449,23,3.93%
2019-05,המרכז,28,מ.א. ברנר,מועצה איזורית,65,30,35,28,37,3,64,2,1.57%
2019-05,המרכז,32,מ.א. גדרות,מועצה איזורית,30,15,15,21,9,1,30,0,1.22%
2019-05,המרכז,30,מ.א. גזר,מועצה איזורית,279,114,165,96,183,24,277,0,2.06%
2019-05,המרכז,27,מ.א. גן רווה,מועצה איזורית,49,21,28,25,24,4,48,1,1.60%
2019-05,המרכז,20,מ.א. דרום השרון,מועצה איזורית,329,139,190,131,198,11,328,0,2.03%
2019-05,המרכז,29,מ.א. חבל יבנה,מועצה איזורית,35,19,16,15,20,0,34,0,1.30%
2019-05,המרכז,25,מ.א. חבל מודיעין,מועצה איזורית,245,103,142,62,183,16,241,0,2.19%
2019-05,המרכז,19,מ.א. חוף השרון,מועצה איזורית,101,39,62,50,51,3,101,0,1.81%
2019-05,המרכז,18,מ.א. לב השרון,מועצה איזורית,239,107,132,81,158,20,234,0,2.10%
2019-05,המרכז,31,מ.א. נחל שורק,מועצה איזורית,65,29,36,21,44,6,62,35,1.45%
2019-05,המרכז,16,מ.א. עמק חפר,מועצה איזורית,372,179,193,146,226,13,370,0,1.88%
2019-05,המרכז,40,מ.א. שדות דן,מועצה איזורית,134,74,60,32,102,8,132,0,2.05%
2019-05,המרכז,1200,מודיעין-מכבים-רעות*,יישוב,872,367,505,387,485,21,854,13,1.85%
2019-05,המרכז,28,מזכרת בתיה,יישוב,156,64,92,53,103,14,153,2,1.88%
2019-05,המרכז,7200,נס ציונה,יישוב,542,244,298,154,388,98,529,13,2.14%
2019-05,המרכז,7400,נתניה,יישוב,3678,1829,1849,513,3165,870,3602,88,3.32%
2019-05,המרכז,587,סביון*,יישוב,17,8,9,7,10,0,17,0,0.82%
2019-05,המרכז,171,פרדסייה,יישוב,71,34,37,26,45,1,69,1,1.84%
2019-05,המרכז,7900,פתח תקווה,יישוב,3518,1683,1835,776,2742,619,3408,69,2.64%
2019-05,המרכז,195,קדימה-צורן,יישוב,251,107,144,95,156,20,245,2,2.09%
2019-05,המרכז,638,קלנסווה,יישוב,280,153,127,15,265,139,248,10,2.56%
2019-05,המרכז,469,קריית עקרון,יישוב,232,123,109,24,208,76,219,13,3.59%
2019-05,המרכז,2640,ראש העין,יישוב,893,404,489,173,720,102,881,4,2.84%
2019-05,המרכז,8300,ראשון לציון,יישוב,3707,1669,2038,844,2863,582,3656,55,2.60%
2019-05,המרכז,8400,רחובות,יישוב,1919,881,1038,469,1450,465,1844,77,2.60%
2019-05,המרכז,8500,רמלה,יישוב,1343,673,670,98,1245,407,1291,51,3.33%
2019-05,המרכז,8700,רעננה,יישוב,711,300,411,324,387,31,699,11,1.85%
2019-05,המרכז,1304,שוהם,יישוב,192,80,112,92,100,7,192,2,1.59%
2019-05,המרכז,154,תל מונד,יישוב,147,68,79,56,91,20,146,2,2.11%
2019-05,הצפון,473,אבו סנאן,יישוב,515,236,279,9,506,316,505,8,7.98%
2019-05,הצפון,478,אכסאל,יישוב,393,189,204,21,372,298,392,4,6.16%
2019-05,הצפון,529,אעבלין,יישוב,335,145,190,16,319,231,329,8,5.34%
2019-05,הצפון,482,בועיינה-נוג'ידאת,יישוב,229,116,113,17,212,138,225,5,5.21%
2019-05,הצפון,4001,בוקעאתא,יישוב,251,109,142,5,246,177,248,2,8.39%
2019-05,הצפון,998,ביר אל-מכסור,יישוב,253,134,119,4,249,146,249,5,5.99%
2019-05,הצפון,480,בית ג'ן,יישוב,361,116,245,22,339,212,348,7,5.80%
2019-05,הצפון,9200,בית שאן,יישוב,587,286,301,24,563,267,564,31,5.39%
2019-05,הצפון,944,בסמת טבעון,יישוב,148,66,82,6,142,81,138,1,3.83%
2019-05,הצפון,483,בענה,יישוב,311,141,170,12,299,219,301,5,7.73%
2019-05,הצפון,1292,ג'דיידה-מכר,יישוב,925,435,490,12,913,636,905,13,8.85%
2019-05,הצפון,485,ג'ולס,יישוב,183,67,116,4,179,77,181,3,5.50%
2019-05,הצפון,487,ג'ש (גוש חלב),יישוב,50,28,22,7,43,20,49,1,2.86%
2019-05,הצפון,489,דבורייה,יישוב,217,106,111,12,205,151,214,1,4.54%
2019-05,הצפון,490,דייר אל-אסד,יישוב,317,144,173,15,302,217,310,8,5.38%
2019-05,הצפון,492,דייר חנא,יישוב,455,214,241,12,443,295,453,4,8.60%
2019-05,הצפון,975,זרזיר,יישוב,178,98,80,3,175,83,171,4,4.78%
2019-05,הצפון,496,חורפיש,יישוב,88,42,46,8,80,43,81,1,2.67%
2019-05,הצפון,2034,חצור הגלילית,יישוב,229,105,124,16,213,100,218,8,4.46%
2019-05,הצפון,6700,טבריה,יישוב,1293,620,673,71,1222,540,1160,52,5.20%
2019-05,הצפון,962,טובא-זנגרייה,יישוב,303,127,176,6,297,151,295,4,8.62%
2019-05,הצפון,498,טורעאן,יישוב,311,139,172,26,285,213,305,8,4.83%
2019-05,הצפון,8900,טמרה,יישוב,1054,536,518,24,1030,767,1031,17,6.68%
2019-05,הצפון,1295,יאנוח-ג'ת,יישוב,130,43,87,7,123,50,126,2,3.92%
2019-05,הצפון,46,יבנאל,יישוב,89,45,44,7,82,37,80,5,5.02%
2019-05,הצפון,29,יסוד המעלה,יישוב,17,9,8,6,11,1,17,0,1.93%
2019-05,הצפון,499,יפיע,יישוב,437,203,234,21,416,293,434,4,5.03%
2019-05,הצפון,240,יקנעם עילית,יישוב,445,213,232,91,354,84,432,27,3.34%
2019-05,הצפון,502,ירכא,יישוב,357,142,215,1,356,216,352,8,5.01%
2019-05,הצפון,504,כאבול,יישוב,339,181,158,8,331,253,329,6,6.13%
2019-05,הצפון,505,כאוכב אבו אל-היג'א,יישוב,171,78,93,6,165,123,170,0,9.01%
2019-05,הצפון,1296,כסרא-סמיע,יישוב,173,67,106,5,168,71,166,4,4.27%
2019-05,הצפון,978,כעביה-טבאש-חג'אג'רה,יישוב,138,64,74,5,133,80,136,2,5.29%
2019-05,הצפון,1263,כפר ורדים,יישוב,59,27,32,26,33,2,58,2,1.86%
2019-05,הצפון,507,כפר יאסיף,יישוב,326,136,190,5,321,196,318,2,5.88%
2019-05,הצפון,508,כפר כמא,יישוב,45,23,22,3,42,11,44,0,2.54%
2019-05,הצפון,509,כפר כנא,יישוב,664,342,322,38,626,472,643,12,6.64%
2019-05,הצפון,510,כפר מנדא,יישוב,598,331,267,13,585,399,593,1,7.37%
2019-05,הצפון,47,כפר תבור,יישוב,40,13,27,14,26,1,38,0,1.61%
2019-05,הצפון,1139,כרמיאל,יישוב,1282,553,729,272,1010,573,1191,41,4.60%
2019-05,הצפון,65,מ.א. אל-בטוף,מועצה איזורית,191,102,89,12,179,123,184,3,5.64%
2019-05,הצפון,66,מ.א. בוסתן אל-מרג,מועצה איזורית,25,7,18,1,24,18,25,0,0.71%
2019-05,הצפון,71,מ.א. גולן,מועצה איזורית,196,91,105,58,138,15,195,0,2.22%
2019-05,הצפון,8,מ.א. הגלבוע,מועצה איזורית,477,207,270,61,416,229,464,0,3.29%
2019-05,הצפון,1,מ.א. הגליל העליון,מועצה איזורית,196,84,112,87,109,16,190,0,2.12%
2019-05,הצפון,3,מ.א. הגליל התחתון,מועצה איזורית,118,48,70,43,75,13,115,0,1.91%
2019-05,הצפון,55,מ.א. מבואות החרמון,מועצה איזורית,98,43,55,20,78,20,95,1,2.36%
2019-05,הצפון,13,מ.א. מגידו,מועצה איזורית,98,41,57,46,52,10,97,0,1.72%
2019-05,הצפון,4,מ.א. מטה אשר,מועצה איזורית,400,177,223,77,323,120,389,0,2.74%
2019-05,הצפון,52,מ.א. מעלה יוסף,מועצה איזורית,166,68,98,27,139,38,162,0,2.83%
2019-05,הצפון,2,מ.א. מרום הגליל,מועצה איזורית,272,122,150,42,230,97,266,0,3.73%
2019-05,הצפון,56,מ.א. משגב,מועצה איזורית,530,225,305,123,407,244,510,0,3.61%
2019-05,הצפון,6,מ.א. עמק הירדן,מועצה איזורית,168,71,97,44,124,17,156,0,2.30%
2019-05,הצפון,7,מ.א. עמק המעיינות,מועצה איזורית,178,81,97,50,128,32,172,0,2.62%
2019-05,הצפון,9,מ.א. עמק יזרעאל,מועצה איזורית,390,152,238,208,182,38,387,0,1.98%
2019-05,הצפון,481,מגאר,יישוב,930,385,545,24,906,613,914,7,8.64%
2019-05,הצפון,516,מג'ד אל-כרום,יישוב,419,190,229,11,408,267,411,4,5.58%
2019-05,הצפון,65,מגדל,יישוב,44,17,27,3,41,10,39,3,3.89%
2019-05,הצפון,874,מגדל העמק,יישוב,753,359,394,69,684,221,701,63,5.11%
2019-05,הצפון,4201,מג'דל שמס,יישוב,334,121,213,15,319,214,323,4,6.16%
2019-05,הצפון,517,מזרעה,יישוב,148,72,76,3,145,83,142,1,6.58%
2019-05,הצפון,43,מטולה,יישוב,25,15,10,5,20,5,25,0,2.48%
2019-05,הצפון,4203,מסעדה,יישוב,153,53,100,7,146,104,147,3,8.17%
2019-05,הצפון,518,מעיליא,יישוב,46,23,23,4,42,16,44,1,2.57%
2019-05,הצפון,1063,מעלות-תרשיחא,יישוב,680,320,360,89,591,269,646,30,5.30%
2019-05,הצפון,520,משהד,יישוב,164,74,90,6,158,106,163,2,4.54%
2019-05,הצפון,9100,נהרייה,יישוב,1581,780,801,190,1391,712,1492,56,4.72%
2019-05,הצפון,522,נחף,יישוב,384,175,209,16,368,253,375,4,6.64%
2019-05,הצפון,7300,נצרת,יישוב,2318,1106,1212,125,2193,1566,2293,32,6.24%
2019-05,הצפון,1061,נצרת עילית,יישוב,1230,586,644,126,1104,493,1117,81,4.76%
2019-05,הצפון,525,סאג'ור,יישוב,130,43,87,7,123,62,126,1,5.73%
2019-05,הצפון,7500,סח'נין,יישוב,1401,665,736,60,1341,1031,1378,13,8.99%
2019-05,הצפון,4501,ע'ג'ר,יישוב,82,35,47,3,79,36,79,0,6.58%
2019-05,הצפון,530,עיילבון,יישוב,138,63,75,9,129,79,135,4,4.66%
2019-05,הצפון,511,עילוט,יישוב,245,119,126,8,237,164,244,1,7.59%
2019-05,הצפון,532,עין מאהל,יישוב,316,173,143,10,306,218,308,3,5.27%
2019-05,הצפון,4502,עין קנייא,יישוב,84,32,52,2,82,60,82,0,7.54%
2019-05,הצפון,7600,עכו,יישוב,2411,1106,1305,136,2275,1604,2304,33,8.52%
2019-05,הצפון,7700,עפולה,יישוב,1507,696,811,181,1326,460,1433,59,5.20%
2019-05,הצפון,531,עראבה,יישוב,987,444,543,35,952,765,974,7,8.74%
2019-05,הצפון,535,פסוטה,יישוב,84,38,46,11,73,31,82,2,4.55%
2019-05,הצפון,536,פקיעין (בוקייעה),יישוב,101,53,48,8,93,53,99,2,3.31%
2019-05,הצפון,8000,צפת,יישוב,883,470,413,92,791,465,846,26,6.08%
2019-05,הצפון,4100,קצרין,יישוב,170,72,98,27,143,61,165,4,4.12%
2019-05,הצפון,2800,קריית שמונה,יישוב,583,285,298,74,509,187,560,22,4.34%
2019-05,הצפון,543,ראמה,יישוב,220,98,122,19,201,130,212,3,5.17%
2019-05,הצפון,26,ראש פינה,יישוב,41,18,23,6,35,22,41,1,2.49%
2019-05,הצפון,542,ריינה,יישוב,398,194,204,15,383,253,387,4,5.24%
2019-05,הצפון,122,רמת ישי,יישוב,91,35,56,32,59,9,89,0,2.15%
2019-05,הצפון,913,שבלי - אום אל-גנם,יישוב,171,72,99,9,162,85,167,3,5.85%
2019-05,הצפון,812,שלומי,יישוב,203,92,111,18,185,73,197,9,5.38%
2019-05,הצפון,538,שעב,יישוב,319,149,170,8,311,239,315,2,9.49%
2019-05,הצפון,8800,שפרעם,יישוב,1158,550,608,61,1097,727,1133,16,5.81%
2019-05,חיפה,1326,"בסמ""ה",יישוב,282,134,148,10,272,191,280,3,6.28%
2019-05,חיפה,2710,אום אל-פחם,יישוב,2155,1010,1145,39,2116,1569,2099,40,9.10%
2019-05,חיפה,1020,אור עקיבא,יישוב,493,220,273,54,439,100,478,16,4.52%
2019-05,חיפה,6000,באקה אל-גרביה,יישוב,475,223,252,11,464,253,465,11,3.58%
2019-05,חיפה,9800,בנימינה-גבעת עדה*,יישוב,156,62,94,76,80,15,155,2,2.06%
2019-05,חיפה,541,ג'סר א-זרקא,יישוב,232,137,95,3,229,42,228,10,3.55%
2019-05,חיפה,628,ג'ת,יישוב,189,103,86,13,176,84,185,7,3.20%
2019-05,חיפה,494,דאלית אל-כרמל,יישוב,415,180,235,25,390,188,398,9,4.53%
2019-05,חיפה,9300,זכרון יעקב,יישוב,234,98,136,109,125,15,231,0,2.03%
2019-05,חיפה,6500,חדרה,יישוב,1999,938,1061,236,1763,519,1878,57,3.62%
2019-05,חיפה,4000,חיפה,יישוב,5153,2550,2603,1207,3946,2029,4827,115,3.42%
2019-05,חיפה,1247,חריש,יישוב,252,93,159,55,197,38,243,2,5.54%
2019-05,חיפה,2100,טירת כרמל,יישוב,664,353,311,47,617,286,640,18,5.21%
2019-05,חיפה,654,כפר קרע,יישוב,348,166,182,21,327,157,339,7,3.62%
2019-05,חיפה,45,מ.א. אלונה,מועצה איזורית,22,8,14,10,12,0,22,0,2.06%
2019-05,חיפה,12,מ.א. זבולון,מועצה איזורית,221,123,98,24,197,101,211,0,3.56%
2019-05,חיפה,15,מ.א. חוף הכרמל,מועצה איזורית,285,135,150,116,169,44,279,0,1.88%
2019-05,חיפה,14,מ.א. מנשה,מועצה איזורית,223,104,119,62,161,48,220,0,2.56%
2019-05,חיפה,1327,מעלה עירון,יישוב,540,251,289,14,526,371,531,6,8.17%
2019-05,חיפה,2500,נשר,יישוב,374,186,188,90,284,101,353,4,2.79%
2019-05,חיפה,534,עספיא,יישוב,302,141,161,30,272,134,286,6,4.66%
2019-05,חיפה,637,ערערה,יישוב,441,199,242,22,419,254,429,13,4.78%
2019-05,חיפה,537,פוריידיס,יישוב,190,106,84,7,183,34,186,8,3.07%
2019-05,חיפה,7800,פרדס חנה-כרכור,יישוב,651,302,349,193,458,57,637,18,2.97%
2019-05,חיפה,6800,קריית אתא,יישוב,1247,587,660,122,1125,450,1196,31,3.87%
2019-05,חיפה,9500,קריית ביאליק,יישוב,748,330,418,102,646,280,722,18,3.39%
2019-05,חיפה,2300,קריית טבעון,יישוב,161,64,97,66,95,25,160,1,1.91%
2019-05,חיפה,9600,קריית ים,יישוב,1058,526,532,95,963,467,1007,25,4.76%
2019-05,חיפה,8200,קריית מוצקין,יישוב,805,373,432,138,667,242,778,16,3.34%
2019-05,חיפה,922,רכסים,יישוב,110,56,54,9,101,39,106,2,2.84%
2019-05,ירושלים,472,אבו גוש,יישוב,214,115,99,9,205,144,213,2,6.13%
2019-05,ירושלים,2610,בית שמש,יישוב,1184,541,643,119,1065,253,1142,36,3.05%
2019-05,ירושלים,3000,ירושלים,יישוב,10458,4922,5536,1361,9097,5684,10148,171,3.17%
2019-05,ירושלים,26,מ.א. מטה יהודה,מועצה איזורית,596,294,302,154,442,93,587,1,2.27%
2019-05,ירושלים,1015,מבשרת ציון,יישוב,274,143,131,74,200,74,268,6,2.10%
2019-05,ירושלים,1137,קריית יערים,יישוב,40,17,23,11,29,10,40,1,2.25%
2019-05,תל אביב,2400,אור יהודה,יישוב,631,316,315,67,564,127,603,32,3.13%
2019-05,תל אביב,565,אזור,יישוב,195,86,109,43,152,14,194,3,2.88%
2019-05,תל אביב,6100,בני ברק,יישוב,1465,694,771,106,1359,436,1371,20,2.27%
2019-05,תל אביב,6200,בת ים,יישוב,2396,1181,1215,346,2050,645,2266,75,3.22%
2019-05,תל אביב,6300,גבעתיים,יישוב,731,326,405,365,366,68,719,7,2.26%
2019-05,תל אביב,6400,הרצלייה,יישוב,1055,476,579,415,640,44,1046,14,2.13%
2019-05,תל אביב,6600,חולון,יישוב,2861,1302,1559,477,2384,436,2783,60,2.76%
2019-05,תל אביב,267,כפר שמריהו,יישוב,12,7,5,6,6,0,12,0,1.43%
2019-05,תל אביב,2620,קריית אונו,יישוב,420,186,234,212,208,28,414,3,2.11%
2019-05,תל אביב,8600,רמת גן,יישוב,1947,894,1053,798,1149,225,1922,29,2.35%
2019-05,תל אביב,2650,רמת השרון,יישוב,386,143,243,187,199,10,381,1,1.66%
2019-05,תל אביב,5000,תל אביב -יפו,יישוב,6899,3458,3441,3049,3850,1031,6781,103,2.57%
2019-06,אזור יהודה והשומרון,3760,אורנית,יישוב,111,44,67,50,61,3,111,3,2.20%
2019-06,אזור יהודה והשומרון,3750,אלפי מנשה,יישוב,86,35,51,24,62,1,86,2,1.94%
2019-06,אזור יהודה והשומרון,3560,אלקנה,יישוב,36,18,18,19,17,3,36,1,1.95%
2019-06,אזור יהודה והשומרון,3650,אפרת,יישוב,78,37,41,47,31,5,78,4,1.58%
2019-06,אזור יהודה והשומרון,3570,אריאל,יישוב,296,130,166,73,223,14,292,15,2.65%
2019-06,אזור יהודה והשומרון,3574,בית אל,יישוב,41,26,15,15,26,8,40,1,1.60%
2019-06,אזור יהודה והשומרון,3652,בית אריה,יישוב,53,27,26,12,41,0,52,0,1.81%
2019-06,אזור יהודה והשומרון,3780,ביתר עילית,יישוב,507,236,271,25,482,138,497,4,3.19%
2019-06,אזור יהודה והשומרון,3730,גבעת זאב,יישוב,198,94,104,34,164,38,196,5,2.41%
2019-06,אזור יהודה והשומרון,3769,הר אדר,יישוב,42,17,25,15,27,4,41,1,1.87%
2019-06,אזור יהודה והשומרון,76,מ.א. גוש עציון,מועצה איזורית,168,80,88,72,96,16,164,0,1.62%
2019-06,אזור יהודה והשומרון,78,מ.א. הר חברון,מועצה איזורית,61,32,29,31,30,2,61,0,1.54%
2019-06,אזור יהודה והשומרון,74,מ.א. מגילות ים המלח,מועצה איזורית,20,7,13,9,11,0,20,0,2.17%
2019-06,אזור יהודה והשומרון,73,מ.א. מטה בנימין,מועצה איזורית,594,286,308,184,410,88,584,0,2.06%
2019-06,אזור יהודה והשומרון,75,מ.א. ערבות הירדן,מועצה איזורית,70,39,31,15,55,6,67,0,2.60%
2019-06,אזור יהודה והשומרון,72,מ.א. שומרון,מועצה איזורית,445,220,225,181,264,9,444,0,2.34%
2019-06,אזור יהודה והשומרון,3797,מודיעין עילית,יישוב,484,138,346,34,450,26,480,5,2.98%
2019-06,אזור יהודה והשומרון,3616,מעלה אדומים,יישוב,560,260,300,101,459,86,554,20,2.65%
2019-06,אזור יהודה והשומרון,3608,מעלה אפרים,יישוב,32,14,18,1,31,11,32,0,3.99%
2019-06,אזור יהודה והשומרון,3660,עמנואל,יישוב,50,28,22,2,48,12,48,0,3.53%
2019-06,אזור יהודה והשומרון,3557,קדומים,יישוב,28,20,8,14,14,1,28,1,1.41%
2019-06,אזור יהודה והשומרון,3611,קריית ארבע,יישוב,109,57,52,17,92,36,103,6,3.05%
2019-06,אזור יהודה והשומרון,3640,קרני שומרון,יישוב,81,40,41,27,54,5,80,0,1.97%
2019-06,הדרום,31,אופקים,יישוב,848,376,472,41,807,329,817,28,5.65%
2019-06,הדרום,2600,אילת,יישוב,972,483,489,52,920,245,934,51,2.71%
2019-06,הדרום,70,אשדוד,יישוב,4741,2083,2658,632,4109,1750,4530,108,4.05%
2019-06,הדרום,7100,אשקלון,יישוב,3375,1531,1844,372,3003,1224,3110,75,4.19%
2019-06,הדרום,9000,באר שבע,יישוב,5101,2507,2594,729,4372,2351,4809,124,4.49%
2019-06,הדרום,2200,דימונה,יישוב,1462,693,769,71,1391,861,1393,47,7.18%
2019-06,הדרום,1303,חורה,יישוב,485,231,254,3,482,401,459,3,9.59%
2019-06,הדרום,831,ירוחם,יישוב,349,183,166,15,334,194,328,19,6.43%
2019-06,הדרום,1059,כסיפה,יישוב,986,401,585,3,983,881,975,5,17.88%
2019-06,הדרום,1271,להבים,יישוב,41,17,24,23,18,4,41,2,1.16%
2019-06,הדרום,1060,לקיה,יישוב,571,267,304,3,568,467,536,8,11.03%
2019-06,הדרום,69,מ.א. אל קסום,מועצה איזורית,820,337,483,5,815,698,788,0,23.10%
2019-06,הדרום,38,מ.א. אשכול,מועצה איזורית,113,61,52,26,87,5,111,0,1.58%
2019-06,הדרום,33,מ.א. באר טוביה,מועצה איזורית,281,118,163,63,218,41,275,0,2.43%
2019-06,הדרום,41,מ.א. בני שמעון,מועצה איזורית,88,35,53,28,60,15,87,1,1.80%
2019-06,הדרום,54,מ.א. הערבה התיכונה,מועצה איזורית,41,16,25,15,26,0,41,0,2.15%
2019-06,הדרום,53,מ.א. חבל אילות,מועצה איזורית,24,10,14,5,19,1,24,4,0.98%
2019-06,הדרום,36,מ.א. חוף אשקלון,מועצה איזורית,232,107,125,49,183,34,222,0,2.55%
2019-06,הדרום,35,מ.א. יואב,מועצה איזורית,88,35,53,33,55,11,86,0,2.10%
2019-06,הדרום,50,מ.א. לכיש,מועצה איזורית,198,93,105,33,165,41,196,0,3.52%
2019-06,הדרום,42,מ.א. מרחבים,מועצה איזורית,150,63,87,27,123,18,149,0,2.37%
2019-06,הדרום,68,מ.א. נווה מדבר,מועצה איזורית,124,50,74,2,122,99,120,0,6.35%
2019-06,הדרום,48,מ.א. רמת נגב,מועצה איזורית,300,149,151,16,284,236,294,0,8.84%
2019-06,הדרום,39,מ.א. שדות נגב,מועצה איזורית,117,53,64,21,96,26,114,1,2.34%
2019-06,הדרום,37,מ.א. שער הנגב,מועצה איזורית,101,44,57,41,60,23,98,0,2.45%
2019-06,הדרום,34,מ.א. שפיר,מועצה איזורית,160,76,84,18,142,32,159,0,3.19%
2019-06,הדרום,51,מ.א. תמר,מועצה איזורית,17,8,9,4,13,3,16,0,2.46%
2019-06,הדרום,1268,מיתר,יישוב,69,32,37,33,36,6,69,0,1.40%
2019-06,הדרום,99,מצפה רמון,יישוב,228,90,138,10,218,151,223,13,8.00%
2019-06,הדרום,246,נתיבות,יישוב,921,427,494,73,848,352,872,36,5.30%
2019-06,הדרום,666,עומר,יישוב,46,22,24,25,21,4,45,0,1.07%
2019-06,הדרום,2560,ערד,יישוב,618,317,301,75,543,244,590,33,4.65%
2019-06,הדרום,1192,ערערה-בנגב,יישוב,959,406,553,23,936,863,929,6,18.20%
2019-06,הדרום,2630,קריית גת,יישוב,1624,728,896,132,1492,575,1555,54,5.29%
2019-06,הדרום,1034,קריית מלאכי,יישוב,749,351,398,32,717,328,706,36,5.70%
2019-06,הדרום,1161,רהט,יישוב,2004,845,1159,20,1984,1349,1978,41,8.85%
2019-06,הדרום,1286,שגב-שלום,יישוב,332,144,188,5,327,243,320,6,9.89%
2019-06,הדרום,1031,שדרות,יישוב,996,485,511,65,931,431,912,29,6.11%
2019-06,הדרום,1054,תל שבע,יישוב,709,339,370,6,703,587,659,12,11.46%
2019-06,המרכז,1066,"בני עי""ש",יישוב,135,72,63,19,116,35,128,5,3.19%
2019-06,המרכז,182,אבן יהודה,יישוב,144,65,79,58,86,15,144,1,2.06%
2019-06,המרכז,41,אליכין,יישוב,54,29,25,8,46,12,51,1,2.60%
2019-06,המרכז,1309,אלעד,יישוב,341,155,186,32,309,21,334,10,2.35%
2019-06,המרכז,2530,באר יעקב,יישוב,312,122,190,86,226,26,308,3,2.38%
2019-06,המרכז,466,בית דגן,יישוב,106,55,51,20,86,20,105,1,2.80%
2019-06,המרכז,681,גבעת שמואל,יישוב,238,117,121,95,143,24,232,2,1.86%
2019-06,המרכז,2550,גדרה,יישוב,273,134,139,68,205,44,267,5,2.06%
2019-06,המרכז,627,ג'לג'וליה,יישוב,66,39,27,3,63,29,62,1,1.45%
2019-06,המרכז,166,גן יבנה,יישוב,299,119,180,60,239,48,292,1,2.30%
2019-06,המרכז,229,גני תקווה,יישוב,191,79,112,69,122,17,190,3,1.97%
2019-06,המרכז,9700,הוד השרון,יישוב,645,273,372,291,354,20,639,8,1.96%
2019-06,המרכז,1290,זמר,יישוב,118,52,66,10,108,57,118,2,3.60%
2019-06,המרכז,2730,טייבה,יישוב,748,375,373,23,725,451,626,18,3.26%
2019-06,המרכז,2720,טירה,יישוב,134,85,49,18,116,21,129,9,1.03%
2019-06,המרכז,2660,יבנה,יישוב,659,321,338,135,524,112,644,33,2.56%
2019-06,המרכז,9400,יהוד,יישוב,366,176,190,117,249,27,362,8,2.22%
2019-06,המרכז,1224,כוכב יאיר,יישוב,86,38,48,40,46,1,86,1,1.55%
2019-06,המרכז,633,כפר ברא,יישוב,16,10,6,1,15,1,16,0,0.99%
2019-06,המרכז,168,כפר יונה,יישוב,335,156,179,59,276,36,331,6,2.81%
2019-06,המרכז,6900,כפר סבא,יישוב,1070,483,587,402,668,43,1062,22,2.01%
2019-06,המרכז,634,כפר קאסם,יישוב,192,93,99,12,180,69,188,2,1.82%
2019-06,המרכז,7000,לוד,יישוב,1506,726,780,124,1382,603,1465,41,3.97%
2019-06,המרכז,28,מ.א. ברנר,מועצה איזורית,63,28,35,24,39,2,63,3,1.55%
2019-06,המרכז,32,מ.א. גדרות,מועצה איזורית,29,13,16,19,10,1,29,0,1.17%
2019-06,המרכז,30,מ.א. גזר,מועצה איזורית,281,126,155,99,182,23,277,0,2.06%
2019-06,המרכז,27,מ.א. גן רווה,מועצה איזורית,53,22,31,27,26,4,52,0,1.74%
2019-06,המרכז,20,מ.א. דרום השרון,מועצה איזורית,341,147,194,137,204,9,340,0,2.10%
2019-06,המרכז,29,מ.א. חבל יבנה,מועצה איזורית,41,18,23,16,25,0,40,0,1.53%
2019-06,המרכז,25,מ.א. חבל מודיעין,מועצה איזורית,244,104,140,71,173,17,241,0,2.19%
2019-06,המרכז,19,מ.א. חוף השרון,מועצה איזורית,100,40,60,49,51,4,100,0,1.80%
2019-06,המרכז,18,מ.א. לב השרון,מועצה איזורית,244,117,127,82,162,17,241,0,2.17%
2019-06,המרכז,31,מ.א. נחל שורק,מועצה איזורית,57,27,30,17,40,6,55,28,1.28%
2019-06,המרכז,16,מ.א. עמק חפר,מועצה איזורית,359,173,186,144,215,11,358,0,1.82%
2019-06,המרכז,40,מ.א. שדות דן,מועצה איזורית,145,71,74,30,115,10,142,0,2.20%
2019-06,המרכז,1200,מודיעין-מכבים-רעות*,יישוב,872,377,495,380,492,29,858,15,1.86%
2019-06,המרכז,28,מזכרת בתיה,יישוב,156,65,91,60,96,11,155,3,1.90%
2019-06,המרכז,7200,נס ציונה,יישוב,568,247,321,163,405,98,554,15,2.24%
2019-06,המרכז,7400,נתניה,יישוב,3571,1796,1775,511,3060,856,3494,81,3.22%
2019-06,המרכז,587,סביון*,יישוב,17,7,10,7,10,1,17,0,0.82%
2019-06,המרכז,171,פרדסייה,יישוב,73,32,41,24,49,0,72,1,1.92%
2019-06,המרכז,7900,פתח תקווה,יישוב,3412,1636,1776,766,2646,604,3323,59,2.57%
2019-06,המרכז,195,קדימה-צורן,יישוב,257,108,149,97,160,16,253,0,2.16%
2019-06,המרכז,638,קלנסווה,יישוב,285,154,131,18,267,135,252,10,2.60%
2019-06,המרכז,469,קריית עקרון,יישוב,218,119,99,26,192,73,207,9,3.40%
2019-06,המרכז,2640,ראש העין,יישוב,884,411,473,172,712,98,873,15,2.81%
2019-06,המרכז,8300,ראשון לציון,יישוב,3713,1710,2003,822,2891,573,3667,62,2.61%
2019-06,המרכז,8400,רחובות,יישוב,1944,884,1060,467,1477,462,1875,67,2.65%
2019-06,המרכז,8500,רמלה,יישוב,1303,641,662,94,1209,390,1258,60,3.25%
2019-06,המרכז,8700,רעננה,יישוב,721,312,409,321,400,26,712,13,1.88%
2019-06,המרכז,1304,שוהם,יישוב,190,82,108,84,106,7,187,1,1.55%
2019-06,המרכז,154,תל מונד,יישוב,138,69,69,55,83,15,137,0,1.98%
2019-06,הצפון,473,אבו סנאן,יישוב,486,227,259,8,478,303,478,3,7.59%
2019-06,הצפון,478,אכסאל,יישוב,377,180,197,19,358,293,374,2,5.89%
2019-06,הצפון,529,אעבלין,יישוב,331,146,185,12,319,224,322,4,5.23%
2019-06,הצפון,482,בועיינה-נוג'ידאת,יישוב,221,108,113,13,208,137,216,4,5.01%
2019-06,הצפון,4001,בוקעאתא,יישוב,227,103,124,5,222,163,224,5,7.64%
2019-06,הצפון,998,ביר אל-מכסור,יישוב,235,128,107,4,231,135,233,2,5.62%
2019-06,הצפון,480,בית ג'ן,יישוב,352,122,230,16,336,211,340,2,5.68%
2019-06,הצפון,9200,בית שאן,יישוב,575,284,291,26,549,253,558,26,5.33%
2019-06,הצפון,944,בסמת טבעון,יישוב,138,64,74,5,133,74,130,0,3.61%
2019-06,הצפון,483,בענה,יישוב,306,144,162,9,297,217,297,6,7.64%
2019-06,הצפון,1292,ג'דיידה-מכר,יישוב,911,434,477,10,901,622,894,11,8.75%
2019-06,הצפון,485,ג'ולס,יישוב,174,58,116,3,171,72,173,2,5.27%
2019-06,הצפון,487,ג'ש (גוש חלב),יישוב,50,26,24,6,44,20,49,2,2.86%
2019-06,הצפון,489,דבורייה,יישוב,204,101,103,9,195,140,202,1,4.30%
2019-06,הצפון,490,דייר אל-אסד,יישוב,310,145,165,16,294,221,304,4,5.29%
2019-06,הצפון,492,דייר חנא,יישוב,425,194,231,11,414,282,423,4,8.08%
2019-06,הצפון,975,זרזיר,יישוב,194,92,102,3,191,94,190,6,5.29%
2019-06,הצפון,496,חורפיש,יישוב,84,38,46,8,76,37,77,5,2.54%
2019-06,הצפון,2034,חצור הגלילית,יישוב,231,103,128,15,216,104,220,3,4.50%
2019-06,הצפון,6700,טבריה,יישוב,1280,609,671,75,1205,520,1159,53,5.19%
2019-06,הצפון,962,טובא-זנגרייה,יישוב,281,120,161,2,279,151,273,2,8.03%
2019-06,הצפון,498,טורעאן,יישוב,294,133,161,16,278,215,290,3,4.60%
2019-06,הצפון,8900,טמרה,יישוב,1006,510,496,19,987,741,991,15,6.44%
2019-06,הצפון,1295,יאנוח-ג'ת,יישוב,119,46,73,5,114,50,114,10,3.56%
2019-06,הצפון,46,יבנאל,יישוב,85,47,38,6,79,39,80,2,5.02%
2019-06,הצפון,29,יסוד המעלה,יישוב,14,7,7,5,9,2,14,0,1.60%
2019-06,הצפון,499,יפיע,יישוב,429,199,230,22,407,288,427,0,4.96%
2019-06,הצפון,240,יקנעם עילית,יישוב,432,213,219,83,349,92,418,24,3.24%
2019-06,הצפון,502,ירכא,יישוב,339,136,203,2,337,201,335,5,4.78%
2019-06,הצפון,504,כאבול,יישוב,321,173,148,6,315,238,312,4,5.83%
2019-06,הצפון,505,כאוכב אבו אל-היג'א,יישוב,170,78,92,7,163,116,169,0,8.96%
2019-06,הצפון,1296,כסרא-סמיע,יישוב,176,70,106,3,173,72,167,3,4.29%
2019-06,הצפון,978,כעביה-טבאש-חג'אג'רה,יישוב,133,54,79,4,129,82,130,4,5.07%
2019-06,הצפון,1263,כפר ורדים,יישוב,64,26,38,29,35,5,63,1,2.02%
2019-06,הצפון,507,כפר יאסיף,יישוב,323,134,189,8,315,184,318,2,5.88%
2019-06,הצפון,508,כפר כמא,יישוב,50,25,25,3,47,15,47,0,2.71%
2019-06,הצפון,509,כפר כנא,יישוב,669,340,329,30,639,465,650,14,6.70%
2019-06,הצפון,510,כפר מנדא,יישוב,597,327,270,16,581,398,595,1,7.39%
2019-06,הצפון,47,כפר תבור,יישוב,44,15,29,16,28,1,42,0,1.77%
2019-06,הצפון,1139,כרמיאל,יישוב,1283,553,730,274,1009,568,1199,43,4.63%
2019-06,הצפון,65,מ.א. אל-בטוף,מועצה איזורית,187,94,93,14,173,119,179,1,5.49%
2019-06,הצפון,66,מ.א. בוסתן אל-מרג,מועצה איזורית,25,7,18,0,25,18,24,0,0.68%
2019-06,הצפון,71,מ.א. גולן,מועצה איזורית,187,89,98,55,132,14,186,0,2.12%
2019-06,הצפון,8,מ.א. הגלבוע,מועצה איזורית,484,208,276,65,419,218,477,0,3.38%
2019-06,הצפון,1,מ.א. הגליל העליון,מועצה איזורית,180,77,103,80,100,11,175,0,1.96%
2019-06,הצפון,3,מ.א. הגליל התחתון,מועצה איזורית,118,50,68,40,78,10,113,0,1.88%
2019-06,הצפון,55,מ.א. מבואות החרמון,מועצה איזורית,97,40,57,17,80,20,94,0,2.34%
2019-06,הצפון,13,מ.א. מגידו,מועצה איזורית,99,43,56,45,54,12,97,0,1.72%
2019-06,הצפון,4,מ.א. מטה אשר,מועצה איזורית,381,179,202,73,308,117,371,0,2.61%
2019-06,הצפון,52,מ.א. מעלה יוסף,מועצה איזורית,165,70,95,27,138,40,161,0,2.81%
2019-06,הצפון,2,מ.א. מרום הגליל,מועצה איזורית,257,117,140,32,225,93,254,0,3.56%
2019-06,הצפון,56,מ.א. משגב,מועצה איזורית,503,216,287,115,388,224,485,0,3.43%
2019-06,הצפון,6,מ.א. עמק הירדן,מועצה איזורית,154,65,89,36,118,19,146,0,2.15%
2019-06,הצפון,7,מ.א. עמק המעיינות,מועצה איזורית,175,91,84,49,126,32,170,0,2.59%
2019-06,הצפון,9,מ.א. עמק יזרעאל,מועצה איזורית,387,149,238,187,200,40,379,0,1.94%
2019-06,הצפון,481,מגאר,יישוב,912,383,529,24,888,608,896,8,8.48%
2019-06,הצפון,516,מג'ד אל-כרום,יישוב,412,190,222,9,403,259,402,5,5.46%
2019-06,הצפון,65,מגדל,יישוב,40,16,24,4,36,9,36,1,3.60%
2019-06,הצפון,874,מגדל העמק,יישוב,749,352,397,79,670,220,706,50,5.14%
2019-06,הצפון,4201,מג'דל שמס,יישוב,306,115,191,12,294,198,298,7,5.71%
2019-06,הצפון,517,מזרעה,יישוב,145,65,80,4,141,80,142,2,6.58%
2019-06,הצפון,43,מטולה,יישוב,25,15,10,6,19,6,25,0,2.48%
2019-06,הצפון,4203,מסעדה,יישוב,137,45,92,5,132,92,132,3,7.40%
2019-06,הצפון,518,מעיליא,יישוב,52,27,25,6,46,17,50,2,2.91%
2019-06,הצפון,1063,מעלות-תרשיחא,יישוב,672,324,348,87,585,277,635,29,5.21%
2019-06,הצפון,520,משהד,יישוב,168,70,98,9,159,113,167,2,4.65%
2019-06,הצפון,9100,נהרייה,יישוב,1556,760,796,190,1366,717,1467,64,4.64%
2019-06,הצפון,522,נחף,יישוב,384,176,208,15,369,252,376,7,6.66%
2019-06,הצפון,7300,נצרת,יישוב,2268,1096,1172,103,2165,1521,2248,20,6.12%
2019-06,הצפון,1061,נצרת עילית,יישוב,1219,578,641,126,1093,474,1116,75,4.76%
2019-06,הצפון,525,סאג'ור,יישוב,129,40,89,6,123,59,127,0,5.77%
2019-06,הצפון,7500,סח'נין,יישוב,1340,636,704,52,1288,989,1327,18,8.68%
2019-06,הצפון,4501,ע'ג'ר,יישוב,78,33,45,2,76,36,76,0,6.35%
2019-06,הצפון,530,עיילבון,יישוב,137,64,73,6,131,69,135,1,4.66%
2019-06,הצפון,511,עילוט,יישוב,241,119,122,8,233,164,240,2,7.47%
2019-06,הצפון,532,עין מאהל,יישוב,305,165,140,12,293,211,297,1,5.09%
2019-06,הצפון,4502,עין קנייא,יישוב,80,29,51,2,78,57,78,0,7.20%
2019-06,הצפון,7600,עכו,יישוב,2436,1113,1323,139,2297,1604,2328,31,8.61%
2019-06,הצפון,7700,עפולה,יישוב,1494,690,804,183,1311,436,1428,53,5.19%
2019-06,הצפון,531,עראבה,יישוב,956,426,530,39,917,747,944,10,8.49%
2019-06,הצפון,535,פסוטה,יישוב,78,36,42,12,66,32,76,1,4.23%
2019-06,הצפון,536,פקיעין (בוקייעה),יישוב,100,53,47,10,90,53,97,2,3.25%
2019-06,הצפון,8000,צפת,יישוב,833,440,393,79,754,446,791,19,5.71%
2019-06,הצפון,4100,קצרין,יישוב,164,68,96,30,134,56,161,6,4.02%
2019-06,הצפון,2800,קריית שמונה,יישוב,618,300,318,73,545,190,589,20,4.55%
2019-06,הצפון,543,ראמה,יישוב,217,93,124,16,201,132,207,2,5.05%
2019-06,הצפון,26,ראש פינה,יישוב,40,16,24,7,33,21,40,0,2.43%
2019-06,הצפון,542,ריינה,יישוב,386,197,189,14,372,247,379,7,5.13%
2019-06,הצפון,122,רמת ישי,יישוב,96,38,58,36,60,11,91,0,2.20%
2019-06,הצפון,913,שבלי - אום אל-גנם,יישוב,172,70,102,5,167,88,168,3,5.89%
2019-06,הצפון,812,שלומי,יישוב,187,81,106,18,169,66,183,6,5.01%
2019-06,הצפון,538,שעב,יישוב,314,142,172,6,308,236,311,3,9.38%
2019-06,הצפון,8800,שפרעם,יישוב,1109,523,586,50,1059,714,1089,12,5.60%
2019-06,חיפה,1326,"בסמ""ה",יישוב,269,129,140,10,259,190,265,6,5.97%
2019-06,חיפה,2710,אום אל-פחם,יישוב,2149,990,1159,39,2110,1564,2094,38,9.08%
2019-06,חיפה,1020,אור עקיבא,יישוב,492,248,244,54,438,99,477,11,4.51%
2019-06,חיפה,6000,באקה אל-גרביה,יישוב,496,231,265,12,484,254,486,13,3.73%
2019-06,חיפה,9800,בנימינה-גבעת עדה*,יישוב,148,55,93,71,77,18,147,1,1.96%
2019-06,חיפה,541,ג'סר א-זרקא,יישוב,231,143,88,3,228,35,229,15,3.56%
2019-06,חיפה,628,ג'ת,יישוב,181,102,79,11,170,82,179,4,3.10%
2019-06,חיפה,494,דאלית אל-כרמל,יישוב,413,177,236,21,392,185,398,11,4.53%
2019-06,חיפה,9300,זכרון יעקב,יישוב,241,106,135,107,134,12,238,4,2.09%
2019-06,חיפה,6500,חדרה,יישוב,1939,927,1012,234,1705,513,1831,50,3.53%
2019-06,חיפה,4000,חיפה,יישוב,4949,2475,2474,1150,3799,1906,4678,104,3.31%
2019-06,חיפה,1247,חריש,יישוב,267,98,169,60,207,36,260,2,5.91%
2019-06,חיפה,2100,טירת כרמל,יישוב,624,330,294,51,573,277,600,16,4.90%
2019-06,חיפה,654,כפר קרע,יישוב,344,154,190,16,328,162,334,7,3.57%
2019-06,חיפה,45,מ.א. אלונה,מועצה איזורית,22,8,14,7,15,1,22,0,2.06%
2019-06,חיפה,12,מ.א. זבולון,מועצה איזורית,222,116,106,25,197,103,207,0,3.49%
2019-06,חיפה,15,מ.א. חוף הכרמל,מועצה איזורית,272,130,142,113,159,40,266,0,1.80%
2019-06,חיפה,14,מ.א. מנשה,מועצה איזורית,234,108,126,70,164,46,229,0,2.66%
2019-06,חיפה,1327,מעלה עירון,יישוב,536,246,290,15,521,366,525,14,8.09%
2019-06,חיפה,2500,נשר,יישוב,361,183,178,82,279,94,348,7,2.75%
2019-06,חיפה,534,עספיא,יישוב,299,140,159,28,271,131,283,5,4.61%
2019-06,חיפה,637,ערערה,יישוב,458,210,248,16,442,261,440,6,4.89%
2019-06,חיפה,537,פוריידיס,יישוב,178,86,92,8,170,26,175,6,2.89%
2019-06,חיפה,7800,פרדס חנה-כרכור,יישוב,637,300,337,195,442,51,630,16,2.94%
2019-06,חיפה,6800,קריית אתא,יישוב,1234,587,647,125,1109,460,1189,28,3.85%
2019-06,חיפה,9500,קריית ביאליק,יישוב,729,338,391,97,632,256,707,16,3.32%
2019-06,חיפה,2300,קריית טבעון,יישוב,150,61,89,57,93,22,148,1,1.77%
2019-06,חיפה,9600,קריית ים,יישוב,1033,521,512,105,928,450,983,29,4.66%
2019-06,חיפה,8200,קריית מוצקין,יישוב,805,367,438,134,671,246,778,12,3.34%
2019-06,חיפה,922,רכסים,יישוב,124,59,65,11,113,46,118,0,3.16%
2019-06,ירושלים,472,אבו גוש,יישוב,208,113,95,9,199,143,205,1,5.91%
2019-06,ירושלים,2610,בית שמש,יישוב,1209,535,674,123,1086,266,1160,53,3.09%
2019-06,ירושלים,3000,ירושלים,יישוב,10500,4917,5583,1307,9193,5559,10161,168,3.18%
2019-06,ירושלים,26,מ.א. מטה יהודה,מועצה איזורית,597,284,313,153,444,86,591,0,2.28%
2019-06,ירושלים,1015,מבשרת ציון,יישוב,279,145,134,72,207,76,274,4,2.15%
2019-06,ירושלים,1137,קריית יערים,יישוב,42,16,26,12,30,11,42,0,2.36%
2019-06,תל אביב,2400,אור יהודה,יישוב,647,337,310,53,594,126,622,21,3.22%
2019-06,תל אביב,565,אזור,יישוב,183,77,106,41,142,14,181,5,2.70%
2019-06,תל אביב,6100,בני ברק,יישוב,1499,699,800,97,1402,427,1410,21,2.33%
2019-06,תל אביב,6200,בת ים,יישוב,2346,1185,1161,347,1999,624,2241,75,3.18%
2019-06,תל אביב,6300,גבעתיים,יישוב,754,349,405,369,385,67,746,9,2.34%
2019-06,תל אביב,6400,הרצלייה,יישוב,1041,487,554,380,661,44,1029,12,2.09%
2019-06,תל אביב,6600,חולון,יישוב,2851,1304,1547,489,2362,420,2786,57,2.76%
2019-06,תל אביב,267,כפר שמריהו,יישוב,14,9,5,8,6,0,14,0,1.67%
2019-06,תל אביב,2620,קריית אונו,יישוב,406,172,234,209,197,27,399,6,2.04%
2019-06,תל אביב,8600,רמת גן,יישוב,1889,873,1016,748,1141,223,1858,28,2.27%
2019-06,תל אביב,2650,רמת השרון,יישוב,385,153,232,186,199,7,379,0,1.65%
2019-06,תל אביב,5000,תל אביב -יפו,יישוב,6806,3420,3386,2942,3864,1025,6672,112,2.53%
2019-07,אזור יהודה והשומרון,3760,אורנית,יישוב,111,41,70,45,66,2,111,0,2.20%
2019-07,אזור יהודה והשומרון,3750,אלפי מנשה,יישוב,90,35,55,25,65,0,90,3,2.03%
2019-07,אזור יהודה והשומרון,3560,אלקנה,יישוב,37,16,21,18,19,2,37,0,2.00%
2019-07,אזור יהודה והשומרון,3650,אפרת,יישוב,88,43,45,50,38,6,88,1,1.78%
2019-07,אזור יהודה והשומרון,3570,אריאל,יישוב,320,141,179,85,235,12,312,17,2.83%
2019-07,אזור יהודה והשומרון,3574,בית אל,יישוב,44,27,17,16,28,9,43,1,1.72%
2019-07,אזור יהודה והשומרון,3652,בית אריה,יישוב,59,29,30,11,48,1,59,1,2.05%
2019-07,אזור יהודה והשומרון,3780,ביתר עילית,יישוב,944,303,641,31,913,147,930,4,5.80%
2019-07,אזור יהודה והשומרון,3730,גבעת זאב,יישוב,232,105,127,37,195,38,230,6,2.82%
2019-07,אזור יהודה והשומרון,3769,הר אדר,יישוב,53,22,31,24,29,3,52,0,2.35%
2019-07,אזור יהודה והשומרון,76,מ.א. גוש עציון,מועצה איזורית,205,98,107,76,129,14,200,0,1.97%
2019-07,אזור יהודה והשומרון,78,מ.א. הר חברון,מועצה איזורית,73,41,32,36,37,2,73,0,1.84%
2019-07,אזור יהודה והשומרון,74,מ.א. מגילות ים המלח,מועצה איזורית,24,9,15,10,14,0,24,1,2.60%
2019-07,אזור יהודה והשומרון,73,מ.א. מטה בנימין,מועצה איזורית,666,316,350,215,451,78,659,0,2.32%
2019-07,אזור יהודה והשומרון,75,מ.א. ערבות הירדן,מועצה איזורית,70,36,34,14,56,7,68,0,2.64%
2019-07,אזור יהודה והשומרון,72,מ.א. שומרון,מועצה איזורית,464,221,243,179,285,11,464,0,2.45%
2019-07,אזור יהודה והשומרון,3797,מודיעין עילית,יישוב,979,166,813,38,941,25,974,4,5.88%
2019-07,אזור יהודה והשומרון,3616,מעלה אדומים,יישוב,657,268,389,114,543,103,648,18,3.09%
2019-07,אזור יהודה והשומרון,3608,מעלה אפרים,יישוב,38,15,23,2,36,12,37,0,4.58%
2019-07,אזור יהודה והשומרון,3660,עמנואל,יישוב,65,29,36,3,62,10,65,0,4.72%
2019-07,אזור יהודה והשומרון,3557,קדומים,יישוב,36,23,13,14,22,4,36,0,1.80%
2019-07,אזור יהודה והשומרון,3611,קריית ארבע,יישוב,107,59,48,17,90,28,103,4,3.05%
2019-07,אזור יהודה והשומרון,3640,קרני שומרון,יישוב,85,40,45,27,58,5,83,4,2.04%
2019-07,הדרום,31,אופקים,יישוב,1075,404,671,50,1025,330,1049,35,7.14%
2019-07,הדרום,2600,אילת,יישוב,992,479,513,61,931,238,952,49,2.76%
2019-07,הדרום,70,אשדוד,יישוב,5469,2223,3246,713,4756,1745,5254,84,4.66%
2019-07,הדרום,7100,אשקלון,יישוב,3677,1600,2077,439,3238,1272,3404,82,4.57%
2019-07,הדרום,9000,באר שבע,יישוב,5454,2561,2893,771,4683,2340,5150,109,4.79%
2019-07,הדרום,2200,דימונה,יישוב,1601,745,856,76,1525,916,1521,37,7.79%
2019-07,הדרום,1303,חורה,יישוב,520,242,278,5,515,417,490,5,10.17%
2019-07,הדרום,831,ירוחם,יישוב,422,209,213,17,405,205,404,17,7.81%
2019-07,הדרום,1059,כסיפה,יישוב,1031,421,610,2,1029,917,1019,4,18.53%
2019-07,הדרום,1271,להבים,יישוב,38,17,21,20,18,4,38,1,1.08%
2019-07,הדרום,1060,לקיה,יישוב,641,276,365,6,635,492,600,4,12.19%
2019-07,הדרום,69,מ.א. אל קסום,מועצה איזורית,871,359,512,7,864,715,830,0,24.34%
2019-07,הדרום,38,מ.א. אשכול,מועצה איזורית,135,72,63,33,102,5,132,0,1.88%
2019-07,הדרום,33,מ.א. באר טוביה,מועצה איזורית,301,126,175,72,229,44,294,0,2.60%
2019-07,הדרום,41,מ.א. בני שמעון,מועצה איזורית,98,39,59,31,67,14,97,1,2.00%
2019-07,הדרום,54,מ.א. הערבה התיכונה,מועצה איזורית,51,22,29,16,35,0,51,0,2.68%
2019-07,הדרום,53,מ.א. חבל אילות,מועצה איזורית,20,8,12,3,17,1,20,2,0.81%
2019-07,הדרום,36,מ.א. חוף אשקלון,מועצה איזורית,248,108,140,52,196,38,237,0,2.72%
2019-07,הדרום,35,מ.א. יואב,מועצה איזורית,82,31,51,28,54,11,81,0,1.98%
2019-07,הדרום,50,מ.א. לכיש,מועצה איזורית,222,96,126,41,181,41,218,0,3.91%
2019-07,הדרום,42,מ.א. מרחבים,מועצה איזורית,192,70,122,29,163,23,189,0,3.00%
2019-07,הדרום,68,מ.א. נווה מדבר,מועצה איזורית,141,56,85,4,137,103,137,0,7.25%
2019-07,הדרום,48,מ.א. רמת נגב,מועצה איזורית,313,152,161,19,294,241,309,1,9.27%
2019-07,הדרום,39,מ.א. שדות נגב,מועצה איזורית,146,65,81,25,121,26,140,0,2.88%
2019-07,הדרום,37,מ.א. שער הנגב,מועצה איזורית,114,47,67,45,69,22,109,1,2.73%
2019-07,הדרום,34,מ.א. שפיר,מועצה איזורית,180,78,102,21,159,33,179,0,3.59%
2019-07,הדרום,51,מ.א. תמר,מועצה איזורית,17,9,8,1,16,2,17,0,2.61%
2019-07,הדרום,1268,מיתר,יישוב,68,31,37,31,37,5,68,0,1.38%
2019-07,הדרום,99,מצפה רמון,יישוב,264,107,157,12,252,159,256,7,9.07%
2019-07,הדרום,246,נתיבות,יישוב,1226,453,773,89,1137,357,1173,41,7.00%
2019-07,הדרום,666,עומר,יישוב,58,26,32,32,26,3,57,0,1.35%
2019-07,הדרום,2560,ערד,יישוב,724,350,374,84,640,249,694,24,5.42%
2019-07,הדרום,1192,ערערה-בנגב,יישוב,997,426,571,28,969,885,974,4,18.91%
2019-07,הדרום,2630,קריית גת,יישוב,1796,791,1005,141,1655,560,1726,51,5.84%
2019-07,הדרום,1034,קריית מלאכי,יישוב,800,381,419,39,761,329,759,30,6.10%
2019-07,הדרום,1161,רהט,יישוב,2286,943,1343,25,2261,1385,2255,40,9.96%
2019-07,הדרום,1286,שגב-שלום,יישוב,379,158,221,4,375,269,366,2,11.15%
2019-07,הדרום,1031,שדרות,יישוב,1058,504,554,72,986,427,969,47,6.47%
2019-07,הדרום,1054,תל שבע,יישוב,801,367,434,4,797,610,741,18,12.71%
2019-07,המרכז,1066,"בני עי""ש",יישוב,146,69,77,18,128,36,142,4,3.53%
2019-07,המרכז,182,אבן יהודה,יישוב,148,68,80,60,88,14,148,1,2.12%
2019-07,המרכז,41,אליכין,יישוב,58,33,25,6,52,11,55,1,2.80%
2019-07,המרכז,1309,אלעד,יישוב,704,186,518,42,662,30,697,0,4.78%
2019-07,המרכז,2530,באר יעקב,יישוב,334,131,203,84,250,30,327,6,2.53%
2019-07,המרכז,466,בית דגן,יישוב,112,56,56,22,90,19,111,1,2.96%
2019-07,המרכז,681,גבעת שמואל,יישוב,243,116,127,94,149,25,240,1,1.92%
2019-07,המרכז,2550,גדרה,יישוב,290,126,164,68,222,44,283,11,2.18%
2019-07,המרכז,627,ג'לג'וליה,יישוב,83,42,41,4,79,34,77,4,1.79%
2019-07,המרכז,166,גן יבנה,יישוב,333,127,206,72,261,47,329,3,2.58%
2019-07,המרכז,229,גני תקווה,יישוב,228,91,137,74,154,26,226,2,2.34%
2019-07,המרכז,9700,הוד השרון,יישוב,731,285,446,294,437,22,724,8,2.21%
2019-07,המרכז,1290,זמר,יישוב,120,54,66,9,111,54,119,3,3.63%
2019-07,המרכז,2730,טייבה,יישוב,829,392,437,25,804,461,709,26,3.68%
2019-07,המרכז,2720,טירה,יישוב,166,99,67,26,140,19,161,8,1.29%
2019-07,המרכז,2660,יבנה,יישוב,753,334,419,143,610,116,745,29,2.95%
2019-07,המרכז,9400,יהוד,יישוב,396,170,226,132,264,23,391,13,2.39%
2019-07,המרכז,1224,כוכב יאיר,יישוב,86,34,52,39,47,1,85,1,1.53%
2019-07,המרכז,633,כפר ברא,יישוב,27,11,16,3,24,3,26,0,1.60%
2019-07,המרכז,168,כפר יונה,יישוב,352,163,189,60,292,37,347,4,2.94%
2019-07,המרכז,6900,כפר סבא,יישוב,1185,518,667,428,757,40,1175,19,2.22%
2019-07,המרכז,634,כפר קאסם,יישוב,219,100,119,12,207,86,210,3,2.03%
2019-07,המרכז,7000,לוד,יישוב,1595,743,852,137,1458,631,1557,31,4.21%
2019-07,המרכז,28,מ.א. ברנר,מועצה איזורית,71,33,38,24,47,5,71,4,1.74%
2019-07,המרכז,32,מ.א. גדרות,מועצה איזורית,36,14,22,24,12,0,35,0,1.42%
2019-07,המרכז,30,מ.א. גזר,מועצה איזורית,311,127,184,120,191,24,310,0,2.31%
2019-07,המרכז,27,מ.א. גן רווה,מועצה איזורית,58,21,37,28,30,4,57,1,1.90%
2019-07,המרכז,20,מ.א. דרום השרון,מועצה איזורית,360,156,204,160,200,10,358,0,2.21%
2019-07,המרכז,29,מ.א. חבל יבנה,מועצה איזורית,39,17,22,14,25,0,38,0,1.45%
2019-07,המרכז,25,מ.א. חבל מודיעין,מועצה איזורית,245,101,144,68,177,18,240,0,2.18%
2019-07,המרכז,19,מ.א. חוף השרון,מועצה איזורית,106,47,59,56,50,5,106,0,1.90%
2019-07,המרכז,18,מ.א. לב השרון,מועצה איזורית,266,112,154,85,181,18,263,0,2.36%
2019-07,המרכז,31,מ.א. נחל שורק,מועצה איזורית,71,30,41,21,50,8,70,35,1.54%
2019-07,המרכז,16,מ.א. עמק חפר,מועצה איזורית,377,181,196,149,228,17,374,0,1.90%
2019-07,המרכז,40,מ.א. שדות דן,מועצה איזורית,162,68,94,44,118,9,161,0,2.50%
2019-07,המרכז,1200,מודיעין-מכבים-רעות*,יישוב,912,380,532,385,527,27,902,21,1.95%
2019-07,המרכז,28,מזכרת בתיה,יישוב,177,68,109,69,108,14,175,4,2.14%
2019-07,המרכז,7200,נס ציונה,יישוב,606,248,358,176,430,94,595,8,2.40%
2019-07,המרכז,7400,נתניה,יישוב,3952,1887,2065,548,3404,878,3892,89,3.58%
2019-07,המרכז,587,סביון*,יישוב,17,7,10,10,7,1,17,0,0.82%
2019-07,המרכז,171,פרדסייה,יישוב,85,40,45,24,61,3,83,1,2.20%
2019-07,המרכז,7900,פתח תקווה,יישוב,3810,1738,2072,835,2975,640,3706,60,2.86%
2019-07,המרכז,195,קדימה-צורן,יישוב,270,104,166,98,172,17,268,1,2.28%
2019-07,המרכז,638,קלנסווה,יישוב,308,153,155,14,294,140,274,13,2.83%
2019-07,המרכז,469,קריית עקרון,יישוב,242,114,128,30,212,70,229,8,3.75%
2019-07,המרכז,2640,ראש העין,יישוב,1055,430,625,190,865,96,1047,7,3.35%
2019-07,המרכז,8300,ראשון לציון,יישוב,3982,1784,2198,858,3124,567,3935,50,2.80%
2019-07,המרכז,8400,רחובות,יישוב,2219,953,1266,504,1715,448,2149,56,3.02%
2019-07,המרכז,8500,רמלה,יישוב,1434,668,766,95,1339,389,1392,53,3.58%
2019-07,המרכז,8700,רעננה,יישוב,779,332,447,338,441,25,764,13,2.01%
2019-07,המרכז,1304,שוהם,יישוב,209,89,120,90,119,7,206,7,1.70%
2019-07,המרכז,154,תל מונד,יישוב,138,58,80,50,88,13,137,0,1.98%
2019-07,הצפון,473,אבו סנאן,יישוב,501,233,268,5,496,310,494,7,7.82%
2019-07,הצפון,478,אכסאל,יישוב,386,176,210,22,364,296,384,1,6.04%
2019-07,הצפון,529,אעבלין,יישוב,356,157,199,16,340,229,349,7,5.64%
2019-07,הצפון,482,בועיינה-נוג'ידאת,יישוב,229,110,119,12,217,137,225,3,5.21%
2019-07,הצפון,4001,בוקעאתא,יישוב,231,103,128,4,227,161,229,1,7.80%
2019-07,הצפון,998,ביר אל-מכסור,יישוב,252,136,116,5,247,149,249,2,5.99%
2019-07,הצפון,480,בית ג'ן,יישוב,378,127,251,18,360,216,363,3,6.04%
2019-07,הצפון,9200,בית שאן,יישוב,660,332,328,33,627,267,638,30,6.05%
2019-07,הצפון,944,בסמת טבעון,יישוב,152,67,85,6,146,83,142,1,3.93%
2019-07,הצפון,483,בענה,יישוב,301,142,159,11,290,220,293,7,7.54%
2019-07,הצפון,1292,ג'דיידה-מכר,יישוב,960,436,524,13,947,628,947,14,9.22%
2019-07,הצפון,485,ג'ולס,יישוב,182,60,122,3,179,72,182,1,5.53%
2019-07,הצפון,487,ג'ש (גוש חלב),יישוב,49,24,25,4,45,21,48,0,2.80%
2019-07,הצפון,489,דבורייה,יישוב,220,110,110,11,209,144,215,2,4.56%
2019-07,הצפון,490,דייר אל-אסד,יישוב,318,144,174,12,306,218,311,3,5.40%
2019-07,הצפון,492,דייר חנא,יישוב,450,198,252,10,440,286,445,7,8.46%
2019-07,הצפון,975,זרזיר,יישוב,227,101,126,5,222,93,222,10,6.12%
2019-07,הצפון,496,חורפיש,יישוב,92,43,49,7,85,41,82,3,2.70%
2019-07,הצפון,2034,חצור הגלילית,יישוב,245,107,138,25,220,103,232,4,4.73%
2019-07,הצפון,6700,טבריה,יישוב,1394,644,750,78,1316,517,1276,44,5.69%
2019-07,הצפון,962,טובא-זנגרייה,יישוב,286,115,171,2,284,156,277,7,8.14%
2019-07,הצפון,498,טורעאן,יישוב,322,131,191,24,298,213,319,5,5.04%
2019-07,הצפון,8900,טמרה,יישוב,1086,524,562,32,1054,751,1073,9,6.93%
2019-07,הצפון,1295,יאנוח-ג'ת,יישוב,129,52,77,9,120,50,124,4,3.86%
2019-07,הצפון,46,יבנאל,יישוב,100,50,50,8,92,44,97,1,6.02%
2019-07,הצפון,29,יסוד המעלה,יישוב,19,9,10,7,12,3,19,0,2.16%
2019-07,הצפון,499,יפיע,יישוב,463,206,257,28,435,308,459,9,5.31%
2019-07,הצפון,240,יקנעם עילית,יישוב,527,243,284,93,434,96,514,26,3.95%
2019-07,הצפון,502,ירכא,יישוב,345,141,204,2,343,197,342,4,4.88%
2019-07,הצפון,504,כאבול,יישוב,338,174,164,8,330,240,329,1,6.13%
2019-07,הצפון,505,כאוכב אבו אל-היג'א,יישוב,175,77,98,8,167,122,174,1,9.20%
2019-07,הצפון,1296,כסרא-סמיע,יישוב,173,69,104,4,169,67,164,4,4.22%
2019-07,הצפון,978,כעביה-טבאש-חג'אג'רה,יישוב,147,57,90,6,141,79,142,0,5.51%
2019-07,הצפון,1263,כפר ורדים,יישוב,61,24,37,26,35,3,60,2,1.93%
2019-07,הצפון,507,כפר יאסיף,יישוב,333,140,193,9,324,183,329,2,6.08%
2019-07,הצפון,508,כפר כמא,יישוב,47,24,23,3,44,12,44,2,2.54%
2019-07,הצפון,509,כפר כנא,יישוב,712,348,364,35,677,472,689,17,7.08%
2019-07,הצפון,510,כפר מנדא,יישוב,646,335,311,21,625,397,641,1,7.91%
2019-07,הצפון,47,כפר תבור,יישוב,50,19,31,17,33,3,49,1,2.06%
2019-07,הצפון,1139,כרמיאל,יישוב,1361,572,789,277,1084,570,1263,38,4.86%
2019-07,הצפון,65,מ.א. אל-בטוף,מועצה איזורית,205,103,102,15,190,131,196,3,6.01%
2019-07,הצפון,66,מ.א. בוסתן אל-מרג,מועצה איזורית,26,8,18,0,26,19,25,1,0.71%
2019-07,הצפון,71,מ.א. גולן,מועצה איזורית,218,101,117,66,152,18,216,0,2.46%
2019-07,הצפון,8,מ.א. הגלבוע,מועצה איזורית,545,229,316,73,472,222,537,0,3.80%
2019-07,הצפון,1,מ.א. הגליל העליון,מועצה איזורית,190,80,110,88,102,12,185,0,2.07%
2019-07,הצפון,3,מ.א. הגליל התחתון,מועצה איזורית,131,54,77,42,89,9,127,0,2.11%
2019-07,הצפון,55,מ.א. מבואות החרמון,מועצה איזורית,112,40,72,28,84,17,111,0,2.76%
2019-07,הצפון,13,מ.א. מגידו,מועצה איזורית,108,49,59,43,65,9,107,0,1.89%
2019-07,הצפון,4,מ.א. מטה אשר,מועצה איזורית,427,188,239,84,343,126,410,0,2.89%
2019-07,הצפון,52,מ.א. מעלה יוסף,מועצה איזורית,184,82,102,25,159,38,180,0,3.14%
2019-07,הצפון,2,מ.א. מרום הגליל,מועצה איזורית,291,130,161,37,254,92,286,0,4.01%
2019-07,הצפון,56,מ.א. משגב,מועצה איזורית,512,226,286,116,396,218,498,0,3.52%
2019-07,הצפון,6,מ.א. עמק הירדן,מועצה איזורית,161,72,89,43,118,16,153,0,2.25%
2019-07,הצפון,7,מ.א. עמק המעיינות,מועצה איזורית,181,83,98,52,129,36,174,0,2.65%
2019-07,הצפון,9,מ.א. עמק יזרעאל,מועצה איזורית,398,159,239,180,218,38,389,0,1.99%
2019-07,הצפון,481,מגאר,יישוב,918,376,542,35,883,605,902,17,8.54%
2019-07,הצפון,516,מג'ד אל-כרום,יישוב,463,201,262,13,450,262,453,5,6.11%
2019-07,הצפון,65,מגדל,יישוב,40,17,23,3,37,9,35,3,3.50%
2019-07,הצפון,874,מגדל העמק,יישוב,888,414,474,86,802,218,841,48,6.07%
2019-07,הצפון,4201,מג'דל שמס,יישוב,301,106,195,16,285,188,295,8,5.65%
2019-07,הצפון,517,מזרעה,יישוב,158,76,82,3,155,78,153,6,7.05%
2019-07,הצפון,43,מטולה,יישוב,28,13,15,11,17,7,28,0,2.77%
2019-07,הצפון,4203,מסעדה,יישוב,141,50,91,6,135,92,133,0,7.45%
2019-07,הצפון,518,מעיליא,יישוב,52,24,28,6,46,19,52,4,3.03%
2019-07,הצפון,1063,מעלות-תרשיחא,יישוב,746,357,389,91,655,279,708,38,5.78%
2019-07,הצפון,520,משהד,יישוב,181,72,109,12,169,119,179,5,4.96%
2019-07,הצפון,9100,נהרייה,יישוב,1628,790,838,196,1432,712,1534,50,4.84%
2019-07,הצפון,522,נחף,יישוב,374,171,203,17,357,243,369,7,6.54%
2019-07,הצפון,7300,נצרת,יישוב,2446,1133,1313,124,2322,1564,2422,21,6.56%
2019-07,הצפון,1061,נצרת עילית,יישוב,1311,594,717,149,1162,486,1215,81,5.16%
2019-07,הצפון,525,סאג'ור,יישוב,133,40,93,7,126,59,131,1,5.94%
2019-07,הצפון,7500,סח'נין,יישוב,1376,641,735,54,1322,974,1359,10,8.88%
2019-07,הצפון,4501,ע'ג'ר,יישוב,80,28,52,3,77,32,78,1,6.51%
2019-07,הצפון,530,עיילבון,יישוב,142,67,75,7,135,72,140,0,4.82%
2019-07,הצפון,511,עילוט,יישוב,248,117,131,5,243,166,246,0,7.64%
2019-07,הצפון,532,עין מאהל,יישוב,321,158,163,12,309,221,311,2,5.32%
2019-07,הצפון,4502,עין קנייא,יישוב,81,33,48,1,80,59,80,3,7.37%
2019-07,הצפון,7600,עכו,יישוב,2685,1155,1530,154,2531,1634,2577,21,9.44%
2019-07,הצפון,7700,עפולה,יישוב,1743,764,979,200,1543,456,1676,63,6.03%
2019-07,הצפון,531,עראבה,יישוב,981,429,552,49,932,755,970,12,8.70%
2019-07,הצפון,535,פסוטה,יישוב,82,38,44,8,74,32,80,5,4.44%
2019-07,הצפון,536,פקיעין (בוקייעה),יישוב,103,61,42,12,91,50,101,3,3.37%
2019-07,הצפון,8000,צפת,יישוב,1028,486,542,98,930,480,988,28,7.03%
2019-07,הצפון,4100,קצרין,יישוב,188,79,109,34,154,57,177,4,4.41%
2019-07,הצפון,2800,קריית שמונה,יישוב,652,311,341,72,580,200,623,18,4.80%
2019-07,הצפון,543,ראמה,יישוב,226,93,133,19,207,129,217,3,5.28%
2019-07,הצפון,26,ראש פינה,יישוב,46,19,27,6,40,21,46,1,2.79%
2019-07,הצפון,542,ריינה,יישוב,428,207,221,20,408,260,420,7,5.66%
2019-07,הצפון,122,רמת ישי,יישוב,100,37,63,38,62,12,97,2,2.34%
2019-07,הצפון,913,שבלי - אום אל-גנם,יישוב,180,68,112,10,170,83,178,1,6.22%
2019-07,הצפון,812,שלומי,יישוב,190,86,104,19,171,66,186,4,5.09%
2019-07,הצפון,538,שעב,יישוב,308,139,169,10,298,235,306,1,9.24%
2019-07,הצפון,8800,שפרעם,יישוב,1172,528,644,51,1121,726,1158,21,5.94%
2019-07,חיפה,1326,"בסמ""ה",יישוב,276,132,144,7,269,188,269,3,6.05%
2019-07,חיפה,2710,אום אל-פחם,יישוב,2282,1005,1277,47,2235,1591,2233,43,9.62%
2019-07,חיפה,1020,אור עקיבא,יישוב,522,258,264,58,464,101,504,10,4.75%
2019-07,חיפה,6000,באקה אל-גרביה,יישוב,517,236,281,14,503,270,508,13,3.90%
2019-07,חיפה,9800,בנימינה-גבעת עדה*,יישוב,152,62,90,69,83,15,151,3,2.01%
2019-07,חיפה,541,ג'סר א-זרקא,יישוב,241,141,100,3,238,43,240,12,3.73%
2019-07,חיפה,628,ג'ת,יישוב,178,95,83,11,167,78,176,6,3.05%
2019-07,חיפה,494,דאלית אל-כרמל,יישוב,441,186,255,23,418,190,423,6,4.80%
2019-07,חיפה,9300,זכרון יעקב,יישוב,265,108,157,115,150,13,264,6,2.31%
2019-07,חיפה,6500,חדרה,יישוב,2094,972,1122,247,1847,519,1985,51,3.82%
2019-07,חיפה,4000,חיפה,יישוב,5246,2487,2759,1177,4069,1896,4969,119,3.51%
2019-07,חיפה,1247,חריש,יישוב,295,100,195,64,231,32,287,5,6.48%
2019-07,חיפה,2100,טירת כרמל,יישוב,653,347,306,60,593,283,632,19,5.15%
2019-07,חיפה,654,כפר קרע,יישוב,371,162,209,21,350,163,361,8,3.85%
2019-07,חיפה,45,מ.א. אלונה,מועצה איזורית,25,7,18,9,16,0,25,0,2.34%
2019-07,חיפה,12,מ.א. זבולון,מועצה איזורית,221,110,111,26,195,108,211,0,3.56%
2019-07,חיפה,15,מ.א. חוף הכרמל,מועצה איזורית,299,141,158,118,181,40,290,0,1.96%
2019-07,חיפה,14,מ.א. מנשה,מועצה איזורית,247,110,137,75,172,47,247,0,2.87%
2019-07,חיפה,1327,מעלה עירון,יישוב,565,253,312,15,550,375,555,10,8.51%
2019-07,חיפה,2500,נשר,יישוב,396,172,224,88,308,100,380,6,2.99%
2019-07,חיפה,534,עספיא,יישוב,303,133,170,24,279,144,284,7,4.63%
2019-07,חיפה,637,ערערה,יישוב,503,210,293,20,483,266,485,10,5.37%
2019-07,חיפה,537,פוריידיס,יישוב,209,103,106,11,198,24,203,2,3.34%
2019-07,חיפה,7800,פרדס חנה-כרכור,יישוב,695,319,376,201,494,54,683,21,3.18%
2019-07,חיפה,6800,קריית אתא,יישוב,1342,603,739,133,1209,475,1292,41,4.17%
2019-07,חיפה,9500,קריית ביאליק,יישוב,763,340,423,105,658,261,743,16,3.49%
2019-07,חיפה,2300,קריית טבעון,יישוב,172,71,101,68,104,21,170,1,2.02%
2019-07,חיפה,9600,קריית ים,יישוב,1057,507,550,123,934,458,1007,30,4.76%
2019-07,חיפה,8200,קריית מוצקין,יישוב,832,385,447,137,695,247,805,19,3.46%
2019-07,חיפה,922,רכסים,יישוב,192,65,127,13,179,44,187,1,4.91%
2019-07,ירושלים,472,אבו גוש,יישוב,223,122,101,12,211,140,221,4,6.34%
2019-07,ירושלים,2610,בית שמש,יישוב,1865,644,1221,146,1719,271,1815,54,4.76%
2019-07,ירושלים,3000,ירושלים,יישוב,12805,5158,7647,1578,11227,5710,12458,136,3.87%
2019-07,ירושלים,26,מ.א. מטה יהודה,מועצה איזורית,657,284,373,177,480,89,650,1,2.51%
2019-07,ירושלים,1015,מבשרת ציון,יישוב,303,158,145,74,229,77,298,7,2.33%
2019-07,ירושלים,1137,קריית יערים,יישוב,76,22,54,18,58,11,76,0,4.19%
2019-07,תל אביב,2400,אור יהודה,יישוב,771,359,412,64,707,117,751,39,3.87%
2019-07,תל אביב,565,אזור,יישוב,204,81,123,38,166,15,203,1,3.01%
2019-07,תל אביב,6100,בני ברק,יישוב,2757,777,1980,133,2624,435,2659,20,4.31%
2019-07,תל אביב,6200,בת ים,יישוב,2466,1186,1280,392,2074,620,2351,83,3.33%
2019-07,תל אביב,6300,גבעתיים,יישוב,807,362,445,399,408,63,801,5,2.51%
2019-07,תל אביב,6400,הרצלייה,יישוב,1144,510,634,421,723,62,1127,5,2.29%
2019-07,תל אביב,6600,חולון,יישוב,3099,1372,1727,536,2563,419,3038,50,3.00%
2019-07,תל אביב,267,כפר שמריהו,יישוב,13,8,5,7,6,0,13,0,1.55%
2019-07,תל אביב,2620,קריית אונו,יישוב,445,183,262,222,223,34,439,1,2.24%
2019-07,תל אביב,8600,רמת גן,יישוב,2105,921,1184,815,1290,234,2065,27,2.52%
2019-07,תל אביב,2650,רמת השרון,יישוב,409,165,244,192,217,7,407,0,1.77%
2019-07,תל אביב,5000,תל אביב -יפו,יישוב,7301,3617,3684,3237,4064,1013,7180,99,2.72%
2019-08,אזור יהודה והשומרון,3760,אורנית,יישוב,100,38,62,39,61,1,100,2,1.99%
2019-08,אזור יהודה והשומרון,3750,אלפי מנשה,יישוב,105,42,63,28,77,1,105,1,2.36%
2019-08,אזור יהודה והשומרון,3560,אלקנה,יישוב,35,18,17,16,19,2,35,0,1.90%
2019-08,אזור יהודה והשומרון,3650,אפרת,יישוב,86,39,47,52,34,6,86,1,1.74%
2019-08,אזור יהודה והשומרון,3570,אריאל,יישוב,320,146,174,85,235,12,312,14,2.83%
2019-08,אזור יהודה והשומרון,3574,בית אל,יישוב,45,30,15,16,29,8,45,0,1.80%
2019-08,אזור יהודה והשומרון,3652,בית אריה,יישוב,53,28,25,10,43,1,51,0,1.78%
2019-08,אזור יהודה והשומרון,3780,ביתר עילית,יישוב,1101,311,790,31,1070,138,1093,6,6.75%
2019-08,אזור יהודה והשומרון,3730,גבעת זאב,יישוב,224,95,129,35,189,36,223,1,2.74%
2019-08,אזור יהודה והשומרון,3769,הר אדר,יישוב,50,20,30,24,26,4,50,1,2.27%
2019-08,אזור יהודה והשומרון,76,מ.א. גוש עציון,מועצה איזורית,204,91,113,72,132,16,196,0,1.93%
2019-08,אזור יהודה והשומרון,78,מ.א. הר חברון,מועצה איזורית,73,40,33,35,38,2,73,0,1.84%
2019-08,אזור יהודה והשומרון,74,מ.א. מגילות ים המלח,מועצה איזורית,31,14,17,12,19,0,31,0,3.36%
2019-08,אזור יהודה והשומרון,73,מ.א. מטה בנימין,מועצה איזורית,692,307,385,217,475,81,686,0,2.42%
2019-08,אזור יהודה והשומרון,75,מ.א. ערבות הירדן,מועצה איזורית,71,35,36,18,53,7,70,0,2.72%
2019-08,אזור יהודה והשומרון,72,מ.א. שומרון,מועצה איזורית,465,218,247,183,282,12,464,0,2.45%
2019-08,אזור יהודה והשומרון,3797,מודיעין עילית,יישוב,1149,162,987,36,1113,28,1145,8,6.84%
2019-08,אזור יהודה והשומרון,3616,מעלה אדומים,יישוב,619,253,366,109,510,92,608,14,2.90%
2019-08,אזור יהודה והשומרון,3608,מעלה אפרים,יישוב,39,16,23,2,37,10,38,0,4.70%
2019-08,אזור יהודה והשומרון,3660,עמנואל,יישוב,74,29,45,5,69,10,74,1,5.34%
2019-08,אזור יהודה והשומרון,3557,קדומים,יישוב,34,20,14,14,20,1,34,0,1.70%
2019-08,אזור יהודה והשומרון,3611,קריית ארבע,יישוב,89,49,40,19,70,26,88,1,2.62%
2019-08,אזור יהודה והשומרון,3640,קרני שומרון,יישוב,89,47,42,30,59,5,87,3,2.14%
2019-08,הדרום,31,אופקים,יישוב,1089,356,733,48,1041,317,1067,33,7.25%
2019-08,הדרום,2600,אילת,יישוב,948,457,491,62,886,221,900,38,2.61%
2019-08,הדרום,70,אשדוד,יישוב,5456,2111,3345,709,4747,1689,5257,77,4.67%
2019-08,הדרום,7100,אשקלון,יישוב,3551,1527,2024,448,3103,1225,3321,75,4.46%
2019-08,הדרום,9000,באר שבע,יישוב,5239,2380,2859,757,4482,2221,4978,82,4.64%
2019-08,הדרום,2200,דימונה,יישוב,1526,680,846,78,1448,872,1460,28,7.50%
2019-08,הדרום,1303,חורה,יישוב,479,216,263,9,470,391,460,9,9.61%
2019-08,הדרום,831,ירוחם,יישוב,421,190,231,15,406,205,403,10,7.79%
2019-08,הדרום,1059,כסיפה,יישוב,1009,399,610,2,1007,908,997,3,18.21%
2019-08,הדרום,1271,להבים,יישוב,43,21,22,18,25,2,43,0,1.22%
2019-08,הדרום,1060,לקיה,יישוב,595,254,341,6,589,460,567,1,11.60%
2019-08,הדרום,69,מ.א. אל קסום,מועצה איזורית,830,343,487,13,817,684,798,0,23.39%
2019-08,הדרום,38,מ.א. אשכול,מועצה איזורית,130,65,65,36,94,5,129,0,1.84%
2019-08,הדרום,33,מ.א. באר טוביה,מועצה איזורית,309,124,185,78,231,41,303,0,2.68%
2019-08,הדרום,41,מ.א. בני שמעון,מועצה איזורית,100,39,61,38,62,12,97,3,2.00%
2019-08,הדרום,54,מ.א. הערבה התיכונה,מועצה איזורית,46,18,28,16,30,1,45,0,2.36%
2019-08,הדרום,53,מ.א. חבל אילות,מועצה איזורית,26,14,12,5,21,1,26,2,1.05%
2019-08,הדרום,36,מ.א. חוף אשקלון,מועצה איזורית,235,105,130,56,179,35,224,0,2.58%
2019-08,הדרום,35,מ.א. יואב,מועצה איזורית,95,35,60,39,56,11,93,0,2.28%
2019-08,הדרום,50,מ.א. לכיש,מועצה איזורית,203,83,120,34,169,36,201,0,3.61%
2019-08,הדרום,42,מ.א. מרחבים,מועצה איזורית,205,63,142,31,174,25,201,0,3.19%
2019-08,הדרום,68,מ.א. נווה מדבר,מועצה איזורית,136,53,83,4,132,102,133,0,7.04%
2019-08,הדרום,48,מ.א. רמת נגב,מועצה איזורית,307,145,162,22,285,237,304,1,9.13%
2019-08,הדרום,39,מ.א. שדות נגב,מועצה איזורית,166,73,93,27,139,25,162,0,3.33%
2019-08,הדרום,37,מ.א. שער הנגב,מועצה איזורית,121,56,65,39,82,24,116,0,2.90%
2019-08,הדרום,34,מ.א. שפיר,מועצה איזורית,154,64,90,20,134,31,154,0,3.09%
2019-08,הדרום,51,מ.א. תמר,מועצה איזורית,19,11,8,2,17,1,19,0,2.92%
2019-08,הדרום,1268,מיתר,יישוב,74,33,41,40,34,3,74,1,1.50%
2019-08,הדרום,99,מצפה רמון,יישוב,250,92,158,15,235,150,246,6,8.75%
2019-08,הדרום,246,נתיבות,יישוב,1305,462,843,97,1208,363,1255,41,7.45%
2019-08,הדרום,666,עומר,יישוב,59,30,29,29,30,1,58,2,1.37%
2019-08,הדרום,2560,ערד,יישוב,687,310,377,81,606,247,665,28,5.21%
2019-08,הדרום,1192,ערערה-בנגב,יישוב,965,402,563,28,937,861,945,6,18.45%
2019-08,הדרום,2630,קריית גת,יישוב,1704,734,970,133,1571,551,1641,40,5.57%
2019-08,הדרום,1034,קריית מלאכי,יישוב,818,364,454,41,777,321,784,42,6.29%
2019-08,הדרום,1161,רהט,יישוב,2105,845,1260,26,2079,1358,2084,35,9.28%
2019-08,הדרום,1286,שגב-שלום,יישוב,362,155,207,8,354,257,348,3,10.66%
2019-08,הדרום,1031,שדרות,יישוב,978,464,514,61,917,434,881,25,5.91%
2019-08,הדרום,1054,תל שבע,יישוב,734,322,412,5,729,572,684,2,11.84%
2019-08,המרכז,1066,"בני עי""ש",יישוב,134,63,71,12,122,34,129,1,3.21%
2019-08,המרכז,182,אבן יהודה,יישוב,152,67,85,65,87,12,152,0,2.17%
2019-08,המרכז,41,אליכין,יישוב,57,29,28,13,44,10,54,3,2.75%
2019-08,המרכז,1309,אלעד,יישוב,817,198,619,43,774,28,811,9,5.51%
2019-08,המרכז,2530,באר יעקב,יישוב,315,126,189,74,241,27,309,2,2.39%
2019-08,המרכז,466,בית דגן,יישוב,111,53,58,21,90,21,111,0,2.96%
2019-08,המרכז,681,גבעת שמואל,יישוב,234,112,122,93,141,23,230,1,1.84%
2019-08,המרכז,2550,גדרה,יישוב,273,125,148,66,207,43,266,10,2.06%
2019-08,המרכז,627,ג'לג'וליה,יישוב,73,34,39,5,68,31,69,2,1.61%
2019-08,המרכז,166,גן יבנה,יישוב,350,133,217,70,280,49,344,5,2.70%
2019-08,המרכז,229,גני תקווה,יישוב,229,94,135,75,154,23,227,1,2.35%
2019-08,המרכז,9700,הוד השרון,יישוב,733,274,459,289,444,14,727,6,2.22%
2019-08,המרכז,1290,זמר,יישוב,111,53,58,8,103,53,110,4,3.37%
2019-08,המרכז,2730,טייבה,יישוב,774,356,418,22,752,443,662,23,3.44%
2019-08,המרכז,2720,טירה,יישוב,171,82,89,19,152,17,169,11,1.35%
2019-08,המרכז,2660,יבנה,יישוב,737,327,410,137,600,112,727,24,2.88%
2019-08,המרכז,9400,יהוד,יישוב,386,155,231,117,269,17,385,8,2.36%
2019-08,המרכז,1224,כוכב יאיר,יישוב,80,31,49,44,36,1,80,2,1.44%
2019-08,המרכז,633,כפר ברא,יישוב,30,13,17,3,27,5,30,2,1.84%
2019-08,המרכז,168,כפר יונה,יישוב,365,164,201,70,295,38,359,3,3.04%
2019-08,המרכז,6900,כפר סבא,יישוב,1139,469,670,436,703,37,1133,13,2.14%
2019-08,המרכז,634,כפר קאסם,יישוב,198,94,104,10,188,67,193,7,1.87%
2019-08,המרכז,7000,לוד,יישוב,1448,666,782,121,1327,574,1424,29,3.87%
2019-08,המרכז,28,מ.א. ברנר,מועצה איזורית,84,33,51,28,56,5,84,3,2.05%
2019-08,המרכז,32,מ.א. גדרות,מועצה איזורית,35,10,25,20,15,0,35,0,1.42%
2019-08,המרכז,30,מ.א. גזר,מועצה איזורית,326,125,201,118,208,24,324,0,2.41%
2019-08,המרכז,27,מ.א. גן רווה,מועצה איזורית,58,25,33,27,31,4,57,0,1.90%
2019-08,המרכז,20,מ.א. דרום השרון,מועצה איזורית,348,143,205,147,201,6,346,0,2.14%
2019-08,המרכז,29,מ.א. חבל יבנה,מועצה איזורית,42,17,25,18,24,0,41,1,1.56%
2019-08,המרכז,25,מ.א. חבל מודיעין,מועצה איזורית,232,91,141,63,169,15,228,0,2.07%
2019-08,המרכז,19,מ.א. חוף השרון,מועצה איזורית,96,37,59,52,44,5,96,0,1.72%
2019-08,המרכז,18,מ.א. לב השרון,מועצה איזורית,287,119,168,82,205,26,282,0,2.54%
2019-08,המרכז,31,מ.א. נחל שורק,מועצה איזורית,77,29,48,18,59,8,76,33,1.67%
2019-08,המרכז,16,מ.א. עמק חפר,מועצה איזורית,373,172,201,142,231,17,370,0,1.88%
2019-08,המרכז,40,מ.א. שדות דן,מועצה איזורית,171,69,102,44,127,10,169,0,2.62%
2019-08,המרכז,1200,מודיעין-מכבים-רעות*,יישוב,953,373,580,376,577,23,942,14,2.04%
2019-08,המרכז,28,מזכרת בתיה,יישוב,186,65,121,66,120,16,185,3,2.26%
2019-08,המרכז,7200,נס ציונה,יישוב,619,250,369,180,439,93,606,7,2.44%
2019-08,המרכז,7400,נתניה,יישוב,4101,1783,2318,550,3551,835,4044,72,3.71%
2019-08,המרכז,587,סביון*,יישוב,17,9,8,12,5,0,17,0,0.82%
2019-08,המרכז,171,פרדסייה,יישוב,74,39,35,21,53,2,73,0,1.94%
2019-08,המרכז,7900,פתח תקווה,יישוב,3892,1647,2245,827,3065,619,3804,66,2.94%
2019-08,המרכז,195,קדימה-צורן,יישוב,275,110,165,98,177,17,273,3,2.32%
2019-08,המרכז,638,קלנסווה,יישוב,298,147,151,13,285,137,263,6,2.72%
2019-08,המרכז,469,קריית עקרון,יישוב,244,106,138,18,226,74,238,4,3.89%
2019-08,המרכז,2640,ראש העין,יישוב,1100,424,676,201,899,96,1092,11,3.49%
2019-08,המרכז,8300,ראשון לציון,יישוב,3816,1682,2134,830,2986,517,3784,61,2.69%
2019-08,המרכז,8400,רחובות,יישוב,2318,912,1406,505,1813,432,2262,48,3.17%
2019-08,המרכז,8500,רמלה,יישוב,1351,597,754,97,1254,393,1317,51,3.39%
2019-08,המרכז,8700,רעננה,יישוב,748,304,444,320,428,20,738,5,1.95%
2019-08,המרכז,1304,שוהם,יישוב,198,80,118,86,112,5,198,5,1.63%
2019-08,המרכז,154,תל מונד,יישוב,163,66,97,57,106,15,163,1,2.35%
2019-08,הצפון,473,אבו סנאן,יישוב,478,218,260,3,475,304,469,4,7.46%
2019-08,הצפון,478,אכסאל,יישוב,366,169,197,18,348,280,364,1,5.74%
2019-08,הצפון,529,אעבלין,יישוב,331,141,190,19,312,221,325,4,5.28%
2019-08,הצפון,482,בועיינה-נוג'ידאת,יישוב,212,99,113,12,200,137,210,6,4.88%
2019-08,הצפון,4001,בוקעאתא,יישוב,213,91,122,5,208,152,209,3,7.16%
2019-08,הצפון,998,ביר אל-מכסור,יישוב,245,134,111,5,240,145,244,2,5.87%
2019-08,הצפון,480,בית ג'ן,יישוב,370,114,256,21,349,208,356,0,5.93%
2019-08,הצפון,9200,בית שאן,יישוב,630,296,334,34,596,256,613,30,5.83%
2019-08,הצפון,944,בסמת טבעון,יישוב,145,72,73,7,138,76,140,0,3.88%
2019-08,הצפון,483,בענה,יישוב,285,135,150,7,278,208,278,1,7.18%
2019-08,הצפון,1292,ג'דיידה-מכר,יישוב,924,407,517,13,911,588,909,13,8.89%
2019-08,הצפון,485,ג'ולס,יישוב,164,50,114,2,162,69,164,2,5.01%
2019-08,הצפון,487,ג'ש (גוש חלב),יישוב,46,19,27,7,39,17,45,0,2.63%
2019-08,הצפון,489,דבורייה,יישוב,203,103,100,11,192,134,202,0,4.30%
2019-08,הצפון,490,דייר אל-אסד,יישוב,328,134,194,15,313,214,317,2,5.50%
2019-08,הצפון,492,דייר חנא,יישוב,426,182,244,13,413,276,424,2,8.09%
2019-08,הצפון,975,זרזיר,יישוב,205,90,115,5,200,88,202,7,5.60%
2019-08,הצפון,496,חורפיש,יישוב,88,41,47,9,79,39,80,0,2.63%
2019-08,הצפון,2034,חצור הגלילית,יישוב,236,100,136,20,216,95,222,8,4.54%
2019-08,הצפון,6700,טבריה,יישוב,1327,583,744,84,1243,502,1215,46,5.43%
2019-08,הצפון,962,טובא-זנגרייה,יישוב,255,100,155,4,251,147,247,7,7.32%
2019-08,הצפון,498,טורעאן,יישוב,327,128,199,24,303,208,324,4,5.11%
2019-08,הצפון,8900,טמרה,יישוב,1067,521,546,32,1035,748,1050,6,6.79%
2019-08,הצפון,1295,יאנוח-ג'ת,יישוב,125,51,74,8,117,48,121,5,3.77%
2019-08,הצפון,46,יבנאל,יישוב,108,50,58,7,101,43,105,2,6.48%
2019-08,הצפון,29,יסוד המעלה,יישוב,22,9,13,7,15,5,22,1,2.49%
2019-08,הצפון,499,יפיע,יישוב,440,200,240,28,412,289,437,1,5.07%
2019-08,הצפון,240,יקנעם עילית,יישוב,492,210,282,93,399,86,484,27,3.73%
2019-08,הצפון,502,ירכא,יישוב,327,128,199,3,324,198,323,5,4.62%
2019-08,הצפון,504,כאבול,יישוב,331,172,159,8,323,233,323,4,6.03%
2019-08,הצפון,505,כאוכב אבו אל-היג'א,יישוב,171,73,98,8,163,117,169,0,8.96%
2019-08,הצפון,1296,כסרא-סמיע,יישוב,165,71,94,4,161,67,157,6,4.05%
2019-08,הצפון,978,כעביה-טבאש-חג'אג'רה,יישוב,143,59,84,4,139,80,140,3,5.43%
2019-08,הצפון,1263,כפר ורדים,יישוב,69,23,46,27,42,3,68,1,2.18%
2019-08,הצפון,507,כפר יאסיף,יישוב,311,129,182,10,301,176,305,1,5.66%
2019-08,הצפון,508,כפר כמא,יישוב,34,19,15,2,32,11,33,0,1.92%
2019-08,הצפון,509,כפר כנא,יישוב,634,316,318,31,603,448,616,16,6.38%
2019-08,הצפון,510,כפר מנדא,יישוב,624,314,310,21,603,393,620,3,7.68%
2019-08,הצפון,47,כפר תבור,יישוב,47,17,30,17,30,1,46,1,1.94%
2019-08,הצפון,1139,כרמיאל,יישוב,1314,533,781,277,1037,537,1226,43,4.73%
2019-08,הצפון,65,מ.א. אל-בטוף,מועצה איזורית,195,97,98,15,180,125,188,0,5.78%
2019-08,הצפון,66,מ.א. בוסתן אל-מרג,מועצה איזורית,21,8,13,0,21,17,21,0,0.60%
2019-08,הצפון,71,מ.א. גולן,מועצה איזורית,225,107,118,66,159,17,223,0,2.54%
2019-08,הצפון,8,מ.א. הגלבוע,מועצה איזורית,533,213,320,69,464,211,528,0,3.74%
2019-08,הצפון,1,מ.א. הגליל העליון,מועצה איזורית,193,79,114,89,104,11,187,0,2.09%
2019-08,הצפון,3,מ.א. הגליל התחתון,מועצה איזורית,140,64,76,43,97,9,139,0,2.31%
2019-08,הצפון,55,מ.א. מבואות החרמון,מועצה איזורית,97,33,64,22,75,16,94,0,2.34%
2019-08,הצפון,13,מ.א. מגידו,מועצה איזורית,110,53,57,41,69,10,108,0,1.91%
2019-08,הצפון,4,מ.א. מטה אשר,מועצה איזורית,416,179,237,84,332,125,403,0,2.84%
2019-08,הצפון,52,מ.א. מעלה יוסף,מועצה איזורית,183,73,110,28,155,37,179,1,3.12%
2019-08,הצפון,2,מ.א. מרום הגליל,מועצה איזורית,279,116,163,33,246,91,277,0,3.88%
2019-08,הצפון,56,מ.א. משגב,מועצה איזורית,501,226,275,121,380,213,490,0,3.47%
2019-08,הצפון,6,מ.א. עמק הירדן,מועצה איזורית,159,70,89,39,120,20,152,0,2.24%
2019-08,הצפון,7,מ.א. עמק המעיינות,מועצה איזורית,183,80,103,49,134,34,178,0,2.71%
2019-08,הצפון,9,מ.א. עמק יזרעאל,מועצה איזורית,387,161,226,172,215,32,382,0,1.95%
2019-08,הצפון,481,מגאר,יישוב,867,362,505,31,836,582,854,7,8.12%
2019-08,הצפון,516,מג'ד אל-כרום,יישוב,467,191,276,14,453,255,457,0,6.16%
2019-08,הצפון,65,מגדל,יישוב,31,12,19,4,27,6,28,0,2.82%
2019-08,הצפון,874,מגדל העמק,יישוב,841,363,478,93,748,215,802,48,5.80%
2019-08,הצפון,4201,מג'דל שמס,יישוב,273,100,173,11,262,181,268,8,5.16%
2019-08,הצפון,517,מזרעה,יישוב,147,70,77,4,143,80,143,1,6.62%
2019-08,הצפון,43,מטולה,יישוב,21,10,11,6,15,3,21,0,2.09%
2019-08,הצפון,4203,מסעדה,יישוב,133,49,84,6,127,86,129,2,7.24%
2019-08,הצפון,518,מעיליא,יישוב,51,21,30,5,46,19,51,0,2.97%
2019-08,הצפון,1063,מעלות-תרשיחא,יישוב,727,342,385,86,641,271,696,38,5.69%
2019-08,הצפון,520,משהד,יישוב,173,73,100,9,164,118,173,2,4.81%
2019-08,הצפון,9100,נהרייה,יישוב,1568,746,822,195,1373,693,1483,47,4.69%
2019-08,הצפון,522,נחף,יישוב,359,161,198,14,345,237,356,2,6.33%
2019-08,הצפון,7300,נצרת,יישוב,2355,1069,1286,128,2227,1505,2340,11,6.36%
2019-08,הצפון,1061,נצרת עילית,יישוב,1243,558,685,142,1101,451,1157,81,4.92%
2019-08,הצפון,525,סאג'ור,יישוב,120,35,85,9,111,59,117,4,5.34%
2019-08,הצפון,7500,סח'נין,יישוב,1338,599,739,64,1274,942,1324,13,8.67%
2019-08,הצפון,4501,ע'ג'ר,יישוב,84,34,50,3,81,39,81,1,6.74%
2019-08,הצפון,530,עיילבון,יישוב,147,70,77,6,141,71,145,1,4.99%
2019-08,הצפון,511,עילוט,יישוב,244,112,132,7,237,160,244,0,7.59%
2019-08,הצפון,532,עין מאהל,יישוב,307,144,163,12,295,211,301,3,5.15%
2019-08,הצפון,4502,עין קנייא,יישוב,82,31,51,1,81,60,78,3,7.20%
2019-08,הצפון,7600,עכו,יישוב,2673,1092,1581,173,2500,1601,2570,38,9.42%
2019-08,הצפון,7700,עפולה,יישוב,1671,678,993,182,1489,439,1605,65,5.79%
2019-08,הצפון,531,עראבה,יישוב,916,403,513,46,870,719,905,11,8.17%
2019-08,הצפון,535,פסוטה,יישוב,83,36,47,10,73,31,79,3,4.39%
2019-08,הצפון,536,פקיעין (בוקייעה),יישוב,96,51,45,10,86,52,94,1,3.15%
2019-08,הצפון,8000,צפת,יישוב,966,430,536,87,879,440,931,15,6.65%
2019-08,הצפון,4100,קצרין,יישוב,175,80,95,30,145,53,167,6,4.17%
2019-08,הצפון,2800,קריית שמונה,יישוב,665,306,359,74,591,202,637,22,4.90%
2019-08,הצפון,543,ראמה,יישוב,227,89,138,20,207,127,217,2,5.28%
2019-08,הצפון,26,ראש פינה,יישוב,47,17,30,8,39,19,47,0,2.85%
2019-08,הצפון,542,ריינה,יישוב,397,185,212,21,376,244,388,8,5.25%
2019-08,הצפון,122,רמת ישי,יישוב,92,34,58,29,63,9,90,3,2.18%
2019-08,הצפון,913,שבלי - אום אל-גנם,יישוב,163,58,105,8,155,79,160,2,5.62%
2019-08,הצפון,812,שלומי,יישוב,192,89,103,14,178,65,186,1,5.09%
2019-08,הצפון,538,שעב,יישוב,325,145,180,10,315,239,321,6,9.65%
2019-08,הצפון,8800,שפרעם,יישוב,1138,507,631,48,1090,708,1121,24,5.76%
2019-08,חיפה,1326,"בסמ""ה",יישוב,250,111,139,5,245,179,247,1,5.58%
2019-08,חיפה,2710,אום אל-פחם,יישוב,2143,950,1193,49,2094,1533,2100,45,9.10%
2019-08,חיפה,1020,אור עקיבא,יישוב,486,246,240,56,430,99,475,7,4.49%
2019-08,חיפה,6000,באקה אל-גרביה,יישוב,487,235,252,13,474,260,478,14,3.68%
2019-08,חיפה,9800,בנימינה-גבעת עדה*,יישוב,147,61,86,59,88,11,145,1,1.93%
2019-08,חיפה,541,ג'סר א-זרקא,יישוב,217,126,91,5,212,43,214,5,3.34%
2019-08,חיפה,628,ג'ת,יישוב,160,91,69,8,152,79,159,3,2.76%
2019-08,חיפה,494,דאלית אל-כרמל,יישוב,409,167,242,27,382,174,395,5,4.50%
2019-08,חיפה,9300,זכרון יעקב,יישוב,234,100,134,101,133,10,233,0,2.04%
2019-08,חיפה,6500,חדרה,יישוב,2012,896,1116,246,1766,493,1901,29,3.66%
2019-08,חיפה,4000,חיפה,יישוב,4986,2303,2683,1119,3867,1760,4741,95,3.36%
2019-08,חיפה,1247,חריש,יישוב,297,109,188,58,239,31,292,2,6.58%
2019-08,חיפה,2100,טירת כרמל,יישוב,636,314,322,55,581,273,616,16,5.02%
2019-08,חיפה,654,כפר קרע,יישוב,348,151,197,23,325,157,339,3,3.62%
2019-08,חיפה,45,מ.א. אלונה,מועצה איזורית,24,7,17,9,15,0,23,0,2.16%
2019-08,חיפה,12,מ.א. זבולון,מועצה איזורית,205,101,104,27,178,94,196,0,3.31%
2019-08,חיפה,15,מ.א. חוף הכרמל,מועצה איזורית,306,139,167,119,187,43,301,0,2.03%
2019-08,חיפה,14,מ.א. מנשה,מועצה איזורית,240,102,138,74,166,49,240,0,2.79%
2019-08,חיפה,1327,מעלה עירון,יישוב,546,243,303,10,536,369,538,6,8.27%
2019-08,חיפה,2500,נשר,יישוב,390,163,227,88,302,103,370,10,2.92%
2019-08,חיפה,534,עספיא,יישוב,283,125,158,20,263,129,270,8,4.41%
2019-08,חיפה,637,ערערה,יישוב,462,194,268,19,443,257,448,5,4.98%
2019-08,חיפה,537,פוריידיס,יישוב,181,95,86,13,168,26,180,1,2.97%
2019-08,חיפה,7800,פרדס חנה-כרכור,יישוב,644,288,356,193,451,50,634,17,2.96%
2019-08,חיפה,6800,קריית אתא,יישוב,1336,571,765,129,1207,441,1299,35,4.19%
2019-08,חיפה,9500,קריית ביאליק,יישוב,767,315,452,110,657,259,742,20,3.48%
2019-08,חיפה,2300,קריית טבעון,יישוב,172,73,99,66,106,21,171,2,2.04%
2019-08,חיפה,9600,קריית ים,יישוב,1031,494,537,122,909,452,982,29,4.65%
2019-08,חיפה,8200,קריית מוצקין,יישוב,796,356,440,134,662,229,774,20,3.33%
2019-08,חיפה,922,רכסים,יישוב,220,60,160,13,207,48,214,0,5.58%
2019-08,ירושלים,472,אבו גוש,יישוב,214,116,98,8,206,135,213,2,6.13%
2019-08,ירושלים,2610,בית שמש,יישוב,1883,579,1304,142,1741,249,1841,45,4.82%
2019-08,ירושלים,3000,ירושלים,יישוב,13053,4977,8076,1561,11492,5535,12782,116,3.96%
2019-08,ירושלים,26,מ.א. מטה יהודה,מועצה איזורית,629,257,372,171,458,82,623,0,2.41%
2019-08,ירושלים,1015,מבשרת ציון,יישוב,308,152,156,77,231,73,301,5,2.36%
2019-08,ירושלים,1137,קריית יערים,יישוב,75,18,57,16,59,9,75,0,4.13%
2019-08,תל אביב,2400,אור יהודה,יישוב,802,317,485,65,737,97,784,25,4.03%
2019-08,תל אביב,565,אזור,יישוב,179,71,108,37,142,13,179,3,2.67%
2019-08,תל אביב,6100,בני ברק,יישוב,3315,772,2543,133,3182,404,3228,14,5.19%
2019-08,תל אביב,6200,בת ים,יישוב,2343,1114,1229,376,1967,554,2247,71,3.19%
2019-08,תל אביב,6300,גבעתיים,יישוב,784,337,447,395,389,54,781,6,2.45%
2019-08,תל אביב,6400,הרצלייה,יישוב,1135,481,654,419,716,56,1125,13,2.28%
2019-08,תל אביב,6600,חולון,יישוב,2954,1271,1683,506,2448,393,2902,56,2.87%
2019-08,תל אביב,267,כפר שמריהו,יישוב,16,8,8,9,7,0,16,0,1.90%
2019-08,תל אביב,2620,קריית אונו,יישוב,461,183,278,227,234,31,453,1,2.31%
2019-08,תל אביב,8600,רמת גן,יישוב,2064,870,1194,807,1257,207,2034,29,2.49%
2019-08,תל אביב,2650,רמת השרון,יישוב,409,146,263,179,230,8,408,3,1.78%
2019-08,תל אביב,5000,תל אביב -יפו,יישוב,7128,3439,3689,3164,3964,945,7032,100,2.67%
2019-09,אזור יהודה והשומרון,3760,אורנית,יישוב,102,44,58,43,59,2,102,1,2.03%
2019-09,אזור יהודה והשומרון,3750,אלפי מנשה,יישוב,95,37,58,26,69,1,95,1,2.14%
2019-09,אזור יהודה והשומרון,3560,אלקנה,יישוב,32,16,16,15,17,2,32,0,1.74%
2019-09,אזור יהודה והשומרון,3650,אפרת,יישוב,91,45,46,53,38,6,89,0,1.80%
2019-09,אזור יהודה והשומרון,3570,אריאל,יישוב,325,152,173,98,227,15,320,9,2.90%
2019-09,אזור יהודה והשומרון,3574,בית אל,יישוב,46,26,20,19,27,9,43,0,1.72%
2019-09,אזור יהודה והשומרון,3652,בית אריה,יישוב,64,28,36,16,48,1,63,0,2.19%
2019-09,אזור יהודה והשומרון,3780,ביתר עילית,יישוב,705,276,429,29,676,142,693,4,4.39%
2019-09,אזור יהודה והשומרון,3730,גבעת זאב,יישוב,217,100,117,42,175,39,215,6,2.64%
2019-09,אזור יהודה והשומרון,3769,הר אדר,יישוב,51,21,30,22,29,3,50,0,2.27%
2019-09,אזור יהודה והשומרון,76,מ.א. גוש עציון,מועצה איזורית,212,92,120,81,131,17,209,0,2.06%
2019-09,אזור יהודה והשומרון,78,מ.א. הר חברון,מועצה איזורית,100,53,47,44,56,2,99,0,2.50%
2019-09,אזור יהודה והשומרון,74,מ.א. מגילות ים המלח,מועצה איזורית,34,15,19,12,22,0,34,0,3.68%
2019-09,אזור יהודה והשומרון,73,מ.א. מטה בנימין,מועצה איזורית,669,305,364,232,437,82,664,0,2.34%
2019-09,אזור יהודה והשומרון,75,מ.א. ערבות הירדן,מועצה איזורית,71,31,40,25,46,5,71,0,2.76%
2019-09,אזור יהודה והשומרון,72,מ.א. שומרון,מועצה איזורית,495,233,262,205,290,12,495,0,2.61%
2019-09,אזור יהודה והשומרון,3797,מודיעין עילית,יישוב,746,168,578,38,708,26,741,4,4.53%
2019-09,אזור יהודה והשומרון,3616,מעלה אדומים,יישוב,598,260,338,98,500,89,588,15,2.81%
2019-09,אזור יהודה והשומרון,3608,מעלה אפרים,יישוב,33,13,20,3,30,9,32,1,3.99%
2019-09,אזור יהודה והשומרון,3660,עמנואל,יישוב,60,28,32,3,57,10,60,1,4.37%
2019-09,אזור יהודה והשומרון,3557,קדומים,יישוב,40,20,20,17,23,2,40,0,2.00%
2019-09,אזור יהודה והשומרון,3611,קריית ארבע,יישוב,98,44,54,19,79,26,96,7,2.85%
2019-09,אזור יהודה והשומרון,3640,קרני שומרון,יישוב,96,47,49,30,66,5,93,1,2.28%
2019-09,הדרום,31,אופקים,יישוב,997,398,599,61,936,327,972,26,6.65%
2019-09,הדרום,2600,אילת,יישוב,993,481,512,66,927,235,947,50,2.74%
2019-09,הדרום,70,אשדוד,יישוב,5001,2138,2863,690,4311,1686,4805,84,4.28%
2019-09,הדרום,7100,אשקלון,יישוב,3635,1602,2033,486,3149,1265,3377,77,4.54%
2019-09,הדרום,9000,באר שבע,יישוב,5336,2455,2881,811,4525,2280,5037,118,4.69%
2019-09,הדרום,2200,דימונה,יישוב,1519,675,844,80,1439,892,1441,31,7.41%
2019-09,הדרום,1303,חורה,יישוב,483,214,269,13,470,398,461,3,9.62%
2019-09,הדרום,831,ירוחם,יישוב,446,209,237,21,425,215,421,16,8.11%
2019-09,הדרום,1059,כסיפה,יישוב,1056,427,629,5,1051,937,1043,2,18.89%
2019-09,הדרום,1271,להבים,יישוב,46,22,24,17,29,2,46,0,1.30%
2019-09,הדרום,1060,לקיה,יישוב,576,266,310,8,568,470,544,4,11.18%
2019-09,הדרום,69,מ.א. אל קסום,מועצה איזורית,862,362,500,14,848,707,827,0,24.24%
2019-09,הדרום,38,מ.א. אשכול,מועצה איזורית,147,74,73,43,104,4,146,0,2.08%
2019-09,הדרום,33,מ.א. באר טוביה,מועצה איזורית,333,129,204,82,251,44,328,0,2.90%
2019-09,הדרום,41,מ.א. בני שמעון,מועצה איזורית,109,42,67,50,59,13,105,3,2.16%
2019-09,הדרום,54,מ.א. הערבה התיכונה,מועצה איזורית,48,16,32,17,31,0,48,0,2.52%
2019-09,הדרום,53,מ.א. חבל אילות,מועצה איזורית,25,10,15,3,22,2,25,0,1.01%
2019-09,הדרום,36,מ.א. חוף אשקלון,מועצה איזורית,245,100,145,62,183,34,239,0,2.75%
2019-09,הדרום,35,מ.א. יואב,מועצה איזורית,90,33,57,32,58,10,89,0,2.18%
2019-09,הדרום,50,מ.א. לכיש,מועצה איזורית,221,97,124,38,183,39,218,0,3.91%
2019-09,הדרום,42,מ.א. מרחבים,מועצה איזורית,206,69,137,38,168,23,203,0,3.22%
2019-09,הדרום,68,מ.א. נווה מדבר,מועצה איזורית,140,53,87,4,136,104,136,0,7.20%
2019-09,הדרום,48,מ.א. רמת נגב,מועצה איזורית,319,151,168,25,294,236,317,1,9.52%
2019-09,הדרום,39,מ.א. שדות נגב,מועצה איזורית,158,75,83,25,133,22,155,0,3.19%
2019-09,הדרום,37,מ.א. שער הנגב,מועצה איזורית,116,50,66,43,73,24,113,2,2.83%
2019-09,הדרום,34,מ.א. שפיר,מועצה איזורית,167,74,93,27,140,30,166,0,3.33%
2019-09,הדרום,51,מ.א. תמר,מועצה איזורית,18,10,8,3,15,1,18,0,2.76%
2019-09,הדרום,1268,מיתר,יישוב,73,33,40,42,31,3,73,0,1.48%
2019-09,הדרום,99,מצפה רמון,יישוב,241,94,147,14,227,157,236,3,8.43%
2019-09,הדרום,246,נתיבות,יישוב,1098,440,658,81,1017,361,1046,36,6.29%
2019-09,הדרום,666,עומר,יישוב,56,30,26,29,27,1,55,0,1.30%
2019-09,הדרום,2560,ערד,יישוב,689,319,370,83,606,259,661,24,5.18%
2019-09,הדרום,1192,ערערה-בנגב,יישוב,990,425,565,30,960,892,959,6,18.68%
2019-09,הדרום,2630,קריית גת,יישוב,1724,718,1006,128,1596,573,1665,30,5.65%
2019-09,הדרום,1034,קריית מלאכי,יישוב,810,365,445,45,765,321,766,38,6.15%
2019-09,הדרום,1161,רהט,יישוב,2115,887,1228,25,2090,1366,2093,40,9.31%
2019-09,הדרום,1286,שגב-שלום,יישוב,351,148,203,7,344,273,336,2,10.33%
2019-09,הדרום,1031,שדרות,יישוב,991,468,523,83,908,436,895,22,6.00%
2019-09,הדרום,1054,תל שבע,יישוב,742,349,393,4,738,609,680,10,11.78%
2019-09,המרכז,1066,"בני עי""ש",יישוב,121,60,61,13,108,36,116,4,2.90%
2019-09,המרכז,182,אבן יהודה,יישוב,165,67,98,73,92,14,165,1,2.35%
2019-09,המרכז,41,אליכין,יישוב,72,36,36,16,56,8,69,3,3.49%
2019-09,המרכז,1309,אלעד,יישוב,483,167,316,34,449,36,473,4,3.29%
2019-09,המרכז,2530,באר יעקב,יישוב,316,127,189,80,236,25,310,3,2.40%
2019-09,המרכז,466,בית דגן,יישוב,100,46,54,18,82,17,100,0,2.67%
2019-09,המרכז,681,גבעת שמואל,יישוב,244,115,129,106,138,27,241,1,1.93%
2019-09,המרכז,2550,גדרה,יישוב,315,139,176,73,242,47,308,9,2.37%
2019-09,המרכז,627,ג'לג'וליה,יישוב,78,38,40,7,71,33,75,2,1.75%
2019-09,המרכז,166,גן יבנה,יישוב,353,135,218,75,278,53,346,4,2.71%
2019-09,המרכז,229,גני תקווה,יישוב,245,101,144,83,162,25,243,1,2.51%
2019-09,המרכז,9700,הוד השרון,יישוב,720,279,441,325,395,13,714,8,2.18%
2019-09,המרכז,1290,זמר,יישוב,123,58,65,10,113,54,121,5,3.69%
2019-09,המרכז,2730,טייבה,יישוב,781,352,429,29,752,441,667,19,3.47%
2019-09,המרכז,2720,טירה,יישוב,173,97,76,24,149,14,171,11,1.36%
2019-09,המרכז,2660,יבנה,יישוב,735,320,415,141,594,115,725,19,2.87%
2019-09,המרכז,9400,יהוד,יישוב,390,164,226,116,274,27,382,3,2.34%
2019-09,המרכז,1224,כוכב יאיר,יישוב,82,36,46,43,39,1,81,1,1.46%
2019-09,המרכז,633,כפר ברא,יישוב,25,10,15,2,23,5,25,0,1.54%
2019-09,המרכז,168,כפר יונה,יישוב,370,164,206,75,295,40,365,4,3.09%
2019-09,המרכז,6900,כפר סבא,יישוב,1181,519,662,454,727,44,1170,22,2.21%
2019-09,המרכז,634,כפר קאסם,יישוב,186,93,93,9,177,67,180,3,1.74%
2019-09,המרכז,7000,לוד,יישוב,1489,701,788,119,1370,590,1458,34,3.96%
2019-09,המרכז,28,מ.א. ברנר,מועצה איזורית,86,37,49,29,57,5,86,2,2.10%
2019-09,המרכז,32,מ.א. גדרות,מועצה איזורית,33,11,22,18,15,2,32,0,1.30%
2019-09,המרכז,30,מ.א. גזר,מועצה איזורית,311,124,187,122,189,24,309,0,2.30%
2019-09,המרכז,27,מ.א. גן רווה,מועצה איזורית,58,22,36,28,30,3,58,0,1.94%
2019-09,המרכז,20,מ.א. דרום השרון,מועצה איזורית,342,138,204,145,197,7,341,0,2.11%
2019-09,המרכז,29,מ.א. חבל יבנה,מועצה איזורית,41,12,29,18,23,1,40,1,1.53%
2019-09,המרכז,25,מ.א. חבל מודיעין,מועצה איזורית,243,91,152,79,164,10,240,0,2.18%
2019-09,המרכז,19,מ.א. חוף השרון,מועצה איזורית,106,46,60,57,49,3,105,0,1.89%
2019-09,המרכז,18,מ.א. לב השרון,מועצה איזורית,259,117,142,76,183,22,256,0,2.30%
2019-09,המרכז,31,מ.א. נחל שורק,מועצה איזורית,71,29,42,19,52,6,70,26,1.57%
2019-09,המרכז,16,מ.א. עמק חפר,מועצה איזורית,381,176,205,152,229,16,379,0,1.93%
2019-09,המרכז,40,מ.א. שדות דן,מועצה איזורית,171,78,93,42,129,10,170,0,2.64%
2019-09,המרכז,1200,מודיעין-מכבים-רעות*,יישוב,984,400,584,404,580,24,972,11,2.10%
2019-09,המרכז,28,מזכרת בתיה,יישוב,179,71,108,69,110,14,176,2,2.16%
2019-09,המרכז,7200,נס ציונה,יישוב,566,240,326,165,401,84,559,10,2.26%
2019-09,המרכז,7400,נתניה,יישוב,3727,1768,1959,561,3166,845,3661,78,3.37%
2019-09,המרכז,587,סביון*,יישוב,20,8,12,12,8,0,20,0,0.96%
2019-09,המרכז,171,פרדסייה,יישוב,72,35,37,20,52,2,70,2,1.86%
2019-09,המרכז,7900,פתח תקווה,יישוב,3821,1689,2132,846,2975,602,3733,63,2.88%
2019-09,המרכז,195,קדימה-צורן,יישוב,265,112,153,93,172,17,263,0,2.24%
2019-09,המרכז,638,קלנסווה,יישוב,312,152,160,17,295,143,275,10,2.84%
2019-09,המרכז,469,קריית עקרון,יישוב,194,96,98,12,182,65,188,8,3.10%
2019-09,המרכז,2640,ראש העין,יישוב,1005,415,590,209,796,98,995,15,3.19%
2019-09,המרכז,8300,ראשון לציון,יישוב,3925,1709,2216,843,3082,567,3872,46,2.75%
2019-09,המרכז,8400,רחובות,יישוב,2129,914,1215,511,1618,470,2053,51,2.89%
2019-09,המרכז,8500,רמלה,יישוב,1387,633,754,111,1276,412,1347,53,3.47%
2019-09,המרכז,8700,רעננה,יישוב,777,311,466,338,439,26,768,7,2.02%
2019-09,המרכז,1304,שוהם,יישוב,199,88,111,88,111,6,197,0,1.63%
2019-09,המרכז,154,תל מונד,יישוב,155,73,82,57,98,14,155,2,2.24%
2019-09,הצפון,473,אבו סנאן,יישוב,482,218,264,10,472,302,474,9,7.53%
2019-09,הצפון,478,אכסאל,יישוב,386,173,213,23,363,292,385,0,6.05%
2019-09,הצפון,529,אעבלין,יישוב,328,148,180,18,310,222,321,8,5.22%
2019-09,הצפון,482,בועיינה-נוג'ידאת,יישוב,201,96,105,11,190,133,197,3,4.59%
2019-09,הצפון,4001,בוקעאתא,יישוב,212,98,114,5,207,147,210,3,7.20%
2019-09,הצפון,998,ביר אל-מכסור,יישוב,257,138,119,5,252,149,256,1,6.14%
2019-09,הצפון,480,בית ג'ן,יישוב,345,111,234,17,328,198,330,2,5.52%
2019-09,הצפון,9200,בית שאן,יישוב,680,308,372,45,635,269,655,29,6.20%
2019-09,הצפון,944,בסמת טבעון,יישוב,154,78,76,7,147,82,146,0,4.04%
2019-09,הצפון,483,בענה,יישוב,283,132,151,9,274,212,274,5,7.09%
2019-09,הצפון,1292,ג'דיידה-מכר,יישוב,899,407,492,15,884,602,884,6,8.66%
2019-09,הצפון,485,ג'ולס,יישוב,177,56,121,3,174,75,175,0,5.33%
2019-09,הצפון,487,ג'ש (גוש חלב),יישוב,57,21,36,12,45,17,55,0,3.20%
2019-09,הצפון,489,דבורייה,יישוב,211,99,112,14,197,136,209,3,4.44%
2019-09,הצפון,490,דייר אל-אסד,יישוב,300,139,161,17,283,202,293,3,5.10%
2019-09,הצפון,492,דייר חנא,יישוב,422,188,234,15,407,274,418,1,7.99%
2019-09,הצפון,975,זרזיר,יישוב,215,93,122,6,209,87,209,3,5.78%
2019-09,הצפון,496,חורפיש,יישוב,96,41,55,8,88,41,89,2,2.92%
2019-09,הצפון,2034,חצור הגלילית,יישוב,264,106,158,23,241,100,249,3,5.06%
2019-09,הצפון,6700,טבריה,יישוב,1425,618,807,90,1335,530,1306,59,5.81%
2019-09,הצפון,962,טובא-זנגרייה,יישוב,261,107,154,6,255,143,255,5,7.54%
2019-09,הצפון,498,טורעאן,יישוב,292,132,160,27,265,208,290,3,4.60%
2019-09,הצפון,8900,טמרה,יישוב,1032,520,512,37,995,747,1012,13,6.56%
2019-09,הצפון,1295,יאנוח-ג'ת,יישוב,117,42,75,11,106,48,115,2,3.59%
2019-09,הצפון,46,יבנאל,יישוב,111,53,58,8,103,46,106,0,6.54%
2019-09,הצפון,29,יסוד המעלה,יישוב,13,4,9,5,8,1,13,1,1.49%
2019-09,הצפון,499,יפיע,יישוב,459,206,253,32,427,293,455,2,5.27%
2019-09,הצפון,240,יקנעם עילית,יישוב,478,226,252,111,367,82,470,22,3.63%
2019-09,הצפון,502,ירכא,יישוב,344,135,209,4,340,204,338,1,4.82%
2019-09,הצפון,504,כאבול,יישוב,325,174,151,8,317,235,320,4,5.97%
2019-09,הצפון,505,כאוכב אבו אל-היג'א,יישוב,177,72,105,6,171,118,176,1,9.30%
2019-09,הצפון,1296,כסרא-סמיע,יישוב,178,80,98,4,174,78,170,4,4.37%
2019-09,הצפון,978,כעביה-טבאש-חג'אג'רה,יישוב,154,59,95,8,146,84,151,5,5.84%
2019-09,הצפון,1263,כפר ורדים,יישוב,71,25,46,27,44,6,69,1,2.21%
2019-09,הצפון,507,כפר יאסיף,יישוב,322,136,186,13,309,172,318,1,5.88%
2019-09,הצפון,508,כפר כמא,יישוב,35,16,19,4,31,10,34,0,1.97%
2019-09,הצפון,509,כפר כנא,יישוב,662,323,339,38,624,462,640,14,6.61%
2019-09,הצפון,510,כפר מנדא,יישוב,587,315,272,24,563,394,585,1,7.27%
2019-09,הצפון,47,כפר תבור,יישוב,50,19,31,18,32,1,48,0,2.02%
2019-09,הצפון,1139,כרמיאל,יישוב,1398,588,810,294,1104,564,1307,32,5.02%
2019-09,הצפון,65,מ.א. אל-בטוף,מועצה איזורית,186,97,89,13,173,127,175,2,5.37%
2019-09,הצפון,66,מ.א. בוסתן אל-מרג,מועצה איזורית,21,9,12,0,21,16,21,0,0.60%
2019-09,הצפון,71,מ.א. גולן,מועצה איזורית,250,108,142,84,166,22,247,1,2.81%
2019-09,הצפון,8,מ.א. הגלבוע,מועצה איזורית,557,232,325,71,486,218,552,0,3.91%
2019-09,הצפון,1,מ.א. הגליל העליון,מועצה איזורית,210,80,130,95,115,10,206,0,2.30%
2019-09,הצפון,3,מ.א. הגליל התחתון,מועצה איזורית,150,63,87,52,98,10,146,0,2.42%
2019-09,הצפון,55,מ.א. מבואות החרמון,מועצה איזורית,111,37,74,30,81,15,109,0,2.71%
2019-09,הצפון,13,מ.א. מגידו,מועצה איזורית,108,46,62,42,66,8,107,0,1.89%
2019-09,הצפון,4,מ.א. מטה אשר,מועצה איזורית,442,189,253,102,340,123,430,0,3.03%
2019-09,הצפון,52,מ.א. מעלה יוסף,מועצה איזורית,196,69,127,30,166,39,192,0,3.35%
2019-09,הצפון,2,מ.א. מרום הגליל,מועצה איזורית,287,123,164,35,252,88,284,0,3.98%
2019-09,הצפון,56,מ.א. משגב,מועצה איזורית,531,253,278,132,399,215,516,0,3.65%
2019-09,הצפון,6,מ.א. עמק הירדן,מועצה איזורית,157,65,92,41,116,17,153,0,2.25%
2019-09,הצפון,7,מ.א. עמק המעיינות,מועצה איזורית,189,82,107,48,141,37,185,0,2.82%
2019-09,הצפון,9,מ.א. עמק יזרעאל,מועצה איזורית,400,154,246,188,212,36,394,0,2.01%
2019-09,הצפון,481,מגאר,יישוב,893,370,523,32,861,592,877,12,8.32%
2019-09,הצפון,516,מג'ד אל-כרום,יישוב,433,200,233,15,418,254,424,6,5.75%
2019-09,הצפון,65,מגדל,יישוב,34,16,18,2,32,5,32,2,3.21%
2019-09,הצפון,874,מגדל העמק,יישוב,859,381,478,102,757,229,814,58,5.88%
2019-09,הצפון,4201,מג'דל שמס,יישוב,274,110,164,13,261,180,268,3,5.16%
2019-09,הצפון,517,מזרעה,יישוב,150,75,75,3,147,81,146,3,6.75%
2019-09,הצפון,43,מטולה,יישוב,26,15,11,6,20,6,26,0,2.57%
2019-09,הצפון,4203,מסעדה,יישוב,141,52,89,6,135,91,138,5,7.71%
2019-09,הצפון,518,מעיליא,יישוב,54,23,31,7,47,18,54,1,3.14%
2019-09,הצפון,1063,מעלות-תרשיחא,יישוב,747,356,391,92,655,274,708,34,5.78%
2019-09,הצפון,520,משהד,יישוב,185,79,106,11,174,126,181,4,5.02%
2019-09,הצפון,9100,נהרייה,יישוב,1629,761,868,207,1422,719,1533,50,4.84%
2019-09,הצפון,522,נחף,יישוב,363,163,200,18,345,239,357,3,6.34%
2019-09,הצפון,7300,נצרת,יישוב,2366,1115,1251,130,2236,1560,2344,25,6.37%
2019-09,הצפון,1061,נצרת עילית,יישוב,1324,579,745,158,1166,477,1221,86,5.18%
2019-09,הצפון,525,סאג'ור,יישוב,122,35,87,9,113,56,119,2,5.43%
2019-09,הצפון,7500,סח'נין,יישוב,1329,610,719,72,1257,933,1314,18,8.61%
2019-09,הצפון,4501,ע'ג'ר,יישוב,86,34,52,3,83,41,83,1,6.89%
2019-09,הצפון,530,עיילבון,יישוב,150,67,83,7,143,70,147,1,5.05%
2019-09,הצפון,511,עילוט,יישוב,230,108,122,7,223,156,230,2,7.18%
2019-09,הצפון,532,עין מאהל,יישוב,304,152,152,11,293,209,298,3,5.11%
2019-09,הצפון,4502,עין קנייא,יישוב,89,38,51,3,86,64,86,3,7.88%
2019-09,הצפון,7600,עכו,יישוב,2511,1119,1392,159,2352,1668,2387,38,8.80%
2019-09,הצפון,7700,עפולה,יישוב,1745,713,1032,205,1540,464,1660,47,5.98%
2019-09,הצפון,531,עראבה,יישוב,911,411,500,40,871,714,903,7,8.15%
2019-09,הצפון,535,פסוטה,יישוב,85,36,49,13,72,31,81,1,4.50%
2019-09,הצפון,536,פקיעין (בוקייעה),יישוב,109,51,58,10,99,54,105,3,3.50%
2019-09,הצפון,8000,צפת,יישוב,976,453,523,93,883,443,929,14,6.64%
2019-09,הצפון,4100,קצרין,יישוב,184,75,109,35,149,50,179,3,4.45%
2019-09,הצפון,2800,קריית שמונה,יישוב,670,318,352,70,600,200,646,21,4.97%
2019-09,הצפון,543,ראמה,יישוב,213,87,126,25,188,121,207,1,5.05%
2019-09,הצפון,26,ראש פינה,יישוב,50,18,32,13,37,18,50,0,3.02%
2019-09,הצפון,542,ריינה,יישוב,377,187,190,20,357,250,364,5,4.94%
2019-09,הצפון,122,רמת ישי,יישוב,99,39,60,32,67,9,97,4,2.34%
2019-09,הצפון,913,שבלי - אום אל-גנם,יישוב,178,70,108,9,169,89,177,3,6.18%
2019-09,הצפון,812,שלומי,יישוב,183,86,97,13,170,67,179,5,4.91%
2019-09,הצפון,538,שעב,יישוב,322,152,170,8,314,235,319,2,9.60%
2019-09,הצפון,8800,שפרעם,יישוב,1125,523,602,48,1077,725,1101,14,5.66%
2019-09,חיפה,1326,"בסמ""ה",יישוב,264,118,146,6,258,181,258,5,5.82%
2019-09,חיפה,2710,אום אל-פחם,יישוב,2160,984,1176,48,2112,1563,2112,33,9.15%
2019-09,חיפה,1020,אור עקיבא,יישוב,507,236,271,59,448,94,496,8,4.68%
2019-09,חיפה,6000,באקה אל-גרביה,יישוב,518,257,261,21,497,251,508,16,3.90%
2019-09,חיפה,9800,בנימינה-גבעת עדה*,יישוב,166,72,94,71,95,14,163,2,2.17%
2019-09,חיפה,541,ג'סר א-זרקא,יישוב,215,119,96,5,210,37,213,14,3.32%
2019-09,חיפה,628,ג'ת,יישוב,173,94,79,10,163,72,171,4,2.96%
2019-09,חיפה,494,דאלית אל-כרמל,יישוב,432,174,258,37,395,177,418,8,4.75%
2019-09,חיפה,9300,זכרון יעקב,יישוב,239,101,138,105,134,17,237,2,2.08%
2019-09,חיפה,6500,חדרה,יישוב,2083,932,1151,255,1828,515,1965,31,3.78%
2019-09,חיפה,4000,חיפה,יישוב,5104,2409,2695,1244,3860,1848,4826,103,3.42%
2019-09,חיפה,1247,חריש,יישוב,357,138,219,68,289,42,353,4,7.85%
2019-09,חיפה,2100,טירת כרמל,יישוב,675,326,349,63,612,273,651,20,5.29%
2019-09,חיפה,654,כפר קרע,יישוב,367,175,192,22,345,157,358,4,3.81%
2019-09,חיפה,45,מ.א. אלונה,מועצה איזורית,18,7,11,8,10,0,17,0,1.59%
2019-09,חיפה,12,מ.א. זבולון,מועצה איזורית,196,106,90,25,171,88,191,0,3.22%
2019-09,חיפה,15,מ.א. חוף הכרמל,מועצה איזורית,315,137,178,133,182,43,310,0,2.09%
2019-09,חיפה,14,מ.א. מנשה,מועצה איזורית,264,114,150,80,184,52,263,0,3.06%
2019-09,חיפה,1327,מעלה עירון,יישוב,563,263,300,11,552,381,548,9,8.41%
2019-09,חיפה,2500,נשר,יישוב,386,171,215,88,298,98,371,9,2.92%
2019-09,חיפה,534,עספיא,יישוב,288,128,160,20,268,136,274,2,4.47%
2019-09,חיפה,637,ערערה,יישוב,462,199,263,17,445,251,451,17,5.01%
2019-09,חיפה,537,פוריידיס,יישוב,193,110,83,11,182,26,189,2,3.12%
2019-09,חיפה,7800,פרדס חנה-כרכור,יישוב,676,308,368,203,473,50,661,20,3.08%
2019-09,חיפה,6800,קריית אתא,יישוב,1251,577,674,134,1117,451,1208,25,3.91%
2019-09,חיפה,9500,קריית ביאליק,יישוב,805,345,460,129,676,248,782,22,3.66%
2019-09,חיפה,2300,קריית טבעון,יישוב,181,75,106,69,112,26,176,2,2.09%
2019-09,חיפה,9600,קריית ים,יישוב,1070,512,558,119,951,460,1012,31,4.79%
2019-09,חיפה,8200,קריית מוצקין,יישוב,772,347,425,135,637,224,752,17,3.24%
2019-09,חיפה,922,רכסים,יישוב,157,65,92,11,146,43,148,0,3.93%
2019-09,ירושלים,472,אבו גוש,יישוב,210,108,102,8,202,137,209,1,6.02%
2019-09,ירושלים,2610,בית שמש,יישוב,1747,590,1157,164,1583,247,1708,32,4.49%
2019-09,ירושלים,3000,ירושלים,יישוב,11473,5087,6386,1535,9938,5627,11167,154,3.48%
2019-09,ירושלים,26,מ.א. מטה יהודה,מועצה איזורית,631,275,356,169,462,80,625,0,2.42%
2019-09,ירושלים,1015,מבשרת ציון,יישוב,303,159,144,75,228,73,297,3,2.33%
2019-09,ירושלים,1137,קריית יערים,יישוב,65,19,46,21,44,9,65,0,3.60%
2019-09,תל אביב,2400,אור יהודה,יישוב,678,314,364,71,607,98,657,30,3.40%
2019-09,תל אביב,565,אזור,יישוב,187,69,118,37,150,16,183,3,2.73%
2019-09,תל אביב,6100,בני ברק,יישוב,1983,736,1247,111,1872,414,1883,18,3.09%
2019-09,תל אביב,6200,בת ים,יישוב,2519,1161,1358,401,2118,561,2411,95,3.42%
2019-09,תל אביב,6300,גבעתיים,יישוב,775,338,437,409,366,53,769,5,2.41%
2019-09,תל אביב,6400,הרצלייה,יישוב,1144,494,650,442,702,63,1133,13,2.30%
2019-09,תל אביב,6600,חולון,יישוב,3001,1341,1660,514,2487,417,2929,64,2.90%
2019-09,תל אביב,267,כפר שמריהו,יישוב,13,7,6,8,5,0,13,0,1.55%
2019-09,תל אביב,2620,קריית אונו,יישוב,457,193,264,233,224,30,452,1,2.30%
2019-09,תל אביב,8600,רמת גן,יישוב,2033,905,1128,841,1192,230,2004,29,2.45%
2019-09,תל אביב,2650,רמת השרון,יישוב,404,159,245,189,215,9,401,4,1.75%
2019-09,תל אביב,5000,תל אביב -יפו,יישוב,7266,3500,3766,3275,3991,973,7151,90,2.71%
2019-10,אזור יהודה והשומרון,3760,אורנית,יישוב,103,38,65,43,60,2,103,0,2.05%
2019-10,אזור יהודה והשומרון,3750,אלפי מנשה,יישוב,100,37,63,34,66,1,100,0,2.25%
2019-10,אזור יהודה והשומרון,3560,אלקנה,יישוב,26,12,14,14,12,2,26,0,1.42%
2019-10,אזור יהודה והשומרון,3650,אפרת,יישוב,81,44,37,43,38,4,79,0,1.60%
2019-10,אזור יהודה והשומרון,3570,אריאל,יישוב,316,147,169,97,219,13,312,5,2.83%
2019-10,אזור יהודה והשומרון,3574,בית אל,יישוב,38,24,14,15,23,7,37,2,1.49%
2019-10,אזור יהודה והשומרון,3652,בית אריה,יישוב,65,29,36,15,50,1,65,0,2.25%
2019-10,אזור יהודה והשומרון,3780,ביתר עילית,יישוב,584,253,331,26,558,136,574,9,3.66%
2019-10,אזור יהודה והשומרון,3730,גבעת זאב,יישוב,208,92,116,44,164,41,207,2,2.54%
2019-10,אזור יהודה והשומרון,3769,הר אדר,יישוב,41,15,26,20,21,3,40,0,1.82%
2019-10,אזור יהודה והשומרון,76,מ.א. גוש עציון,מועצה איזורית,190,89,101,74,116,15,187,0,1.84%
2019-10,אזור יהודה והשומרון,78,מ.א. הר חברון,מועצה איזורית,80,41,39,34,46,2,78,0,1.97%
2019-10,אזור יהודה והשומרון,74,מ.א. מגילות ים המלח,מועצה איזורית,31,14,17,8,23,0,31,0,3.36%
2019-10,אזור יהודה והשומרון,73,מ.א. מטה בנימין,מועצה איזורית,630,294,336,238,392,78,627,0,2.21%
2019-10,אזור יהודה והשומרון,75,מ.א. ערבות הירדן,מועצה איזורית,59,26,33,22,37,7,58,0,2.25%
2019-10,אזור יהודה והשומרון,72,מ.א. שומרון,מועצה איזורית,484,232,252,199,285,15,483,0,2.55%
2019-10,אזור יהודה והשומרון,3797,מודיעין עילית,יישוב,479,151,328,30,449,28,472,2,2.94%
2019-10,אזור יהודה והשומרון,3616,מעלה אדומים,יישוב,541,240,301,88,453,84,533,12,2.55%
2019-10,אזור יהודה והשומרון,3608,מעלה אפרים,יישוב,29,13,16,4,25,8,28,0,3.50%
2019-10,אזור יהודה והשומרון,3660,עמנואל,יישוב,42,24,18,1,41,11,42,2,3.10%
2019-10,אזור יהודה והשומרון,3557,קדומים,יישוב,32,14,18,14,18,1,32,0,1.60%
2019-10,אזור יהודה והשומרון,3611,קריית ארבע,יישוב,84,38,46,17,67,24,82,1,2.44%
2019-10,אזור יהודה והשומרון,3640,קרני שומרון,יישוב,89,39,50,30,59,6,86,1,2.11%
2019-10,הדרום,31,אופקים,יישוב,885,357,528,48,837,316,863,28,5.95%
2019-10,הדרום,2600,אילת,יישוב,903,448,455,71,832,212,867,26,2.52%
2019-10,הדרום,70,אשדוד,יישוב,4646,2029,2617,622,4024,1633,4460,56,3.99%
2019-10,הדרום,7100,אשקלון,יישוב,3367,1476,1891,452,2915,1186,3133,59,4.22%
2019-10,הדרום,9000,באר שבע,יישוב,4964,2326,2638,763,4201,2246,4660,60,4.36%
2019-10,הדרום,2200,דימונה,יישוב,1440,653,787,67,1373,875,1352,27,6.99%
2019-10,הדרום,1303,חורה,יישוב,474,210,264,13,461,392,446,2,9.34%
2019-10,הדרום,831,ירוחם,יישוב,411,192,219,22,389,202,389,8,7.54%
2019-10,הדרום,1059,כסיפה,יישוב,1013,416,597,4,1009,894,1003,2,18.30%
2019-10,הדרום,1271,להבים,יישוב,45,20,25,18,27,2,45,0,1.28%
2019-10,הדרום,1060,לקיה,יישוב,569,267,302,10,559,466,533,3,10.98%
2019-10,הדרום,69,מ.א. אל קסום,מועצה איזורית,827,336,491,13,814,701,781,0,22.90%
2019-10,הדרום,38,מ.א. אשכול,מועצה איזורית,139,72,67,39,100,3,137,0,1.95%
2019-10,הדרום,33,מ.א. באר טוביה,מועצה איזורית,325,130,195,79,246,43,320,0,2.83%
2019-10,הדרום,41,מ.א. בני שמעון,מועצה איזורית,101,44,57,43,58,16,97,1,2.00%
2019-10,הדרום,54,מ.א. הערבה התיכונה,מועצה איזורית,31,11,20,11,20,1,31,0,1.63%
2019-10,הדרום,53,מ.א. חבל אילות,מועצה איזורית,25,10,15,5,20,1,25,1,1.01%
2019-10,הדרום,36,מ.א. חוף אשקלון,מועצה איזורית,236,97,139,62,174,32,231,0,2.66%
2019-10,הדרום,35,מ.א. יואב,מועצה איזורית,85,34,51,31,54,12,83,0,2.03%
2019-10,הדרום,50,מ.א. לכיש,מועצה איזורית,198,95,103,36,162,40,196,0,3.52%
2019-10,הדרום,42,מ.א. מרחבים,מועצה איזורית,171,62,109,30,141,22,167,0,2.65%
2019-10,הדרום,68,מ.א. נווה מדבר,מועצה איזורית,128,50,78,2,126,98,125,0,6.62%
2019-10,הדרום,48,מ.א. רמת נגב,מועצה איזורית,307,152,155,24,283,231,303,0,9.10%
2019-10,הדרום,39,מ.א. שדות נגב,מועצה איזורית,150,69,81,27,123,24,146,0,3.00%
2019-10,הדרום,37,מ.א. שער הנגב,מועצה איזורית,102,42,60,39,63,21,96,1,2.40%
2019-10,הדרום,34,מ.א. שפיר,מועצה איזורית,147,67,80,26,121,28,146,0,2.93%
2019-10,הדרום,51,מ.א. תמר,מועצה איזורית,20,11,9,2,18,3,20,0,3.07%
2019-10,הדרום,1268,מיתר,יישוב,64,29,35,40,24,1,64,0,1.30%
2019-10,הדרום,99,מצפה רמון,יישוב,225,87,138,17,208,145,219,4,7.87%
2019-10,הדרום,246,נתיבות,יישוב,930,404,526,61,869,362,877,22,5.33%
2019-10,הדרום,666,עומר,יישוב,55,29,26,28,27,1,54,0,1.28%
2019-10,הדרום,2560,ערד,יישוב,638,295,343,78,560,256,611,14,4.80%
2019-10,הדרום,1192,ערערה-בנגב,יישוב,949,413,536,28,921,857,925,3,18.13%
2019-10,הדרום,2630,קריית גת,יישוב,1635,699,936,119,1516,577,1573,20,5.35%
2019-10,הדרום,1034,קריית מלאכי,יישוב,725,342,383,41,684,297,693,20,5.60%
2019-10,הדרום,1161,רהט,יישוב,1990,825,1165,18,1972,1338,1969,21,8.81%
2019-10,הדרום,1286,שגב-שלום,יישוב,343,152,191,8,335,256,330,2,10.17%
2019-10,הדרום,1031,שדרות,יישוב,944,446,498,84,860,420,845,17,5.69%
2019-10,הדרום,1054,תל שבע,יישוב,688,330,358,3,685,570,621,1,10.87%
2019-10,המרכז,1066,"בני עי""ש",יישוב,110,52,58,11,99,35,104,2,2.61%
2019-10,המרכז,182,אבן יהודה,יישוב,148,67,81,69,79,10,147,1,2.10%
2019-10,המרכז,41,אליכין,יישוב,61,30,31,12,49,8,58,1,2.95%
2019-10,המרכז,1309,אלעד,יישוב,362,145,217,30,332,29,353,2,2.48%
2019-10,המרכז,2530,באר יעקב,יישוב,285,116,169,72,213,24,282,3,2.19%
2019-10,המרכז,466,בית דגן,יישוב,89,49,40,16,73,13,88,3,2.36%
2019-10,המרכז,681,גבעת שמואל,יישוב,223,111,112,93,130,23,220,0,1.76%
2019-10,המרכז,2550,גדרה,יישוב,283,121,162,59,224,40,278,10,2.15%
2019-10,המרכז,627,ג'לג'וליה,יישוב,66,32,34,7,59,28,63,1,1.47%
2019-10,המרכז,166,גן יבנה,יישוב,317,133,184,68,249,44,314,2,2.47%
2019-10,המרכז,229,גני תקווה,יישוב,228,94,134,84,144,25,224,1,2.32%
2019-10,המרכז,9700,הוד השרון,יישוב,672,277,395,327,345,13,670,5,2.05%
2019-10,המרכז,1290,זמר,יישוב,111,52,59,7,104,52,110,4,3.37%
2019-10,המרכז,2730,טייבה,יישוב,720,350,370,36,684,421,616,17,3.21%
2019-10,המרכז,2720,טירה,יישוב,178,104,74,31,147,18,175,8,1.40%
2019-10,המרכז,2660,יבנה,יישוב,621,298,323,117,504,108,612,18,2.43%
2019-10,המרכז,9400,יהוד,יישוב,372,159,213,114,258,25,362,4,2.22%
2019-10,המרכז,1224,כוכב יאיר,יישוב,94,40,54,49,45,1,94,0,1.69%
2019-10,המרכז,633,כפר ברא,יישוב,17,9,8,0,17,2,16,0,0.99%
2019-10,המרכז,168,כפר יונה,יישוב,339,140,199,72,267,37,336,1,2.85%
2019-10,המרכז,6900,כפר סבא,יישוב,1065,474,591,411,654,32,1057,16,2.00%
2019-10,המרכז,634,כפר קאסם,יישוב,164,84,80,10,154,62,160,2,1.55%
2019-10,המרכז,7000,לוד,יישוב,1403,653,750,115,1288,575,1373,23,3.73%
2019-10,המרכז,28,מ.א. ברנר,מועצה איזורית,73,34,39,24,49,4,72,1,1.77%
2019-10,המרכז,32,מ.א. גדרות,מועצה איזורית,28,8,20,17,11,1,27,0,1.09%
2019-10,המרכז,30,מ.א. גזר,מועצה איזורית,289,117,172,108,181,22,287,0,2.14%
2019-10,המרכז,27,מ.א. גן רווה,מועצה איזורית,51,19,32,26,25,2,51,0,1.70%
2019-10,המרכז,20,מ.א. דרום השרון,מועצה איזורית,320,131,189,144,176,10,316,0,1.95%
2019-10,המרכז,29,מ.א. חבל יבנה,מועצה איזורית,39,17,22,17,22,0,38,0,1.45%
2019-10,המרכז,25,מ.א. חבל מודיעין,מועצה איזורית,217,80,137,76,141,13,214,0,1.95%
2019-10,המרכז,19,מ.א. חוף השרון,מועצה איזורית,92,40,52,54,38,3,92,0,1.65%
2019-10,המרכז,18,מ.א. לב השרון,מועצה איזורית,248,109,139,79,169,18,246,0,2.21%
2019-10,המרכז,31,מ.א. נחל שורק,מועצה איזורית,74,36,38,20,54,5,74,28,1.70%
2019-10,המרכז,16,מ.א. עמק חפר,מועצה איזורית,354,153,201,141,213,17,351,1,1.78%
2019-10,המרכז,40,מ.א. שדות דן,מועצה איזורית,152,72,80,32,120,9,152,0,2.36%
2019-10,המרכז,1200,מודיעין-מכבים-רעות*,יישוב,950,397,553,413,537,28,942,15,2.04%
2019-10,המרכז,28,מזכרת בתיה,יישוב,164,65,99,67,97,10,162,1,1.99%
2019-10,המרכז,7200,נס ציונה,יישוב,515,229,286,150,365,89,504,7,2.04%
2019-10,המרכז,7400,נתניה,יישוב,3475,1657,1818,558,2917,825,3429,57,3.17%
2019-10,המרכז,587,סביון*,יישוב,19,8,11,13,6,1,19,0,0.91%
2019-10,המרכז,171,פרדסייה,יישוב,66,34,32,17,49,2,66,1,1.76%
2019-10,המרכז,7900,פתח תקווה,יישוב,3469,1592,1877,810,2659,564,3398,43,2.63%
2019-10,המרכז,195,קדימה-צורן,יישוב,261,115,146,96,165,18,259,0,2.21%
2019-10,המרכז,638,קלנסווה,יישוב,289,144,145,19,270,142,249,8,2.57%
2019-10,המרכז,469,קריית עקרון,יישוב,183,94,89,13,170,60,178,1,2.94%
2019-10,המרכז,2640,ראש העין,יישוב,960,418,542,211,749,84,956,4,3.07%
2019-10,המרכז,8300,ראשון לציון,יישוב,3661,1616,2045,813,2848,528,3621,35,2.58%
2019-10,המרכז,8400,רחובות,יישוב,1956,885,1071,493,1463,430,1888,20,2.66%
2019-10,המרכז,8500,רמלה,יישוב,1274,582,692,103,1171,396,1231,37,3.18%
2019-10,המרכז,8700,רעננה,יישוב,735,287,448,332,403,17,730,4,1.93%
2019-10,המרכז,1304,שוהם,יישוב,203,86,117,104,99,6,203,0,1.68%
2019-10,המרכז,154,תל מונד,יישוב,124,59,65,55,69,11,124,1,1.80%
2019-10,הצפון,473,אבו סנאן,יישוב,484,228,256,10,474,298,478,5,7.59%
2019-10,הצפון,478,אכסאל,יישוב,372,169,203,23,349,292,371,0,5.85%
2019-10,הצפון,529,אעבלין,יישוב,312,144,168,16,296,213,305,4,4.97%
2019-10,הצפון,482,בועיינה-נוג'ידאת,יישוב,200,101,99,10,190,129,196,4,4.57%
2019-10,הצפון,4001,בוקעאתא,יישוב,210,96,114,7,203,149,208,4,7.13%
2019-10,הצפון,998,ביר אל-מכסור,יישוב,241,133,108,6,235,144,238,2,5.74%
2019-10,הצפון,480,בית ג'ן,יישוב,322,109,213,16,306,190,310,1,5.20%
2019-10,הצפון,9200,בית שאן,יישוב,638,303,335,40,598,254,621,32,5.90%
2019-10,הצפון,944,בסמת טבעון,יישוב,138,73,65,4,134,72,131,1,3.64%
2019-10,הצפון,483,בענה,יישוב,272,123,149,11,261,205,264,1,6.85%
2019-10,הצפון,1292,ג'דיידה-מכר,יישוב,869,392,477,12,857,587,856,7,8.41%
2019-10,הצפון,485,ג'ולס,יישוב,171,54,117,4,167,74,170,0,5.18%
2019-10,הצפון,487,ג'ש (גוש חלב),יישוב,52,21,31,12,40,18,51,1,2.97%
2019-10,הצפון,489,דבורייה,יישוב,197,93,104,16,181,131,195,0,4.15%
2019-10,הצפון,490,דייר אל-אסד,יישוב,281,134,147,16,265,183,274,0,4.79%
2019-10,הצפון,492,דייר חנא,יישוב,397,180,217,11,386,265,393,0,7.55%
2019-10,הצפון,975,זרזיר,יישוב,196,83,113,5,191,87,191,5,5.31%
2019-10,הצפון,496,חורפיש,יישוב,96,40,56,8,88,38,90,0,2.95%
2019-10,הצפון,2034,חצור הגלילית,יישוב,246,102,144,22,224,94,234,2,4.77%
2019-10,הצפון,6700,טבריה,יישוב,1343,626,717,79,1264,513,1225,31,5.47%
2019-10,הצפון,962,טובא-זנגרייה,יישוב,246,110,136,7,239,145,236,0,7.02%
2019-10,הצפון,498,טורעאן,יישוב,274,124,150,23,251,198,272,0,4.33%
2019-10,הצפון,8900,טמרה,יישוב,989,500,489,31,958,736,975,12,6.34%
2019-10,הצפון,1295,יאנוח-ג'ת,יישוב,117,46,71,6,111,53,111,1,3.47%
2019-10,הצפון,46,יבנאל,יישוב,94,46,48,5,89,43,89,1,5.55%
2019-10,הצפון,29,יסוד המעלה,יישוב,17,6,11,6,11,1,17,0,1.93%
2019-10,הצפון,499,יפיע,יישוב,457,205,252,28,429,288,454,3,5.25%
2019-10,הצפון,240,יקנעם עילית,יישוב,455,224,231,106,349,82,451,20,3.49%
2019-10,הצפון,502,ירכא,יישוב,337,128,209,4,333,203,333,1,4.76%
2019-10,הצפון,504,כאבול,יישוב,317,169,148,8,309,228,311,4,5.82%
2019-10,הצפון,505,כאוכב אבו אל-היג'א,יישוב,167,68,99,9,158,118,165,1,8.77%
2019-10,הצפון,1296,כסרא-סמיע,יישוב,168,75,93,1,167,81,157,3,4.05%
2019-10,הצפון,978,כעביה-טבאש-חג'אג'רה,יישוב,162,73,89,13,149,81,160,3,6.16%
2019-10,הצפון,1263,כפר ורדים,יישוב,69,28,41,31,38,4,68,0,2.18%
2019-10,הצפון,507,כפר יאסיף,יישוב,326,140,186,15,311,173,322,1,5.95%
2019-10,הצפון,508,כפר כמא,יישוב,39,22,17,6,33,12,39,0,2.26%
2019-10,הצפון,509,כפר כנא,יישוב,636,325,311,40,596,461,616,15,6.38%
2019-10,הצפון,510,כפר מנדא,יישוב,575,305,270,22,553,390,571,6,7.11%
2019-10,הצפון,47,כפר תבור,יישוב,43,18,25,12,31,1,40,1,1.69%
2019-10,הצפון,1139,כרמיאל,יישוב,1312,545,767,266,1046,543,1227,21,4.73%
2019-10,הצפון,65,מ.א. אל-בטוף,מועצה איזורית,189,97,92,11,178,123,181,0,5.57%
2019-10,הצפון,66,מ.א. בוסתן אל-מרג,מועצה איזורית,23,9,14,1,22,16,23,0,0.65%
2019-10,הצפון,71,מ.א. גולן,מועצה איזורית,237,101,136,73,164,16,235,0,2.68%
2019-10,הצפון,8,מ.א. הגלבוע,מועצה איזורית,508,229,279,70,438,214,502,0,3.55%
2019-10,הצפון,1,מ.א. הגליל העליון,מועצה איזורית,206,83,123,90,116,13,197,0,2.20%
2019-10,הצפון,3,מ.א. הגליל התחתון,מועצה איזורית,139,57,82,51,88,7,134,0,2.22%
2019-10,הצפון,55,מ.א. מבואות החרמון,מועצה איזורית,108,36,72,31,77,13,107,0,2.66%
2019-10,הצפון,13,מ.א. מגידו,מועצה איזורית,111,51,60,43,68,9,108,0,1.91%
2019-10,הצפון,4,מ.א. מטה אשר,מועצה איזורית,411,167,244,101,310,121,399,0,2.81%
2019-10,הצפון,52,מ.א. מעלה יוסף,מועצה איזורית,185,71,114,19,166,43,179,0,3.12%
2019-10,הצפון,2,מ.א. מרום הגליל,מועצה איזורית,255,124,131,31,224,93,252,0,3.53%
2019-10,הצפון,56,מ.א. משגב,מועצה איזורית,519,251,268,126,393,221,503,0,3.56%
2019-10,הצפון,6,מ.א. עמק הירדן,מועצה איזורית,143,71,72,37,106,18,138,0,2.03%
2019-10,הצפון,7,מ.א. עמק המעיינות,מועצה איזורית,170,74,96,40,130,34,170,0,2.59%
2019-10,הצפון,9,מ.א. עמק יזרעאל,מועצה איזורית,388,154,234,186,202,34,382,0,1.95%
2019-10,הצפון,481,מגאר,יישוב,898,388,510,39,859,600,884,10,8.38%
2019-10,הצפון,516,מג'ד אל-כרום,יישוב,402,190,212,8,394,259,395,4,5.37%
2019-10,הצפון,65,מגדל,יישוב,27,15,12,1,26,7,24,0,2.43%
2019-10,הצפון,874,מגדל העמק,יישוב,758,335,423,97,661,206,722,43,5.25%
2019-10,הצפון,4201,מג'דל שמס,יישוב,273,112,161,15,258,176,269,1,5.18%
2019-10,הצפון,517,מזרעה,יישוב,142,75,67,1,141,77,138,1,6.41%
2019-10,הצפון,43,מטולה,יישוב,27,15,12,9,18,5,27,0,2.67%
2019-10,הצפון,4203,מסעדה,יישוב,134,55,79,4,130,94,131,1,7.35%
2019-10,הצפון,518,מעיליא,יישוב,51,23,28,8,43,19,50,0,2.91%
2019-10,הצפון,1063,מעלות-תרשיחא,יישוב,683,337,346,94,589,273,649,16,5.32%
2019-10,הצפון,520,משהד,יישוב,156,68,88,11,145,111,155,0,4.33%
2019-10,הצפון,9100,נהרייה,יישוב,1591,744,847,213,1378,703,1492,35,4.72%
2019-10,הצפון,522,נחף,יישוב,342,154,188,16,326,237,337,0,6.01%
2019-10,הצפון,7300,נצרת,יישוב,2290,1080,1210,128,2162,1550,2275,16,6.19%
2019-10,הצפון,1061,נצרת עילית,יישוב,1238,555,683,145,1093,458,1145,55,4.88%
2019-10,הצפון,525,סאג'ור,יישוב,120,39,81,9,111,53,117,1,5.34%
2019-10,הצפון,7500,סח'נין,יישוב,1268,586,682,80,1188,901,1257,15,8.26%
2019-10,הצפון,4501,ע'ג'ר,יישוב,80,32,48,1,79,40,76,1,6.35%
2019-10,הצפון,530,עיילבון,יישוב,153,70,83,9,144,73,151,2,5.18%
2019-10,הצפון,511,עילוט,יישוב,220,103,117,4,216,157,219,2,6.86%
2019-10,הצפון,532,עין מאהל,יישוב,315,166,149,14,301,211,308,3,5.27%
2019-10,הצפון,4502,עין קנייא,יישוב,92,43,49,1,91,59,89,0,8.14%
2019-10,הצפון,7600,עכו,יישוב,2423,1124,1299,155,2268,1615,2318,10,8.57%
2019-10,הצפון,7700,עפולה,יישוב,1546,668,878,194,1352,453,1493,24,5.41%
2019-10,הצפון,531,עראבה,יישוב,888,408,480,39,849,688,881,8,7.97%
2019-10,הצפון,535,פסוטה,יישוב,81,34,47,11,70,34,75,1,4.18%
2019-10,הצפון,536,פקיעין (בוקייעה),יישוב,104,50,54,10,94,53,102,0,3.41%
2019-10,הצפון,8000,צפת,יישוב,881,440,441,90,791,429,833,12,6.00%
2019-10,הצפון,4100,קצרין,יישוב,184,68,116,37,147,59,181,2,4.50%
2019-10,הצפון,2800,קריית שמונה,יישוב,647,296,351,66,581,210,621,16,4.79%
2019-10,הצפון,543,ראמה,יישוב,230,101,129,26,204,130,221,1,5.38%
2019-10,הצפון,26,ראש פינה,יישוב,54,16,38,12,42,20,53,0,3.20%
2019-10,הצפון,542,ריינה,יישוב,357,182,175,17,340,241,348,3,4.73%
2019-10,הצפון,122,רמת ישי,יישוב,94,42,52,27,67,10,90,0,2.18%
2019-10,הצפון,913,שבלי - אום אל-גנם,יישוב,164,65,99,5,159,86,162,0,5.69%
2019-10,הצפון,812,שלומי,יישוב,171,81,90,11,160,61,168,3,4.62%
2019-10,הצפון,538,שעב,יישוב,305,144,161,5,300,228,301,1,9.10%
2019-10,הצפון,8800,שפרעם,יישוב,1124,523,601,48,1076,721,1103,18,5.67%
2019-10,חיפה,1326,"בסמ""ה",יישוב,258,115,143,6,252,181,252,8,5.69%
2019-10,חיפה,2710,אום אל-פחם,יישוב,2069,944,1125,54,2015,1531,2018,41,8.78%
2019-10,חיפה,1020,אור עקיבא,יישוב,485,235,250,54,431,93,471,9,4.45%
2019-10,חיפה,6000,באקה אל-גרביה,יישוב,508,251,257,24,484,252,500,15,3.84%
2019-10,חיפה,9800,בנימינה-גבעת עדה*,יישוב,168,68,100,74,94,11,167,0,2.22%
2019-10,חיפה,541,ג'סר א-זרקא,יישוב,199,119,80,6,193,35,196,9,3.06%
2019-10,חיפה,628,ג'ת,יישוב,158,87,71,9,149,64,158,1,2.74%
2019-10,חיפה,494,דאלית אל-כרמל,יישוב,409,169,240,31,378,175,396,4,4.51%
2019-10,חיפה,9300,זכרון יעקב,יישוב,215,91,124,98,117,12,214,2,1.88%
2019-10,חיפה,6500,חדרה,יישוב,1951,908,1043,252,1699,498,1840,25,3.55%
2019-10,חיפה,4000,חיפה,יישוב,4955,2382,2573,1222,3733,1787,4680,61,3.32%
2019-10,חיפה,1247,חריש,יישוב,362,153,209,67,295,45,357,3,7.93%
2019-10,חיפה,2100,טירת כרמל,יישוב,629,314,315,61,568,265,607,13,4.95%
2019-10,חיפה,654,כפר קרע,יישוב,361,166,195,24,337,152,356,8,3.79%
2019-10,חיפה,45,מ.א. אלונה,מועצה איזורית,18,6,12,7,11,0,17,0,1.59%
2019-10,חיפה,12,מ.א. זבולון,מועצה איזורית,195,101,94,28,167,86,191,0,3.22%
2019-10,חיפה,15,מ.א. חוף הכרמל,מועצה איזורית,314,136,178,128,186,39,310,0,2.09%
2019-10,חיפה,14,מ.א. מנשה,מועצה איזורית,249,110,139,73,176,49,248,0,2.88%
2019-10,חיפה,1327,מעלה עירון,יישוב,536,259,277,12,524,367,524,7,8.07%
2019-10,חיפה,2500,נשר,יישוב,357,158,199,78,279,89,343,4,2.71%
2019-10,חיפה,534,עספיא,יישוב,301,135,166,21,280,134,288,3,4.69%
2019-10,חיפה,637,ערערה,יישוב,425,192,233,12,413,241,414,4,4.62%
2019-10,חיפה,537,פוריידיס,יישוב,177,107,70,11,166,27,175,2,2.89%
2019-10,חיפה,7800,פרדס חנה-כרכור,יישוב,605,272,333,200,405,58,594,12,2.78%
2019-10,חיפה,6800,קריית אתא,יישוב,1176,565,611,133,1043,423,1134,11,3.68%
2019-10,חיפה,9500,קריית ביאליק,יישוב,775,325,450,140,635,242,750,7,3.52%
2019-10,חיפה,2300,קריית טבעון,יישוב,167,75,92,66,101,22,163,0,1.94%
2019-10,חיפה,9600,קריית ים,יישוב,1001,478,523,113,888,438,956,15,4.53%
2019-10,חיפה,8200,קריית מוצקין,יישוב,719,331,388,131,588,221,706,11,3.04%
2019-10,חיפה,922,רכסים,יישוב,144,67,77,10,134,42,137,0,3.64%
2019-10,ירושלים,472,אבו גוש,יישוב,215,113,102,13,202,130,214,2,6.15%
2019-10,ירושלים,2610,בית שמש,יישוב,1333,525,808,155,1178,240,1300,34,3.45%
2019-10,ירושלים,3000,ירושלים,יישוב,10959,4957,6002,1505,9454,5473,10680,95,3.33%
2019-10,ירושלים,26,מ.א. מטה יהודה,מועצה איזורית,584,274,310,159,425,78,580,0,2.24%
2019-10,ירושלים,1015,מבשרת ציון,יישוב,297,162,135,77,220,69,293,4,2.30%
2019-10,ירושלים,1137,קריית יערים,יישוב,56,17,39,18,38,8,55,0,3.07%
2019-10,תל אביב,2400,אור יהודה,יישוב,605,300,305,64,541,100,580,20,3.01%
2019-10,תל אביב,565,אזור,יישוב,175,69,106,34,141,17,174,1,2.59%
2019-10,תל אביב,6100,בני ברק,יישוב,1551,678,873,108,1443,404,1456,10,2.41%
2019-10,תל אביב,6200,בת ים,יישוב,2398,1129,1269,404,1994,568,2306,51,3.27%
2019-10,תל אביב,6300,גבעתיים,יישוב,738,329,409,394,344,50,728,4,2.29%
2019-10,תל אביב,6400,הרצלייה,יישוב,1034,457,577,418,616,44,1023,10,2.08%
2019-10,תל אביב,6600,חולון,יישוב,2790,1251,1539,478,2312,406,2726,52,2.70%
2019-10,תל אביב,267,כפר שמריהו,יישוב,8,4,4,4,4,0,8,0,0.96%
2019-10,תל אביב,2620,קריית אונו,יישוב,418,180,238,221,197,25,414,3,2.11%
2019-10,תל אביב,8600,רמת גן,יישוב,1940,867,1073,817,1123,212,1911,14,2.34%
2019-10,תל אביב,2650,רמת השרון,יישוב,377,159,218,184,193,10,375,1,1.63%
2019-10,תל אביב,5000,תל אביב -יפו,יישוב,6837,3330,3507,3104,3733,950,6729,59,2.55%
2019-11,אזור יהודה והשומרון,3760,אורנית,יישוב,116,44,72,45,71,3,116,0,2.30%
2019-11,אזור יהודה והשומרון,3750,אלפי מנשה,יישוב,110,41,69,42,68,1,110,3,2.47%
2019-11,אזור יהודה והשומרון,3560,אלקנה,יישוב,27,13,14,13,14,2,27,0,1.47%
2019-11,אזור יהודה והשומרון,3650,אפרת,יישוב,88,50,38,45,43,5,87,0,1.76%
2019-11,אזור יהודה והשומרון,3570,אריאל,יישוב,331,157,174,82,249,12,325,14,2.94%
2019-11,אזור יהודה והשומרון,3574,בית אל,יישוב,45,25,20,16,29,8,43,0,1.72%
2019-11,אזור יהודה והשומרון,3652,בית אריה,יישוב,59,26,33,16,43,0,59,0,2.05%
2019-11,אזור יהודה והשומרון,3780,ביתר עילית,יישוב,615,269,346,31,584,136,600,5,3.82%
2019-11,אזור יהודה והשומרון,3730,גבעת זאב,יישוב,218,98,120,49,169,43,216,1,2.65%
2019-11,אזור יהודה והשומרון,3769,הר אדר,יישוב,41,13,28,22,19,4,40,1,1.82%
2019-11,אזור יהודה והשומרון,76,מ.א. גוש עציון,מועצה איזורית,209,104,105,74,135,18,204,0,2.01%
2019-11,אזור יהודה והשומרון,78,מ.א. הר חברון,מועצה איזורית,85,45,40,33,52,1,83,0,2.09%
2019-11,אזור יהודה והשומרון,74,מ.א. מגילות ים המלח,מועצה איזורית,34,19,15,9,25,1,34,1,3.68%
2019-11,אזור יהודה והשומרון,73,מ.א. מטה בנימין,מועצה איזורית,660,312,348,236,424,84,654,0,2.30%
2019-11,אזור יהודה והשומרון,75,מ.א. ערבות הירדן,מועצה איזורית,60,29,31,22,38,7,59,0,2.29%
2019-11,אזור יהודה והשומרון,72,מ.א. שומרון,מועצה איזורית,511,243,268,209,302,17,506,0,2.67%
2019-11,אזור יהודה והשומרון,3797,מודיעין עילית,יישוב,463,163,300,31,432,24,458,4,2.85%
2019-11,אזור יהודה והשומרון,3616,מעלה אדומים,יישוב,570,245,325,93,477,89,566,17,2.71%
2019-11,אזור יהודה והשומרון,3608,מעלה אפרים,יישוב,32,13,19,2,30,8,30,0,3.75%
2019-11,אזור יהודה והשומרון,3660,עמנואל,יישוב,42,24,18,1,41,11,42,1,3.10%
2019-11,אזור יהודה והשומרון,3557,קדומים,יישוב,26,13,13,13,13,1,26,0,1.31%
2019-11,אזור יהודה והשומרון,3611,קריית ארבע,יישוב,91,42,49,17,74,26,87,3,2.59%
2019-11,אזור יהודה והשומרון,3640,קרני שומרון,יישוב,88,43,45,26,62,6,87,0,2.14%
2019-11,הדרום,31,אופקים,יישוב,921,383,538,52,869,338,890,28,6.12%
2019-11,הדרום,2600,אילת,יישוב,1004,526,478,68,936,232,968,48,2.80%
2019-11,הדרום,70,אשדוד,יישוב,4833,2134,2699,643,4190,1661,4644,92,4.15%
2019-11,הדרום,7100,אשקלון,יישוב,3429,1551,1878,457,2972,1217,3180,69,4.28%
2019-11,הדרום,9000,באר שבע,יישוב,5048,2397,2651,756,4292,2288,4740,123,4.43%
2019-11,הדרום,2200,דימונה,יישוב,1488,709,779,64,1424,866,1411,41,7.27%
2019-11,הדרום,1303,חורה,יישוב,500,229,271,14,486,398,474,1,9.87%
2019-11,הדרום,831,ירוחם,יישוב,425,201,224,27,398,207,402,26,7.77%
2019-11,הדרום,1059,כסיפה,יישוב,1057,438,619,2,1055,926,1041,10,18.86%
2019-11,הדרום,1271,להבים,יישוב,47,24,23,20,27,2,47,2,1.33%
2019-11,הדרום,1060,לקיה,יישוב,562,273,289,8,554,454,528,3,10.88%
2019-11,הדרום,69,מ.א. אל קסום,מועצה איזורית,861,360,501,14,847,710,821,0,24.06%
2019-11,הדרום,38,מ.א. אשכול,מועצה איזורית,144,67,77,36,108,6,142,0,2.03%
2019-11,הדרום,33,מ.א. באר טוביה,מועצה איזורית,312,132,180,77,235,42,309,0,2.73%
2019-11,הדרום,41,מ.א. בני שמעון,מועצה איזורית,102,44,58,39,63,15,97,0,2.00%
2019-11,הדרום,54,מ.א. הערבה התיכונה,מועצה איזורית,31,10,21,14,17,0,30,0,1.57%
2019-11,הדרום,53,מ.א. חבל אילות,מועצה איזורית,23,9,14,5,18,1,23,0,0.93%
2019-11,הדרום,36,מ.א. חוף אשקלון,מועצה איזורית,237,105,132,51,186,41,229,0,2.63%
2019-11,הדרום,35,מ.א. יואב,מועצה איזורית,84,35,49,27,57,11,83,0,2.03%
2019-11,הדרום,50,מ.א. לכיש,מועצה איזורית,204,97,107,41,163,40,200,0,3.59%
2019-11,הדרום,42,מ.א. מרחבים,מועצה איזורית,166,63,103,32,134,20,161,0,2.56%
2019-11,הדרום,68,מ.א. נווה מדבר,מועצה איזורית,138,59,79,4,134,98,134,0,7.09%
2019-11,הדרום,48,מ.א. רמת נגב,מועצה איזורית,314,156,158,23,291,234,310,1,9.31%
2019-11,הדרום,39,מ.א. שדות נגב,מועצה איזורית,165,75,90,26,139,27,161,1,3.31%
2019-11,הדרום,37,מ.א. שער הנגב,מועצה איזורית,118,49,69,51,67,23,112,1,2.80%
2019-11,הדרום,34,מ.א. שפיר,מועצה איזורית,149,75,74,26,123,30,148,0,2.97%
2019-11,הדרום,51,מ.א. תמר,מועצה איזורית,18,11,7,3,15,1,18,0,2.76%
2019-11,הדרום,1268,מיתר,יישוב,74,38,36,42,32,1,73,0,1.48%
2019-11,הדרום,99,מצפה רמון,יישוב,230,88,142,15,215,145,226,7,8.10%
2019-11,הדרום,246,נתיבות,יישוב,961,420,541,58,903,366,901,30,5.46%
2019-11,הדרום,666,עומר,יישוב,55,27,28,26,29,2,54,2,1.28%
2019-11,הדרום,2560,ערד,יישוב,678,317,361,67,611,260,648,19,5.08%
2019-11,הדרום,1192,ערערה-בנגב,יישוב,949,426,523,30,919,843,921,8,18.07%
2019-11,הדרום,2630,קריית גת,יישוב,1678,737,941,131,1547,570,1607,34,5.46%
2019-11,הדרום,1034,קריית מלאכי,יישוב,787,378,409,48,739,313,755,33,6.07%
2019-11,הדרום,1161,רהט,יישוב,2128,923,1205,16,2112,1354,2106,52,9.37%
2019-11,הדרום,1286,שגב-שלום,יישוב,343,156,187,6,337,255,328,5,10.11%
2019-11,הדרום,1031,שדרות,יישוב,1005,485,520,86,919,427,906,31,6.07%
2019-11,הדרום,1054,תל שבע,יישוב,727,349,378,5,722,599,658,10,11.45%
2019-11,המרכז,1066,"בני עי""ש",יישוב,104,50,54,9,95,31,100,7,2.51%
2019-11,המרכז,182,אבן יהודה,יישוב,139,62,77,67,72,9,139,0,1.99%
2019-11,המרכז,41,אליכין,יישוב,57,26,31,12,45,9,53,0,2.70%
2019-11,המרכז,1309,אלעד,יישוב,366,158,208,23,343,33,357,1,2.50%
2019-11,המרכז,2530,באר יעקב,יישוב,272,118,154,62,210,21,269,2,2.09%
2019-11,המרכז,466,בית דגן,יישוב,78,41,37,11,67,17,78,1,2.10%
2019-11,המרכז,681,גבעת שמואל,יישוב,214,110,104,90,124,23,211,0,1.69%
2019-11,המרכז,2550,גדרה,יישוב,294,126,168,61,233,43,283,6,2.18%
2019-11,המרכז,627,ג'לג'וליה,יישוב,74,39,35,8,66,31,69,0,1.61%
2019-11,המרכז,166,גן יבנה,יישוב,334,134,200,74,260,48,327,2,2.57%
2019-11,המרכז,229,גני תקווה,יישוב,220,83,137,82,138,20,217,0,2.24%
2019-11,המרכז,9700,הוד השרון,יישוב,702,293,409,340,362,18,700,12,2.14%
2019-11,המרכז,1290,זמר,יישוב,105,46,59,5,100,52,105,3,3.22%
2019-11,המרכז,2730,טייבה,יישוב,748,366,382,36,712,436,640,22,3.33%
2019-11,המרכז,2720,טירה,יישוב,194,113,81,31,163,22,188,9,1.50%
2019-11,המרכז,2660,יבנה,יישוב,650,312,338,118,532,105,639,22,2.54%
2019-11,המרכז,9400,יהוד,יישוב,369,159,210,108,261,26,359,16,2.20%
2019-11,המרכז,1224,כוכב יאיר,יישוב,88,42,46,47,41,0,88,0,1.58%
2019-11,המרכז,633,כפר ברא,יישוב,16,9,7,2,14,4,16,1,0.99%
2019-11,המרכז,168,כפר יונה,יישוב,368,154,214,78,290,45,362,7,3.07%
2019-11,המרכז,6900,כפר סבא,יישוב,1101,471,630,418,683,33,1088,23,2.06%
2019-11,המרכז,634,כפר קאסם,יישוב,179,95,84,7,172,76,169,6,1.64%
2019-11,המרכז,7000,לוד,יישוב,1488,712,776,124,1364,603,1451,32,3.94%
2019-11,המרכז,28,מ.א. ברנר,מועצה איזורית,74,32,42,28,46,4,73,2,1.79%
2019-11,המרכז,32,מ.א. גדרות,מועצה איזורית,28,8,20,15,13,1,27,0,1.09%
2019-11,המרכז,30,מ.א. גזר,מועצה איזורית,305,124,181,113,192,22,297,0,2.21%
2019-11,המרכז,27,מ.א. גן רווה,מועצה איזורית,48,21,27,22,26,1,48,0,1.60%
2019-11,המרכז,20,מ.א. דרום השרון,מועצה איזורית,315,131,184,146,169,6,312,0,1.93%
2019-11,המרכז,29,מ.א. חבל יבנה,מועצה איזורית,34,17,17,14,20,0,33,1,1.26%
2019-11,המרכז,25,מ.א. חבל מודיעין,מועצה איזורית,230,84,146,69,161,11,229,0,2.08%
2019-11,המרכז,19,מ.א. חוף השרון,מועצה איזורית,96,41,55,50,46,4,95,0,1.71%
2019-11,המרכז,18,מ.א. לב השרון,מועצה איזורית,251,117,134,76,175,15,248,0,2.23%
2019-11,המרכז,31,מ.א. נחל שורק,מועצה איזורית,84,45,39,25,59,5,84,28,1.92%
2019-11,המרכז,16,מ.א. עמק חפר,מועצה איזורית,377,160,217,153,224,19,374,0,1.90%
2019-11,המרכז,40,מ.א. שדות דן,מועצה איזורית,150,74,76,30,120,9,150,0,2.33%
2019-11,המרכז,1200,מודיעין-מכבים-רעות*,יישוב,959,415,544,405,554,29,947,11,2.05%
2019-11,המרכז,28,מזכרת בתיה,יישוב,165,64,101,65,100,13,165,2,2.02%
2019-11,המרכז,7200,נס ציונה,יישוב,542,243,299,156,386,90,527,7,2.13%
2019-11,המרכז,7400,נתניה,יישוב,3689,1778,1911,558,3131,875,3630,88,3.35%
2019-11,המרכז,587,סביון*,יישוב,17,6,11,11,6,0,17,0,0.82%
2019-11,המרכז,171,פרדסייה,יישוב,75,38,37,18,57,4,75,1,1.99%
2019-11,המרכז,7900,פתח תקווה,יישוב,3573,1645,1928,803,2770,593,3487,74,2.70%
2019-11,המרכז,195,קדימה-צורן,יישוב,272,119,153,96,176,20,269,1,2.29%
2019-11,המרכז,638,קלנסווה,יישוב,292,147,145,20,272,140,255,10,2.64%
2019-11,המרכז,469,קריית עקרון,יישוב,187,93,94,15,172,56,183,6,3.02%
2019-11,המרכז,2640,ראש העין,יישוב,1041,467,574,225,816,91,1026,15,3.29%
2019-11,המרכז,8300,ראשון לציון,יישוב,3731,1662,2069,801,2930,535,3686,61,2.63%
2019-11,המרכז,8400,רחובות,יישוב,1985,915,1070,498,1487,420,1911,40,2.70%
2019-11,המרכז,8500,רמלה,יישוב,1375,655,720,108,1267,398,1328,39,3.42%
2019-11,המרכז,8700,רעננה,יישוב,740,300,440,333,407,20,728,8,1.92%
2019-11,המרכז,1304,שוהם,יישוב,191,78,113,97,94,6,190,0,1.57%
2019-11,המרכז,154,תל מונד,יישוב,131,61,70,51,80,14,131,0,1.90%
2019-11,הצפון,473,אבו סנאן,יישוב,482,224,258,12,470,299,473,3,7.52%
2019-11,הצפון,478,אכסאל,יישוב,389,183,206,24,365,302,389,2,6.11%
2019-11,הצפון,529,אעבלין,יישוב,327,152,175,12,315,225,320,9,5.20%
2019-11,הצפון,482,בועיינה-נוג'ידאת,יישוב,203,99,104,10,193,133,199,6,4.63%
2019-11,הצפון,4001,בוקעאתא,יישוב,213,95,118,7,206,151,210,5,7.20%
2019-11,הצפון,998,ביר אל-מכסור,יישוב,250,137,113,7,243,148,247,3,5.94%
2019-11,הצפון,480,בית ג'ן,יישוב,345,113,232,16,329,192,333,4,5.56%
2019-11,הצפון,9200,בית שאן,יישוב,674,338,336,49,625,256,657,23,6.22%
2019-11,הצפון,944,בסמת טבעון,יישוב,151,81,70,5,146,75,148,1,4.09%
2019-11,הצפון,483,בענה,יישוב,282,127,155,14,268,212,271,0,7.02%
2019-11,הצפון,1292,ג'דיידה-מכר,יישוב,890,402,488,13,877,595,878,10,8.61%
2019-11,הצפון,485,ג'ולס,יישוב,191,56,135,6,185,80,191,1,5.78%
2019-11,הצפון,487,ג'ש (גוש חלב),יישוב,58,24,34,9,49,21,57,0,3.31%
2019-11,הצפון,489,דבורייה,יישוב,209,95,114,15,194,134,207,1,4.40%
2019-11,הצפון,490,דייר אל-אסד,יישוב,287,140,147,18,269,182,284,1,4.95%
2019-11,הצפון,492,דייר חנא,יישוב,413,193,220,14,399,270,410,3,7.85%
2019-11,הצפון,975,זרזיר,יישוב,226,102,124,8,218,95,219,6,6.04%
2019-11,הצפון,496,חורפיש,יישוב,105,47,58,9,96,44,97,2,3.18%
2019-11,הצפון,2034,חצור הגלילית,יישוב,261,118,143,19,242,94,253,10,5.14%
2019-11,הצפון,6700,טבריה,יישוב,1407,675,732,80,1327,521,1281,54,5.71%
2019-11,הצפון,962,טובא-זנגרייה,יישוב,261,118,143,7,254,151,250,2,7.40%
2019-11,הצפון,498,טורעאן,יישוב,291,135,156,19,272,203,285,3,4.52%
2019-11,הצפון,8900,טמרה,יישוב,997,499,498,30,967,739,982,9,6.38%
2019-11,הצפון,1295,יאנוח-ג'ת,יישוב,121,51,70,6,115,50,117,1,3.65%
2019-11,הצפון,46,יבנאל,יישוב,97,47,50,6,91,44,91,1,5.67%
2019-11,הצפון,29,יסוד המעלה,יישוב,19,6,13,6,13,2,19,1,2.16%
2019-11,הצפון,499,יפיע,יישוב,453,204,249,24,429,282,449,3,5.20%
2019-11,הצפון,240,יקנעם עילית,יישוב,468,226,242,99,369,92,460,17,3.55%
2019-11,הצפון,502,ירכא,יישוב,347,135,212,5,342,204,342,0,4.88%
2019-11,הצפון,504,כאבול,יישוב,330,183,147,6,324,240,322,3,6.01%
2019-11,הצפון,505,כאוכב אבו אל-היג'א,יישוב,169,66,103,8,161,118,166,2,8.82%
2019-11,הצפון,1296,כסרא-סמיע,יישוב,172,78,94,3,169,80,162,7,4.17%
2019-11,הצפון,978,כעביה-טבאש-חג'אג'רה,יישוב,174,81,93,10,164,80,171,5,6.56%
2019-11,הצפון,1263,כפר ורדים,יישוב,76,29,47,35,41,4,76,0,2.43%
2019-11,הצפון,507,כפר יאסיף,יישוב,325,141,184,13,312,174,316,2,5.85%
2019-11,הצפון,508,כפר כמא,יישוב,39,21,18,7,32,13,38,0,2.20%
2019-11,הצפון,509,כפר כנא,יישוב,672,349,323,51,621,464,650,17,6.70%
2019-11,הצפון,510,כפר מנדא,יישוב,599,320,279,24,575,405,597,1,7.41%
2019-11,הצפון,47,כפר תבור,יישוב,42,17,25,13,29,1,40,0,1.69%
2019-11,הצפון,1139,כרמיאל,יישוב,1355,561,794,272,1083,550,1263,41,4.86%
2019-11,הצפון,65,מ.א. אל-בטוף,מועצה איזורית,194,96,98,12,182,121,183,0,5.62%
2019-11,הצפון,66,מ.א. בוסתן אל-מרג,מועצה איזורית,29,14,15,2,27,18,29,0,0.82%
2019-11,הצפון,71,מ.א. גולן,מועצה איזורית,250,112,138,79,171,21,247,0,2.81%
2019-11,הצפון,8,מ.א. הגלבוע,מועצה איזורית,534,245,289,76,458,217,524,0,3.71%
2019-11,הצפון,1,מ.א. הגליל העליון,מועצה איזורית,232,95,137,92,140,10,225,0,2.51%
2019-11,הצפון,3,מ.א. הגליל התחתון,מועצה איזורית,139,61,78,46,93,6,132,0,2.19%
2019-11,הצפון,55,מ.א. מבואות החרמון,מועצה איזורית,123,44,79,33,90,15,122,0,3.04%
2019-11,הצפון,13,מ.א. מגידו,מועצה איזורית,109,49,60,41,68,7,108,0,1.91%
2019-11,הצפון,4,מ.א. מטה אשר,מועצה איזורית,443,183,260,102,341,129,433,0,3.05%
2019-11,הצפון,52,מ.א. מעלה יוסף,מועצה איזורית,209,84,125,25,184,46,203,0,3.54%
2019-11,הצפון,2,מ.א. מרום הגליל,מועצה איזורית,275,136,139,35,240,93,272,0,3.81%
2019-11,הצפון,56,מ.א. משגב,מועצה איזורית,542,266,276,132,410,232,519,0,3.67%
2019-11,הצפון,6,מ.א. עמק הירדן,מועצה איזורית,172,73,99,47,125,20,167,0,2.46%
2019-11,הצפון,7,מ.א. עמק המעיינות,מועצה איזורית,182,85,97,47,135,33,180,0,2.74%
2019-11,הצפון,9,מ.א. עמק יזרעאל,מועצה איזורית,411,161,250,191,220,38,404,0,2.07%
2019-11,הצפון,481,מגאר,יישוב,882,391,491,36,846,592,866,12,8.22%
2019-11,הצפון,516,מג'ד אל-כרום,יישוב,427,209,218,10,417,268,419,3,5.68%
2019-11,הצפון,65,מגדל,יישוב,33,17,16,1,32,8,30,0,3.02%
2019-11,הצפון,874,מגדל העמק,יישוב,806,366,440,94,712,202,755,46,5.48%
2019-11,הצפון,4201,מג'דל שמס,יישוב,300,133,167,15,285,185,296,2,5.67%
2019-11,הצפון,517,מזרעה,יישוב,147,76,71,2,145,72,144,1,6.67%
2019-11,הצפון,43,מטולה,יישוב,28,18,10,7,21,6,28,0,2.77%
2019-11,הצפון,4203,מסעדה,יישוב,130,57,73,4,126,90,125,5,7.03%
2019-11,הצפון,518,מעיליא,יישוב,55,25,30,11,44,21,54,0,3.14%
2019-11,הצפון,1063,מעלות-תרשיחא,יישוב,728,357,371,89,639,284,688,32,5.62%
2019-11,הצפון,520,משהד,יישוב,160,75,85,7,153,114,159,4,4.43%
2019-11,הצפון,9100,נהרייה,יישוב,1690,812,878,210,1480,739,1594,57,5.02%
2019-11,הצפון,522,נחף,יישוב,348,157,191,19,329,233,344,2,6.13%
2019-11,הצפון,7300,נצרת,יישוב,2322,1101,1221,128,2194,1558,2299,27,6.25%
2019-11,הצפון,1061,נצרת עילית,יישוב,1290,587,703,147,1143,459,1197,84,5.09%
2019-11,הצפון,525,סאג'ור,יישוב,123,40,83,9,114,49,120,1,5.47%
2019-11,הצפון,7500,סח'נין,יישוב,1295,606,689,74,1221,915,1283,17,8.42%
2019-11,הצפון,4501,ע'ג'ר,יישוב,84,34,50,1,83,40,80,0,6.66%
2019-11,הצפון,530,עיילבון,יישוב,149,66,83,7,142,76,148,1,5.08%
2019-11,הצפון,511,עילוט,יישוב,225,100,125,6,219,163,224,1,7.01%
2019-11,הצפון,532,עין מאהל,יישוב,330,179,151,14,316,217,321,1,5.48%
2019-11,הצפון,4502,עין קנייא,יישוב,102,49,53,1,101,61,98,2,8.88%
2019-11,הצפון,7600,עכו,יישוב,2519,1174,1345,153,2366,1658,2411,34,8.88%
2019-11,הצפון,7700,עפולה,יישוב,1648,706,942,200,1448,475,1578,44,5.70%
2019-11,הצפון,531,עראבה,יישוב,927,431,496,41,886,721,917,6,8.27%
2019-11,הצפון,535,פסוטה,יישוב,77,37,40,12,65,35,74,1,4.12%
2019-11,הצפון,536,פקיעין (בוקייעה),יישוב,111,57,54,10,101,55,109,2,3.63%
2019-11,הצפון,8000,צפת,יישוב,916,447,469,87,829,438,862,22,6.19%
2019-11,הצפון,4100,קצרין,יישוב,199,83,116,37,162,63,195,1,4.83%
2019-11,הצפון,2800,קריית שמונה,יישוב,728,347,381,66,662,214,698,28,5.35%
2019-11,הצפון,543,ראמה,יישוב,244,112,132,26,218,131,237,3,5.74%
2019-11,הצפון,26,ראש פינה,יישוב,49,13,36,12,37,18,48,1,2.91%
2019-11,הצפון,542,ריינה,יישוב,366,187,179,15,351,246,354,9,4.81%
2019-11,הצפון,122,רמת ישי,יישוב,98,40,58,31,67,9,96,3,2.32%
2019-11,הצפון,913,שבלי - אום אל-גנם,יישוב,175,75,100,7,168,90,172,2,6.02%
2019-11,הצפון,812,שלומי,יישוב,186,98,88,12,174,64,182,5,4.99%
2019-11,הצפון,538,שעב,יישוב,318,147,171,4,314,240,315,3,9.49%
2019-11,הצפון,8800,שפרעם,יישוב,1176,555,621,50,1126,744,1147,21,5.88%
2019-11,חיפה,1326,"בסמ""ה",יישוב,264,118,146,5,259,188,259,2,5.84%
2019-11,חיפה,2710,אום אל-פחם,יישוב,2110,972,1138,50,2060,1559,2057,38,8.93%
2019-11,חיפה,1020,אור עקיבא,יישוב,499,235,264,52,447,101,486,7,4.59%
2019-11,חיפה,6000,באקה אל-גרביה,יישוב,513,257,256,19,494,251,501,13,3.85%
2019-11,חיפה,9800,בנימינה-גבעת עדה*,יישוב,175,76,99,82,93,12,174,3,2.31%
2019-11,חיפה,541,ג'סר א-זרקא,יישוב,211,131,80,2,209,40,208,13,3.24%
2019-11,חיפה,628,ג'ת,יישוב,161,85,76,7,154,69,161,4,2.80%
2019-11,חיפה,494,דאלית אל-כרמל,יישוב,428,163,265,39,389,180,411,6,4.67%
2019-11,חיפה,9300,זכרון יעקב,יישוב,219,92,127,97,122,13,219,5,1.92%
2019-11,חיפה,6500,חדרה,יישוב,2039,953,1086,260,1779,514,1922,46,3.70%
2019-11,חיפה,4000,חיפה,יישוב,5226,2544,2682,1230,3996,1927,4935,116,3.49%
2019-11,חיפה,1247,חריש,יישוב,382,165,217,67,315,48,374,3,8.28%
2019-11,חיפה,2100,טירת כרמל,יישוב,630,319,311,56,574,265,612,13,4.99%
2019-11,חיפה,654,כפר קרע,יישוב,376,182,194,26,350,164,370,4,3.94%
2019-11,חיפה,45,מ.א. אלונה,מועצה איזורית,22,4,18,9,13,0,22,0,2.06%
2019-11,חיפה,12,מ.א. זבולון,מועצה איזורית,217,116,101,31,186,89,212,0,3.58%
2019-11,חיפה,15,מ.א. חוף הכרמל,מועצה איזורית,347,154,193,142,205,44,340,0,2.29%
2019-11,חיפה,14,מ.א. מנשה,מועצה איזורית,239,110,129,65,174,48,237,0,2.76%
2019-11,חיפה,1327,מעלה עירון,יישוב,536,262,274,13,523,381,521,5,8.03%
2019-11,חיפה,2500,נשר,יישוב,366,173,193,78,288,83,356,8,2.81%
2019-11,חיפה,534,עספיא,יישוב,317,140,177,25,292,129,302,4,4.90%
2019-11,חיפה,637,ערערה,יישוב,449,213,236,19,430,246,440,15,4.89%
2019-11,חיפה,537,פוריידיס,יישוב,196,120,76,9,187,22,195,8,3.21%
2019-11,חיפה,7800,פרדס חנה-כרכור,יישוב,651,297,354,208,443,60,644,13,3.00%
2019-11,חיפה,6800,קריית אתא,יישוב,1221,595,626,138,1083,426,1180,43,3.82%
2019-11,חיפה,9500,קריית ביאליק,יישוב,804,354,450,137,667,250,782,20,3.66%
2019-11,חיפה,2300,קריית טבעון,יישוב,168,76,92,69,99,25,163,3,1.94%
2019-11,חיפה,9600,קריית ים,יישוב,1038,528,510,110,928,444,993,43,4.70%
2019-11,חיפה,8200,קריית מוצקין,יישוב,740,342,398,137,603,222,723,15,3.11%
2019-11,חיפה,922,רכסים,יישוב,144,64,80,10,134,43,137,1,3.64%
2019-11,ירושלים,472,אבו גוש,יישוב,215,113,102,12,203,135,214,3,6.15%
2019-11,ירושלים,2610,בית שמש,יישוב,1361,573,788,140,1221,242,1318,36,3.50%
2019-11,ירושלים,3000,ירושלים,יישוב,11195,5133,6062,1484,9711,5637,10902,142,3.40%
2019-11,ירושלים,26,מ.א. מטה יהודה,מועצה איזורית,588,285,303,162,426,78,581,1,2.25%
2019-11,ירושלים,1015,מבשרת ציון,יישוב,314,170,144,69,245,77,308,4,2.41%
2019-11,ירושלים,1137,קריית יערים,יישוב,49,14,35,15,34,7,49,0,2.74%
2019-11,תל אביב,2400,אור יהודה,יישוב,641,318,323,72,569,96,607,27,3.15%
2019-11,תל אביב,565,אזור,יישוב,188,76,112,37,151,15,188,4,2.80%
2019-11,תל אביב,6100,בני ברק,יישוב,1529,705,824,101,1428,400,1440,17,2.38%
2019-11,תל אביב,6200,בת ים,יישוב,2589,1243,1346,429,2160,576,2479,69,3.51%
2019-11,תל אביב,6300,גבעתיים,יישוב,764,357,407,389,375,53,755,9,2.37%
2019-11,תל אביב,6400,הרצלייה,יישוב,1055,477,578,412,643,52,1046,8,2.13%
2019-11,תל אביב,6600,חולון,יישוב,2906,1286,1620,491,2415,402,2832,50,2.81%
2019-11,תל אביב,267,כפר שמריהו,יישוב,9,3,6,5,4,0,9,0,1.08%
2019-11,תל אביב,2620,קריית אונו,יישוב,422,178,244,214,208,25,416,2,2.12%
2019-11,תל אביב,8600,רמת גן,יישוב,1970,886,1084,803,1167,225,1943,28,2.38%
2019-11,תל אביב,2650,רמת השרון,יישוב,402,166,236,197,205,10,399,1,1.74%
2019-11,תל אביב,5000,תל אביב -יפו,יישוב,6943,3429,3514,3026,3917,992,6832,89,2.59%
2019-12,אזור יהודה והשומרון,3760,אורנית,יישוב,116,40,76,42,74,2,116,1,2.30%
2019-12,אזור יהודה והשומרון,3750,אלפי מנשה,יישוב,105,39,66,36,69,3,105,0,2.36%
2019-12,אזור יהודה והשומרון,3560,אלקנה,יישוב,34,19,15,17,17,2,34,0,1.84%
2019-12,אזור יהודה והשומרון,3650,אפרת,יישוב,82,45,37,39,43,5,80,0,1.62%
2019-12,אזור יהודה והשומרון,3570,אריאל,יישוב,313,163,150,71,242,10,306,16,2.78%
2019-12,אזור יהודה והשומרון,3574,בית אל,יישוב,44,25,19,18,26,7,44,0,1.76%
2019-12,אזור יהודה והשומרון,3652,בית אריה,יישוב,66,24,42,17,49,1,66,0,2.29%
2019-12,אזור יהודה והשומרון,3780,ביתר עילית,יישוב,583,264,319,31,552,133,566,4,3.61%
2019-12,אזור יהודה והשומרון,3730,גבעת זאב,יישוב,221,101,120,46,175,42,219,2,2.69%
2019-12,אזור יהודה והשומרון,3769,הר אדר,יישוב,39,14,25,21,18,4,38,0,1.73%
2019-12,אזור יהודה והשומרון,76,מ.א. גוש עציון,מועצה איזורית,212,103,109,80,132,17,208,0,2.05%
2019-12,אזור יהודה והשומרון,78,מ.א. הר חברון,מועצה איזורית,85,44,41,35,50,1,83,0,2.09%
2019-12,אזור יהודה והשומרון,74,מ.א. מגילות ים המלח,מועצה איזורית,26,16,10,7,19,0,26,0,2.82%
2019-12,אזור יהודה והשומרון,73,מ.א. מטה בנימין,מועצה איזורית,680,341,339,249,431,78,673,0,2.37%
2019-12,אזור יהודה והשומרון,75,מ.א. ערבות הירדן,מועצה איזורית,60,30,30,22,38,4,59,0,2.29%
2019-12,אזור יהודה והשומרון,72,מ.א. שומרון,מועצה איזורית,495,228,267,209,286,14,492,0,2.60%
2019-12,אזור יהודה והשומרון,3797,מודיעין עילית,יישוב,434,157,277,27,407,21,429,6,2.68%
2019-12,אזור יהודה והשומרון,3616,מעלה אדומים,יישוב,540,258,282,85,455,90,535,14,2.56%
2019-12,אזור יהודה והשומרון,3608,מעלה אפרים,יישוב,35,15,20,4,31,10,32,0,3.99%
2019-12,אזור יהודה והשומרון,3660,עמנואל,יישוב,46,25,21,2,44,11,46,3,3.39%
2019-12,אזור יהודה והשומרון,3557,קדומים,יישוב,28,11,17,12,16,3,28,1,1.41%
2019-12,אזור יהודה והשומרון,3611,קריית ארבע,יישוב,93,50,43,21,72,29,88,3,2.62%
2019-12,אזור יהודה והשומרון,3640,קרני שומרון,יישוב,89,44,45,25,64,6,87,0,2.14%
2019-12,הדרום,31,אופקים,יישוב,857,356,501,50,807,328,821,32,5.67%
2019-12,הדרום,2600,אילת,יישוב,1069,571,498,65,1004,229,1037,55,3.00%
2019-12,הדרום,70,אשדוד,יישוב,4827,2171,2656,631,4196,1696,4622,104,4.13%
2019-12,הדרום,7100,אשקלון,יישוב,3504,1602,1902,451,3053,1236,3259,80,4.38%
2019-12,הדרום,9000,באר שבע,יישוב,5091,2446,2645,786,4305,2293,4796,110,4.48%
2019-12,הדרום,2200,דימונה,יישוב,1487,704,783,65,1422,855,1406,33,7.25%
2019-12,הדרום,1303,חורה,יישוב,492,229,263,12,480,396,463,3,9.66%
2019-12,הדרום,831,ירוחם,יישוב,410,200,210,25,385,189,383,31,7.43%
2019-12,הדרום,1059,כסיפה,יישוב,1063,445,618,4,1059,926,1045,8,18.92%
2019-12,הדרום,1271,להבים,יישוב,48,22,26,24,24,2,48,0,1.36%
2019-12,הדרום,1060,לקיה,יישוב,597,304,293,11,586,472,554,7,11.36%
2019-12,הדרום,69,מ.א. אל קסום,מועצה איזורית,876,368,508,14,862,720,840,0,24.60%
2019-12,הדרום,38,מ.א. אשכול,מועצה איזורית,129,64,65,40,89,3,128,0,1.83%
2019-12,הדרום,33,מ.א. באר טוביה,מועצה איזורית,307,129,178,76,231,41,303,0,2.68%
2019-12,הדרום,41,מ.א. בני שמעון,מועצה איזורית,109,53,56,39,70,17,107,1,2.21%
2019-12,הדרום,54,מ.א. הערבה התיכונה,מועצה איזורית,36,11,25,14,22,2,36,0,1.89%
2019-12,הדרום,53,מ.א. חבל אילות,מועצה איזורית,25,10,15,6,19,2,24,3,0.97%
2019-12,הדרום,36,מ.א. חוף אשקלון,מועצה איזורית,250,111,139,55,195,34,245,0,2.82%
2019-12,הדרום,35,מ.א. יואב,מועצה איזורית,94,42,52,33,61,14,94,0,2.30%
2019-12,הדרום,50,מ.א. לכיש,מועצה איזורית,202,104,98,44,158,45,198,0,3.55%
2019-12,הדרום,42,מ.א. מרחבים,מועצה איזורית,163,65,98,30,133,24,159,0,2.53%
2019-12,הדרום,68,מ.א. נווה מדבר,מועצה איזורית,133,58,75,4,129,95,131,0,6.93%
2019-12,הדרום,48,מ.א. רמת נגב,מועצה איזורית,301,143,158,27,274,220,298,0,8.95%
2019-12,הדרום,39,מ.א. שדות נגב,מועצה איזורית,168,76,92,35,133,24,165,0,3.39%
2019-12,הדרום,37,מ.א. שער הנגב,מועצה איזורית,117,46,71,51,66,22,110,0,2.75%
2019-12,הדרום,34,מ.א. שפיר,מועצה איזורית,155,82,73,28,127,36,152,0,3.05%
2019-12,הדרום,51,מ.א. תמר,מועצה איזורית,22,12,10,3,19,1,22,0,3.38%
2019-12,הדרום,1268,מיתר,יישוב,77,38,39,43,34,2,76,1,1.54%
2019-12,הדרום,99,מצפה רמון,יישוב,241,95,146,17,224,154,237,9,8.46%
2019-12,הדרום,246,נתיבות,יישוב,975,438,537,58,917,372,919,46,5.57%
2019-12,הדרום,666,עומר,יישוב,56,29,27,30,26,2,54,1,1.28%
2019-12,הדרום,2560,ערד,יישוב,645,310,335,67,578,259,611,24,4.80%
2019-12,הדרום,1192,ערערה-בנגב,יישוב,972,445,527,35,937,850,948,6,18.50%
2019-12,הדרום,2630,קריית גת,יישוב,1722,770,952,127,1595,598,1647,49,5.59%
2019-12,הדרום,1034,קריית מלאכי,יישוב,766,361,405,42,724,290,733,31,5.90%
2019-12,הדרום,1161,רהט,יישוב,2152,925,1227,16,2136,1394,2127,45,9.45%
2019-12,הדרום,1286,שגב-שלום,יישוב,345,154,191,4,341,256,333,1,10.25%
2019-12,הדרום,1031,שדרות,יישוב,1004,493,511,83,921,427,901,37,6.04%
2019-12,הדרום,1054,תל שבע,יישוב,721,359,362,6,715,599,655,8,11.40%
2019-12,המרכז,1066,"בני עי""ש",יישוב,106,50,56,7,99,30,100,3,2.51%
2019-12,המרכז,182,אבן יהודה,יישוב,147,66,81,65,82,9,147,0,2.10%
2019-12,המרכז,41,אליכין,יישוב,59,30,29,12,47,9,54,1,2.75%
2019-12,המרכז,1309,אלעד,יישוב,324,139,185,19,305,29,314,6,2.21%
2019-12,המרכז,2530,באר יעקב,יישוב,279,116,163,69,210,24,276,4,2.14%
2019-12,המרכז,466,בית דגן,יישוב,90,40,50,10,80,25,89,1,2.39%
2019-12,המרכז,681,גבעת שמואל,יישוב,223,113,110,95,128,25,219,1,1.76%
2019-12,המרכז,2550,גדרה,יישוב,308,145,163,61,247,40,300,9,2.31%
2019-12,המרכז,627,ג'לג'וליה,יישוב,76,31,45,10,66,32,72,1,1.68%
2019-12,המרכז,166,גן יבנה,יישוב,349,151,198,78,271,48,340,2,2.67%
2019-12,המרכז,229,גני תקווה,יישוב,216,83,133,81,135,22,212,1,2.19%
2019-12,המרכז,9700,הוד השרון,יישוב,719,298,421,343,376,16,716,8,2.19%
2019-12,המרכז,1290,זמר,יישוב,107,50,57,4,103,53,107,3,3.28%
2019-12,המרכז,2730,טייבה,יישוב,749,370,379,37,712,422,648,25,3.37%
2019-12,המרכז,2720,טירה,יישוב,200,124,76,33,167,22,196,15,1.56%
2019-12,המרכז,2660,יבנה,יישוב,655,317,338,129,526,104,646,18,2.57%
2019-12,המרכז,9400,יהוד,יישוב,377,172,205,98,279,22,369,12,2.26%
2019-12,המרכז,1224,כוכב יאיר,יישוב,90,42,48,51,39,0,89,1,1.60%
2019-12,המרכז,633,כפר ברא,יישוב,18,12,6,1,17,4,17,0,1.05%
2019-12,המרכז,168,כפר יונה,יישוב,353,147,206,81,272,38,350,7,2.97%
2019-12,המרכז,6900,כפר סבא,יישוב,1116,479,637,423,693,39,1106,23,2.09%
2019-12,המרכז,634,כפר קאסם,יישוב,178,90,88,9,169,69,172,8,1.67%
2019-12,המרכז,7000,לוד,יישוב,1507,742,765,131,1376,575,1486,37,4.03%
2019-12,המרכז,28,מ.א. ברנר,מועצה איזורית,72,28,44,26,46,5,70,2,1.72%
2019-12,המרכז,32,מ.א. גדרות,מועצה איזורית,28,12,16,15,13,1,26,0,1.05%
2019-12,המרכז,30,מ.א. גזר,מועצה איזורית,301,127,174,112,189,24,292,0,2.18%
2019-12,המרכז,27,מ.א. גן רווה,מועצה איזורית,42,15,27,19,23,0,42,0,1.40%
2019-12,המרכז,20,מ.א. דרום השרון,מועצה איזורית,332,143,189,143,189,12,329,0,2.03%
2019-12,המרכז,29,מ.א. חבל יבנה,מועצה איזורית,38,19,19,19,19,1,35,0,1.33%
2019-12,המרכז,25,מ.א. חבל מודיעין,מועצה איזורית,254,104,150,79,175,12,250,0,2.28%
2019-12,המרכז,19,מ.א. חוף השרון,מועצה איזורית,104,43,61,48,56,5,102,0,1.83%
2019-12,המרכז,18,מ.א. לב השרון,מועצה איזורית,248,123,125,80,168,15,246,0,2.21%
2019-12,המרכז,31,מ.א. נחל שורק,מועצה איזורית,83,43,40,23,60,5,83,32,1.93%
2019-12,המרכז,16,מ.א. עמק חפר,מועצה איזורית,393,173,220,155,238,18,387,0,1.97%
2019-12,המרכז,40,מ.א. שדות דן,מועצה איזורית,147,82,65,35,112,10,147,0,2.28%
2019-12,המרכז,1200,מודיעין-מכבים-רעות*,יישוב,1014,444,570,433,581,25,1004,14,2.17%
2019-12,המרכז,28,מזכרת בתיה,יישוב,164,70,94,64,100,12,161,2,1.98%
2019-12,המרכז,7200,נס ציונה,יישוב,539,244,295,163,376,81,527,8,2.13%
2019-12,המרכז,7400,נתניה,יישוב,3619,1771,1848,541,3078,854,3559,95,3.28%
2019-12,המרכז,587,סביון*,יישוב,23,8,15,14,9,1,22,0,1.05%
2019-12,המרכז,171,פרדסייה,יישוב,71,35,36,21,50,2,71,0,1.89%
2019-12,המרכז,7900,פתח תקווה,יישוב,3507,1639,1868,804,2703,600,3423,63,2.65%
2019-12,המרכז,195,קדימה-צורן,יישוב,263,122,141,91,172,21,259,2,2.21%
2019-12,המרכז,638,קלנסווה,יישוב,289,160,129,22,267,136,261,10,2.70%
2019-12,המרכז,469,קריית עקרון,יישוב,173,92,81,11,162,56,168,2,2.78%
2019-12,המרכז,2640,ראש העין,יישוב,1061,475,586,238,823,95,1051,16,3.37%
2019-12,המרכז,8300,ראשון לציון,יישוב,3722,1668,2054,810,2912,548,3679,48,2.62%
2019-12,המרכז,8400,רחובות,יישוב,2008,949,1059,507,1501,398,1933,51,2.73%
2019-12,המרכז,8500,רמלה,יישוב,1368,671,697,105,1263,379,1322,53,3.41%
2019-12,המרכז,8700,רעננה,יישוב,730,290,440,335,395,22,719,9,1.90%
2019-12,המרכז,1304,שוהם,יישוב,218,88,130,103,115,7,216,5,1.78%
2019-12,המרכז,154,תל מונד,יישוב,134,65,69,49,85,11,134,3,1.94%
2019-12,הצפון,473,אבו סנאן,יישוב,466,215,251,14,452,302,458,7,7.30%
2019-12,הצפון,478,אכסאל,יישוב,388,187,201,21,367,290,388,3,6.10%
2019-12,הצפון,529,אעבלין,יישוב,304,152,152,11,293,211,297,7,4.84%
2019-12,הצפון,482,בועיינה-נוג'ידאת,יישוב,202,108,94,11,191,131,200,2,4.66%
2019-12,הצפון,4001,בוקעאתא,יישוב,216,97,119,8,208,153,212,4,7.26%
2019-12,הצפון,998,ביר אל-מכסור,יישוב,255,139,116,7,248,149,253,4,6.08%
2019-12,הצפון,480,בית ג'ן,יישוב,354,113,241,14,340,194,341,6,5.69%
2019-12,הצפון,9200,בית שאן,יישוב,690,350,340,47,643,258,669,26,6.33%
2019-12,הצפון,944,בסמת טבעון,יישוב,162,91,71,5,157,81,158,0,4.36%
2019-12,הצפון,483,בענה,יישוב,276,126,150,14,262,206,269,1,6.97%
2019-12,הצפון,1292,ג'דיידה-מכר,יישוב,874,403,471,12,862,579,862,4,8.47%
2019-12,הצפון,485,ג'ולס,יישוב,172,47,125,6,166,71,172,0,5.24%
2019-12,הצפון,487,ג'ש (גוש חלב),יישוב,62,25,37,11,51,22,60,1,3.48%
2019-12,הצפון,489,דבורייה,יישוב,221,112,109,16,205,132,220,1,4.66%
2019-12,הצפון,490,דייר אל-אסד,יישוב,293,140,153,15,278,187,284,4,4.95%
2019-12,הצפון,492,דייר חנא,יישוב,423,200,223,14,409,269,419,2,8.01%
2019-12,הצפון,975,זרזיר,יישוב,227,111,116,9,218,95,224,3,6.17%
2019-12,הצפון,496,חורפיש,יישוב,101,48,53,8,93,46,92,3,3.02%
2019-12,הצפון,2034,חצור הגלילית,יישוב,231,107,124,19,212,92,222,2,4.54%
2019-12,הצפון,6700,טבריה,יישוב,1362,669,693,75,1287,529,1247,61,5.56%
2019-12,הצפון,962,טובא-זנגרייה,יישוב,259,124,135,7,252,139,253,9,7.48%
2019-12,הצפון,498,טורעאן,יישוב,295,140,155,16,279,204,291,1,4.61%
2019-12,הצפון,8900,טמרה,יישוב,973,492,481,28,945,713,957,17,6.23%
2019-12,הצפון,1295,יאנוח-ג'ת,יישוב,125,61,64,4,121,57,119,2,3.71%
2019-12,הצפון,46,יבנאל,יישוב,99,44,55,6,93,49,91,1,5.67%
2019-12,הצפון,29,יסוד המעלה,יישוב,23,9,14,7,16,2,23,0,2.60%
2019-12,הצפון,499,יפיע,יישוב,449,209,240,23,426,284,438,6,5.08%
2019-12,הצפון,240,יקנעם עילית,יישוב,462,229,233,94,368,83,455,18,3.51%
2019-12,הצפון,502,ירכא,יישוב,364,152,212,5,359,209,361,3,5.13%
2019-12,הצפון,504,כאבול,יישוב,320,181,139,6,314,225,315,5,5.89%
2019-12,הצפון,505,כאוכב אבו אל-היג'א,יישוב,158,62,96,5,153,115,156,2,8.33%
2019-12,הצפון,1296,כסרא-סמיע,יישוב,174,76,98,2,172,84,164,3,4.22%
2019-12,הצפון,978,כעביה-טבאש-חג'אג'רה,יישוב,170,85,85,12,158,75,166,5,6.38%
2019-12,הצפון,1263,כפר ורדים,יישוב,66,26,40,25,41,3,66,1,2.12%
2019-12,הצפון,507,כפר יאסיף,יישוב,328,141,187,13,315,177,318,6,5.88%
2019-12,הצפון,508,כפר כמא,יישוב,38,20,18,6,32,12,38,0,2.20%
2019-12,הצפון,509,כפר כנא,יישוב,680,357,323,47,633,473,658,19,6.78%
2019-12,הצפון,510,כפר מנדא,יישוב,590,322,268,27,563,391,588,3,7.31%
2019-12,הצפון,47,כפר תבור,יישוב,42,19,23,15,27,2,40,0,1.69%
2019-12,הצפון,1139,כרמיאל,יישוב,1329,568,761,259,1070,531,1237,40,4.77%
2019-12,הצפון,65,מ.א. אל-בטוף,מועצה איזורית,205,103,102,13,192,128,196,0,6.00%
2019-12,הצפון,66,מ.א. בוסתן אל-מרג,מועצה איזורית,28,13,15,1,27,18,28,1,0.80%
2019-12,הצפון,71,מ.א. גולן,מועצה איזורית,254,119,135,84,170,17,250,1,2.85%
2019-12,הצפון,8,מ.א. הגלבוע,מועצה איזורית,539,255,284,83,456,223,531,0,3.76%
2019-12,הצפון,1,מ.א. הגליל העליון,מועצה איזורית,235,97,138,84,151,11,228,0,2.55%
2019-12,הצפון,3,מ.א. הגליל התחתון,מועצה איזורית,150,62,88,49,101,7,143,0,2.37%
2019-12,הצפון,55,מ.א. מבואות החרמון,מועצה איזורית,116,39,77,33,83,14,115,0,2.87%
2019-12,הצפון,13,מ.א. מגידו,מועצה איזורית,107,46,61,42,65,6,105,0,1.86%
2019-12,הצפון,4,מ.א. מטה אשר,מועצה איזורית,461,196,265,107,354,132,449,0,3.16%
2019-12,הצפון,52,מ.א. מעלה יוסף,מועצה איזורית,200,81,119,28,172,41,196,0,3.42%
2019-12,הצפון,2,מ.א. מרום הגליל,מועצה איזורית,272,134,138,36,236,95,268,0,3.75%
2019-12,הצפון,56,מ.א. משגב,מועצה איזורית,517,254,263,123,394,219,499,0,3.53%
2019-12,הצפון,6,מ.א. עמק הירדן,מועצה איזורית,172,78,94,45,127,20,167,0,2.46%
2019-12,הצפון,7,מ.א. עמק המעיינות,מועצה איזורית,180,87,93,50,130,28,179,0,2.73%
2019-12,הצפון,9,מ.א. עמק יזרעאל,מועצה איזורית,410,159,251,184,226,32,404,0,2.07%
2019-12,הצפון,481,מגאר,יישוב,892,404,488,30,862,583,881,12,8.35%
2019-12,הצפון,516,מג'ד אל-כרום,יישוב,427,206,221,10,417,266,420,10,5.69%
2019-12,הצפון,65,מגדל,יישוב,42,21,21,3,39,9,40,0,3.98%
2019-12,הצפון,874,מגדל העמק,יישוב,802,385,417,80,722,214,754,56,5.47%
2019-12,הצפון,4201,מג'דל שמס,יישוב,311,144,167,15,296,185,305,5,5.83%
2019-12,הצפון,517,מזרעה,יישוב,140,74,66,3,137,74,137,1,6.36%
2019-12,הצפון,43,מטולה,יישוב,30,17,13,9,21,6,30,0,2.96%
2019-12,הצפון,4203,מסעדה,יישוב,125,61,64,5,120,81,122,3,6.88%
2019-12,הצפון,518,מעיליא,יישוב,55,27,28,11,44,21,55,1,3.19%
2019-12,הצפון,1063,מעלות-תרשיחא,יישוב,711,351,360,99,612,282,674,25,5.52%
2019-12,הצפון,520,משהד,יישוב,163,73,90,10,153,113,163,1,4.54%
2019-12,הצפון,9100,נהרייה,יישוב,1694,825,869,203,1491,756,1597,60,5.03%
2019-12,הצפון,522,נחף,יישוב,354,160,194,17,337,240,343,5,6.11%
2019-12,הצפון,7300,נצרת,יישוב,2262,1108,1154,120,2142,1522,2241,22,6.10%
2019-12,הצפון,1061,נצרת עילית,יישוב,1292,611,681,138,1154,442,1190,64,5.06%
2019-12,הצפון,525,סאג'ור,יישוב,126,40,86,6,120,48,125,3,5.68%
2019-12,הצפון,7500,סח'נין,יישוב,1313,630,683,66,1247,895,1298,17,8.51%
2019-12,הצפון,4501,ע'ג'ר,יישוב,92,35,57,2,90,44,90,1,7.43%
2019-12,הצפון,530,עיילבון,יישוב,144,70,74,5,139,74,142,3,4.89%
2019-12,הצפון,511,עילוט,יישוב,221,107,114,3,218,158,220,1,6.89%
2019-12,הצפון,532,עין מאהל,יישוב,319,175,144,11,308,215,312,1,5.33%
2019-12,הצפון,4502,עין קנייא,יישוב,93,41,52,1,92,53,93,1,8.47%
2019-12,הצפון,7600,עכו,יישוב,2492,1153,1339,157,2335,1637,2380,27,8.78%
2019-12,הצפון,7700,עפולה,יישוב,1618,741,877,182,1436,470,1548,48,5.60%
2019-12,הצפון,531,עראבה,יישוב,910,422,488,38,872,692,894,11,8.08%
2019-12,הצפון,535,פסוטה,יישוב,71,34,37,10,61,31,68,1,3.80%
2019-12,הצפון,536,פקיעין (בוקייעה),יישוב,109,62,47,11,98,52,106,3,3.54%
2019-12,הצפון,8000,צפת,יישוב,878,441,437,89,789,432,825,9,5.94%
2019-12,הצפון,4100,קצרין,יישוב,207,94,113,41,166,72,199,7,4.93%
2019-12,הצפון,2800,קריית שמונה,יישוב,728,348,380,64,664,214,687,28,5.27%
2019-12,הצפון,543,ראמה,יישוב,225,101,124,26,199,127,220,1,5.35%
2019-12,הצפון,26,ראש פינה,יישוב,53,16,37,11,42,17,53,2,3.20%
2019-12,הצפון,542,ריינה,יישוב,345,180,165,15,330,238,335,5,4.56%
2019-12,הצפון,122,רמת ישי,יישוב,102,40,62,30,72,11,101,2,2.44%
2019-12,הצפון,913,שבלי - אום אל-גנם,יישוב,196,84,112,10,186,96,190,2,6.61%
2019-12,הצפון,812,שלומי,יישוב,189,95,94,13,176,61,185,2,5.07%
2019-12,הצפון,538,שעב,יישוב,317,146,171,5,312,237,314,3,9.46%
2019-12,הצפון,8800,שפרעם,יישוב,1191,576,615,50,1141,742,1169,27,5.99%
2019-12,חיפה,1326,"בסמ""ה",יישוב,266,121,145,5,261,191,261,4,5.88%
2019-12,חיפה,2710,אום אל-פחם,יישוב,2108,989,1119,46,2062,1558,2059,29,8.94%
2019-12,חיפה,1020,אור עקיבא,יישוב,479,233,246,48,431,109,465,13,4.40%
2019-12,חיפה,6000,באקה אל-גרביה,יישוב,514,256,258,18,496,258,505,15,3.87%
2019-12,חיפה,9800,בנימינה-גבעת עדה*,יישוב,175,78,97,92,83,13,174,0,2.31%
2019-12,חיפה,541,ג'סר א-זרקא,יישוב,218,133,85,3,215,46,208,17,3.24%
2019-12,חיפה,628,ג'ת,יישוב,179,95,84,9,170,75,179,2,3.10%
2019-12,חיפה,494,דאלית אל-כרמל,יישוב,405,153,252,31,374,175,396,5,4.51%
2019-12,חיפה,9300,זכרון יעקב,יישוב,227,103,124,95,132,14,225,2,1.98%
2019-12,חיפה,6500,חדרה,יישוב,2027,965,1062,268,1759,486,1931,52,3.72%
2019-12,חיפה,4000,חיפה,יישוב,5182,2563,2619,1234,3948,1921,4885,121,3.46%
2019-12,חיפה,1247,חריש,יישוב,386,164,222,64,322,47,381,4,8.42%
2019-12,חיפה,2100,טירת כרמל,יישוב,625,326,299,52,573,274,602,10,4.91%
2019-12,חיפה,654,כפר קרע,יישוב,379,186,193,26,353,173,371,6,3.95%
2019-12,חיפה,45,מ.א. אלונה,מועצה איזורית,24,4,20,8,16,0,24,0,2.25%
2019-12,חיפה,12,מ.א. זבולון,מועצה איזורית,227,125,102,36,191,101,216,0,3.64%
2019-12,חיפה,15,מ.א. חוף הכרמל,מועצה איזורית,338,148,190,131,207,41,331,0,2.23%
2019-12,חיפה,14,מ.א. מנשה,מועצה איזורית,236,104,132,63,173,44,236,0,2.74%
2019-12,חיפה,1327,מעלה עירון,יישוב,538,260,278,15,523,379,526,9,8.10%
2019-12,חיפה,2500,נשר,יישוב,360,172,188,81,279,86,347,7,2.74%
2019-12,חיפה,534,עספיא,יישוב,313,137,176,26,287,123,297,3,4.83%
2019-12,חיפה,637,ערערה,יישוב,458,215,243,20,438,260,446,6,4.96%
2019-12,חיפה,537,פוריידיס,יישוב,212,125,87,7,205,28,211,9,3.47%
2019-12,חיפה,7800,פרדס חנה-כרכור,יישוב,671,300,371,215,456,62,661,13,3.08%
2019-12,חיפה,6800,קריית אתא,יישוב,1239,608,631,150,1089,422,1197,39,3.87%
2019-12,חיפה,9500,קריית ביאליק,יישוב,788,351,437,132,656,239,764,22,3.58%
2019-12,חיפה,2300,קריית טבעון,יישוב,155,76,79,61,94,23,151,1,1.80%
2019-12,חיפה,9600,קריית ים,יישוב,1028,531,497,113,915,435,983,38,4.66%
2019-12,חיפה,8200,קריית מוצקין,יישוב,715,340,375,122,593,210,696,25,3.00%
2019-12,חיפה,922,רכסים,יישוב,143,68,75,10,133,43,137,1,3.64%
2019-12,ירושלים,472,אבו גוש,יישוב,222,114,108,11,211,137,220,3,6.31%
2019-12,ירושלים,2610,בית שמש,יישוב,1368,590,778,136,1232,220,1325,35,3.52%
2019-12,ירושלים,3000,ירושלים,יישוב,11351,5270,6081,1539,9812,5665,11045,159,3.44%
2019-12,ירושלים,26,מ.א. מטה יהודה,מועצה איזורית,601,310,291,170,431,77,589,2,2.28%
2019-12,ירושלים,1015,מבשרת ציון,יישוב,320,171,149,72,248,76,312,7,2.44%
2019-12,ירושלים,1137,קריית יערים,יישוב,51,18,33,14,37,8,51,0,2.85%
2019-12,תל אביב,2400,אור יהודה,יישוב,639,319,320,71,568,98,602,31,3.12%
2019-12,תל אביב,565,אזור,יישוב,180,76,104,32,148,13,180,2,2.68%
2019-12,תל אביב,6100,בני ברק,יישוב,1453,692,761,110,1343,382,1370,22,2.27%
2019-12,תל אביב,6200,בת ים,יישוב,2565,1258,1307,395,2170,577,2466,87,3.49%
2019-12,תל אביב,6300,גבעתיים,יישוב,765,341,424,410,355,48,752,7,2.36%
2019-12,תל אביב,6400,הרצלייה,יישוב,1077,500,577,434,643,44,1065,11,2.16%
2019-12,תל אביב,6600,חולון,יישוב,2938,1314,1624,498,2440,404,2880,58,2.85%
2019-12,תל אביב,267,כפר שמריהו,יישוב,6,3,3,4,2,0,6,0,0.72%
2019-12,תל אביב,2620,קריית אונו,יישוב,420,190,230,212,208,22,413,7,2.11%
2019-12,תל אביב,8600,רמת גן,יישוב,2009,912,1097,818,1191,219,1974,39,2.41%
2019-12,תל אביב,2650,רמת השרון,יישוב,406,177,229,201,205,9,405,1,1.76%
2019-12,תל אביב,5000,תל אביב -יפו,יישוב,7196,3514,3682,3266,3930,978,7067,103,2.68%
2020-01,אזור יהודה והשומרון,3760,אורנית,יישוב,111,44,67,42,69,0,111,1,2.20%
2020-01,אזור יהודה והשומרון,3750,אלפי מנשה,יישוב,108,40,68,39,69,1,107,2,2.40%
2020-01,אזור יהודה והשומרון,3560,אלקנה,יישוב,38,19,19,20,18,1,38,0,2.06%
2020-01,אזור יהודה והשומרון,3650,אפרת,יישוב,82,40,42,41,41,7,79,0,1.60%
2020-01,אזור יהודה והשומרון,3570,אריאל,יישוב,310,154,156,74,236,10,305,18,2.77%
2020-01,אזור יהודה והשומרון,3574,בית אל,יישוב,48,30,18,19,29,7,47,0,1.88%
2020-01,אזור יהודה והשומרון,3652,בית אריה,יישוב,66,18,48,17,49,0,66,0,2.29%
2020-01,אזור יהודה והשומרון,3780,ביתר עילית,יישוב,539,250,289,29,510,122,525,7,3.36%
2020-01,אזור יהודה והשומרון,3730,גבעת זאב,יישוב,223,94,129,52,171,39,223,4,2.74%
2020-01,אזור יהודה והשומרון,3769,הר אדר,יישוב,41,16,25,25,16,3,41,0,1.87%
2020-01,אזור יהודה והשומרון,76,מ.א. גוש עציון,מועצה איזורית,216,106,110,89,127,17,211,0,2.08%
2020-01,אזור יהודה והשומרון,78,מ.א. הר חברון,מועצה איזורית,91,47,44,40,51,1,91,0,2.29%
2020-01,אזור יהודה והשומרון,74,מ.א. מגילות ים המלח,מועצה איזורית,25,16,9,8,17,0,25,0,2.70%
2020-01,אזור יהודה והשומרון,73,מ.א. מטה בנימין,מועצה איזורית,691,348,343,242,449,74,682,0,2.40%
2020-01,אזור יהודה והשומרון,75,מ.א. ערבות הירדן,מועצה איזורית,63,27,36,20,43,6,61,0,2.37%
2020-01,אזור יהודה והשומרון,72,מ.א. שומרון,מועצה איזורית,504,234,270,212,292,15,497,0,2.62%
2020-01,אזור יהודה והשומרון,3797,מודיעין עילית,יישוב,418,160,258,28,390,27,411,4,2.57%
2020-01,אזור יהודה והשומרון,3616,מעלה אדומים,יישוב,577,280,297,97,480,80,573,14,2.74%
2020-01,אזור יהודה והשומרון,3608,מעלה אפרים,יישוב,36,18,18,2,34,9,34,0,4.22%
2020-01,אזור יהודה והשומרון,3660,עמנואל,יישוב,44,23,21,0,44,11,44,1,3.24%
2020-01,אזור יהודה והשומרון,3557,קדומים,יישוב,31,12,19,13,18,3,30,1,1.51%
2020-01,אזור יהודה והשומרון,3611,קריית ארבע,יישוב,87,43,44,24,63,27,86,2,2.56%
2020-01,אזור יהודה והשומרון,3640,קרני שומרון,יישוב,93,46,47,24,69,7,93,1,2.28%
2020-01,הדרום,31,אופקים,יישוב,844,370,474,49,795,326,810,34,5.60%
2020-01,הדרום,2600,אילת,יישוב,1196,600,596,78,1118,240,1156,47,3.33%
2020-01,הדרום,70,אשדוד,יישוב,4804,2170,2634,617,4187,1670,4590,96,4.10%
2020-01,הדרום,7100,אשקלון,יישוב,3383,1587,1796,464,2919,1195,3156,80,4.25%
2020-01,הדרום,9000,באר שבע,יישוב,5123,2490,2633,771,4352,2274,4818,136,4.50%
2020-01,הדרום,2200,דימונה,יישוב,1445,672,773,70,1375,843,1369,26,7.07%
2020-01,הדרום,1303,חורה,יישוב,501,236,265,11,490,412,468,5,9.76%
2020-01,הדרום,831,ירוחם,יישוב,413,214,199,24,389,198,382,23,7.41%
2020-01,הדרום,1059,כסיפה,יישוב,1058,445,613,4,1054,918,1044,4,18.90%
2020-01,הדרום,1271,להבים,יישוב,44,19,25,23,21,2,44,1,1.25%
2020-01,הדרום,1060,לקיה,יישוב,586,297,289,8,578,470,540,4,11.10%
2020-01,הדרום,69,מ.א. אל קסום,מועצה איזורית,885,385,500,18,867,725,841,0,24.63%
2020-01,הדרום,38,מ.א. אשכול,מועצה איזורית,135,71,64,38,97,3,135,0,1.93%
2020-01,הדרום,33,מ.א. באר טוביה,מועצה איזורית,310,130,180,79,231,44,306,0,2.70%
2020-01,הדרום,41,מ.א. בני שמעון,מועצה איזורית,103,51,52,35,68,13,102,0,2.10%
2020-01,הדרום,54,מ.א. הערבה התיכונה,מועצה איזורית,36,11,25,15,21,1,36,0,1.89%
2020-01,הדרום,53,מ.א. חבל אילות,מועצה איזורית,27,6,21,6,21,2,26,1,1.04%
2020-01,הדרום,36,מ.א. חוף אשקלון,מועצה איזורית,242,113,129,54,188,34,238,0,2.74%
2020-01,הדרום,35,מ.א. יואב,מועצה איזורית,103,39,64,39,64,13,100,0,2.45%
2020-01,הדרום,50,מ.א. לכיש,מועצה איזורית,211,109,102,47,164,41,209,0,3.75%
2020-01,הדרום,42,מ.א. מרחבים,מועצה איזורית,183,72,111,25,158,25,174,0,2.76%
2020-01,הדרום,68,מ.א. נווה מדבר,מועצה איזורית,143,65,78,5,138,95,140,0,7.41%
2020-01,הדרום,48,מ.א. רמת נגב,מועצה איזורית,318,157,161,35,283,218,313,0,9.41%
2020-01,הדרום,39,מ.א. שדות נגב,מועצה איזורית,166,77,89,36,130,21,161,0,3.31%
2020-01,הדרום,37,מ.א. שער הנגב,מועצה איזורית,126,54,72,58,68,23,120,0,3.00%
2020-01,הדרום,34,מ.א. שפיר,מועצה איזורית,152,78,74,27,125,39,149,0,2.99%
2020-01,הדרום,51,מ.א. תמר,מועצה איזורית,22,13,9,3,19,1,22,0,3.38%
2020-01,הדרום,1268,מיתר,יישוב,76,40,36,39,37,3,75,0,1.52%
2020-01,הדרום,99,מצפה רמון,יישוב,246,96,150,20,226,151,239,19,8.52%
2020-01,הדרום,246,נתיבות,יישוב,1008,452,556,68,940,367,934,43,5.65%
2020-01,הדרום,666,עומר,יישוב,54,27,27,30,24,2,53,0,1.26%
2020-01,הדרום,2560,ערד,יישוב,654,299,355,62,592,248,625,18,4.91%
2020-01,הדרום,1192,ערערה-בנגב,יישוב,990,462,528,34,956,857,960,24,18.69%
2020-01,הדרום,2630,קריית גת,יישוב,1714,786,928,133,1581,574,1637,40,5.56%
2020-01,הדרום,1034,קריית מלאכי,יישוב,792,373,419,49,743,298,759,33,6.10%
2020-01,הדרום,1161,רהט,יישוב,2187,965,1222,13,2174,1402,2153,48,9.56%
2020-01,הדרום,1286,שגב-שלום,יישוב,347,157,190,4,343,260,330,6,10.17%
2020-01,הדרום,1031,שדרות,יישוב,992,487,505,85,907,415,883,39,5.93%
2020-01,הדרום,1054,תל שבע,יישוב,710,362,348,9,701,585,652,8,11.35%
2020-01,המרכז,1066,"בני עי""ש",יישוב,112,59,53,8,104,28,108,6,2.70%
2020-01,המרכז,182,אבן יהודה,יישוב,152,73,79,69,83,9,152,0,2.17%
2020-01,המרכז,41,אליכין,יישוב,60,33,27,10,50,8,56,0,2.85%
2020-01,המרכז,1309,אלעד,יישוב,311,141,170,22,289,27,300,11,2.11%
2020-01,המרכז,2530,באר יעקב,יישוב,296,126,170,86,210,27,289,7,2.24%
2020-01,המרכז,466,בית דגן,יישוב,97,40,57,13,84,22,93,3,2.49%
2020-01,המרכז,681,גבעת שמואל,יישוב,213,99,114,87,126,24,209,1,1.68%
2020-01,המרכז,2550,גדרה,יישוב,303,141,162,61,242,44,296,6,2.28%
2020-01,המרכז,627,ג'לג'וליה,יישוב,83,36,47,11,72,36,77,1,1.79%
2020-01,המרכז,166,גן יבנה,יישוב,358,160,198,85,273,46,355,4,2.78%
2020-01,המרכז,229,גני תקווה,יישוב,235,95,140,95,140,22,229,1,2.37%
2020-01,המרכז,9700,הוד השרון,יישוב,723,293,430,357,366,13,721,7,2.20%
2020-01,המרכז,1290,זמר,יישוב,108,49,59,4,104,53,108,8,3.31%
2020-01,המרכז,2730,טייבה,יישוב,750,386,364,37,713,417,645,30,3.36%
2020-01,המרכז,2720,טירה,יישוב,204,122,82,40,164,19,202,10,1.61%
2020-01,המרכז,2660,יבנה,יישוב,652,332,320,121,531,93,642,19,2.55%
2020-01,המרכז,9400,יהוד,יישוב,378,170,208,110,268,20,372,13,2.28%
2020-01,המרכז,1224,כוכב יאיר,יישוב,97,46,51,57,40,2,97,3,1.74%
2020-01,המרכז,633,כפר ברא,יישוב,17,11,6,2,15,1,17,1,1.05%
2020-01,המרכז,168,כפר יונה,יישוב,344,139,205,74,270,33,338,13,2.87%
2020-01,המרכז,6900,כפר סבא,יישוב,1117,479,638,421,696,39,1103,27,2.08%
2020-01,המרכז,634,כפר קאסם,יישוב,171,86,85,14,157,71,161,6,1.56%
2020-01,המרכז,7000,לוד,יישוב,1558,752,806,147,1411,590,1521,32,4.12%
2020-01,המרכז,28,מ.א. ברנר,מועצה איזורית,83,38,45,35,48,2,83,6,2.04%
2020-01,המרכז,32,מ.א. גדרות,מועצה איזורית,29,15,14,13,16,1,28,0,1.14%
2020-01,המרכז,30,מ.א. גזר,מועצה איזורית,315,145,170,128,187,26,304,0,2.26%
2020-01,המרכז,27,מ.א. גן רווה,מועצה איזורית,46,18,28,17,29,1,46,0,1.53%
2020-01,המרכז,20,מ.א. דרום השרון,מועצה איזורית,336,138,198,146,190,7,335,0,2.07%
2020-01,המרכז,29,מ.א. חבל יבנה,מועצה איזורית,44,22,22,22,22,1,43,0,1.64%
2020-01,המרכז,25,מ.א. חבל מודיעין,מועצה איזורית,246,98,148,76,170,18,244,0,2.22%
2020-01,המרכז,19,מ.א. חוף השרון,מועצה איזורית,115,53,62,50,65,5,113,0,2.03%
2020-01,המרכז,18,מ.א. לב השרון,מועצה איזורית,241,122,119,84,157,13,237,0,2.13%
2020-01,המרכז,31,מ.א. נחל שורק,מועצה איזורית,86,46,40,22,64,3,86,34,2.00%
2020-01,המרכז,16,מ.א. עמק חפר,מועצה איזורית,411,184,227,154,257,18,407,0,2.07%
2020-01,המרכז,40,מ.א. שדות דן,מועצה איזורית,149,76,73,47,102,9,149,0,2.31%
2020-01,המרכז,1200,מודיעין-מכבים-רעות*,יישוב,1029,469,560,450,579,24,1021,19,2.20%
2020-01,המרכז,28,מזכרת בתיה,יישוב,156,60,96,61,95,15,150,6,1.84%
2020-01,המרכז,7200,נס ציונה,יישוב,541,249,292,182,359,79,530,10,2.14%
2020-01,המרכז,7400,נתניה,יישוב,3653,1840,1813,571,3082,825,3578,96,3.30%
2020-01,המרכז,587,סביון*,יישוב,21,6,15,12,9,1,21,0,1.01%
2020-01,המרכז,171,פרדסייה,יישוב,67,36,31,23,44,1,67,0,1.79%
2020-01,המרכז,7900,פתח תקווה,יישוב,3535,1668,1867,824,2711,559,3446,61,2.67%
2020-01,המרכז,195,קדימה-צורן,יישוב,269,124,145,87,182,24,265,1,2.26%
2020-01,המרכז,638,קלנסווה,יישוב,270,150,120,13,257,134,245,6,2.53%
2020-01,המרכז,469,קריית עקרון,יישוב,166,93,73,10,156,55,156,7,2.59%
2020-01,המרכז,2640,ראש העין,יישוב,1110,489,621,266,844,105,1096,18,3.50%
2020-01,המרכז,8300,ראשון לציון,יישוב,3795,1698,2097,825,2970,535,3739,62,2.66%
2020-01,המרכז,8400,רחובות,יישוב,1934,890,1044,522,1412,370,1868,56,2.64%
2020-01,המרכז,8500,רמלה,יישוב,1366,674,692,94,1272,374,1315,46,3.39%
2020-01,המרכז,8700,רעננה,יישוב,743,301,442,351,392,21,733,12,1.93%
2020-01,המרכז,1304,שוהם,יישוב,214,89,125,106,108,8,212,4,1.75%
2020-01,המרכז,154,תל מונד,יישוב,140,59,81,49,91,14,139,1,2.01%
2020-01,הצפון,473,אבו סנאן,יישוב,478,231,247,15,463,296,471,4,7.49%
2020-01,הצפון,478,אכסאל,יישוב,387,189,198,18,369,286,384,2,6.04%
2020-01,הצפון,529,אעבלין,יישוב,315,153,162,11,304,212,309,3,5.03%
2020-01,הצפון,482,בועיינה-נוג'ידאת,יישוב,231,120,111,16,215,139,225,3,5.21%
2020-01,הצפון,4001,בוקעאתא,יישוב,201,91,110,7,194,142,199,2,6.85%
2020-01,הצפון,998,ביר אל-מכסור,יישוב,262,145,117,5,257,154,258,4,6.19%
2020-01,הצפון,480,בית ג'ן,יישוב,359,118,241,16,343,198,346,3,5.77%
2020-01,הצפון,9200,בית שאן,יישוב,676,347,329,36,640,255,655,23,6.20%
2020-01,הצפון,944,בסמת טבעון,יישוב,180,99,81,4,176,96,175,1,4.81%
2020-01,הצפון,483,בענה,יישוב,278,126,152,14,264,211,264,6,6.85%
2020-01,הצפון,1292,ג'דיידה-מכר,יישוב,862,411,451,11,851,578,852,9,8.38%
2020-01,הצפון,485,ג'ולס,יישוב,161,47,114,6,155,72,161,2,4.92%
2020-01,הצפון,487,ג'ש (גוש חלב),יישוב,67,25,42,11,56,20,66,2,3.82%
2020-01,הצפון,489,דבורייה,יישוב,229,112,117,19,210,136,225,2,4.76%
2020-01,הצפון,490,דייר אל-אסד,יישוב,296,139,157,14,282,193,283,9,4.94%
2020-01,הצפון,492,דייר חנא,יישוב,419,206,213,19,400,250,414,10,7.92%
2020-01,הצפון,975,זרזיר,יישוב,226,111,115,9,217,85,220,10,6.07%
2020-01,הצפון,496,חורפיש,יישוב,105,49,56,9,96,45,98,4,3.21%
2020-01,הצפון,2034,חצור הגלילית,יישוב,221,102,119,13,208,97,209,7,4.28%
2020-01,הצפון,6700,טבריה,יישוב,1398,689,709,71,1327,550,1279,55,5.70%
2020-01,הצפון,962,טובא-זנגרייה,יישוב,251,121,130,8,243,128,243,4,7.21%
2020-01,הצפון,498,טורעאן,יישוב,310,146,164,16,294,204,306,5,4.84%
2020-01,הצפון,8900,טמרה,יישוב,989,505,484,27,962,716,966,21,6.28%
2020-01,הצפון,1295,יאנוח-ג'ת,יישוב,138,63,75,8,130,51,133,1,4.13%
2020-01,הצפון,46,יבנאל,יישוב,97,45,52,6,91,50,89,1,5.55%
2020-01,הצפון,29,יסוד המעלה,יישוב,25,11,14,8,17,2,25,0,2.82%
2020-01,הצפון,499,יפיע,יישוב,460,223,237,22,438,284,452,11,5.23%
2020-01,הצפון,240,יקנעם עילית,יישוב,443,209,234,86,357,79,435,21,3.37%
2020-01,הצפון,502,ירכא,יישוב,362,148,214,3,359,206,359,6,5.11%
2020-01,הצפון,504,כאבול,יישוב,334,185,149,9,325,232,328,3,6.11%
2020-01,הצפון,505,כאוכב אבו אל-היג'א,יישוב,163,71,92,6,157,112,159,4,8.48%
2020-01,הצפון,1296,כסרא-סמיע,יישוב,196,84,112,3,193,88,186,4,4.76%
2020-01,הצפון,978,כעביה-טבאש-חג'אג'רה,יישוב,169,84,85,12,157,74,166,0,6.38%
2020-01,הצפון,1263,כפר ורדים,יישוב,69,33,36,28,41,4,69,0,2.21%
2020-01,הצפון,507,כפר יאסיף,יישוב,326,142,184,11,315,179,319,1,5.90%
2020-01,הצפון,508,כפר כמא,יישוב,48,27,21,7,41,13,48,0,2.76%
2020-01,הצפון,509,כפר כנא,יישוב,694,373,321,50,644,456,673,17,6.93%
2020-01,הצפון,510,כפר מנדא,יישוב,588,319,269,29,559,399,582,5,7.24%
2020-01,הצפון,47,כפר תבור,יישוב,46,23,23,16,30,2,43,2,1.82%
2020-01,הצפון,1139,כרמיאל,יישוב,1264,556,708,245,1019,509,1186,38,4.58%
2020-01,הצפון,65,מ.א. אל-בטוף,מועצה איזורית,213,112,101,16,197,127,205,4,6.27%
2020-01,הצפון,66,מ.א. בוסתן אל-מרג,מועצה איזורית,31,13,18,1,30,17,31,0,0.88%
2020-01,הצפון,71,מ.א. גולן,מועצה איזורית,259,116,143,73,186,21,256,0,2.92%
2020-01,הצפון,8,מ.א. הגלבוע,מועצה איזורית,577,278,299,83,494,228,570,0,4.04%
2020-01,הצפון,1,מ.א. הגליל העליון,מועצה איזורית,236,95,141,82,154,11,229,0,2.56%
2020-01,הצפון,3,מ.א. הגליל התחתון,מועצה איזורית,154,64,90,44,110,7,148,0,2.46%
2020-01,הצפון,55,מ.א. מבואות החרמון,מועצה איזורית,128,48,80,40,88,16,126,0,3.14%
2020-01,הצפון,13,מ.א. מגידו,מועצה איזורית,119,55,64,42,77,6,117,0,2.07%
2020-01,הצפון,4,מ.א. מטה אשר,מועצה איזורית,446,201,245,106,340,131,437,0,3.08%
2020-01,הצפון,52,מ.א. מעלה יוסף,מועצה איזורית,204,86,118,36,168,37,199,0,3.47%
2020-01,הצפון,2,מ.א. מרום הגליל,מועצה איזורית,277,142,135,37,240,94,271,0,3.80%
2020-01,הצפון,56,מ.א. משגב,מועצה איזורית,523,256,267,129,394,221,505,0,3.57%
2020-01,הצפון,6,מ.א. עמק הירדן,מועצה איזורית,183,89,94,48,135,22,178,0,2.62%
2020-01,הצפון,7,מ.א. עמק המעיינות,מועצה איזורית,189,89,100,46,143,29,188,2,2.87%
2020-01,הצפון,9,מ.א. עמק יזרעאל,מועצה איזורית,419,167,252,183,236,37,412,0,2.11%
2020-01,הצפון,481,מגאר,יישוב,899,416,483,31,868,571,890,13,8.43%
2020-01,הצפון,516,מג'ד אל-כרום,יישוב,429,215,214,10,419,254,419,3,5.68%
2020-01,הצפון,65,מגדל,יישוב,45,21,24,1,44,9,43,4,4.27%
2020-01,הצפון,874,מגדל העמק,יישוב,800,399,401,96,704,206,758,46,5.50%
2020-01,הצפון,4201,מג'דל שמס,יישוב,312,148,164,14,298,176,306,5,5.85%
2020-01,הצפון,517,מזרעה,יישוב,146,79,67,4,142,71,144,1,6.67%
2020-01,הצפון,43,מטולה,יישוב,28,15,13,9,19,6,28,1,2.77%
2020-01,הצפון,4203,מסעדה,יישוב,122,59,63,6,116,78,120,3,6.77%
2020-01,הצפון,518,מעיליא,יישוב,56,28,28,13,43,21,55,0,3.19%
2020-01,הצפון,1063,מעלות-תרשיחא,יישוב,715,363,352,100,615,284,678,32,5.55%
2020-01,הצפון,520,משהד,יישוב,172,89,83,11,161,116,171,3,4.75%
2020-01,הצפון,9100,נהרייה,יישוב,1734,851,883,189,1545,738,1634,61,5.14%
2020-01,הצפון,522,נחף,יישוב,322,151,171,14,308,222,315,3,5.64%
2020-01,הצפון,7300,נצרת,יישוב,2343,1158,1185,137,2206,1522,2320,37,6.31%
2020-01,הצפון,1061,נצרת עילית,יישוב,1338,655,683,149,1189,446,1240,70,5.26%
2020-01,הצפון,525,סאג'ור,יישוב,118,42,76,5,113,44,118,3,5.38%
2020-01,הצפון,7500,סח'נין,יישוב,1374,672,702,67,1307,908,1353,23,8.84%
2020-01,הצפון,4501,ע'ג'ר,יישוב,100,32,68,3,97,40,98,0,8.04%
2020-01,הצפון,530,עיילבון,יישוב,155,80,75,10,145,72,154,5,5.28%
2020-01,הצפון,511,עילוט,יישוב,233,111,122,2,231,163,233,1,7.27%
2020-01,הצפון,532,עין מאהל,יישוב,327,184,143,13,314,208,321,2,5.48%
2020-01,הצפון,4502,עין קנייא,יישוב,97,44,53,2,95,55,97,2,8.80%
2020-01,הצפון,7600,עכו,יישוב,2510,1145,1365,149,2361,1628,2392,28,8.82%
2020-01,הצפון,7700,עפולה,יישוב,1632,738,894,195,1437,473,1569,55,5.67%
2020-01,הצפון,531,עראבה,יישוב,919,439,480,33,886,689,897,14,8.10%
2020-01,הצפון,535,פסוטה,יישוב,75,39,36,9,66,30,71,4,3.96%
2020-01,הצפון,536,פקיעין (בוקייעה),יישוב,104,58,46,7,97,52,101,3,3.37%
2020-01,הצפון,8000,צפת,יישוב,857,453,404,85,772,423,815,21,5.87%
2020-01,הצפון,4100,קצרין,יישוב,201,95,106,42,159,64,194,1,4.81%
2020-01,הצפון,2800,קריית שמונה,יישוב,732,356,376,52,680,210,703,27,5.38%
2020-01,הצפון,543,ראמה,יישוב,229,102,127,22,207,128,223,5,5.42%
2020-01,הצפון,26,ראש פינה,יישוב,57,19,38,14,43,20,56,0,3.37%
2020-01,הצפון,542,ריינה,יישוב,361,185,176,15,346,246,350,4,4.76%
2020-01,הצפון,122,רמת ישי,יישוב,102,42,60,34,68,10,100,0,2.41%
2020-01,הצפון,913,שבלי - אום אל-גנם,יישוב,197,91,106,8,189,92,192,2,6.67%
2020-01,הצפון,812,שלומי,יישוב,185,85,100,11,174,66,181,3,4.96%
2020-01,הצפון,538,שעב,יישוב,319,151,168,4,315,232,317,2,9.54%
2020-01,הצפון,8800,שפרעם,יישוב,1197,567,630,45,1152,753,1170,20,5.99%
2020-01,חיפה,1326,"בסמ""ה",יישוב,278,139,139,7,271,188,272,2,6.12%
2020-01,חיפה,2710,אום אל-פחם,יישוב,2125,1004,1121,51,2074,1539,2071,46,8.98%
2020-01,חיפה,1020,אור עקיבא,יישוב,480,235,245,51,429,102,462,12,4.37%
2020-01,חיפה,6000,באקה אל-גרביה,יישוב,530,278,252,25,505,260,524,15,4.01%
2020-01,חיפה,9800,בנימינה-גבעת עדה*,יישוב,172,72,100,82,90,15,171,2,2.27%
2020-01,חיפה,541,ג'סר א-זרקא,יישוב,196,132,64,3,193,37,193,9,3.02%
2020-01,חיפה,628,ג'ת,יישוב,183,98,85,8,175,78,183,3,3.16%
2020-01,חיפה,494,דאלית אל-כרמל,יישוב,419,164,255,33,386,173,412,4,4.68%
2020-01,חיפה,9300,זכרון יעקב,יישוב,224,105,119,97,127,13,223,5,1.96%
2020-01,חיפה,6500,חדרה,יישוב,2065,996,1069,253,1812,490,1961,40,3.77%
2020-01,חיפה,4000,חיפה,יישוב,5163,2593,2570,1246,3917,1843,4892,103,3.46%
2020-01,חיפה,1247,חריש,יישוב,398,168,230,69,329,45,391,9,8.62%
2020-01,חיפה,2100,טירת כרמל,יישוב,623,339,284,51,572,254,605,17,4.94%
2020-01,חיפה,654,כפר קרע,יישוב,379,185,194,23,356,175,373,13,3.97%
2020-01,חיפה,45,מ.א. אלונה,מועצה איזורית,22,5,17,7,15,0,22,0,2.06%
2020-01,חיפה,12,מ.א. זבולון,מועצה איזורית,235,124,111,34,201,101,226,0,3.81%
2020-01,חיפה,15,מ.א. חוף הכרמל,מועצה איזורית,374,168,206,151,223,41,369,0,2.49%
2020-01,חיפה,14,מ.א. מנשה,מועצה איזורית,251,111,140,67,184,43,251,0,2.92%
2020-01,חיפה,1327,מעלה עירון,יישוב,533,260,273,17,516,373,519,5,8.00%
2020-01,חיפה,2500,נשר,יישוב,376,182,194,83,293,92,361,6,2.85%
2020-01,חיפה,534,עספיא,יישוב,307,148,159,24,283,114,295,6,4.80%
2020-01,חיפה,637,ערערה,יישוב,448,213,235,17,431,260,431,14,4.80%
2020-01,חיפה,537,פוריידיס,יישוב,204,131,73,8,196,28,200,5,3.29%
2020-01,חיפה,7800,פרדס חנה-כרכור,יישוב,675,301,374,218,457,67,665,20,3.10%
2020-01,חיפה,6800,קריית אתא,יישוב,1236,593,643,137,1099,437,1183,25,3.83%
2020-01,חיפה,9500,קריית ביאליק,יישוב,798,361,437,139,659,240,772,30,3.62%
2020-01,חיפה,2300,קריית טבעון,יישוב,159,74,85,72,87,21,156,0,1.86%
2020-01,חיפה,9600,קריית ים,יישוב,1052,552,500,124,928,447,1005,32,4.76%
2020-01,חיפה,8200,קריית מוצקין,יישוב,736,338,398,116,620,213,714,14,3.08%
2020-01,חיפה,922,רכסים,יישוב,145,68,77,10,135,39,140,4,3.72%
2020-01,ירושלים,472,אבו גוש,יישוב,215,109,106,15,200,133,213,4,6.13%
2020-01,ירושלים,2610,בית שמש,יישוב,1353,619,734,133,1220,231,1308,37,3.48%
2020-01,ירושלים,3000,ירושלים,יישוב,11459,5443,6016,1605,9854,5646,11151,158,3.48%
2020-01,ירושלים,26,מ.א. מטה יהודה,מועצה איזורית,632,324,308,176,456,83,620,0,2.40%
2020-01,ירושלים,1015,מבשרת ציון,יישוב,330,169,161,78,252,82,324,1,2.53%
2020-01,ירושלים,1137,קריית יערים,יישוב,64,20,44,13,51,9,64,0,3.55%
2020-01,תל אביב,2400,אור יהודה,יישוב,595,296,299,62,533,101,568,25,2.95%
2020-01,תל אביב,565,אזור,יישוב,186,78,108,29,157,12,184,3,2.74%
2020-01,תל אביב,6100,בני ברק,יישוב,1472,686,786,115,1357,380,1387,30,2.30%
2020-01,תל אביב,6200,בת ים,יישוב,2523,1260,1263,393,2130,581,2409,75,3.41%
2020-01,תל אביב,6300,גבעתיים,יישוב,772,329,443,405,367,42,764,10,2.40%
2020-01,תל אביב,6400,הרצלייה,יישוב,1097,512,585,446,651,43,1083,22,2.20%
2020-01,תל אביב,6600,חולון,יישוב,2936,1302,1634,507,2429,409,2859,52,2.83%
2020-01,תל אביב,267,כפר שמריהו,יישוב,7,4,3,6,1,0,7,0,0.84%
2020-01,תל אביב,2620,קריית אונו,יישוב,412,186,226,211,201,19,406,6,2.07%
2020-01,תל אביב,8600,רמת גן,יישוב,2013,925,1088,828,1185,193,1985,24,2.43%
2020-01,תל אביב,2650,רמת השרון,יישוב,423,186,237,222,201,8,422,3,1.84%
2020-01,תל אביב,5000,תל אביב -יפו,יישוב,7185,3555,3630,3342,3843,908,7066,135,2.68%
2020-02,אזור יהודה והשומרון,3760,אורנית,יישוב,110,43,67,46,64,0,110,0,2.19%
2020-02,אזור יהודה והשומרון,3750,אלפי מנשה,יישוב,115,43,72,38,77,0,115,0,2.58%
2020-02,אזור יהודה והשומרון,3560,אלקנה,יישוב,35,18,17,17,18,1,35,0,1.90%
2020-02,אזור יהודה והשומרון,3650,אפרת,יישוב,81,47,34,41,40,4,80,0,1.62%
2020-02,אזור יהודה והשומרון,3570,אריאל,יישוב,278,130,148,68,210,11,274,12,2.49%
2020-02,אזור יהודה והשומרון,3574,בית אל,יישוב,44,28,16,15,29,5,44,0,1.76%
2020-02,אזור יהודה והשומרון,3652,בית אריה,יישוב,68,21,47,18,50,0,68,1,2.36%
2020-02,אזור יהודה והשומרון,3780,ביתר עילית,יישוב,488,225,263,24,464,115,471,8,3.03%
2020-02,אזור יהודה והשומרון,3730,גבעת זאב,יישוב,221,96,125,49,172,39,220,5,2.70%
2020-02,אזור יהודה והשומרון,3769,הר אדר,יישוב,35,17,18,18,17,3,35,0,1.60%
2020-02,אזור יהודה והשומרון,76,מ.א. גוש עציון,מועצה איזורית,210,95,115,84,126,18,204,0,2.01%
2020-02,אזור יהודה והשומרון,78,מ.א. הר חברון,מועצה איזורית,87,45,42,37,50,1,86,0,2.17%
2020-02,אזור יהודה והשומרון,74,מ.א. מגילות ים המלח,מועצה איזורית,23,15,8,9,14,1,23,0,2.49%
2020-02,אזור יהודה והשומרון,73,מ.א. מטה בנימין,מועצה איזורית,659,339,320,229,430,74,653,0,2.30%
2020-02,אזור יהודה והשומרון,75,מ.א. ערבות הירדן,מועצה איזורית,61,30,31,19,42,5,59,0,2.29%
2020-02,אזור יהודה והשומרון,72,מ.א. שומרון,מועצה איזורית,472,211,261,210,262,10,468,0,2.47%
2020-02,אזור יהודה והשומרון,3797,מודיעין עילית,יישוב,391,164,227,26,365,21,386,5,2.41%
2020-02,אזור יהודה והשומרון,3616,מעלה אדומים,יישוב,592,292,300,85,507,79,588,17,2.81%
2020-02,אזור יהודה והשומרון,3608,מעלה אפרים,יישוב,37,18,19,2,35,9,35,0,4.34%
2020-02,אזור יהודה והשומרון,3660,עמנואל,יישוב,36,18,18,0,36,10,36,0,2.67%
2020-02,אזור יהודה והשומרון,3557,קדומים,יישוב,34,14,20,14,20,4,33,0,1.65%
2020-02,אזור יהודה והשומרון,3611,קריית ארבע,יישוב,98,52,46,24,74,29,96,3,2.85%
2020-02,אזור יהודה והשומרון,3640,קרני שומרון,יישוב,85,40,45,23,62,5,85,1,2.09%
2020-02,הדרום,31,אופקים,יישוב,808,356,452,48,760,295,784,31,5.43%
2020-02,הדרום,2600,אילת,יישוב,1188,592,596,83,1105,250,1160,53,3.34%
2020-02,הדרום,70,אשדוד,יישוב,4606,2086,2520,593,4013,1623,4459,61,3.99%
2020-02,הדרום,7100,אשקלון,יישוב,3315,1536,1779,452,2863,1168,3101,65,4.18%
2020-02,הדרום,9000,באר שבע,יישוב,5088,2475,2613,821,4267,2225,4810,128,4.49%
2020-02,הדרום,2200,דימונה,יישוב,1428,673,755,68,1360,832,1358,23,7.02%
2020-02,הדרום,1303,חורה,יישוב,510,240,270,9,501,407,479,5,9.96%
2020-02,הדרום,831,ירוחם,יישוב,412,208,204,24,388,201,388,23,7.52%
2020-02,הדרום,1059,כסיפה,יישוב,1046,443,603,4,1042,910,1038,1,18.81%
2020-02,הדרום,1271,להבים,יישוב,46,23,23,24,22,3,46,0,1.30%
2020-02,הדרום,1060,לקיה,יישוב,565,285,280,8,557,459,532,2,10.96%
2020-02,הדרום,69,מ.א. אל קסום,מועצה איזורית,858,367,491,14,844,716,816,0,23.91%
2020-02,הדרום,38,מ.א. אשכול,מועצה איזורית,129,68,61,37,92,3,129,0,1.84%
2020-02,הדרום,33,מ.א. באר טוביה,מועצה איזורית,306,131,175,85,221,46,304,0,2.69%
2020-02,הדרום,41,מ.א. בני שמעון,מועצה איזורית,101,48,53,38,63,15,101,2,2.09%
2020-02,הדרום,54,מ.א. הערבה התיכונה,מועצה איזורית,37,14,23,14,23,1,37,0,1.94%
2020-02,הדרום,53,מ.א. חבל אילות,מועצה איזורית,27,7,20,7,20,2,26,1,1.04%
2020-02,הדרום,36,מ.א. חוף אשקלון,מועצה איזורית,243,114,129,59,184,32,240,0,2.76%
2020-02,הדרום,35,מ.א. יואב,מועצה איזורית,97,35,62,41,56,11,96,0,2.35%
2020-02,הדרום,50,מ.א. לכיש,מועצה איזורית,192,100,92,43,149,40,191,0,3.43%
2020-02,הדרום,42,מ.א. מרחבים,מועצה איזורית,165,75,90,22,143,23,158,0,2.51%
2020-02,הדרום,68,מ.א. נווה מדבר,מועצה איזורית,135,57,78,3,132,94,130,0,6.88%
2020-02,הדרום,48,מ.א. רמת נגב,מועצה איזורית,315,152,163,37,278,219,313,1,9.40%
2020-02,הדרום,39,מ.א. שדות נגב,מועצה איזורית,151,66,85,34,117,23,148,0,3.04%
2020-02,הדרום,37,מ.א. שער הנגב,מועצה איזורית,146,68,78,56,90,43,141,0,3.53%
2020-02,הדרום,34,מ.א. שפיר,מועצה איזורית,145,77,68,23,122,34,143,0,2.87%
2020-02,הדרום,51,מ.א. תמר,מועצה איזורית,19,10,9,2,17,2,19,0,2.92%
2020-02,הדרום,1268,מיתר,יישוב,71,37,34,35,36,4,70,0,1.42%
2020-02,הדרום,99,מצפה רמון,יישוב,240,94,146,18,222,150,235,13,8.39%
2020-02,הדרום,246,נתיבות,יישוב,950,426,524,62,888,357,898,41,5.45%
2020-02,הדרום,666,עומר,יישוב,48,23,25,26,22,1,48,0,1.14%
2020-02,הדרום,2560,ערד,יישוב,637,301,336,57,580,250,611,25,4.80%
2020-02,הדרום,1192,ערערה-בנגב,יישוב,984,461,523,37,947,839,963,8,18.74%
2020-02,הדרום,2630,קריית גת,יישוב,1688,729,959,141,1547,553,1616,38,5.49%
2020-02,הדרום,1034,קריית מלאכי,יישוב,789,369,420,44,745,283,759,33,6.10%
2020-02,הדרום,1161,רהט,יישוב,2079,912,1167,17,2062,1365,2053,51,9.15%
2020-02,הדרום,1286,שגב-שלום,יישוב,339,160,179,3,336,242,330,4,10.17%
2020-02,הדרום,1031,שדרות,יישוב,909,448,461,81,828,393,822,25,5.54%
2020-02,הדרום,1054,תל שבע,יישוב,720,361,359,8,712,600,660,7,11.48%
2020-02,המרכז,1066,"בני עי""ש",יישוב,111,55,56,11,100,28,106,4,2.66%
2020-02,המרכז,182,אבן יהודה,יישוב,154,70,84,66,88,11,154,1,2.20%
2020-02,המרכז,41,אליכין,יישוב,54,28,26,8,46,7,50,2,2.55%
2020-02,המרכז,1309,אלעד,יישוב,346,141,205,26,320,23,338,5,2.37%
2020-02,המרכז,2530,באר יעקב,יישוב,285,123,162,80,205,26,283,4,2.19%
2020-02,המרכז,466,בית דגן,יישוב,101,44,57,14,87,21,99,2,2.65%
2020-02,המרכז,681,גבעת שמואל,יישוב,212,95,117,91,121,24,210,3,1.69%
2020-02,המרכז,2550,גדרה,יישוב,308,134,174,65,243,40,302,3,2.33%
2020-02,המרכז,627,ג'לג'וליה,יישוב,71,32,39,9,62,26,69,2,1.61%
2020-02,המרכז,166,גן יבנה,יישוב,336,135,201,87,249,43,333,3,2.61%
2020-02,המרכז,229,גני תקווה,יישוב,219,94,125,96,123,18,216,1,2.23%
2020-02,המרכז,9700,הוד השרון,יישוב,749,321,428,364,385,16,748,7,2.28%
2020-02,המרכז,1290,זמר,יישוב,108,47,61,4,104,53,108,4,3.31%
2020-02,המרכז,2730,טייבה,יישוב,725,387,338,27,698,403,643,21,3.35%
2020-02,המרכז,2720,טירה,יישוב,218,138,80,34,184,28,213,15,1.69%
2020-02,המרכז,2660,יבנה,יישוב,631,325,306,122,509,91,624,17,2.48%
2020-02,המרכז,9400,יהוד,יישוב,370,170,200,104,266,24,364,11,2.23%
2020-02,המרכז,1224,כוכב יאיר,יישוב,96,46,50,53,43,1,96,0,1.72%
2020-02,המרכז,633,כפר ברא,יישוב,15,10,5,2,13,1,15,0,0.93%
2020-02,המרכז,168,כפר יונה,יישוב,334,138,196,76,258,32,332,4,2.82%
2020-02,המרכז,6900,כפר סבא,יישוב,1143,489,654,430,713,43,1126,29,2.13%
2020-02,המרכז,634,כפר קאסם,יישוב,174,93,81,14,160,70,169,8,1.64%
2020-02,המרכז,7000,לוד,יישוב,1566,741,825,151,1415,581,1538,45,4.16%
2020-02,המרכז,28,מ.א. ברנר,מועצה איזורית,82,39,43,37,45,2,82,2,2.02%
2020-02,המרכז,32,מ.א. גדרות,מועצה איזורית,37,19,18,17,20,1,36,0,1.46%
2020-02,המרכז,30,מ.א. גזר,מועצה איזורית,308,137,171,129,179,19,304,0,2.26%
2020-02,המרכז,27,מ.א. גן רווה,מועצה איזורית,50,19,31,19,31,1,50,0,1.67%
2020-02,המרכז,20,מ.א. דרום השרון,מועצה איזורית,331,135,196,147,184,7,331,0,2.05%
2020-02,המרכז,29,מ.א. חבל יבנה,מועצה איזורית,40,21,19,18,22,1,39,0,1.48%
2020-02,המרכז,25,מ.א. חבל מודיעין,מועצה איזורית,243,105,138,85,158,13,242,0,2.20%
2020-02,המרכז,19,מ.א. חוף השרון,מועצה איזורית,110,53,57,47,63,6,106,0,1.90%
2020-02,המרכז,18,מ.א. לב השרון,מועצה איזורית,235,116,119,77,158,13,233,0,2.10%
2020-02,המרכז,31,מ.א. נחל שורק,מועצה איזורית,74,41,33,22,52,3,74,31,1.73%
2020-02,המרכז,16,מ.א. עמק חפר,מועצה איזורית,390,165,225,152,238,11,386,0,1.96%
2020-02,המרכז,40,מ.א. שדות דן,מועצה איזורית,151,69,82,50,101,10,151,0,2.34%
2020-02,המרכז,1200,מודיעין-מכבים-רעות*,יישוב,940,421,519,438,502,18,936,12,2.02%
2020-02,המרכז,28,מזכרת בתיה,יישוב,157,67,90,60,97,10,152,2,1.87%
2020-02,המרכז,7200,נס ציונה,יישוב,542,244,298,184,358,73,535,6,2.16%
2020-02,המרכז,7400,נתניה,יישוב,3592,1816,1776,558,3034,830,3527,92,3.25%
2020-02,המרכז,587,סביון*,יישוב,25,5,20,14,11,1,25,0,1.20%
2020-02,המרכז,171,פרדסייה,יישוב,77,36,41,32,45,0,77,0,2.05%
2020-02,המרכז,7900,פתח תקווה,יישוב,3500,1678,1822,844,2656,546,3429,59,2.65%
2020-02,המרכז,195,קדימה-צורן,יישוב,276,124,152,84,192,23,273,1,2.32%
2020-02,המרכז,638,קלנסווה,יישוב,276,147,129,17,259,139,250,7,2.58%
2020-02,המרכז,469,קריית עקרון,יישוב,175,94,81,13,162,57,168,5,2.78%
2020-02,המרכז,2640,ראש העין,יישוב,1063,466,597,271,792,96,1052,14,3.37%
2020-02,המרכז,8300,ראשון לציון,יישוב,3699,1658,2041,825,2874,505,3673,58,2.62%
2020-02,המרכז,8400,רחובות,יישוב,1950,907,1043,519,1431,351,1921,57,2.71%
2020-02,המרכז,8500,רמלה,יישוב,1348,655,693,96,1252,345,1299,50,3.35%
2020-02,המרכז,8700,רעננה,יישוב,759,315,444,348,411,21,750,7,1.98%
2020-02,המרכז,1304,שוהם,יישוב,204,83,121,102,102,7,203,1,1.68%
2020-02,המרכז,154,תל מונד,יישוב,141,64,77,52,89,10,141,0,2.04%
2020-02,הצפון,473,אבו סנאן,יישוב,489,224,265,15,474,288,482,2,7.65%
2020-02,הצפון,478,אכסאל,יישוב,393,192,201,17,376,287,392,1,6.16%
2020-02,הצפון,529,אעבלין,יישוב,320,170,150,13,307,207,314,4,5.11%
2020-02,הצפון,482,בועיינה-נוג'ידאת,יישוב,227,121,106,13,214,132,223,1,5.16%
2020-02,הצפון,4001,בוקעאתא,יישוב,210,93,117,6,204,138,208,1,7.13%
2020-02,הצפון,998,ביר אל-מכסור,יישוב,271,150,121,5,266,152,268,0,6.41%
2020-02,הצפון,480,בית ג'ן,יישוב,352,109,243,20,332,191,343,1,5.72%
2020-02,הצפון,9200,בית שאן,יישוב,645,340,305,34,611,243,633,28,6.01%
2020-02,הצפון,944,בסמת טבעון,יישוב,166,90,76,5,161,89,159,0,4.38%
2020-02,הצפון,483,בענה,יישוב,260,120,140,11,249,196,252,5,6.56%
2020-02,הצפון,1292,ג'דיידה-מכר,יישוב,862,417,445,11,851,561,853,7,8.39%
2020-02,הצפון,485,ג'ולס,יישוב,154,42,112,7,147,66,154,0,4.72%
2020-02,הצפון,487,ג'ש (גוש חלב),יישוב,66,23,43,11,55,21,66,3,3.82%
2020-02,הצפון,489,דבורייה,יישוב,233,118,115,17,216,137,229,2,4.84%
2020-02,הצפון,490,דייר אל-אסד,יישוב,289,140,149,13,276,185,282,9,4.92%
2020-02,הצפון,492,דייר חנא,יישוב,409,204,205,17,392,243,406,5,7.78%
2020-02,הצפון,975,זרזיר,יישוב,208,102,106,5,203,83,204,5,5.65%
2020-02,הצפון,496,חורפיש,יישוב,97,45,52,8,89,41,93,2,3.05%
2020-02,הצפון,2034,חצור הגלילית,יישוב,208,100,108,13,195,83,201,2,4.13%
2020-02,הצפון,6700,טבריה,יישוב,1361,671,690,76,1285,563,1262,46,5.63%
2020-02,הצפון,962,טובא-זנגרייה,יישוב,254,129,125,8,246,131,250,3,7.40%
2020-02,הצפון,498,טורעאן,יישוב,323,146,177,19,304,205,320,5,5.05%
2020-02,הצפון,8900,טמרה,יישוב,994,513,481,26,968,713,979,7,6.36%
2020-02,הצפון,1295,יאנוח-ג'ת,יישוב,134,62,72,9,125,51,127,4,3.95%
2020-02,הצפון,46,יבנאל,יישוב,88,45,43,3,85,50,82,1,5.13%
2020-02,הצפון,29,יסוד המעלה,יישוב,24,10,14,8,16,2,24,0,2.71%
2020-02,הצפון,499,יפיע,יישוב,469,236,233,21,448,292,462,7,5.34%
2020-02,הצפון,240,יקנעם עילית,יישוב,423,189,234,84,339,79,417,15,3.23%
2020-02,הצפון,502,ירכא,יישוב,350,145,205,2,348,206,348,3,4.96%
2020-02,הצפון,504,כאבול,יישוב,343,196,147,9,334,237,337,2,6.27%
2020-02,הצפון,505,כאוכב אבו אל-היג'א,יישוב,145,63,82,5,140,101,143,4,7.69%
2020-02,הצפון,1296,כסרא-סמיע,יישוב,193,81,112,4,189,83,186,2,4.76%
2020-02,הצפון,978,כעביה-טבאש-חג'אג'רה,יישוב,178,91,87,16,162,79,173,5,6.63%
2020-02,הצפון,1263,כפר ורדים,יישוב,59,29,30,26,33,2,59,1,1.90%
2020-02,הצפון,507,כפר יאסיף,יישוב,321,140,181,9,312,170,317,1,5.87%
2020-02,הצפון,508,כפר כמא,יישוב,54,31,23,8,46,13,54,0,3.10%
2020-02,הצפון,509,כפר כנא,יישוב,695,389,306,56,639,463,675,16,6.94%
2020-02,הצפון,510,כפר מנדא,יישוב,587,325,262,23,564,388,583,2,7.25%
2020-02,הצפון,47,כפר תבור,יישוב,40,20,20,16,24,5,38,0,1.61%
2020-02,הצפון,1139,כרמיאל,יישוב,1249,560,689,239,1010,496,1179,40,4.56%
2020-02,הצפון,65,מ.א. אל-בטוף,מועצה איזורית,219,116,103,12,207,124,214,0,6.56%
2020-02,הצפון,66,מ.א. בוסתן אל-מרג,מועצה איזורית,34,15,19,1,33,17,34,0,0.97%
2020-02,הצפון,71,מ.א. גולן,מועצה איזורית,245,111,134,70,175,23,241,0,2.75%
2020-02,הצפון,8,מ.א. הגלבוע,מועצה איזורית,578,273,305,68,510,257,570,0,4.04%
2020-02,הצפון,1,מ.א. הגליל העליון,מועצה איזורית,218,94,124,75,143,9,214,0,2.39%
2020-02,הצפון,3,מ.א. הגליל התחתון,מועצה איזורית,151,59,92,46,105,7,146,0,2.42%
2020-02,הצפון,55,מ.א. מבואות החרמון,מועצה איזורית,123,49,74,40,83,18,122,0,3.04%
2020-02,הצפון,13,מ.א. מגידו,מועצה איזורית,120,51,69,47,73,6,117,0,2.07%
2020-02,הצפון,4,מ.א. מטה אשר,מועצה איזורית,464,211,253,111,353,130,457,0,3.22%
2020-02,הצפון,52,מ.א. מעלה יוסף,מועצה איזורית,213,90,123,38,175,43,207,0,3.61%
2020-02,הצפון,2,מ.א. מרום הגליל,מועצה איזורית,263,131,132,35,228,93,258,0,3.61%
2020-02,הצפון,56,מ.א. משגב,מועצה איזורית,516,250,266,125,391,209,502,0,3.55%
2020-02,הצפון,6,מ.א. עמק הירדן,מועצה איזורית,174,84,90,42,132,25,170,0,2.50%
2020-02,הצפון,7,מ.א. עמק המעיינות,מועצה איזורית,198,93,105,40,158,30,196,0,2.99%
2020-02,הצפון,9,מ.א. עמק יזרעאל,מועצה איזורית,410,170,240,179,231,35,405,0,2.07%
2020-02,הצפון,481,מגאר,יישוב,884,411,473,37,847,555,877,15,8.32%
2020-02,הצפון,516,מג'ד אל-כרום,יישוב,394,198,196,9,385,231,387,11,5.27%
2020-02,הצפון,65,מגדל,יישוב,42,19,23,2,40,11,39,0,3.89%
2020-02,הצפון,874,מגדל העמק,יישוב,779,401,378,92,687,201,739,57,5.37%
2020-02,הצפון,4201,מג'דל שמס,יישוב,315,151,164,13,302,170,310,5,5.92%
2020-02,הצפון,517,מזרעה,יישוב,142,81,61,1,141,71,139,1,6.45%
2020-02,הצפון,43,מטולה,יישוב,23,13,10,10,13,4,23,1,2.28%
2020-02,הצפון,4203,מסעדה,יישוב,121,53,68,6,115,76,120,2,6.77%
2020-02,הצפון,518,מעיליא,יישוב,52,28,24,9,43,21,52,0,3.03%
2020-02,הצפון,1063,מעלות-תרשיחא,יישוב,710,379,331,91,619,290,678,29,5.55%
2020-02,הצפון,520,משהד,יישוב,177,90,87,10,167,116,176,6,4.88%
2020-02,הצפון,9100,נהרייה,יישוב,1760,864,896,215,1545,748,1678,43,5.27%
2020-02,הצפון,522,נחף,יישוב,310,145,165,13,297,213,305,3,5.47%
2020-02,הצפון,7300,נצרת,יישוב,2356,1151,1205,142,2214,1513,2332,21,6.34%
2020-02,הצפון,1061,נצרת עילית,יישוב,1351,648,703,151,1200,443,1266,58,5.36%
2020-02,הצפון,525,סאג'ור,יישוב,117,44,73,7,110,45,116,1,5.30%
2020-02,הצפון,7500,סח'נין,יישוב,1348,668,680,62,1286,878,1334,25,8.73%
2020-02,הצפון,4501,ע'ג'ר,יישוב,98,30,68,3,95,42,97,0,7.96%
2020-02,הצפון,530,עיילבון,יישוב,150,75,75,13,137,73,149,2,5.12%
2020-02,הצפון,511,עילוט,יישוב,217,106,111,2,215,149,215,1,6.75%
2020-02,הצפון,532,עין מאהל,יישוב,345,199,146,15,330,208,338,5,5.75%
2020-02,הצפון,4502,עין קנייא,יישוב,93,42,51,1,92,50,93,1,8.47%
2020-02,הצפון,7600,עכו,יישוב,2493,1140,1353,153,2340,1627,2397,17,8.84%
2020-02,הצפון,7700,עפולה,יישוב,1542,733,809,187,1355,465,1494,58,5.41%
2020-02,הצפון,531,עראבה,יישוב,895,426,469,32,863,655,881,14,7.97%
2020-02,הצפון,535,פסוטה,יישוב,73,37,36,8,65,31,69,4,3.85%
2020-02,הצפון,536,פקיעין (בוקייעה),יישוב,99,54,45,6,93,46,97,0,3.25%
2020-02,הצפון,8000,צפת,יישוב,845,442,403,83,762,422,809,15,5.83%
2020-02,הצפון,4100,קצרין,יישוב,195,98,97,39,156,66,191,2,4.74%
2020-02,הצפון,2800,קריית שמונה,יישוב,732,352,380,62,670,222,708,24,5.42%
2020-02,הצפון,543,ראמה,יישוב,214,94,120,22,192,126,210,2,5.12%
2020-02,הצפון,26,ראש פינה,יישוב,49,17,32,11,38,17,48,1,2.91%
2020-02,הצפון,542,ריינה,יישוב,377,198,179,16,361,261,369,9,5.00%
2020-02,הצפון,122,רמת ישי,יישוב,105,41,64,32,73,11,104,2,2.51%
2020-02,הצפון,913,שבלי - אום אל-גנם,יישוב,193,93,100,8,185,93,187,1,6.51%
2020-02,הצפון,812,שלומי,יישוב,197,90,107,13,184,73,195,7,5.32%
2020-02,הצפון,538,שעב,יישוב,320,156,164,6,314,230,317,0,9.54%
2020-02,הצפון,8800,שפרעם,יישוב,1197,569,628,52,1145,738,1175,18,6.02%
2020-02,חיפה,1326,"בסמ""ה",יישוב,281,140,141,10,271,189,275,2,6.18%
2020-02,חיפה,2710,אום אל-פחם,יישוב,2096,995,1101,53,2043,1529,2046,48,8.89%
2020-02,חיפה,1020,אור עקיבא,יישוב,484,239,245,53,431,101,474,12,4.48%
2020-02,חיפה,6000,באקה אל-גרביה,יישוב,542,293,249,27,515,254,535,15,4.10%
2020-02,חיפה,9800,בנימינה-גבעת עדה*,יישוב,153,69,84,69,84,14,153,0,2.04%
2020-02,חיפה,541,ג'סר א-זרקא,יישוב,199,132,67,3,196,35,197,5,3.08%
2020-02,חיפה,628,ג'ת,יישוב,192,106,86,11,181,83,192,6,3.32%
2020-02,חיפה,494,דאלית אל-כרמל,יישוב,421,167,254,36,385,164,411,4,4.67%
2020-02,חיפה,9300,זכרון יעקב,יישוב,218,91,127,99,119,13,216,4,1.90%
2020-02,חיפה,6500,חדרה,יישוב,2044,1011,1033,253,1791,475,1958,42,3.77%
2020-02,חיפה,4000,חיפה,יישוב,5097,2570,2527,1236,3861,1816,4857,107,3.44%
2020-02,חיפה,1247,חריש,יישוב,402,167,235,71,331,49,398,5,8.76%
2020-02,חיפה,2100,טירת כרמל,יישוב,611,320,291,47,564,248,598,13,4.88%
2020-02,חיפה,654,כפר קרע,יישוב,364,176,188,24,340,165,361,6,3.85%
2020-02,חיפה,45,מ.א. אלונה,מועצה איזורית,25,9,16,8,17,0,25,0,2.34%
2020-02,חיפה,12,מ.א. זבולון,מועצה איזורית,230,123,107,40,190,99,222,0,3.74%
2020-02,חיפה,15,מ.א. חוף הכרמל,מועצה איזורית,370,165,205,142,228,43,364,0,2.46%
2020-02,חיפה,14,מ.א. מנשה,מועצה איזורית,248,117,131,68,180,44,247,0,2.87%
2020-02,חיפה,1327,מעלה עירון,יישוב,545,270,275,20,525,372,533,11,8.20%
2020-02,חיפה,2500,נשר,יישוב,380,191,189,84,296,96,366,7,2.89%
2020-02,חיפה,534,עספיא,יישוב,301,148,153,26,275,113,288,7,4.69%
2020-02,חיפה,637,ערערה,יישוב,460,227,233,18,442,254,445,7,4.95%
2020-02,חיפה,537,פוריידיס,יישוב,194,121,73,5,189,37,190,5,3.13%
2020-02,חיפה,7800,פרדס חנה-כרכור,יישוב,641,282,359,203,438,63,632,16,2.95%
2020-02,חיפה,6800,קריית אתא,יישוב,1192,566,626,138,1054,419,1155,38,3.74%
2020-02,חיפה,9500,קריית ביאליק,יישוב,794,368,426,146,648,252,772,27,3.62%
2020-02,חיפה,2300,קריית טבעון,יישוב,164,82,82,72,92,21,160,0,1.91%
2020-02,חיפה,9600,קריית ים,יישוב,1020,550,470,111,909,424,982,28,4.65%
2020-02,חיפה,8200,קריית מוצקין,יישוב,740,342,398,115,625,203,729,11,3.14%
2020-02,חיפה,922,רכסים,יישוב,136,59,77,10,126,43,133,2,3.54%
2020-02,ירושלים,472,אבו גוש,יישוב,220,113,107,11,209,137,216,2,6.21%
2020-02,ירושלים,2610,בית שמש,יישוב,1322,597,725,131,1191,231,1288,43,3.42%
2020-02,ירושלים,3000,ירושלים,יישוב,11283,5431,5852,1613,9670,5587,11031,138,3.44%
2020-02,ירושלים,26,מ.א. מטה יהודה,מועצה איזורית,620,317,303,178,442,85,614,1,2.37%
2020-02,ירושלים,1015,מבשרת ציון,יישוב,335,172,163,84,251,81,331,4,2.59%
2020-02,ירושלים,1137,קריית יערים,יישוב,58,19,39,11,47,9,58,0,3.23%
2020-02,תל אביב,2400,אור יהודה,יישוב,549,289,260,57,492,85,531,26,2.77%
2020-02,תל אביב,565,אזור,יישוב,182,79,103,32,150,15,182,3,2.71%
2020-02,תל אביב,6100,בני ברק,יישוב,1412,669,743,122,1290,357,1342,32,2.22%
2020-02,תל אביב,6200,בת ים,יישוב,2465,1247,1218,377,2088,568,2377,78,3.37%
2020-02,תל אביב,6300,גבעתיים,יישוב,757,340,417,401,356,45,753,10,2.36%
2020-02,תל אביב,6400,הרצלייה,יישוב,1076,484,592,432,644,39,1070,16,2.17%
2020-02,תל אביב,6600,חולון,יישוב,2883,1271,1612,530,2353,415,2820,62,2.79%
2020-02,תל אביב,267,כפר שמריהו,יישוב,9,4,5,5,4,0,9,0,1.08%
2020-02,תל אביב,2620,קריית אונו,יישוב,432,184,248,217,215,31,429,4,2.19%
2020-02,תל אביב,8600,רמת גן,יישוב,2003,900,1103,827,1176,192,1977,41,2.42%
2020-02,תל אביב,2650,רמת השרון,יישוב,427,187,240,223,204,9,425,3,1.85%
2020-02,תל אביב,5000,תל אביב -יפו,יישוב,7097,3483,3614,3360,3737,896,7012,117,2.66%
2020-03,אזור יהודה והשומרון,3760,אורנית,יישוב,1001,422,579,68,933,16,1001,0,19.88%
2020-03,אזור יהודה והשומרון,3750,אלפי מנשה,יישוב,941,393,548,57,884,14,938,1,21.03%
2020-03,אזור יהודה והשומרון,3560,אלקנה,יישוב,303,122,181,43,260,3,301,0,16.31%
2020-03,אזור יהודה והשומרון,3650,אפרת,יישוב,910,429,481,70,840,21,904,1,18.36%
2020-03,אזור יהודה והשומרון,3570,אריאל,יישוב,2496,1052,1444,138,2358,36,2490,9,22.66%
2020-03,אזור יהודה והשומרון,3574,בית אל,יישוב,557,302,255,33,524,8,554,0,22.19%
2020-03,אזור יהודה והשומרון,3652,בית אריה,יישוב,593,239,354,32,561,8,593,0,20.55%
2020-03,אזור יהודה והשומרון,3780,ביתר עילית,יישוב,6461,2312,4149,66,6395,209,6442,2,41.39%
2020-03,אזור יהודה והשומרון,3730,גבעת זאב,יישוב,2083,890,1193,91,1992,67,2076,1,25.48%
2020-03,אזור יהודה והשומרון,3769,הר אדר,יישוב,358,144,214,29,329,10,357,0,16.29%
2020-03,אזור יהודה והשומרון,76,מ.א. גוש עציון,מועצה איזורית,2102,990,1112,151,1951,51,2089,0,20.60%
2020-03,אזור יהודה והשומרון,78,מ.א. הר חברון,מועצה איזורית,715,324,391,56,659,11,714,0,17.99%
2020-03,אזור יהודה והשומרון,74,מ.א. מגילות ים המלח,מועצה איזורית,229,99,130,17,212,1,229,0,24.81%
2020-03,אזור יהודה והשומרון,73,מ.א. מטה בנימין,מועצה איזורית,5896,2657,3239,402,5494,164,5877,0,20.71%
2020-03,אזור יהודה והשומרון,75,מ.א. ערבות הירדן,מועצה איזורית,452,214,238,43,409,13,450,0,17.49%
2020-03,אזור יהודה והשומרון,72,מ.א. שומרון,מועצה איזורית,4083,1770,2313,322,3761,61,4077,0,21.53%
2020-03,אזור יהודה והשומרון,3797,מודיעין עילית,יישוב,5937,1558,4379,61,5876,59,5927,2,37.07%
2020-03,אזור יהודה והשומרון,3616,מעלה אדומים,יישוב,4622,2018,2604,214,4408,108,4605,8,22.00%
2020-03,אזור יהודה והשומרון,3608,מעלה אפרים,יישוב,218,86,132,6,212,15,216,0,26.80%
2020-03,אזור יהודה והשומרון,3660,עמנואל,יישוב,500,195,305,4,496,16,498,0,36.94%
2020-03,אזור יהודה והשומרון,3557,קדומים,יישוב,344,159,185,18,326,5,344,0,17.24%
2020-03,אזור יהודה והשומרון,3611,קריית ארבע,יישוב,952,425,527,40,912,47,949,0,28.14%
2020-03,אזור יהודה והשומרון,3640,קרני שומרון,יישוב,883,416,467,51,832,24,879,0,21.59%
2020-03,הדרום,31,אופקים,יישוב,3661,1258,2403,117,3544,383,3634,23,25.18%
2020-03,הדרום,2600,אילת,יישוב,14298,6771,7527,246,14052,730,14230,29,40.97%
2020-03,הדרום,70,אשדוד,יישוב,26876,10539,16337,1124,25752,2183,26685,75,23.86%
2020-03,הדרום,7100,אשקלון,יישוב,16559,6497,10062,772,15787,1693,16312,49,21.99%
2020-03,הדרום,9000,באר שבע,יישוב,23175,9105,14070,1463,21712,2888,22889,70,21.36%
2020-03,הדרום,2200,דימונה,יישוב,4979,1959,3020,225,4754,996,4916,12,25.40%
2020-03,הדרום,1303,חורה,יישוב,1014,616,398,13,1001,410,985,2,20.49%
2020-03,הדרום,831,ירוחם,יישוב,1355,538,817,71,1284,210,1335,7,25.88%
2020-03,הדרום,1059,כסיפה,יישוב,1886,1100,786,15,1871,897,1879,0,34.06%
2020-03,הדרום,1271,להבים,יישוב,424,163,261,35,389,15,422,0,11.96%
2020-03,הדרום,1060,לקיה,יישוב,1040,568,472,12,1028,458,1008,1,20.76%
2020-03,הדרום,69,מ.א. אל קסום,מועצה איזורית,1605,773,832,26,1579,714,1573,1,46.09%
2020-03,הדרום,38,מ.א. אשכול,מועצה איזורית,1173,442,731,83,1090,25,1172,0,16.72%
2020-03,הדרום,33,מ.א. באר טוביה,מועצה איזורית,2231,834,1397,148,2083,96,2223,0,19.63%
2020-03,הדרום,41,מ.א. בני שמעון,מועצה איזורית,770,267,503,60,710,26,769,0,15.89%
2020-03,הדרום,54,מ.א. הערבה התיכונה,מועצה איזורית,325,105,220,37,288,10,324,0,17.00%
2020-03,הדרום,53,מ.א. חבל אילות,מועצה איזורית,356,132,224,14,342,7,355,1,14.26%
2020-03,הדרום,36,מ.א. חוף אשקלון,מועצה איזורית,1697,657,1040,98,1599,68,1690,0,19.43%
2020-03,הדרום,35,מ.א. יואב,מועצה איזורית,718,271,447,72,646,30,717,0,17.54%
2020-03,הדרום,50,מ.א. לכיש,מועצה איזורית,1159,446,713,78,1081,54,1157,0,20.77%
2020-03,הדרום,42,מ.א. מרחבים,מועצה איזורית,1303,417,886,67,1236,41,1293,0,20.54%
2020-03,הדרום,68,מ.א. נווה מדבר,מועצה איזורית,346,178,168,6,340,96,342,0,18.10%
2020-03,הדרום,48,מ.א. רמת נגב,מועצה איזורית,782,296,486,94,688,225,779,0,23.39%
2020-03,הדרום,39,מ.א. שדות נגב,מועצה איזורית,965,337,628,66,899,31,962,0,19.79%
2020-03,הדרום,37,מ.א. שער הנגב,מועצה איזורית,835,323,512,114,721,88,829,0,20.73%
2020-03,הדרום,34,מ.א. שפיר,מועצה איזורית,982,381,601,60,922,55,980,0,19.65%
2020-03,הדרום,51,מ.א. תמר,מועצה איזורית,152,75,77,12,140,9,152,0,23.35%
2020-03,הדרום,1268,מיתר,יישוב,742,309,433,68,674,17,741,0,15.04%
2020-03,הדרום,99,מצפה רמון,יישוב,894,368,526,64,830,168,884,3,31.57%
2020-03,הדרום,246,נתיבות,יישוב,4645,1674,2971,184,4461,445,4598,41,27.89%
2020-03,הדרום,666,עומר,יישוב,589,272,317,61,528,14,587,0,13.92%
2020-03,הדרום,2560,ערד,יישוב,3857,1580,2277,184,3673,359,3819,17,30.02%
2020-03,הדרום,1192,ערערה-בנגב,יישוב,1394,732,662,43,1351,834,1363,0,26.52%
2020-03,הדרום,2630,קריית גת,יישוב,7204,2867,4337,282,6922,691,7145,24,24.27%
2020-03,הדרום,1034,קריית מלאכי,יישוב,3110,1314,1796,98,3012,353,3074,19,24.70%
2020-03,הדרום,1161,רהט,יישוב,4221,2055,2166,42,4179,1438,4186,48,18.66%
2020-03,הדרום,1286,שגב-שלום,יישוב,569,314,255,6,563,259,558,0,17.19%
2020-03,הדרום,1031,שדרות,יישוב,3480,1516,1964,201,3279,453,3389,18,22.84%
2020-03,הדרום,1054,תל שבע,יישוב,1429,697,732,14,1415,599,1386,8,24.10%
2020-03,המרכז,1066,"בני עי""ש",יישוב,871,336,535,23,848,59,863,3,21.62%
2020-03,המרכז,182,אבן יהודה,יישוב,1226,508,718,96,1130,26,1224,0,17.50%
2020-03,המרכז,41,אליכין,יישוב,441,200,241,20,421,10,439,0,22.42%
2020-03,המרכז,1309,אלעד,יישוב,4764,1660,3104,82,4682,84,4742,1,33.31%
2020-03,המרכז,2530,באר יעקב,יישוב,2750,1142,1608,168,2582,71,2745,1,21.28%
2020-03,המרכז,466,בית דגן,יישוב,899,392,507,35,864,34,896,2,23.95%
2020-03,המרכז,681,גבעת שמואל,יישוב,2195,923,1272,193,2002,53,2190,1,17.57%
2020-03,המרכז,2550,גדרה,יישוב,2436,978,1458,118,2318,77,2426,2,18.70%
2020-03,המרכז,627,ג'לג'וליה,יישוב,882,387,495,17,865,48,877,0,20.45%
2020-03,המרכז,166,גן יבנה,יישוב,2598,1015,1583,135,2463,76,2596,5,20.37%
2020-03,המרכז,229,גני תקווה,יישוב,1850,777,1073,123,1727,42,1845,2,19.09%
2020-03,המרכז,9700,הוד השרון,יישוב,6103,2481,3622,502,5601,109,6089,6,18.58%
2020-03,המרכז,1290,זמר,יישוב,640,340,300,7,633,64,637,1,19.50%
2020-03,המרכז,2730,טייבה,יישוב,4457,2188,2269,93,4364,447,4362,26,22.70%
2020-03,המרכז,2720,טירה,יישוב,2425,1089,1336,52,2373,77,2415,14,19.21%
2020-03,המרכז,2660,יבנה,יישוב,5382,2184,3198,224,5158,178,5362,23,21.32%
2020-03,המרכז,9400,יהוד,יישוב,3675,1557,2118,189,3486,80,3668,3,22.47%
2020-03,המרכז,1224,כוכב יאיר,יישוב,915,384,531,76,839,13,913,0,16.38%
2020-03,המרכז,633,כפר ברא,יישוב,297,163,134,7,290,11,297,0,18.42%
2020-03,המרכז,168,כפר יונה,יישוב,2838,1166,1672,133,2705,89,2828,1,24.02%
2020-03,המרכז,6900,כפר סבא,יישוב,10184,4204,5980,684,9500,222,10156,12,19.17%
2020-03,המרכז,634,כפר קאסם,יישוב,1925,896,1029,20,1905,104,1919,1,18.62%
2020-03,המרכז,7000,לוד,יישוב,9108,4025,5083,282,8826,780,9067,31,24.55%
2020-03,המרכז,28,מ.א. ברנר,מועצה איזורית,702,291,411,50,652,9,700,2,17.22%
2020-03,המרכז,32,מ.א. גדרות,מועצה איזורית,380,148,232,31,349,4,379,0,15.39%
2020-03,המרכז,30,מ.א. גזר,מועצה איזורית,2614,1111,1503,193,2421,63,2609,0,19.44%
2020-03,המרכז,27,מ.א. גן רווה,מועצה איזורית,602,254,348,39,563,5,601,0,20.05%
2020-03,המרכז,20,מ.א. דרום השרון,מועצה איזורית,3122,1277,1845,225,2897,54,3111,0,19.22%
2020-03,המרכז,29,מ.א. חבל יבנה,מועצה איזורית,418,170,248,31,387,4,413,0,15.72%
2020-03,המרכז,25,מ.א. חבל מודיעין,מועצה איזורית,2277,894,1383,130,2147,51,2269,0,20.65%
2020-03,המרכז,19,מ.א. חוף השרון,מועצה איזורית,991,425,566,82,909,17,983,0,17.66%
2020-03,המרכז,18,מ.א. לב השרון,מועצה איזורית,2109,857,1252,133,1976,48,2102,0,18.90%
2020-03,המרכז,31,מ.א. נחל שורק,מועצה איזורית,612,258,354,41,571,19,612,23,14.33%
2020-03,המרכז,16,מ.א. עמק חפר,מועצה איזורית,3755,1482,2273,273,3482,52,3744,0,19.03%
2020-03,המרכז,40,מ.א. שדות דן,מועצה איזורית,1414,599,815,84,1330,26,1410,0,21.87%
2020-03,המרכז,1200,מודיעין-מכבים-רעות*,יישוב,8533,3400,5133,617,7916,154,8513,21,18.41%
2020-03,המרכז,28,מזכרת בתיה,יישוב,1440,565,875,84,1356,42,1435,2,17.64%
2020-03,המרכז,7200,נס ציונה,יישוב,4671,1985,2686,281,4390,156,4660,5,18.85%
2020-03,המרכז,7400,נתניה,יישוב,26743,11339,15404,1123,25620,1485,26639,40,24.58%
2020-03,המרכז,587,סביון*,יישוב,302,136,166,23,279,6,301,0,14.41%
2020-03,המרכז,171,פרדסייה,יישוב,746,330,416,53,693,9,742,1,19.72%
2020-03,המרכז,7900,פתח תקווה,יישוב,27399,11422,15977,1356,26043,963,27304,37,21.14%
2020-03,המרכז,195,קדימה-צורן,יישוב,2297,948,1349,148,2149,50,2291,2,19.49%
2020-03,המרכז,638,קלנסווה,יישוב,1825,1015,810,47,1778,158,1798,9,18.59%
2020-03,המרכז,469,קריית עקרון,יישוב,1378,575,803,32,1346,85,1372,2,22.70%
2020-03,המרכז,2640,ראש העין,יישוב,7664,3137,4527,477,7187,212,7637,15,24.45%
2020-03,המרכז,8300,ראשון לציון,יישוב,33378,13760,19618,1701,31677,1279,33313,40,23.73%
2020-03,המרכז,8400,רחובות,יישוב,14750,5903,8847,830,13920,637,14695,32,20.72%
2020-03,המרכז,8500,רמלה,יישוב,9397,4155,5242,219,9178,582,9356,44,24.13%
2020-03,המרכז,8700,רעננה,יישוב,6915,2886,4029,505,6410,168,6895,13,18.19%
2020-03,המרכז,1304,שוהם,יישוב,2060,823,1237,167,1893,40,2055,0,16.96%
2020-03,המרכז,154,תל מונד,יישוב,1252,491,761,91,1161,27,1252,1,18.12%
2020-03,הצפון,473,אבו סנאן,יישוב,1695,796,899,24,1671,334,1681,2,26.67%
2020-03,הצפון,478,אכסאל,יישוב,1300,669,631,23,1277,300,1297,0,20.37%
2020-03,הצפון,529,אעבלין,יישוב,1582,794,788,34,1548,262,1571,2,25.55%
2020-03,הצפון,482,בועיינה-נוג'ידאת,יישוב,1035,580,455,26,1009,155,1028,0,23.80%
2020-03,הצפון,4001,בוקעאתא,יישוב,706,314,392,24,682,150,701,2,24.04%
2020-03,הצפון,998,ביר אל-מכסור,יישוב,852,467,385,10,842,179,847,1,20.27%
2020-03,הצפון,480,בית ג'ן,יישוב,1105,376,729,38,1067,206,1096,0,18.28%
2020-03,הצפון,9200,בית שאן,יישוב,2689,1098,1591,71,2618,323,2675,20,25.39%
2020-03,הצפון,944,בסמת טבעון,יישוב,938,489,449,12,926,109,933,0,25.73%
2020-03,הצפון,483,בענה,יישוב,1011,480,531,20,991,222,1002,4,26.07%
2020-03,הצפון,1292,ג'דיידה-מכר,יישוב,2910,1417,1493,32,2878,601,2891,3,28.42%
2020-03,הצפון,485,ג'ולס,יישוב,601,188,413,12,589,70,600,0,18.38%
2020-03,הצפון,487,ג'ש (גוש חלב),יישוב,341,144,197,17,324,29,341,0,19.71%
2020-03,הצפון,489,דבורייה,יישוב,902,460,442,29,873,155,897,2,18.96%
2020-03,הצפון,490,דייר אל-אסד,יישוב,1037,526,511,22,1015,210,1028,4,17.94%
2020-03,הצפון,492,דייר חנא,יישוב,1710,915,795,39,1671,270,1708,2,32.72%
2020-03,הצפון,975,זרזיר,יישוב,805,388,417,9,796,109,798,6,22.12%
2020-03,הצפון,496,חורפיש,יישוב,434,202,232,15,419,53,427,1,14.00%
2020-03,הצפון,2034,חצור הגלילית,יישוב,1402,585,817,37,1365,112,1395,1,28.63%
2020-03,הצפון,6700,טבריה,יישוב,6853,2974,3879,156,6697,775,6735,40,30.03%
2020-03,הצפון,962,טובא-זנגרייה,יישוב,924,350,574,17,907,146,918,1,27.18%
2020-03,הצפון,498,טורעאן,יישוב,1763,1013,750,43,1720,250,1757,3,27.73%
2020-03,הצפון,8900,טמרה,יישוב,3930,2069,1861,60,3870,800,3913,3,25.44%
2020-03,הצפון,1295,יאנוח-ג'ת,יישוב,591,253,338,14,577,66,586,6,18.24%
2020-03,הצפון,46,יבנאל,יישוב,446,192,254,6,440,61,440,0,27.55%
2020-03,הצפון,29,יסוד המעלה,יישוב,187,69,118,18,169,6,187,0,21.11%
2020-03,הצפון,499,יפיע,יישוב,2354,1304,1050,47,2307,338,2346,1,27.13%
2020-03,הצפון,240,יקנעם עילית,יישוב,2478,930,1548,167,2311,131,2469,14,19.13%
2020-03,הצפון,502,ירכא,יישוב,1560,656,904,10,1550,230,1552,1,22.11%
2020-03,הצפון,504,כאבול,יישוב,1262,693,569,24,1238,264,1254,3,23.33%
2020-03,הצפון,505,כאוכב אבו אל-היג'א,יישוב,555,254,301,14,541,119,551,3,29.62%
2020-03,הצפון,1296,כסרא-סמיע,יישוב,610,324,286,9,601,107,603,4,15.43%
2020-03,הצפון,978,כעביה-טבאש-חג'אג'רה,יישוב,645,359,286,24,621,100,641,3,24.57%
2020-03,הצפון,1263,כפר ורדים,יישוב,542,206,336,43,499,15,539,1,17.32%
2020-03,הצפון,507,כפר יאסיף,יישוב,1467,681,786,16,1451,201,1455,0,26.93%
2020-03,הצפון,508,כפר כמא,יישוב,262,116,146,10,252,22,261,0,14.97%
2020-03,הצפון,509,כפר כנא,יישוב,2736,1580,1156,109,2627,550,2702,3,27.80%
2020-03,הצפון,510,כפר מנדא,יישוב,2238,1432,806,41,2197,427,2231,2,27.75%
2020-03,הצפון,47,כפר תבור,יישוב,430,182,248,33,397,11,429,1,18.15%
2020-03,הצפון,1139,כרמיאל,יישוב,5531,2276,3255,437,5094,643,5454,21,21.07%
2020-03,הצפון,65,מ.א. אל-בטוף,מועצה איזורית,934,542,392,22,912,153,927,1,28.40%
2020-03,הצפון,66,מ.א. בוסתן אל-מרג,מועצה איזורית,85,48,37,2,83,20,85,1,2.41%
2020-03,הצפון,71,מ.א. גולן,מועצה איזורית,1771,730,1041,117,1654,49,1758,1,20.03%
2020-03,הצפון,8,מ.א. הגלבוע,מועצה איזורית,2916,1300,1616,138,2778,314,2901,0,20.54%
2020-03,הצפון,1,מ.א. הגליל העליון,מועצה איזורית,1881,719,1162,165,1716,38,1873,0,20.93%
2020-03,הצפון,3,מ.א. הגליל התחתון,מועצה איזורית,1224,485,739,80,1144,23,1212,0,20.12%
2020-03,הצפון,55,מ.א. מבואות החרמון,מועצה איזורית,912,366,546,61,851,31,911,0,22.72%
2020-03,הצפון,13,מ.א. מגידו,מועצה איזורית,903,353,550,78,825,20,900,0,15.92%
2020-03,הצפון,4,מ.א. מטה אשר,מועצה איזורית,2657,1079,1578,162,2495,178,2645,0,18.62%
2020-03,הצפון,52,מ.א. מעלה יוסף,מועצה איזורית,1225,475,750,70,1155,67,1217,0,21.22%
2020-03,הצפון,2,מ.א. מרום הגליל,מועצה איזורית,1480,644,836,63,1417,125,1473,0,20.63%
2020-03,הצפון,56,מ.א. משגב,מועצה איזורית,2790,1223,1567,234,2556,243,2767,0,19.57%
2020-03,הצפון,6,מ.א. עמק הירדן,מועצה איזורית,1644,647,997,88,1556,62,1630,0,24.00%
2020-03,הצפון,7,מ.א. עמק המעיינות,מועצה איזורית,1267,480,787,73,1194,52,1265,0,19.29%
2020-03,הצפון,9,מ.א. עמק יזרעאל,מועצה איזורית,3406,1308,2098,306,3100,90,3392,0,17.34%
2020-03,הצפון,481,מגאר,יישוב,2817,1574,1243,66,2751,607,2804,5,26.60%
2020-03,הצפון,516,מג'ד אל-כרום,יישוב,2055,1108,947,30,2025,263,2042,3,27.81%
2020-03,הצפון,65,מגדל,יישוב,258,95,163,5,253,16,255,1,25.42%
2020-03,הצפון,874,מגדל העמק,יישוב,3212,1317,1895,151,3061,291,3178,44,23.10%
2020-03,הצפון,4201,מג'דל שמס,יישוב,1417,765,652,52,1365,203,1410,4,26.94%
2020-03,הצפון,517,מזרעה,יישוב,534,240,294,7,527,80,528,4,24.50%
2020-03,הצפון,43,מטולה,יישוב,255,117,138,21,234,8,254,0,25.22%
2020-03,הצפון,4203,מסעדה,יישוב,443,228,215,19,424,91,440,1,24.83%
2020-03,הצפון,518,מעיליא,יישוב,337,147,190,19,318,33,332,0,19.31%
2020-03,הצפון,1063,מעלות-תרשיחא,יישוב,2780,1273,1507,153,2627,356,2740,33,22.41%
2020-03,הצפון,520,משהד,יישוב,880,535,345,25,855,130,873,2,24.23%
2020-03,הצפון,9100,נהרייה,יישוב,7664,3256,4408,325,7339,990,7558,46,23.76%
2020-03,הצפון,522,נחף,יישוב,1566,954,612,24,1542,246,1557,1,27.93%
2020-03,הצפון,7300,נצרת,יישוב,10671,5600,5071,291,10380,1705,10634,7,28.89%
2020-03,הצפון,1061,נצרת עילית,יישוב,5867,2627,3240,287,5580,663,5772,44,24.45%
2020-03,הצפון,525,סאג'ור,יישוב,452,171,281,13,439,54,449,0,20.50%
2020-03,הצפון,7500,סח'נין,יישוב,4697,2468,2229,141,4556,961,4673,20,30.57%
2020-03,הצפון,4501,ע'ג'ר,יישוב,382,202,180,5,377,43,380,2,31.20%
2020-03,הצפון,530,עיילבון,יישוב,764,385,379,16,748,92,761,1,26.13%
2020-03,הצפון,511,עילוט,יישוב,736,408,328,10,726,159,731,1,22.94%
2020-03,הצפון,532,עין מאהל,יישוב,1521,907,614,28,1493,240,1511,2,25.71%
2020-03,הצפון,4502,עין קנייא,יישוב,306,147,159,5,301,55,306,0,27.87%
2020-03,הצפון,7600,עכו,יישוב,7715,3260,4455,259,7456,1823,7603,19,28.03%
2020-03,הצפון,7700,עפולה,יישוב,6795,2660,4135,350,6445,647,6743,20,24.43%
2020-03,הצפון,531,עראבה,יישוב,2626,1372,1254,81,2545,722,2606,11,23.57%
2020-03,הצפון,535,פסוטה,יישוב,400,189,211,19,381,39,396,0,22.12%
2020-03,הצפון,536,פקיעין (בוקייעה),יישוב,578,306,272,12,566,68,576,2,19.27%
2020-03,הצפון,8000,צפת,יישוב,4059,1751,2308,149,3910,580,4018,14,28.97%
2020-03,הצפון,4100,קצרין,יישוב,982,415,567,54,928,87,975,4,24.19%
2020-03,הצפון,2800,קריית שמונה,יישוב,3292,1434,1858,165,3127,294,3262,15,24.97%
2020-03,הצפון,543,ראמה,יישוב,1052,515,537,34,1018,143,1046,1,25.51%
2020-03,הצפון,26,ראש פינה,יישוב,392,148,244,18,374,30,391,0,23.67%
2020-03,הצפון,542,ריינה,יישוב,1822,969,853,46,1776,309,1807,1,24.51%
2020-03,הצפון,122,רמת ישי,יישוב,790,313,477,67,723,27,787,2,18.99%
2020-03,הצפון,913,שבלי - אום אל-גנם,יישוב,573,237,336,12,561,101,566,0,19.70%
2020-03,הצפון,812,שלומי,יישוב,884,354,530,18,866,90,880,2,24.03%
2020-03,הצפון,538,שעב,יישוב,793,430,363,16,777,252,787,6,23.69%
2020-03,הצפון,8800,שפרעם,יישוב,5158,2578,2580,109,5049,871,5120,6,26.22%
2020-03,חיפה,1326,"בסמ""ה",יישוב,878,531,347,17,861,192,873,3,19.61%
2020-03,חיפה,2710,אום אל-פחם,יישוב,6281,3593,2688,96,6185,1636,6222,23,27.02%
2020-03,חיפה,1020,אור עקיבא,יישוב,2579,1079,1500,102,2477,153,2560,4,24.21%
2020-03,חיפה,6000,באקה אל-גרביה,יישוב,3009,1687,1322,47,2962,309,3000,19,22.97%
2020-03,חיפה,9800,בנימינה-גבעת עדה*,יישוב,1201,456,745,112,1089,30,1197,2,15.95%
2020-03,חיפה,541,ג'סר א-זרקא,יישוב,1308,713,595,8,1300,64,1299,9,20.30%
2020-03,חיפה,628,ג'ת,יישוב,979,555,424,16,963,94,978,5,16.89%
2020-03,חיפה,494,דאלית אל-כרמל,יישוב,1888,751,1137,56,1832,194,1877,6,21.34%
2020-03,חיפה,9300,זכרון יעקב,יישוב,1969,732,1237,161,1808,37,1966,0,17.27%
2020-03,חיפה,6500,חדרה,יישוב,12074,4983,7091,457,11617,739,11964,32,23.01%
2020-03,חיפה,4000,חיפה,יישוב,31279,13243,18036,2266,29013,2879,30978,46,21.92%
2020-03,חיפה,1247,חריש,יישוב,1642,703,939,115,1527,84,1635,5,36.01%
2020-03,חיפה,2100,טירת כרמל,יישוב,3140,1330,1810,136,3004,324,3111,14,25.40%
2020-03,חיפה,654,כפר קרע,יישוב,1833,802,1031,49,1784,207,1826,2,19.45%
2020-03,חיפה,45,מ.א. אלונה,מועצה איזורית,204,84,120,12,192,2,204,0,19.12%
2020-03,חיפה,12,מ.א. זבולון,מועצה איזורית,1199,563,636,58,1141,120,1191,0,20.08%
2020-03,חיפה,15,מ.א. חוף הכרמל,מועצה איזורית,2758,1126,1632,284,2474,74,2748,0,18.55%
2020-03,חיפה,14,מ.א. מנשה,מועצה איזורית,1838,734,1104,115,1723,69,1834,0,21.33%
2020-03,חיפה,1327,מעלה עירון,יישוב,1557,809,748,24,1533,392,1545,7,23.77%
2020-03,חיפה,2500,נשר,יישוב,2732,1087,1645,177,2555,182,2715,2,21.40%
2020-03,חיפה,534,עספיא,יישוב,1287,569,718,34,1253,129,1272,2,20.70%
2020-03,חיפה,637,ערערה,יישוב,1855,925,930,45,1810,297,1841,3,20.47%
2020-03,חיפה,537,פוריידיס,יישוב,1319,739,580,16,1303,57,1313,4,21.64%
2020-03,חיפה,7800,פרדס חנה-כרכור,יישוב,4434,1778,2656,328,4106,188,4413,12,20.59%
2020-03,חיפה,6800,קריית אתא,יישוב,7078,2777,4301,246,6832,602,7038,23,22.81%
2020-03,חיפה,9500,קריית ביאליק,יישוב,4858,1908,2950,233,4625,387,4825,17,22.61%
2020-03,חיפה,2300,קריית טבעון,יישוב,1448,613,835,126,1322,57,1441,0,17.18%
2020-03,חיפה,9600,קריית ים,יישוב,4789,2031,2758,178,4611,603,4747,23,22.49%
2020-03,חיפה,8200,קריית מוצקין,יישוב,5106,2024,3082,212,4894,346,5086,13,21.91%
2020-03,חיפה,922,רכסים,יישוב,1287,398,889,31,1256,78,1279,0,34.06%
2020-03,ירושלים,472,אבו גוש,יישוב,1108,636,472,32,1076,164,1100,1,31.61%
2020-03,ירושלים,2610,בית שמש,יישוב,10904,4143,6761,275,10629,408,10852,39,28.85%
2020-03,ירושלים,3000,ירושלים,יישוב,85385,42818,42567,3271,82114,6980,84937,79,26.49%
2020-03,ירושלים,26,מ.א. מטה יהודה,מועצה איזורית,5431,2355,3076,342,5089,190,5413,0,20.92%
2020-03,ירושלים,1015,מבשרת ציון,יישוב,2609,1224,1385,170,2439,123,2596,1,20.28%
2020-03,ירושלים,1137,קריית יערים,יישוב,660,227,433,24,636,16,658,0,36.62%
2020-03,תל אביב,2400,אור יהודה,יישוב,4996,2213,2783,120,4876,202,4965,15,25.86%
2020-03,תל אביב,565,אזור,יישוב,1701,711,990,61,1640,59,1698,5,25.29%
2020-03,תל אביב,6100,בני ברק,יישוב,19870,6501,13369,299,19571,548,19779,17,32.77%
2020-03,תל אביב,6200,בת ים,יישוב,18452,8013,10439,848,17604,1187,18301,61,25.95%
2020-03,תל אביב,6300,גבעתיים,יישוב,6279,2688,3591,675,5604,151,6267,4,19.68%
2020-03,תל אביב,6400,הרצלייה,יישוב,10297,4270,6027,767,9530,138,10271,10,20.87%
2020-03,תל אביב,6600,חולון,יישוב,25243,10859,14384,1051,24192,1032,25145,71,24.92%
2020-03,תל אביב,267,כפר שמריהו,יישוב,112,52,60,8,104,1,112,0,13.43%
2020-03,תל אביב,2620,קריית אונו,יישוב,3509,1483,2026,329,3180,75,3496,4,17.83%
2020-03,תל אביב,8600,רמת גן,יישוב,18550,7848,10702,1425,17125,557,18498,10,22.62%
2020-03,תל אביב,2650,רמת השרון,יישוב,4249,1716,2533,349,3900,54,4242,2,18.45%
2020-03,תל אביב,5000,תל אביב -יפו,יישוב,57147,25545,31602,5196,51951,2036,56985,81,21.61%
2020-04,אזור יהודה והשומרון,3760,אורנית,יישוב,1159,515,644,71,1088,21,1158,0,23.00%
2020-04,אזור יהודה והשומרון,3750,אלפי מנשה,יישוב,1102,471,631,60,1042,18,1099,1,24.64%
2020-04,אזור יהודה והשומרון,3560,אלקנה,יישוב,349,148,201,42,307,4,346,0,18.74%
2020-04,אזור יהודה והשומרון,3650,אפרת,יישוב,1104,523,581,76,1028,27,1098,0,22.29%
2020-04,אזור יהודה והשומרון,3570,אריאל,יישוב,2927,1269,1658,148,2779,53,2915,0,26.53%
2020-04,אזור יהודה והשומרון,3574,בית אל,יישוב,632,341,291,38,594,14,627,0,25.11%
2020-04,אזור יהודה והשומרון,3652,בית אריה,יישוב,682,290,392,35,647,7,682,0,23.63%
2020-04,אזור יהודה והשומרון,3780,ביתר עילית,יישוב,7109,2576,4533,75,7034,260,7087,3,45.53%
2020-04,אזור יהודה והשומרון,3730,גבעת זאב,יישוב,2440,1062,1378,99,2341,98,2430,0,29.83%
2020-04,אזור יהודה והשומרון,3769,הר אדר,יישוב,427,176,251,31,396,13,426,0,19.43%
2020-04,אזור יהודה והשומרון,76,מ.א. גוש עציון,מועצה איזורית,2458,1162,1296,152,2306,69,2444,0,24.10%
2020-04,אזור יהודה והשומרון,78,מ.א. הר חברון,מועצה איזורית,816,378,438,59,757,18,814,0,20.51%
2020-04,אזור יהודה והשומרון,74,מ.א. מגילות ים המלח,מועצה איזורית,260,109,151,17,243,3,260,0,28.17%
2020-04,אזור יהודה והשומרון,73,מ.א. מטה בנימין,מועצה איזורית,6906,3171,3735,419,6487,217,6881,0,24.25%
2020-04,אזור יהודה והשומרון,75,מ.א. ערבות הירדן,מועצה איזורית,541,245,296,45,496,18,540,0,20.99%
2020-04,אזור יהודה והשומרון,72,מ.א. שומרון,מועצה איזורית,4674,2072,2602,330,4344,81,4667,0,24.64%
2020-04,אזור יהודה והשומרון,3797,מודיעין עילית,יישוב,6583,1786,4797,67,6516,88,6567,2,41.07%
2020-04,אזור יהודה והשומרון,3616,מעלה אדומים,יישוב,5363,2337,3026,218,5145,145,5347,5,25.54%
2020-04,אזור יהודה והשומרון,3608,מעלה אפרים,יישוב,250,100,150,6,244,16,248,0,30.77%
2020-04,אזור יהודה והשומרון,3660,עמנואל,יישוב,551,219,332,4,547,23,548,0,40.65%
2020-04,אזור יהודה והשומרון,3557,קדומים,יישוב,410,191,219,20,390,10,410,0,20.55%
2020-04,אזור יהודה והשומרון,3611,קריית ארבע,יישוב,1080,496,584,39,1041,56,1077,0,31.94%
2020-04,אזור יהודה והשומרון,3640,קרני שומרון,יישוב,1027,483,544,53,974,34,1023,1,25.13%
2020-04,הדרום,31,אופקים,יישוב,4114,1450,2664,118,3996,424,4088,7,28.33%
2020-04,הדרום,2600,אילת,יישוב,15919,7644,8275,266,15653,899,15837,0,45.60%
2020-04,הדרום,70,אשדוד,יישוב,30650,12437,18213,1153,29497,2515,30451,25,27.23%
2020-04,הדרום,7100,אשקלון,יישוב,19103,7749,11354,807,18296,1954,18840,9,25.40%
2020-04,הדרום,9000,באר שבע,יישוב,26415,10723,15692,1537,24878,3185,26124,21,24.38%
2020-04,הדרום,2200,דימונה,יישוב,5364,2150,3214,246,5118,1057,5299,6,27.38%
2020-04,הדרום,1303,חורה,יישוב,1258,785,473,15,1243,445,1230,2,25.58%
2020-04,הדרום,831,ירוחם,יישוב,1449,588,861,75,1374,231,1430,7,27.72%
2020-04,הדרום,1059,כסיפה,יישוב,2027,1201,826,20,2007,925,2019,0,36.60%
2020-04,הדרום,1271,להבים,יישוב,533,216,317,38,495,20,531,0,15.05%
2020-04,הדרום,1060,לקיה,יישוב,1264,726,538,12,1252,491,1231,0,25.36%
2020-04,הדרום,69,מ.א. אל קסום,מועצה איזורית,1837,936,901,23,1814,761,1804,0,52.86%
2020-04,הדרום,38,מ.א. אשכול,מועצה איזורית,1329,516,813,85,1244,34,1328,0,18.94%
2020-04,הדרום,33,מ.א. באר טוביה,מועצה איזורית,2551,965,1586,155,2396,117,2540,0,22.43%
2020-04,הדרום,41,מ.א. בני שמעון,מועצה איזורית,881,308,573,68,813,29,879,0,18.16%
2020-04,הדרום,54,מ.א. הערבה התיכונה,מועצה איזורית,373,126,247,40,333,10,372,0,19.52%
2020-04,הדרום,53,מ.א. חבל אילות,מועצה איזורית,409,151,258,14,395,7,408,0,16.39%
2020-04,הדרום,36,מ.א. חוף אשקלון,מועצה איזורית,1950,786,1164,104,1846,88,1943,0,22.34%
2020-04,הדרום,35,מ.א. יואב,מועצה איזורית,819,319,500,78,741,38,817,0,19.99%
2020-04,הדרום,50,מ.א. לכיש,מועצה איזורית,1325,525,800,78,1247,67,1322,0,23.73%
2020-04,הדרום,42,מ.א. מרחבים,מועצה איזורית,1464,482,982,71,1393,52,1455,0,23.11%
2020-04,הדרום,68,מ.א. נווה מדבר,מועצה איזורית,396,219,177,7,389,102,392,0,20.75%
2020-04,הדרום,48,מ.א. רמת נגב,מועצה איזורית,860,334,526,94,766,227,858,0,25.76%
2020-04,הדרום,39,מ.א. שדות נגב,מועצה איזורית,1105,393,712,69,1036,34,1101,0,22.65%
2020-04,הדרום,37,מ.א. שער הנגב,מועצה איזורית,928,360,568,127,801,91,923,0,23.08%
2020-04,הדרום,34,מ.א. שפיר,מועצה איזורית,1158,465,693,62,1096,66,1155,0,23.16%
2020-04,הדרום,51,מ.א. תמר,מועצה איזורית,164,83,81,14,150,10,164,0,25.19%
2020-04,הדרום,1268,מיתר,יישוב,875,372,503,72,803,24,873,0,17.72%
2020-04,הדרום,99,מצפה רמון,יישוב,966,407,559,61,905,185,956,0,34.14%
2020-04,הדרום,246,נתיבות,יישוב,5223,1915,3308,199,5024,498,5177,16,31.40%
2020-04,הדרום,666,עומר,יישוב,686,322,364,65,621,18,684,0,16.22%
2020-04,הדרום,2560,ערד,יישוב,4169,1735,2434,203,3966,403,4129,5,32.46%
2020-04,הדרום,1192,ערערה-בנגב,יישוב,1582,850,732,52,1530,854,1547,0,30.10%
2020-04,הדרום,2630,קריית גת,יישוב,8162,3338,4824,298,7864,770,8102,3,27.52%
2020-04,הדרום,1034,קריית מלאכי,יישוב,3566,1552,2014,105,3461,390,3527,1,28.34%
2020-04,הדרום,1161,רהט,יישוב,4896,2440,2456,51,4845,1510,4861,19,21.67%
2020-04,הדרום,1286,שגב-שלום,יישוב,687,388,299,7,680,280,673,0,20.73%
2020-04,הדרום,1031,שדרות,יישוב,3960,1740,2220,229,3731,490,3872,6,26.10%
2020-04,הדרום,1054,תל שבע,יישוב,1717,895,822,16,1701,657,1668,0,29.00%
2020-04,המרכז,1066,"בני עי""ש",יישוב,994,403,591,25,969,64,985,0,24.67%
2020-04,המרכז,182,אבן יהודה,יישוב,1434,595,839,102,1332,31,1432,0,20.47%
2020-04,המרכז,41,אליכין,יישוב,503,232,271,20,483,15,501,0,25.59%
2020-04,המרכז,1309,אלעד,יישוב,5423,1907,3516,89,5334,105,5399,1,37.93%
2020-04,המרכז,2530,באר יעקב,יישוב,3157,1322,1835,184,2973,90,3150,0,24.42%
2020-04,המרכז,466,בית דגן,יישוב,1039,462,577,37,1002,36,1037,0,27.72%
2020-04,המרכז,681,גבעת שמואל,יישוב,2570,1106,1464,203,2367,70,2562,0,20.56%
2020-04,המרכז,2550,גדרה,יישוב,2844,1156,1688,126,2718,90,2832,0,21.82%
2020-04,המרכז,627,ג'לג'וליה,יישוב,1148,539,609,16,1132,61,1137,0,26.51%
2020-04,המרכז,166,גן יבנה,יישוב,2978,1187,1791,134,2844,101,2973,0,23.33%
2020-04,המרכז,229,גני תקווה,יישוב,2147,921,1226,131,2016,51,2141,0,22.15%
2020-04,המרכז,9700,הוד השרון,יישוב,7126,2943,4183,516,6610,151,7101,1,21.67%
2020-04,המרכז,1290,זמר,יישוב,782,431,351,7,775,72,779,0,23.85%
2020-04,המרכז,2730,טייבה,יישוב,5618,2861,2757,137,5481,516,5511,12,28.68%
2020-04,המרכז,2720,טירה,יישוב,3165,1513,1652,54,3111,109,3151,0,25.07%
2020-04,המרכז,2660,יבנה,יישוב,6241,2582,3659,213,6028,175,6223,0,24.74%
2020-04,המרכז,9400,יהוד,יישוב,4289,1822,2467,198,4091,62,4281,1,26.22%
2020-04,המרכז,1224,כוכב יאיר,יישוב,1076,449,627,81,995,19,1074,0,19.27%
2020-04,המרכז,633,כפר ברא,יישוב,386,207,179,8,378,18,385,0,23.88%
2020-04,המרכז,168,כפר יונה,יישוב,3198,1319,1879,133,3065,92,3188,1,27.08%
2020-04,המרכז,6900,כפר סבא,יישוב,11853,4968,6885,706,11147,291,11823,4,22.32%
2020-04,המרכז,634,כפר קאסם,יישוב,2608,1303,1305,21,2587,123,2600,0,25.23%
2020-04,המרכז,7000,לוד,יישוב,10641,4839,5802,296,10345,882,10595,4,28.69%
2020-04,המרכז,28,מ.א. ברנר,מועצה איזורית,802,340,462,52,750,9,799,0,19.66%
2020-04,המרכז,32,מ.א. גדרות,מועצה איזורית,455,179,276,31,424,5,453,0,18.39%
2020-04,המרכז,30,מ.א. גזר,מועצה איזורית,3032,1308,1724,196,2836,88,3024,0,22.53%
2020-04,המרכז,27,מ.א. גן רווה,מועצה איזורית,687,290,397,38,649,9,685,0,22.85%
2020-04,המרכז,20,מ.א. דרום השרון,מועצה איזורית,3599,1488,2111,231,3368,68,3587,0,22.17%
2020-04,המרכז,29,מ.א. חבל יבנה,מועצה איזורית,493,208,285,29,464,9,488,0,18.58%
2020-04,המרכז,25,מ.א. חבל מודיעין,מועצה איזורית,2687,1088,1599,142,2545,61,2677,0,24.36%
2020-04,המרכז,19,מ.א. חוף השרון,מועצה איזורית,1166,500,666,84,1082,27,1159,0,20.82%
2020-04,המרכז,18,מ.א. לב השרון,מועצה איזורית,2452,1033,1419,142,2310,62,2444,0,21.98%
2020-04,המרכז,31,מ.א. נחל שורק,מועצה איזורית,677,289,388,41,636,21,676,7,15.83%
2020-04,המרכז,16,מ.א. עמק חפר,מועצה איזורית,4363,1771,2592,272,4091,69,4349,0,22.10%
2020-04,המרכז,40,מ.א. שדות דן,מועצה איזורית,1690,729,961,88,1602,34,1684,0,26.12%
2020-04,המרכז,1200,מודיעין-מכבים-רעות*,יישוב,9850,4016,5834,634,9216,200,9826,17,21.24%
2020-04,המרכז,28,מזכרת בתיה,יישוב,1663,663,1000,84,1579,46,1657,0,20.37%
2020-04,המרכז,7200,נס ציונה,יישוב,5473,2361,3112,295,5178,181,5457,1,22.08%
2020-04,המרכז,7400,נתניה,יישוב,30573,13168,17405,1172,29401,1754,30441,3,28.09%
2020-04,המרכז,587,סביון*,יישוב,367,168,199,24,343,3,365,0,17.47%
2020-04,המרכז,171,פרדסייה,יישוב,868,392,476,55,813,11,865,0,22.99%
2020-04,המרכז,7900,פתח תקווה,יישוב,31872,13523,18349,1430,30442,1123,31769,15,24.60%
2020-04,המרכז,195,קדימה-צורן,יישוב,2694,1127,1567,154,2540,68,2686,0,22.85%
2020-04,המרכז,638,קלנסווה,יישוב,2329,1332,997,69,2260,176,2296,12,23.74%
2020-04,המרכז,469,קריית עקרון,יישוב,1594,658,936,32,1562,94,1587,0,26.26%
2020-04,המרכז,2640,ראש העין,יישוב,8796,3685,5111,501,8295,263,8769,2,28.08%
2020-04,המרכז,8300,ראשון לציון,יישוב,38679,16363,22316,1796,36883,1566,38590,4,27.49%
2020-04,המרכז,8400,רחובות,יישוב,17109,7006,10103,867,16242,754,17046,6,24.04%
2020-04,המרכז,8500,רמלה,יישוב,11122,5059,6063,229,10893,690,11071,10,28.55%
2020-04,המרכז,8700,רעננה,יישוב,8215,3506,4709,533,7682,210,8192,0,21.61%
2020-04,המרכז,1304,שוהם,יישוב,2463,1003,1460,174,2289,49,2456,0,20.27%
2020-04,המרכז,154,תל מונד,יישוב,1445,588,857,91,1354,36,1445,0,20.91%
2020-04,הצפון,473,אבו סנאן,יישוב,1919,910,1009,25,1894,352,1907,0,30.26%
2020-04,הצפון,478,אכסאל,יישוב,1561,835,726,37,1524,307,1558,0,24.47%
2020-04,הצפון,529,אעבלין,יישוב,1900,999,901,33,1867,277,1889,0,30.73%
2020-04,הצפון,482,בועיינה-נוג'ידאת,יישוב,1228,690,538,29,1199,173,1220,0,28.25%
2020-04,הצפון,4001,בוקעאתא,יישוב,871,416,455,25,846,172,866,0,29.70%
2020-04,הצפון,998,ביר אל-מכסור,יישוב,1053,594,459,10,1043,184,1047,0,25.05%
2020-04,הצפון,480,בית ג'ן,יישוב,1286,450,836,42,1244,216,1275,0,21.27%
2020-04,הצפון,9200,בית שאן,יישוב,2961,1236,1725,72,2889,358,2947,2,27.97%
2020-04,הצפון,944,בסמת טבעון,יישוב,1139,574,565,13,1126,131,1133,0,31.25%
2020-04,הצפון,483,בענה,יישוב,1208,591,617,24,1184,229,1196,0,31.11%
2020-04,הצפון,1292,ג'דיידה-מכר,יישוב,3331,1668,1663,34,3297,625,3314,1,32.58%
2020-04,הצפון,485,ג'ולס,יישוב,697,226,471,16,681,75,695,0,21.29%
2020-04,הצפון,487,ג'ש (גוש חלב),יישוב,394,173,221,18,376,34,394,0,22.77%
2020-04,הצפון,489,דבורייה,יישוב,1153,620,533,29,1124,170,1147,0,24.25%
2020-04,הצפון,490,דייר אל-אסד,יישוב,1308,692,616,26,1282,221,1296,0,22.62%
2020-04,הצפון,492,דייר חנא,יישוב,1900,1039,861,41,1859,273,1897,0,36.34%
2020-04,הצפון,975,זרזיר,יישוב,916,450,466,11,905,125,909,0,25.19%
2020-04,הצפון,496,חורפיש,יישוב,535,252,283,16,519,64,526,0,17.24%
2020-04,הצפון,2034,חצור הגלילית,יישוב,1594,678,916,40,1554,135,1587,1,32.57%
2020-04,הצפון,6700,טבריה,יישוב,7522,3280,4242,159,7363,915,7418,11,33.07%
2020-04,הצפון,962,טובא-זנגרייה,יישוב,1098,442,656,19,1079,152,1092,0,32.33%
2020-04,הצפון,498,טורעאן,יישוב,2065,1234,831,48,2017,270,2054,1,32.42%
2020-04,הצפון,8900,טמרה,יישוב,4668,2563,2105,60,4608,874,4644,0,30.19%
2020-04,הצפון,1295,יאנוח-ג'ת,יישוב,696,298,398,16,680,71,689,1,21.45%
2020-04,הצפון,46,יבנאל,יישוב,523,236,287,7,516,71,518,0,32.44%
2020-04,הצפון,29,יסוד המעלה,יישוב,215,80,135,19,196,9,215,0,24.27%
2020-04,הצפון,499,יפיע,יישוב,2901,1702,1199,67,2834,373,2890,0,33.42%
2020-04,הצפון,240,יקנעם עילית,יישוב,2844,1116,1728,178,2666,167,2834,4,21.96%
2020-04,הצפון,502,ירכא,יישוב,1877,842,1035,10,1867,245,1869,0,26.63%
2020-04,הצפון,504,כאבול,יישוב,1523,850,673,28,1495,288,1512,0,28.14%
2020-04,הצפון,505,כאוכב אבו אל-היג'א,יישוב,615,287,328,16,599,125,611,0,32.85%
2020-04,הצפון,1296,כסרא-סמיע,יישוב,758,395,363,12,746,121,747,2,19.11%
2020-04,הצפון,978,כעביה-טבאש-חג'אג'רה,יישוב,761,427,334,28,733,107,756,0,28.98%
2020-04,הצפון,1263,כפר ורדים,יישוב,619,244,375,44,575,15,616,2,19.79%
2020-04,הצפון,507,כפר יאסיף,יישוב,1681,811,870,19,1662,220,1668,0,30.87%
2020-04,הצפון,508,כפר כמא,יישוב,302,140,162,11,291,26,300,0,17.20%
2020-04,הצפון,509,כפר כנא,יישוב,3233,1904,1329,117,3116,587,3197,1,32.89%
2020-04,הצפון,510,כפר מנדא,יישוב,2633,1675,958,47,2586,469,2626,0,32.66%
2020-04,הצפון,47,כפר תבור,יישוב,484,204,280,37,447,12,483,0,20.43%
2020-04,הצפון,1139,כרמיאל,יישוב,6155,2582,3573,450,5705,732,6086,4,23.51%
2020-04,הצפון,65,מ.א. אל-בטוף,מועצה איזורית,1060,621,439,21,1039,161,1052,0,32.23%
2020-04,הצפון,66,מ.א. בוסתן אל-מרג,מועצה איזורית,94,54,40,2,92,20,94,1,2.67%
2020-04,הצפון,71,מ.א. גולן,מועצה איזורית,2013,831,1182,121,1892,63,2002,0,22.81%
2020-04,הצפון,8,מ.א. הגלבוע,מועצה איזורית,3408,1577,1831,147,3261,358,3395,0,24.04%
2020-04,הצפון,1,מ.א. הגליל העליון,מועצה איזורית,2092,821,1271,186,1906,56,2083,0,23.28%
2020-04,הצפון,3,מ.א. הגליל התחתון,מועצה איזורית,1400,569,831,79,1321,37,1393,0,23.12%
2020-04,הצפון,55,מ.א. מבואות החרמון,מועצה איזורית,1047,421,626,69,978,42,1046,0,26.08%
2020-04,הצפון,13,מ.א. מגידו,מועצה איזורית,1052,422,630,83,969,20,1049,0,18.56%
2020-04,הצפון,4,מ.א. מטה אשר,מועצה איזורית,3090,1304,1786,174,2916,200,3079,0,21.68%
2020-04,הצפון,52,מ.א. מעלה יוסף,מועצה איזורית,1400,563,837,72,1328,92,1392,0,24.27%
2020-04,הצפון,2,מ.א. מרום הגליל,מועצה איזורית,1726,759,967,68,1658,153,1717,0,24.05%
2020-04,הצפון,56,מ.א. משגב,מועצה איזורית,3196,1407,1789,240,2956,270,3170,0,22.42%
2020-04,הצפון,6,מ.א. עמק הירדן,מועצה איזורית,1852,755,1097,95,1757,81,1836,0,27.03%
2020-04,הצפון,7,מ.א. עמק המעיינות,מועצה איזורית,1466,580,886,79,1387,66,1463,0,22.31%
2020-04,הצפון,9,מ.א. עמק יזרעאל,מועצה איזורית,3889,1530,2359,327,3562,116,3870,0,19.78%
2020-04,הצפון,481,מגאר,יישוב,3162,1774,1388,65,3097,654,3143,0,29.81%
2020-04,הצפון,516,מג'ד אל-כרום,יישוב,2428,1377,1051,30,2398,281,2415,0,32.89%
2020-04,הצפון,65,מגדל,יישוב,302,111,191,5,297,24,299,0,29.81%
2020-04,הצפון,874,מגדל העמק,יישוב,3555,1475,2080,173,3382,339,3522,14,25.60%
2020-04,הצפון,4201,מג'דל שמס,יישוב,1722,953,769,59,1663,238,1713,1,32.73%
2020-04,הצפון,517,מזרעה,יישוב,653,308,345,7,646,94,646,1,29.98%
2020-04,הצפון,43,מטולה,יישוב,274,125,149,26,248,8,273,1,27.11%
2020-04,הצפון,4203,מסעדה,יישוב,513,265,248,19,494,99,511,0,28.84%
2020-04,הצפון,518,מעיליא,יישוב,397,180,217,23,374,36,391,0,22.75%
2020-04,הצפון,1063,מעלות-תרשיחא,יישוב,3123,1470,1653,160,2963,384,3083,15,25.22%
2020-04,הצפון,520,משהד,יישוב,1098,675,423,27,1071,146,1086,0,30.14%
2020-04,הצפון,9100,נהרייה,יישוב,8705,3765,4940,355,8350,1134,8599,37,27.03%
2020-04,הצפון,522,נחף,יישוב,1808,1111,697,26,1782,272,1794,0,32.18%
2020-04,הצפון,7300,נצרת,יישוב,12710,6945,5765,340,12370,1894,12667,2,34.42%
2020-04,הצפון,1061,נצרת עילית,יישוב,6636,3010,3626,289,6347,739,6540,9,27.71%
2020-04,הצפון,525,סאג'ור,יישוב,545,210,335,18,527,64,543,0,24.79%
2020-04,הצפון,7500,סח'נין,יישוב,5310,2839,2471,154,5156,1005,5285,0,34.57%
2020-04,הצפון,4501,ע'ג'ר,יישוב,421,228,193,6,415,52,418,0,34.32%
2020-04,הצפון,530,עיילבון,יישוב,865,444,421,16,849,93,862,0,29.60%
2020-04,הצפון,511,עילוט,יישוב,948,558,390,10,938,174,942,0,29.56%
2020-04,הצפון,532,עין מאהל,יישוב,1763,1075,688,28,1735,258,1753,0,29.83%
2020-04,הצפון,4502,עין קנייא,יישוב,352,181,171,5,347,61,351,0,31.97%
2020-04,הצפון,7600,עכו,יישוב,8634,3733,4901,265,8369,1948,8519,1,31.41%
2020-04,הצפון,7700,עפולה,יישוב,7683,3066,4617,365,7318,740,7635,5,27.66%
2020-04,הצפון,531,עראבה,יישוב,3137,1717,1420,86,3051,759,3114,2,28.17%
2020-04,הצפון,535,פסוטה,יישוב,462,221,241,21,441,46,458,2,25.59%
2020-04,הצפון,536,פקיעין (בוקייעה),יישוב,662,356,306,15,647,73,661,0,22.11%
2020-04,הצפון,8000,צפת,יישוב,4499,1999,2500,156,4343,652,4453,4,32.11%
2020-04,הצפון,4100,קצרין,יישוב,1126,493,633,57,1069,104,1120,0,27.78%
2020-04,הצפון,2800,קריית שמונה,יישוב,3537,1556,1981,180,3357,334,3507,6,26.84%
2020-04,הצפון,543,ראמה,יישוב,1231,617,614,42,1189,174,1223,0,29.83%
2020-04,הצפון,26,ראש פינה,יישוב,443,172,271,20,423,34,442,0,26.76%
2020-04,הצפון,542,ריינה,יישוב,2242,1246,996,50,2192,319,2225,0,30.17%
2020-04,הצפון,122,רמת ישי,יישוב,900,356,544,76,824,33,895,0,21.59%
2020-04,הצפון,913,שבלי - אום אל-גנם,יישוב,670,290,380,13,657,111,664,0,23.11%
2020-04,הצפון,812,שלומי,יישוב,987,404,583,18,969,103,981,5,26.79%
2020-04,הצפון,538,שעב,יישוב,955,535,420,17,938,268,949,0,28.57%
2020-04,הצפון,8800,שפרעם,יישוב,6074,3169,2905,112,5962,936,6028,0,30.87%
2020-04,חיפה,1326,"בסמ""ה",יישוב,1061,670,391,17,1044,203,1053,0,23.66%
2020-04,חיפה,2710,אום אל-פחם,יישוב,7398,4310,3088,105,7293,1723,7330,0,31.83%
2020-04,חיפה,1020,אור עקיבא,יישוב,2899,1222,1677,94,2805,198,2877,1,27.20%
2020-04,חיפה,6000,באקה אל-גרביה,יישוב,3711,2130,1581,50,3661,342,3697,1,28.30%
2020-04,חיפה,9800,בנימינה-גבעת עדה*,יישוב,1365,522,843,113,1252,40,1361,0,18.13%
2020-04,חיפה,541,ג'סר א-זרקא,יישוב,1900,944,956,7,1893,87,1887,0,29.49%
2020-04,חיפה,628,ג'ת,יישוב,1196,693,503,15,1181,106,1194,1,20.62%
2020-04,חיפה,494,דאלית אל-כרמל,יישוב,2227,905,1322,57,2170,210,2218,0,25.21%
2020-04,חיפה,9300,זכרון יעקב,יישוב,2312,865,1447,167,2145,64,2305,0,20.25%
2020-04,חיפה,6500,חדרה,יישוב,13897,5852,8045,492,13405,859,13782,4,26.50%
2020-04,חיפה,4000,חיפה,יישוב,35884,15408,20476,2353,33531,3384,35556,6,25.16%
2020-04,חיפה,1247,חריש,יישוב,1835,792,1043,122,1713,105,1827,0,40.23%
2020-04,חיפה,2100,טירת כרמל,יישוב,3539,1516,2023,152,3387,353,3509,0,28.65%
2020-04,חיפה,654,כפר קרע,יישוב,2170,1015,1155,53,2117,226,2163,1,23.04%
2020-04,חיפה,45,מ.א. אלונה,מועצה איזורית,233,97,136,14,219,2,232,0,21.74%
2020-04,חיפה,12,מ.א. זבולון,מועצה איזורית,1389,670,719,59,1330,142,1379,0,23.25%
2020-04,חיפה,15,מ.א. חוף הכרמל,מועצה איזורית,3202,1313,1889,314,2888,102,3189,0,21.53%
2020-04,חיפה,14,מ.א. מנשה,מועצה איזורית,2115,881,1234,114,2001,80,2111,0,24.55%
2020-04,חיפה,1327,מעלה עירון,יישוב,1850,1000,850,28,1822,413,1834,0,28.22%
2020-04,חיפה,2500,נשר,יישוב,3160,1296,1864,187,2973,232,3142,0,24.77%
2020-04,חיפה,534,עספיא,יישוב,1560,698,862,35,1525,143,1546,1,25.16%
2020-04,חיפה,637,ערערה,יישוב,2210,1138,1072,46,2164,322,2194,0,24.39%
2020-04,חיפה,537,פוריידיס,יישוב,1633,915,718,16,1617,75,1628,1,26.83%
2020-04,חיפה,7800,פרדס חנה-כרכור,יישוב,5000,2021,2979,339,4661,228,4980,4,23.23%
2020-04,חיפה,6800,קריית אתא,יישוב,8098,3292,4806,256,7842,732,8062,2,26.12%
2020-04,חיפה,9500,קריית ביאליק,יישוב,5511,2241,3270,234,5277,469,5477,0,25.67%
2020-04,חיפה,2300,קריית טבעון,יישוב,1680,721,959,133,1547,70,1667,0,19.87%
2020-04,חיפה,9600,קריית ים,יישוב,5478,2371,3107,186,5292,709,5431,1,25.73%
2020-04,חיפה,8200,קריית מוצקין,יישוב,5847,2376,3471,226,5621,425,5823,0,25.08%
2020-04,חיפה,922,רכסים,יישוב,1406,449,957,31,1375,92,1393,0,37.10%
2020-04,ירושלים,472,אבו גוש,יישוב,1274,752,522,37,1237,187,1264,0,36.32%
2020-04,ירושלים,2610,בית שמש,יישוב,12377,4842,7535,296,12081,492,12318,9,32.74%
2020-04,ירושלים,3000,ירושלים,יישוב,101037,52284,48753,3566,97471,8064,100506,21,31.34%
2020-04,ירושלים,26,מ.א. מטה יהודה,מועצה איזורית,6261,2764,3497,356,5905,236,6237,0,24.11%
2020-04,ירושלים,1015,מבשרת ציון,יישוב,3031,1429,1602,170,2861,148,3016,1,23.56%
2020-04,ירושלים,1137,קריית יערים,יישוב,733,259,474,26,707,21,731,0,40.68%
2020-04,תל אביב,2400,אור יהודה,יישוב,5763,2625,3138,129,5634,201,5734,4,29.87%
2020-04,תל אביב,565,אזור,יישוב,1973,834,1139,63,1910,67,1970,0,29.34%
2020-04,תל אביב,6100,בני ברק,יישוב,22807,7683,15124,327,22480,629,22702,3,37.62%
2020-04,תל אביב,6200,בת ים,יישוב,21345,9451,11894,908,20437,1394,21194,11,30.05%
2020-04,תל אביב,6300,גבעתיים,יישוב,7220,3113,4107,693,6527,200,7204,2,22.62%
2020-04,תל אביב,6400,הרצלייה,יישוב,12129,5123,7006,799,11330,177,12099,6,24.58%
2020-04,תל אביב,6600,חולון,יישוב,29258,12835,16423,1074,28184,1195,29161,13,28.90%
2020-04,תל אביב,267,כפר שמריהו,יישוב,139,64,75,8,131,1,139,0,16.67%
2020-04,תל אביב,2620,קריית אונו,יישוב,4076,1713,2363,350,3726,73,4061,1,20.71%
2020-04,תל אביב,8600,רמת גן,יישוב,21633,9216,12417,1492,20141,706,21571,8,26.37%
2020-04,תל אביב,2650,רמת השרון,יישוב,4970,2049,2921,351,4619,54,4962,2,21.59%
2020-04,תל אביב,5000,תל אביב -יפו,יישוב,66794,30134,36660,5444,61350,2547,66575,21,25.24%
